omop_concept_id,omop_concept_name,category,category_value,count_females,count_males,count_total
201826,Type 2 diabetes mellitus,ethnic,Hispanic or Latino,211593,127084,338677
320128,Essential hypertension,ethnic,Hispanic or Latino,210586,119016,329602
312648,Benign essential hypertension,ethnic,Hispanic or Latino,149889,82605,232494
433736,Obesity,ethnic,Hispanic or Latino,154765,72866,227631
432867,Hyperlipidemia,ethnic,Hispanic or Latino,144682,81588,226270
4103471,Observation of body mass index,ethnic,Hispanic or Latino,118981,95926,214907
201826,Type 2 diabetes mellitus,racial,White,108392,74927,183319
192278,Type II diabetes mellitus - poor control,ethnic,Hispanic or Latino,94903,65467,160370
320128,Essential hypertension,racial,White,87858,60796,148654
4103471,Observation of body mass index,racial,White,77105,67038,144143
433736,Obesity,racial,White,84113,45841,129954
312648,Benign essential hypertension,racial,White,82138,47371,129509
376065,Neurologic disorder associated with type II diabetes mellitus,ethnic,Hispanic or Latino,82989,43617,126606
437525,Overweight,ethnic,Hispanic or Latino,71461,51492,122953
4079876,Familial combined hyperlipidemia,ethnic,Hispanic or Latino,68703,51865,120568
320128,Essential hypertension,racial,Unknown,79504,37000,116504
4060985,BMI 30+ - obesity,ethnic,Hispanic or Latino,68611,30629,99240
432867,Hyperlipidemia,racial,White,57282,38461,95743
318800,GERD - Gastro-esophageal reflux disease,ethnic,Hispanic or Latino,62254,33049,95303
201826,Type 2 diabetes mellitus,racial,Unknown,59131,29801,88932
317009,Hyperreactive airway disease,ethnic,Hispanic or Latino,47870,39979,87849
80180,Osteoarthritis,ethnic,Hispanic or Latino,60230,21505,81735
432867,Hyperlipidemia,racial,Unknown,53208,28069,81277
257011,Acute upper respiratory infection,ethnic,Hispanic or Latino,42851,34739,77590
192278,Type II diabetes mellitus - poor control,racial,White,42129,34645,76774
432526,Needs influenza immunisation,ethnic,Hispanic or Latino,43001,33210,76211
4064377,Depression screening,ethnic,Hispanic or Latino,46179,28612,74791
140673,Hypothyroid,ethnic,Hispanic or Latino,62296,12300,74596
4079876,Familial combined hyperlipidemia,racial,White,42499,32037,74536
437525,Overweight,racial,White,41441,31798,73239
434005,Morbid obesity,ethnic,Hispanic or Latino,47104,24129,71233
440383,Depressive disorder,ethnic,Hispanic or Latino,50000,18577,68577
376065,Neurologic disorder associated with type II diabetes mellitus,racial,Unknown,46147,22115,68262
312648,Benign essential hypertension,racial,Unknown,41414,23745,65159
4060985,BMI 30+ - obesity,racial,White,42529,21383,63912
320128,Essential hypertension,ethnic,Not Hispanic or Latino,35381,26153,61534
317009,Hyperreactive airway disease,racial,White,30033,28502,58535
4096215,"Hyperlipidemia, group A",ethnic,Hispanic or Latino,39105,19373,58478
433736,Obesity,racial,Unknown,39404,15031,54435
257007,Allergic rhinitis,ethnic,Hispanic or Latino,31089,23177,54266
441542,Anxiety,ethnic,Hispanic or Latino,40832,10766,51598
257011,Acute upper respiratory infection,racial,White,27563,23899,51462
317576,Coronary arteriosclerosis,ethnic,Hispanic or Latino,27710,22581,50291
4064377,Depression screening,racial,White,29481,19463,48944
432526,Needs influenza immunisation,racial,White,26715,21655,48370
75617,Polyarticular osteoarthritis,ethnic,Hispanic or Latino,35940,12047,47987
4175226,Screening for malignant neoplasm of colon,ethnic,Hispanic or Latino,29840,18030,47870
439777,Anemia,ethnic,Hispanic or Latino,33824,13499,47323
432867,Hyperlipidemia,ethnic,Not Hispanic or Latino,28996,18225,47221
201826,Type 2 diabetes mellitus,ethnic,Not Hispanic or Latino,25624,19918,45542
434005,Morbid obesity,racial,White,29300,16045,45345
192278,Type II diabetes mellitus - poor control,racial,Unknown,27600,16245,43845
312648,Benign essential hypertension,ethnic,Not Hispanic or Latino,26954,16866,43820
4062637,TB - Tuberculosis screening,ethnic,Hispanic or Latino,23959,19672,43631
80502,Osteoporosis,ethnic,Hispanic or Latino,39622,1562,41184
439727,HIV - Human immunodeficiency virus infection,ethnic,Hispanic or Latino,5170,35935,41105
436962,Sleeplessness,ethnic,Hispanic or Latino,29944,10780,40724
318800,GERD - Gastro-esophageal reflux disease,racial,Unknown,27027,12898,39925
4103471,Observation of body mass index,ethnic,Not Hispanic or Latino,21282,18069,39351
75860,Costiveness,ethnic,Hispanic or Latino,26673,12211,38884
439727,HIV - Human immunodeficiency virus infection,racial,White,5026,33470,38496
197684,Dysuria,ethnic,Hispanic or Latino,27756,10293,38049
4103471,Observation of body mass index,racial,Unknown,21914,16121,38035
318800,GERD - Gastro-esophageal reflux disease,racial,White,23812,13837,37649
140673,Hypothyroid,racial,White,31478,6070,37548
80180,Osteoarthritis,racial,Unknown,26662,10028,36690
81112,Arthralgia of the lower leg,ethnic,Hispanic or Latino,24074,10805,34879
194133,Low back pain,ethnic,Hispanic or Latino,21441,13246,34687
4096215,"Hyperlipidemia, group A",racial,White,19693,14214,33907
257007,Allergic rhinitis,racial,White,18699,14863,33562
4086918,Viral screening,ethnic,Hispanic or Latino,20475,12300,32775
192279,Diabetic nephropathy,ethnic,Hispanic or Latino,17701,14628,32329
376065,Neurologic disorder associated with type II diabetes mellitus,racial,White,20712,10966,31678
254761,Cough,ethnic,Hispanic or Latino,18867,11157,30024
440383,Depressive disorder,racial,White,21558,7921,29479
4175226,Screening for malignant neoplasm of colon,racial,White,18198,11045,29243
433736,Obesity,ethnic,Not Hispanic or Latino,18922,10253,29175
4062637,TB - Tuberculosis screening,racial,White,15102,13837,28939
25297,Acute pharyngitis,ethnic,Hispanic or Latino,17400,10941,28341
374022,Hemiplegia,ethnic,Hispanic or Latino,12501,15785,28286
4079876,Familial combined hyperlipidemia,racial,Unknown,15005,12351,27356
4064918,Diabetes mellitus screening,ethnic,Hispanic or Latino,16059,11238,27297
140673,Hypothyroid,racial,Unknown,22138,4768,26906
440383,Depressive disorder,racial,Unknown,19430,7054,26484
440360,Pure hyperglyceridemia,ethnic,Hispanic or Latino,12068,14366,26434
200219,Abdominal pain,ethnic,Hispanic or Latino,18734,7116,25850
198995,Type 1 diabetes mellitus - poor control,ethnic,Hispanic or Latino,13876,11518,25394
313217,Atrial fibrillation,ethnic,Hispanic or Latino,13835,10808,24643
197684,Dysuria,racial,White,17800,6801,24601
372328,Otitis media,ethnic,Hispanic or Latino,12206,12367,24573
437525,Overweight,racial,Unknown,14122,10421,24543
81902,Urinary tract infectious disease,ethnic,Hispanic or Latino,21197,3038,24235
441542,Anxiety,racial,White,16530,7102,23632
134736,Backache,ethnic,Hispanic or Latino,15569,7850,23419
192278,Type II diabetes mellitus - poor control,ethnic,Not Hispanic or Latino,13867,9511,23378
317576,Coronary arteriosclerosis,racial,Unknown,13869,9460,23329
195306,Gastroduodenitis,ethnic,Hispanic or Latino,16001,7238,23239
436962,Sleeplessness,racial,Unknown,17156,6015,23171
432867,Hyperlipidemia,racial,Asian,15366,7459,22825
80180,Osteoarthritis,racial,White,17363,5283,22646
320128,Essential hypertension,racial,Asian,13089,9186,22275
312648,Benign essential hypertension,racial,Asian,14676,7408,22084
443767,Diabetic oculopathy,ethnic,Hispanic or Latino,13140,8864,22004
378253,HA - Headache,ethnic,Hispanic or Latino,15790,5874,21664
317009,Hyperreactive airway disease,racial,Unknown,13354,7933,21287
4086918,Viral screening,racial,White,12961,8305,21266
75617,Polyarticular osteoarthritis,racial,Unknown,14260,6748,21008
439777,Anemia,racial,White,13766,7201,20967
260123,Acute inflammation of sinus,ethnic,Hispanic or Latino,13013,7937,20950
433316,Giddiness,ethnic,Hispanic or Latino,14495,6429,20924
194133,Low back pain,racial,White,12498,8402,20900
260139,Acute bronchitis,ethnic,Hispanic or Latino,13326,7521,20847
73553,Arthropathy,ethnic,Hispanic or Latino,15934,4699,20633
317009,Hyperreactive airway disease,ethnic,Not Hispanic or Latino,11555,8998,20553
77670,Chest pain,ethnic,Hispanic or Latino,12954,7530,20484
432285,Recurrent major depressive episodes,ethnic,Hispanic or Latino,14660,5667,20327
198803,Nodular hyperplasia of prostate gland,ethnic,Hispanic or Latino,81,20141,20222
80502,Osteoporosis,racial,Unknown,18004,1886,19890
25297,Acute pharyngitis,racial,White,11622,8075,19697
254761,Cough,racial,White,11627,7758,19385
437525,Overweight,ethnic,Not Hispanic or Latino,10410,8924,19334
441542,Anxiety,racial,Unknown,14757,4398,19155
319835,Congestive cardiac failure,ethnic,Hispanic or Latino,12558,6560,19118
377861,Disorder of refraction AND/OR accommodation,ethnic,Hispanic or Latino,11233,7763,18996
140648,Onychomycosis due to dermatophyte,ethnic,Hispanic or Latino,10127,8496,18623
372328,Otitis media,racial,White,8793,9529,18322
4060985,BMI 30+ - obesity,racial,Unknown,13202,5111,18313
80180,Osteoarthritis,ethnic,Not Hispanic or Latino,13724,4545,18269
197672,Urinary incontinence,ethnic,Hispanic or Latino,14476,3508,17984
317576,Coronary arteriosclerosis,ethnic,Not Hispanic or Latino,10649,7137,17786
443597,Chronic kidney disease stage 3,ethnic,Hispanic or Latino,9787,7986,17773
4096215,"Hyperlipidemia, group A",racial,Unknown,13411,4301,17712
201826,Type 2 diabetes mellitus,racial,Asian,11298,6412,17710
439141,Abnormal increase in weight,ethnic,Hispanic or Latino,9614,8050,17664
4064375,Iron deficiency screening,ethnic,Hispanic or Latino,10219,7395,17614
80824,Senile osteoporosis,ethnic,Hispanic or Latino,16328,943,17271
78232,Shoulder joint pain,ethnic,Hispanic or Latino,11357,5679,17036
440360,Pure hyperglyceridemia,racial,White,7753,9248,17001
75617,Polyarticular osteoarthritis,racial,White,13317,3666,16983
432284,Single major depressive episode,ethnic,Hispanic or Latino,12024,4917,16941
318800,GERD - Gastro-esophageal reflux disease,ethnic,Not Hispanic or Latino,9948,6695,16643
317576,Coronary arteriosclerosis,racial,White,7365,9131,16496
80502,Osteoporosis,ethnic,Not Hispanic or Latino,13250,3222,16472
434005,Morbid obesity,racial,Unknown,11084,5003,16087
376112,Diabetic polyneuropathy,ethnic,Hispanic or Latino,9922,6153,16075
138525,Pain in limb,ethnic,Hispanic or Latino,10474,5449,15923
438557,Abnormal glucose level,ethnic,Hispanic or Latino,9536,6307,15843
439777,Anemia,racial,Unknown,12022,3811,15833
4060985,BMI 30+ - obesity,ethnic,Not Hispanic or Latino,9860,5959,15819
194083,Vaginitis and vulvovaginitis,ethnic,Hispanic or Latino,15698,0,15698
260123,Acute inflammation of sinus,racial,White,9653,6005,15658
81112,Arthralgia of the lower leg,racial,White,10799,4805,15604
4064918,Diabetes mellitus screening,racial,White,8765,6826,15591
75860,Costiveness,racial,White,9619,5959,15578
200219,Abdominal pain,racial,White,10723,4848,15571
321318,Angina,ethnic,Hispanic or Latino,11171,4319,15490
433595,Interstitial edema,ethnic,Hispanic or Latino,10334,5076,15410
443729,Peripheral circulatory disorder associated with type II diabetes mellitus,ethnic,Hispanic or Latino,10187,5143,15330
4062484,Cervical neoplasia screening,ethnic,Hispanic or Latino,15215,18,15233
378419,AD - Alzheimer's disease,ethnic,Hispanic or Latino,8834,6284,15118
81112,Arthralgia of the lower leg,racial,Unknown,10801,4244,15045
257011,Acute upper respiratory infection,racial,Unknown,8864,6031,14895
4064377,Depression screening,ethnic,Not Hispanic or Latino,8547,6263,14810
439147,Amnesia,ethnic,Hispanic or Latino,7976,6723,14699
198995,Type 1 diabetes mellitus - poor control,racial,White,7585,7077,14662
432526,Needs influenza immunisation,racial,Unknown,8637,6019,14656
260139,Acute bronchitis,racial,White,8982,5653,14635
133141,Tinea pedis,ethnic,Hispanic or Latino,7337,7243,14580
440383,Depressive disorder,ethnic,Not Hispanic or Latino,9301,5256,14557
437541,Glaucoma,ethnic,Hispanic or Latino,9195,5325,14520
140673,Hypothyroid,ethnic,Not Hispanic or Latino,11463,3013,14476
134438,CD - Contact dermatitis,ethnic,Hispanic or Latino,8480,5966,14446
80809,Rheumatoid arthritis,ethnic,Hispanic or Latino,12970,1467,14437
378253,HA - Headache,racial,White,10665,3685,14350
80502,Osteoporosis,racial,White,13411,812,14223
257581,Exacerbation of asthma,ethnic,Hispanic or Latino,6477,7740,14217
75860,Costiveness,racial,Unknown,11006,3149,14155
320128,Essential hypertension,racial,Other Race,9669,4416,14085
436238,Elevated levels of transaminase and lactic acid dehydrogenase,ethnic,Hispanic or Latino,8310,5773,14083
437264,Tobacco dependence syndrome,ethnic,Hispanic or Latino,5656,8411,14067
381591,Cerebrovascular disease,ethnic,Hispanic or Latino,5122,8883,14005
4079876,Familial combined hyperlipidemia,ethnic,Not Hispanic or Latino,6905,7029,13934
81902,Urinary tract infectious disease,racial,White,12188,1743,13931
134736,Backache,racial,White,8795,4989,13784
257007,Allergic rhinitis,racial,Unknown,8248,5525,13773
192279,Diabetic nephropathy,racial,Unknown,6162,7585,13747
436962,Sleeplessness,racial,White,9524,4200,13724
80502,Osteoporosis,racial,Asian,11102,2493,13595
141693,Elevated blood-pressure reading without diagnosis of hypertension,ethnic,Hispanic or Latino,6999,6507,13506
377889,Hearing loss,ethnic,Hispanic or Latino,7047,6454,13501
140214,Eruption of skin,ethnic,Hispanic or Latino,7666,5787,13453
4064377,Depression screening,racial,Unknown,8466,4752,13218
321052,Peripheral vascular disease,ethnic,Hispanic or Latino,8036,5173,13209
4308509,Impaired fasting glycaemia,ethnic,Hispanic or Latino,7217,5826,13043
437643,Gait abnormality,ethnic,Hispanic or Latino,6438,6576,13014
436659,Iron deficiency anaemia,ethnic,Hispanic or Latino,9414,3542,12956
4147961,Screening for malignant neoplasm of breast,ethnic,Hispanic or Latino,12880,9,12889
436962,Sleeplessness,ethnic,Not Hispanic or Latino,8259,4545,12804
197928,Menstruation absent,ethnic,Hispanic or Latino,12664,21,12685
374888,Dementia associated with another disease,ethnic,Hispanic or Latino,8834,3834,12668
438332,Disease of possible viral origin,ethnic,Hispanic or Latino,5805,6778,12583
374022,Hemiplegia,racial,Unknown,6601,5939,12540
443767,Diabetic oculopathy,racial,Unknown,7068,5258,12326
439147,Amnesia,racial,Unknown,6677,5644,12321
374366,Sensorineural hearing loss,ethnic,Hispanic or Latino,7947,4308,12255
80180,Osteoarthritis,racial,Asian,9331,2801,12132
439926,Malaise and fatigue,ethnic,Hispanic or Latino,7365,4687,12052
374375,Impacted cerumen,ethnic,Hispanic or Latino,6668,5237,11905
192279,Diabetic nephropathy,racial,White,6277,5557,11834
313217,Atrial fibrillation,racial,White,5612,6215,11827
376065,Neurologic disorder associated with type II diabetes mellitus,ethnic,Not Hispanic or Latino,6569,5152,11721
196991,Chronic renal disease,ethnic,Hispanic or Latino,5966,5741,11707
434056,Late effects of cerebrovascular disease,ethnic,Hispanic or Latino,5676,6024,11700
432526,Needs influenza immunisation,ethnic,Not Hispanic or Latino,6316,5253,11569
443350,Lower urinary tract symptoms,ethnic,Hispanic or Latino,7,11493,11500
4299535,Pregnancy confirmed,ethnic,Hispanic or Latino,11461,14,11475
195306,Gastroduodenitis,racial,Unknown,8899,2553,11452
313878,Respiratory symptoms,ethnic,Hispanic or Latino,6578,4871,11449
196523,Diarrhea,ethnic,Hispanic or Latino,6707,4733,11440
437264,Tobacco dependence syndrome,racial,White,5108,6084,11192
4064375,Iron deficiency screening,racial,White,6226,4745,10971
375545,Lens opacity,ethnic,Hispanic or Latino,7171,3800,10971
434005,Morbid obesity,ethnic,Not Hispanic or Latino,7176,3761,10937
437041,Mother not delivered,ethnic,Hispanic or Latino,10879,9,10888
320128,Essential hypertension,racial,Black or African American ,5900,4894,10794
444202,Abscess,ethnic,Hispanic or Latino,6173,4600,10773
441542,Anxiety,ethnic,Not Hispanic or Latino,6748,3887,10635
377861,Disorder of refraction AND/OR accommodation,racial,White,5952,4572,10524
314658,Cardiomegaly,ethnic,Hispanic or Latino,7454,3025,10479
4299535,Pregnancy confirmed,racial,White,10414,44,10458
317576,Coronary arteriosclerosis,racial,Asian,7022,3298,10320
375281,Acute suppurative otitis media - tympanic membrane intact,ethnic,Hispanic or Latino,5161,5141,10302
138525,Pain in limb,racial,White,6923,3284,10207
374060,Acute ill-defined cerebrovascular disease,ethnic,Hispanic or Latino,4207,5897,10104
201826,Type 2 diabetes mellitus,racial,Other Race,6401,3574,9975
313217,Atrial fibrillation,racial,Unknown,6139,3763,9902
257581,Exacerbation of asthma,racial,White,4681,5200,9881
432867,Hyperlipidemia,racial,Other Race,6693,3172,9865
201254,Insulin dependent diabetes mellitus,ethnic,Hispanic or Latino,6173,3666,9839
198558,Nycturia,ethnic,Hispanic or Latino,6633,3192,9825
4096215,"Hyperlipidemia, group A",ethnic,Not Hispanic or Latino,5559,4071,9630
437663,Fever,ethnic,Hispanic or Latino,4871,4722,9593
439727,HIV - Human immunodeficiency virus infection,ethnic,Not Hispanic or Latino,2337,7257,9594
77670,Chest pain,racial,White,5476,4087,9563
4175226,Screening for malignant neoplasm of colon,racial,Unknown,5716,3807,9523
198803,Nodular hyperplasia of prostate gland,racial,Unknown,0,9513,9513
194133,Low back pain,racial,Unknown,5844,3659,9503
438557,Abnormal glucose level,racial,White,4984,4474,9458
134438,CD - Contact dermatitis,racial,White,5414,4032,9446
443783,Chronic disease,ethnic,Hispanic or Latino,5276,4149,9425
80824,Senile osteoporosis,racial,Unknown,8717,639,9356
375806,Idiopathic peripheral neuropathy,ethnic,Hispanic or Latino,6033,3305,9338
439141,Abnormal increase in weight,racial,White,4773,4559,9332
75650,Proteinuria,ethnic,Hispanic or Latino,4577,4740,9317
321318,Angina,racial,Unknown,5932,3383,9315
140648,Onychomycosis due to dermatophyte,racial,White,4736,4540,9276
194133,Low back pain,ethnic,Not Hispanic or Latino,5377,3848,9225
140214,Eruption of skin,racial,White,4894,4273,9167
198964,Chronic type C viral hepatitis,ethnic,Hispanic or Latino,3319,5706,9025
77354,Primary localised osteoarthrosis of lower leg,ethnic,Hispanic or Latino,6817,2194,9011
257007,Allergic rhinitis,ethnic,Not Hispanic or Latino,5134,3862,8996
378419,AD - Alzheimer's disease,racial,Unknown,5817,3153,8970
440029,Viral disease,ethnic,Hispanic or Latino,4609,4310,8919
443865,Non-infective colitis,ethnic,Hispanic or Latino,4825,4089,8914
197913,Disorder of function of stomach,ethnic,Hispanic or Latino,6049,2818,8867
442793,Diabetic complication,ethnic,Hispanic or Latino,4938,3869,8807
79106,Arthralgia of the pelvic region and thigh,ethnic,Hispanic or Latino,5676,3130,8806
372409,Sciatica neuralgia,ethnic,Hispanic or Latino,5948,2841,8789
433316,Giddiness,racial,White,6118,2670,8788
259153,Throat soreness,ethnic,Hispanic or Latino,5628,3133,8761
4062637,TB - Tuberculosis screening,racial,Unknown,5083,3613,8696
73553,Arthropathy,racial,Unknown,7206,1467,8673
319835,Congestive cardiac failure,racial,Unknown,6371,2282,8653
141693,Elevated blood-pressure reading without diagnosis of hypertension,racial,White,4517,4087,8604
312338,Benign hypertensive heart disease with congestive heart failure,ethnic,Hispanic or Latino,3692,4894,8586
444101,Hypertensive heart failure,ethnic,Hispanic or Latino,5463,3112,8575
194083,Vaginitis and vulvovaginitis,racial,White,8522,21,8543
443238,Diabetic - poor control,ethnic,Hispanic or Latino,4407,4094,8501
381270,Parkinson's disease,ethnic,Hispanic or Latino,4885,3611,8496
443597,Chronic kidney disease stage 3,racial,White,4667,3823,8490
195306,Gastroduodenitis,racial,White,4724,3758,8482
442752,Myalgia,ethnic,Hispanic or Latino,6948,1467,8415
198803,Nodular hyperplasia of prostate gland,ethnic,Not Hispanic or Latino,5,8407,8412
438332,Disease of possible viral origin,racial,White,3905,4501,8406
257011,Acute upper respiratory infection,ethnic,Not Hispanic or Latino,4423,3951,8374
197928,Menstruation absent,racial,White,8126,212,8338
255573,Chronic obstructive lung disease,ethnic,Hispanic or Latino,4885,3436,8321
132740,Positive skin test reaction,ethnic,Hispanic or Latino,5550,2698,8248
78232,Shoulder joint pain,racial,White,5030,3190,8220
436238,Elevated levels of transaminase and lactic acid dehydrogenase,racial,White,4421,3731,8152
4175226,Screening for malignant neoplasm of colon,ethnic,Not Hispanic or Latino,4568,3457,8025
432285,Recurrent major depressive episodes,racial,White,6061,1944,8005
318800,GERD - Gastro-esophageal reflux disease,racial,Asian,4915,3071,7986
4147961,Screening for malignant neoplasm of breast,racial,White,7951,25,7976
4062484,Cervical neoplasia screening,racial,White,7924,46,7970
197684,Dysuria,racial,Unknown,5819,2137,7956
439777,Anemia,ethnic,Not Hispanic or Latino,5143,2493,7636
256451,Bronchitis,ethnic,Hispanic or Latino,4837,2795,7632
133141,Tinea pedis,racial,White,3813,3781,7594
258780,Chronic obstructive bronchitis,ethnic,Hispanic or Latino,4736,2829,7565
4308509,Impaired fasting glycaemia,racial,White,4053,3464,7517
377091,Fits - convulsions,ethnic,Hispanic or Latino,2760,4727,7487
196523,Diarrhea,racial,White,4099,3374,7473
4064905,Venereal disease screening,ethnic,Hispanic or Latino,4911,2500,7411
374366,Sensorineural hearing loss,racial,Unknown,4904,2498,7402
197672,Urinary incontinence,racial,White,6509,886,7395
440674,Gout,ethnic,Hispanic or Latino,1465,5929,7394
374375,Impacted cerumen,racial,White,3970,3413,7383
432285,Recurrent major depressive episodes,racial,Unknown,4685,2691,7376
75617,Polyarticular osteoarthritis,ethnic,Not Hispanic or Latino,5527,1842,7369
77074,Joint pain,ethnic,Hispanic or Latino,5189,2139,7328
198995,Type 1 diabetes mellitus - poor control,racial,Unknown,4262,3057,7319
375281,Acute suppurative otitis media - tympanic membrane intact,racial,White,3452,3855,7307
444202,Abscess,racial,White,3968,3282,7250
134736,Backache,racial,Unknown,5042,2206,7248
439926,Malaise and fatigue,racial,White,3763,3455,7218
432867,Hyperlipidemia,racial,Black or African American ,4359,2843,7202
443597,Chronic kidney disease stage 3,racial,Unknown,3696,3473,7169
319835,Congestive cardiac failure,racial,White,4112,3031,7143
442067,Atopic dermatitis and related conditions,ethnic,Hispanic or Latino,3659,3466,7125
374888,Dementia associated with another disease,racial,Unknown,5106,2001,7107
255848,Pneumonia,ethnic,Hispanic or Latino,3540,3498,7038
376707,Acute conjunctivitis,ethnic,Hispanic or Latino,3726,3312,7038
439708,Disorders of initiating and maintaining sleep,ethnic,Hispanic or Latino,4929,2070,6999
257012,Chronic rhinosinusitis,ethnic,Hispanic or Latino,4492,2500,6992
436962,Sleeplessness,racial,Asian,4802,2183,6985
436659,Iron deficiency anaemia,racial,White,4968,1994,6962
318736,Migraine,ethnic,Hispanic or Latino,6224,722,6946
198964,Chronic type C viral hepatitis,racial,White,2507,4405,6912
314658,Cardiomegaly,racial,Unknown,5244,1668,6912
80767,Breast irregular nodularity,ethnic,Hispanic or Latino,6753,145,6898
433736,Obesity,racial,Other Race,4386,2486,6872
437541,Glaucoma,racial,Unknown,4267,2594,6861
380378,Epilepsy,ethnic,Hispanic or Latino,3206,3641,6847
432284,Single major depressive episode,racial,White,4694,2132,6826
80809,Rheumatoid arthritis,racial,Unknown,6210,570,6780
4302252,High risk pregnancy care,ethnic,Hispanic or Latino,6771,0,6771
254761,Cough,racial,Unknown,4589,2151,6740
437663,Fever,racial,White,3188,3540,6728
81902,Urinary tract infectious disease,racial,Unknown,5955,773,6728
313878,Respiratory symptoms,racial,White,3623,3103,6726
4103471,Observation of body mass index,racial,Asian,3825,2882,6707
192278,Type II diabetes mellitus - poor control,racial,Asian,4607,2086,6693
434613,Generalized anxiety disorder,ethnic,Hispanic or Latino,5104,1543,6647
433316,Giddiness,racial,Unknown,4724,1914,6638
193782,End stage renal disease,ethnic,Hispanic or Latino,2939,3639,6578
192667,Atrophic gastritis,ethnic,Hispanic or Latino,4239,2295,6534
260125,Acute bronchiolitis,ethnic,Hispanic or Latino,3052,3482,6534
73553,Arthropathy,racial,White,5205,1323,6528
443767,Diabetic oculopathy,racial,White,3892,2615,6507
81112,Arthralgia of the lower leg,ethnic,Not Hispanic or Latino,4963,1493,6456
437264,Tobacco dependence syndrome,ethnic,Not Hispanic or Latino,3098,3342,6440
198803,Nodular hyperplasia of prostate gland,racial,White,7,6419,6426
312934,Atherosclerosis of aorta,ethnic,Hispanic or Latino,4326,2061,6387
4093344,Prostate observation,ethnic,Hispanic or Latino,18,6304,6322
316999,Cardiac arrhythmia,ethnic,Hispanic or Latino,4241,2075,6316
4077577,Moderate recurrent major depression,ethnic,Hispanic or Latino,4221,2024,6245
259153,Throat soreness,racial,White,4032,2201,6233
375791,Uncomplicated senile dementia,ethnic,Hispanic or Latino,3648,2578,6226
379019,Inflammation of conjunctiva,ethnic,Hispanic or Latino,3402,2813,6215
24134,Nonspecific pain in the neck region,ethnic,Hispanic or Latino,4566,1633,6199
200219,Abdominal pain,racial,Unknown,4770,1396,6166
195562,Hemorrhoids,ethnic,Hispanic or Latino,3648,2475,6123
75860,Costiveness,ethnic,Not Hispanic or Latino,3928,2192,6120
433595,Interstitial edema,racial,White,4204,1895,6099
434169,Abnormal findings on diagnostic imaging of breast,ethnic,Hispanic or Latino,6054,14,6068
433595,Interstitial edema,racial,Unknown,3597,2436,6033
443729,Peripheral circulatory disorder associated with type II diabetes mellitus,racial,Unknown,3675,2346,6021
197381,Epigastric pain,ethnic,Hispanic or Latino,4515,1497,6012
440029,Viral disease,racial,White,3107,2903,6010
196168,Irregular menstrual bleeding,ethnic,Hispanic or Latino,5964,0,5964
376112,Diabetic polyneuropathy,racial,White,3544,2406,5950
192278,Type II diabetes mellitus - poor control,racial,Other Race,3940,2008,5948
77670,Chest pain,racial,Unknown,4476,1467,5943
381859,Infective OE,ethnic,Hispanic or Latino,3606,2318,5924
437041,Mother not delivered,racial,White,5879,32,5911
381292,Chronic allergic conjunctivitis,ethnic,Hispanic or Latino,3517,2383,5900
201826,Type 2 diabetes mellitus,racial,Black or African American ,3119,2769,5888
4298854,HIV seropositivity,racial,White,683,5203,5886
198194,Female genital organ symptoms,ethnic,Hispanic or Latino,5877,5,5882
4103471,Observation of body mass index,racial,Other Race,3103,2776,5879
25297,Acute pharyngitis,racial,Unknown,4069,1796,5865
317302,Coronary sinus rhythm disorder,ethnic,Hispanic or Latino,3731,2121,5852
443350,Lower urinary tract symptoms,racial,White,5,5842,5847
443865,Non-infective colitis,racial,White,3002,2824,5826
377889,Hearing loss,racial,White,2912,2882,5794
4298854,HIV seropositivity,ethnic,Hispanic or Latino,635,5120,5755
193253,Nephritis,ethnic,Hispanic or Latino,3091,2629,5720
4103471,Observation of body mass index,racial,Black or African American ,2585,3091,5676
199866,Acute gastritis,ethnic,Hispanic or Latino,4078,1596,5674
442752,Myalgia,racial,White,4970,683,5653
376683,Non proliferative diabetic retinopathy,ethnic,Hispanic or Latino,3236,2415,5651
432870,Thrombocytopenia,ethnic,Hispanic or Latino,3717,1932,5649
197672,Urinary incontinence,racial,Unknown,3963,1677,5640
78232,Shoulder joint pain,racial,Unknown,3549,2056,5605
198124,Disorder of kidney,ethnic,Hispanic or Latino,3174,2424,5598
257004,Acute exacerbation of chronic obstructive airways disease,ethnic,Hispanic or Latino,2629,2965,5594
196456,Cholecystolithiasis,ethnic,Hispanic or Latino,4319,1274,5593
258780,Chronic obstructive bronchitis,racial,Unknown,3383,2187,5570
4086918,Viral screening,racial,Unknown,3659,1909,5568
141095,Acne,ethnic,Hispanic or Latino,3107,2459,5566
81611,Diverticular disease of colon,ethnic,Hispanic or Latino,4099,1467,5566
440383,Depressive disorder,racial,Asian,3544,2003,5547
313236,Cough variant asthma,ethnic,Hispanic or Latino,2877,2659,5536
197684,Dysuria,ethnic,Not Hispanic or Latino,3915,1612,5527
374924,Generalized convulsive epilepsy,ethnic,Hispanic or Latino,2479,3045,5524
198803,Nodular hyperplasia of prostate gland,racial,Asian,5,5513,5518
74132,Degeneration of lumbosacral intervertebral disc,ethnic,Hispanic or Latino,4188,1320,5508
377861,Disorder of refraction AND/OR accommodation,racial,Unknown,3540,1962,5502
444246,Cirrhosis of liver not due to alcohol,ethnic,Hispanic or Latino,2990,2454,5444
75354,Osteochondropathy,ethnic,Hispanic or Latino,5099,343,5442
4161977,Patient with cardiac pacemaker,ethnic,Hispanic or Latino,2979,2459,5438
201254,Insulin dependent diabetes mellitus,racial,White,2808,2617,5425
374060,Acute ill-defined cerebrovascular disease,racial,Unknown,3356,2059,5415
133228,Dental caries,ethnic,Hispanic or Latino,3082,2309,5391
437643,Gait abnormality,racial,Unknown,2530,2859,5389
440360,Pure hyperglyceridemia,racial,Unknown,2378,3006,5384
134736,Backache,ethnic,Not Hispanic or Latino,3121,2252,5373
439141,Abnormal increase in weight,racial,Unknown,2898,2454,5352
78517,Arthralgia of multiple joints,ethnic,Hispanic or Latino,4232,1111,5343
439727,HIV - Human immunodeficiency virus infection,racial,Black or African American ,1511,3823,5334
196991,Chronic renal disease,racial,White,2535,2774,5309
140648,Onychomycosis due to dermatophyte,racial,Unknown,3215,2049,5264
80809,Rheumatoid arthritis,racial,White,4630,633,5263
436230,Blood chemistry abnormal,ethnic,Hispanic or Latino,3360,1893,5253
4062637,TB - Tuberculosis screening,ethnic,Not Hispanic or Latino,2700,2530,5230
80824,Senile osteoporosis,racial,White,5124,99,5223
432284,Single major depressive episode,racial,Unknown,3066,2144,5210
321052,Peripheral vascular disease,racial,Unknown,2500,2703,5203
4064918,Diabetes mellitus screening,racial,Unknown,3234,1969,5203
197236,Uterine fibroid,ethnic,Hispanic or Latino,5159,0,5159
316822,Finding of heart murmur,ethnic,Hispanic or Latino,3363,1730,5093
372409,Sciatica neuralgia,racial,White,3528,1555,5083
260139,Acute bronchitis,racial,Unknown,3457,1612,5069
257012,Chronic rhinosinusitis,racial,White,3165,1895,5060
4100857,Pickwickian syndrome,ethnic,Hispanic or Latino,2854,2206,5060
315078,Palpitations,ethnic,Hispanic or Latino,3961,1072,5033
321318,Angina,ethnic,Not Hispanic or Latino,3859,1166,5025
312338,Benign hypertensive heart disease with congestive heart failure,racial,Unknown,2208,2813,5021
312648,Benign essential hypertension,racial,Other Race,3114,1904,5018
256451,Bronchitis,racial,White,2962,2052,5014
379784,Senile dementia with depression,ethnic,Hispanic or Latino,3372,1628,5000
437247,Anaemia of chronic disease,ethnic,Hispanic or Latino,2838,2144,4982
75617,Polyarticular osteoarthritis,racial,Asian,4032,948,4980
260123,Acute inflammation of sinus,ethnic,Not Hispanic or Latino,3027,1941,4968
434056,Late effects of cerebrovascular disease,racial,Unknown,1861,3075,4936
437382,Urine observation,ethnic,Hispanic or Latino,3995,927,4922
375806,Idiopathic peripheral neuropathy,racial,White,3623,1295,4918
4086918,Viral screening,ethnic,Not Hispanic or Latino,2896,2017,4913
381591,Cerebrovascular disease,racial,Unknown,2236,2654,4890
381591,Cerebrovascular disease,ethnic,Not Hispanic or Latino,2178,2712,4890
198995,Type 1 diabetes mellitus - poor control,ethnic,Not Hispanic or Latino,2592,2293,4885
377574,Presbycusis,ethnic,Hispanic or Latino,1587,3287,4874
440426,Vertigo as late effect of stroke,ethnic,Hispanic or Latino,3142,1732,4874
376065,Neurologic disorder associated with type II diabetes mellitus,racial,Asian,2082,2790,4872
376112,Diabetic polyneuropathy,racial,Unknown,3232,1628,4860
380094,Carpal tunnel syndrome,ethnic,Hispanic or Latino,3859,998,4857
441408,Vomiting,ethnic,Hispanic or Latino,2703,2132,4835
318800,GERD - Gastro-esophageal reflux disease,racial,Other Race,3245,1582,4827
433736,Obesity,racial,Black or African American ,3528,1279,4807
137682,Skin sensation disturbance,ethnic,Hispanic or Latino,3296,1507,4803
140821,Spasm,ethnic,Hispanic or Latino,2684,2093,4777
255848,Pneumonia,racial,White,2305,2468,4773
443783,Chronic disease,racial,White,2836,1911,4747
376707,Acute conjunctivitis,racial,White,2452,2293,4745
75650,Proteinuria,racial,White,2194,2539,4733
437038,Blood in urine,ethnic,Hispanic or Latino,2806,1925,4731
260427,Common cold,ethnic,Hispanic or Latino,2608,2121,4729
434056,Late effects of cerebrovascular disease,racial,White,1969,2753,4722
312648,Benign essential hypertension,racial,Black or African American ,3140,1562,4702
24660,Acute tonsillitis,ethnic,Hispanic or Latino,2827,1856,4683
443729,Peripheral circulatory disorder associated with type II diabetes mellitus,racial,White,3163,1513,4676
378253,HA - Headache,racial,Unknown,3222,1435,4657
443537,Deep venous thrombosis of lower extremity,ethnic,Hispanic or Latino,2866,1783,4649
254761,Cough,ethnic,Not Hispanic or Latino,2673,1941,4614
258780,Chronic obstructive bronchitis,ethnic,Not Hispanic or Latino,2360,2226,4586
140641,Verruca vulgaris,ethnic,Hispanic or Latino,2268,2316,4584
433440,Dysthymia,ethnic,Hispanic or Latino,3172,1373,4545
313217,Atrial fibrillation,ethnic,Not Hispanic or Latino,1695,2834,4529
138525,Pain in limb,racial,Unknown,2965,1562,4527
314754,Wheezing,ethnic,Hispanic or Latino,2410,2091,4501
80767,Breast irregular nodularity,racial,White,4342,154,4496
260125,Acute bronchiolitis,racial,White,2123,2364,4487
437541,Glaucoma,racial,White,2935,1548,4483
321052,Peripheral vascular disease,racial,White,2509,1967,4476
373995,Delirium,ethnic,Not Hispanic or Latino,3255,1214,4469
374022,Hemiplegia,racial,White,2095,2362,4457
318736,Migraine,racial,White,3933,522,4455
4093344,Prostate observation,racial,White,14,4439,4453
442067,Atopic dermatitis and related conditions,racial,White,2263,2164,4427
4228802,Mild recurrent major depression,ethnic,Hispanic or Latino,3123,1288,4411
312950,IgE-mediated allergic asthma,ethnic,Hispanic or Latino,2939,1463,4402
440321,Helicobacter-associated disease,ethnic,Hispanic or Latino,3052,1332,4384
260123,Acute inflammation of sinus,racial,Unknown,3013,1352,4365
198363,Candidiasis of vagina,ethnic,Hispanic or Latino,4349,0,4349
442604,Hypertensive heart disease,ethnic,Hispanic or Latino,2266,2075,4341
139099,Ingrowing nail,ethnic,Hispanic or Latino,2505,1824,4329
4064905,Venereal disease screening,racial,White,3043,1270,4313
443238,Diabetic - poor control,racial,Unknown,1854,2431,4285
255573,Chronic obstructive lung disease,racial,White,2229,2033,4262
201613,Chronic nonalcoholic liver disease,ethnic,Hispanic or Latino,2898,1348,4246
4171430,Screening for malignant neoplasm of rectum,ethnic,Hispanic or Latino,1985,2259,4244
373995,Delirium,racial,Unknown,1794,2433,4227
77074,Joint pain,racial,White,2967,1256,4223
440360,Pure hyperglyceridemia,ethnic,Not Hispanic or Latino,1863,2355,4218
198558,Nycturia,racial,Unknown,3252,925,4177
375545,Lens opacity,racial,White,2716,1444,4160
319835,Congestive cardiac failure,ethnic,Not Hispanic or Latino,1927,2231,4158
437525,Overweight,racial,Other Race,2226,1923,4149
134460,Plantar fascial fibromatosis,ethnic,Hispanic or Latino,2841,1304,4145
373995,Delirium,ethnic,Hispanic or Latino,2236,1891,4127
443524,Mixed incontinence,ethnic,Hispanic or Latino,3818,297,4115
442793,Diabetic complication,racial,White,2268,1835,4103
312934,Atherosclerosis of aorta,racial,Unknown,2893,1208,4101
436096,Chronic pain,ethnic,Hispanic or Latino,2560,1536,4096
444101,Hypertensive heart failure,racial,Unknown,2519,1576,4095
77354,Primary localised osteoarthrosis of lower leg,racial,White,3059,1033,4092
4114314,Screening for osteoporosis,ethnic,Hispanic or Latino,3940,140,4080
79106,Arthralgia of the pelvic region and thigh,racial,White,2323,1755,4078
141095,Acne,racial,White,2293,1780,4073
376382,Tension-type headache,ethnic,Hispanic or Latino,3089,982,4071
198263,Right upper quadrant pain,ethnic,Hispanic or Latino,3199,865,4064
317009,Hyperreactive airway disease,racial,Black or African American ,1925,2128,4053
374022,Hemiplegia,ethnic,Not Hispanic or Latino,1976,2070,4046
140673,Hypothyroid,racial,Asian,3197,837,4034
28060,Strept throat,ethnic,Hispanic or Latino,2229,1806,4035
313236,Cough variant asthma,racial,White,2187,1842,4029
4133029,Primigravida,ethnic,Hispanic or Latino,4016,7,4023
194083,Vaginitis and vulvovaginitis,racial,Unknown,4014,0,4014
317576,Coronary arteriosclerosis,racial,Black or African American ,2302,1707,4009
4062484,Cervical neoplasia screening,racial,Unknown,3986,5,3991
439708,Disorders of initiating and maintaining sleep,racial,White,2783,1198,3981
313459,Sleep apnea,ethnic,Hispanic or Latino,1677,2302,3979
198194,Female genital organ symptoms,racial,White,3951,7,3958
440426,Vertigo as late effect of stroke,racial,Unknown,2477,1481,3958
40484513,Hemiplegia of nondominant side as late effect of cerebrovascular disease,ethnic,Hispanic or Latino,1599,2355,3954
437264,Tobacco dependence syndrome,racial,Unknown,1428,2516,3944
321318,Angina,racial,White,2537,1403,3940
77354,Primary localised osteoarthrosis of lower leg,racial,Unknown,3038,895,3933
196991,Chronic renal disease,ethnic,Not Hispanic or Latino,2082,1838,3920
79908,Muscle strength reduced,ethnic,Hispanic or Latino,1812,2093,3905
137497,Dermatophytosis of the body,ethnic,Hispanic or Latino,2272,1628,3900
31317,Can't get food down,ethnic,Hispanic or Latino,2082,1801,3883
4245252,Raised prostate specific antigen,ethnic,Hispanic or Latino,2,3862,3864
443350,Lower urinary tract symptoms,racial,Unknown,0,3864,3864
440383,Depressive disorder,racial,Other Race,2611,1251,3862
436659,Iron deficiency anaemia,racial,Unknown,2744,1113,3857
444239,Postprocedural state finding,ethnic,Hispanic or Latino,2431,1417,3848
197913,Disorder of function of stomach,racial,Unknown,2868,980,3848
381859,Infective OE,racial,White,2344,1504,3848
255841,Chronic bronchitis,ethnic,Hispanic or Latino,2574,1265,3839
443597,Chronic kidney disease stage 3,ethnic,Not Hispanic or Latino,1994,1833,3827
4096215,"Hyperlipidemia, group A",racial,Asian,2362,1454,3816
321596,Peripheral venous insufficiency,ethnic,Hispanic or Latino,2645,1164,3809
78508,Arthralgia of the ankle and/or foot,ethnic,Hispanic or Latino,2854,952,3806
434169,Abnormal findings on diagnostic imaging of breast,racial,White,3790,14,3804
4077577,Moderate recurrent major depression,racial,Unknown,2222,1580,3802
378427,Tear film insufficiency,ethnic,Hispanic or Latino,2880,913,3793
377889,Hearing loss,racial,Unknown,2056,1730,3786
375545,Lens opacity,racial,Unknown,2698,1088,3786
197381,Epigastric pain,racial,White,2785,996,3781
255573,Chronic obstructive lung disease,ethnic,Not Hispanic or Latino,1587,2187,3774
260139,Acute bronchitis,ethnic,Not Hispanic or Latino,2312,1454,3766
439795,Minimal cognitive impairment,ethnic,Hispanic or Latino,1339,2424,3763
439727,HIV - Human immunodeficiency virus infection,racial,Unknown,596,3144,3740
375827,Acute non-suppurative otitis media - serous,ethnic,Hispanic or Latino,1693,2024,3717
197913,Disorder of function of stomach,racial,White,2424,1283,3707
137809,Primary malignant neoplasm of female breast,ethnic,Hispanic or Latino,3685,21,3706
435928,Abnormal decrease in weight,ethnic,Hispanic or Latino,2111,1587,3698
376065,Neurologic disorder associated with type II diabetes mellitus,racial,Other Race,2716,980,3696
197032,Hyperplasia of prostate,ethnic,Hispanic or Latino,2,3689,3691
201620,Calculus of kidney,ethnic,Hispanic or Latino,2535,1143,3678
197610,Ovarian cyst,ethnic,Hispanic or Latino,3673,0,3673
443431,Disorder of menstruation,ethnic,Hispanic or Latino,3655,0,3655
79106,Arthralgia of the pelvic region and thigh,racial,Unknown,2385,1244,3629
194081,Acute cystitis,ethnic,Hispanic or Latino,3271,354,3625
196991,Chronic renal disease,racial,Unknown,2019,1599,3618
195562,Hemorrhoids,racial,White,1957,1656,3613
74132,Degeneration of lumbosacral intervertebral disc,racial,Unknown,3172,439,3611
317009,Hyperreactive airway disease,racial,Asian,2236,1375,3611
4302252,High risk pregnancy care,racial,White,3595,5,3600
196168,Irregular menstrual bleeding,racial,White,3590,7,3597
379019,Inflammation of conjunctiva,racial,White,1875,1707,3582
259055,Extrinsic asthma with asthma attack,ethnic,Hispanic or Latino,1835,1743,3578
133436,Thyrotoxic crisis,ethnic,Hispanic or Latino,2778,780,3558
260427,Common cold,racial,White,1854,1704,3558
40484522,Hemiplegia of dominant side as late effect of cerebrovascular disease,ethnic,Hispanic or Latino,1454,2098,3552
439700,Inhibited sexual desire,ethnic,Hispanic or Latino,2,3547,3549
140641,Verruca vulgaris,racial,White,1615,1932,3547
259848,Chronic rhinitis,ethnic,Hispanic or Latino,2008,1534,3542
140673,Hypothyroid,racial,Other Race,2707,833,3540
25297,Acute pharyngitis,ethnic,Not Hispanic or Latino,2047,1490,3537
438557,Abnormal glucose level,racial,Unknown,2114,1412,3526
132740,Positive skin test reaction,racial,White,2192,1316,3508
24134,Nonspecific pain in the neck region,racial,White,2408,1095,3503
436583,[X]Falls,ethnic,Hispanic or Latino,2413,1086,3499
4064918,Diabetes mellitus screening,ethnic,Not Hispanic or Latino,1801,1693,3494
313878,Respiratory symptoms,racial,Unknown,2215,1277,3492
200843,Observation of frequency of urination,ethnic,Hispanic or Latino,2286,1196,3482
195007,Female stress incontinence,ethnic,Hispanic or Latino,3468,0,3468
381270,Parkinson's disease,racial,Unknown,1854,1612,3466
317576,Coronary arteriosclerosis,racial,Other Race,2371,1088,3459
434613,Generalized anxiety disorder,racial,Unknown,2528,925,3453
436373,DSD - Developmental speech disorder,ethnic,Hispanic or Latino,915,2523,3438
376406,"Impairment level: blindness, one eye - low vision other eye",ethnic,Hispanic or Latino,1941,1495,3436
201254,Insulin dependent diabetes mellitus,racial,Unknown,2199,1233,3432
133141,Tinea pedis,racial,Unknown,1801,1615,3416
374034,Visual disturbance,ethnic,Hispanic or Latino,2059,1350,3409
197607,Polymenorrhagia,ethnic,Hispanic or Latino,3402,0,3402
138525,Pain in limb,ethnic,Not Hispanic or Latino,2208,1189,3397
197236,Uterine fibroid,racial,White,3388,7,3395
76161,Impotence of organic origin,ethnic,Hispanic or Latino,2,3390,3392
27674,N&V - Nausea and vomiting,ethnic,Hispanic or Latino,2362,1030,3392
380378,Epilepsy,ethnic,Not Hispanic or Latino,1624,1766,3390
436238,Elevated levels of transaminase and lactic acid dehydrogenase,racial,Unknown,2206,1182,3388
4100857,Pickwickian syndrome,racial,White,1863,1525,3388
201069,"Peptic ulcer without hemorrhage, without perforation AND without obstruction",ethnic,Hispanic or Latino,1599,1789,3388
443783,Chronic disease,racial,Unknown,1776,1608,3384
198964,Chronic type C viral hepatitis,ethnic,Not Hispanic or Latino,1316,2047,3363
436230,Blood chemistry abnormal,racial,White,2033,1327,3360
376979,Diabetic cataract,ethnic,Hispanic or Latino,2438,913,3351
437643,Gait abnormality,racial,White,2079,1272,3351
24660,Acute tonsillitis,racial,White,1967,1380,3347
78517,Arthralgia of multiple joints,racial,White,2590,752,3342
432285,Recurrent major depressive episodes,ethnic,Not Hispanic or Latino,2075,1265,3340
192279,Diabetic nephropathy,ethnic,Not Hispanic or Latino,1440,1891,3331
193253,Nephritis,racial,White,1603,1725,3328
132740,Positive skin test reaction,racial,Unknown,2263,1037,3300
374060,Acute ill-defined cerebrovascular disease,racial,White,775,2519,3294
373503,Intermittent cerebral ischaemia,ethnic,Hispanic or Latino,1799,1490,3289
439694,Hypertensive heart and renal disease with both (congestive) heart failure and renal failure,ethnic,Hispanic or Latino,2484,794,3278
196456,Cholecystolithiasis,racial,White,2378,897,3275
375806,Idiopathic peripheral neuropathy,racial,Unknown,1700,1564,3264
380733,Otalgia,ethnic,Hispanic or Latino,2383,872,3255
439777,Anemia,racial,Asian,2475,775,3250
75614,Acrodermatitis continua,ethnic,Hispanic or Latino,1180,2065,3245
436972,Glaucoma associated with systemic syndromes,ethnic,Hispanic or Latino,1909,1334,3243
441408,Vomiting,racial,White,1789,1451,3240
4064375,Iron deficiency screening,racial,Unknown,1927,1306,3233
440674,Gout,racial,White,743,2489,3232
437525,Overweight,racial,Asian,1661,1564,3225
372328,Otitis media,racial,Unknown,1826,1396,3222
26662,Testicular hypofunction,ethnic,Hispanic or Latino,0,3220,3220
320536,Abnormal EKG finding,ethnic,Hispanic or Latino,1760,1451,3211
374924,Generalized convulsive epilepsy,racial,White,1424,1778,3202
442588,OSA - Obstructive sleep apnoea,ethnic,Hispanic or Latino,1486,1714,3200
313459,Sleep apnea,racial,White,1332,1865,3197
438878,Abnormal results of liver function studies,ethnic,Hispanic or Latino,2157,1033,3190
312437,Dyspnea,ethnic,Hispanic or Latino,2086,1099,3185
74719,Foot ulcer,ethnic,Hispanic or Latino,1191,1987,3178
199866,Acute gastritis,racial,White,1985,1191,3176
438409,Attention deficit hyperactivity disorder,ethnic,Hispanic or Latino,423,2726,3149
193326,Urge incontinence of urine,ethnic,Hispanic or Latino,2450,679,3129
75860,Costiveness,racial,Asian,2114,1010,3124
436665,Manic-depressive psychosis,ethnic,Hispanic or Latino,2369,752,3121
255573,Chronic obstructive lung disease,racial,Unknown,1553,1562,3115
258780,Chronic obstructive bronchitis,racial,Asian,1265,1845,3110
375791,Uncomplicated senile dementia,racial,Unknown,2233,872,3105
443537,Deep venous thrombosis of lower extremity,racial,White,1888,1212,3100
312327,Acute myocardial infarction,ethnic,Hispanic or Latino,2417,679,3096
316822,Finding of heart murmur,racial,White,1923,1164,3087
432284,Single major depressive episode,ethnic,Not Hispanic or Latino,1955,1120,3075
440674,Gout,ethnic,Not Hispanic or Latino,1017,2052,3069
315078,Palpitations,racial,White,2293,773,3066
438557,Abnormal glucose level,ethnic,Not Hispanic or Latino,1714,1348,3062
314666,Healed coronary,ethnic,Hispanic or Latino,1495,1564,3059
77670,Chest pain,ethnic,Not Hispanic or Latino,1649,1408,3057
26662,Testicular hypofunction,racial,White,0,3057,3057
141693,Elevated blood-pressure reading without diagnosis of hypertension,racial,Unknown,1628,1426,3054
200219,Abdominal pain,ethnic,Not Hispanic or Latino,2056,994,3050
197672,Urinary incontinence,ethnic,Not Hispanic or Latino,2712,324,3036
439926,Malaise and fatigue,racial,Unknown,1994,1042,3036
434610,Hyperkalemia,ethnic,Hispanic or Latino,1594,1442,3036
4171430,Screening for malignant neoplasm of rectum,racial,White,1486,1548,3034
312349,Venous varices,ethnic,Hispanic or Latino,2629,398,3027
4147961,Screening for malignant neoplasm of breast,racial,Unknown,3020,2,3022
374060,Acute ill-defined cerebrovascular disease,ethnic,Not Hispanic or Latino,1242,1773,3015
4060985,BMI 30+ - obesity,racial,Other Race,1946,1060,3006
381292,Chronic allergic conjunctivitis,racial,White,1656,1329,2985
437038,Blood in urine,racial,White,1732,1254,2986
78234,Arthralgia of the hand,ethnic,Hispanic or Latino,2098,886,2984
437382,Urine observation,racial,White,2390,591,2981
436096,Chronic pain,racial,White,1665,1316,2981
4049623,"Moderate major depression, single episode",ethnic,Hispanic or Latino,2121,860,2981
433316,Giddiness,ethnic,Not Hispanic or Latino,2125,856,2981
321052,Peripheral vascular disease,ethnic,Not Hispanic or Latino,669,2300,2969
134461,Tietze disease,ethnic,Hispanic or Latino,2072,886,2958
377574,Presbycusis,racial,Unknown,982,1976,2958
200962,Primary malignant neoplasm of prostate,ethnic,Hispanic or Latino,0,2951,2951
78472,Microscopic haematuria,ethnic,Hispanic or Latino,1691,1260,2951
313217,Atrial fibrillation,racial,Asian,1428,1518,2946
192278,Type II diabetes mellitus - poor control,racial,Black or African American ,1957,984,2941
28060,Strept throat,racial,White,1562,1375,2937
380378,Epilepsy,racial,White,1203,1732,2935
257628,Systemic lupus erythematosus,ethnic,Hispanic or Latino,2645,285,2930
198363,Candidiasis of vagina,racial,White,2912,16,2928
441542,Anxiety,racial,Other Race,2588,338,2926
435171,Allergic state,ethnic,Hispanic or Latino,1863,1051,2914
200174,Disease of skin AND/OR subcutaneous tissue,ethnic,Hispanic or Latino,1921,994,2915
81151,Sprain of ankle joint,ethnic,Hispanic or Latino,1861,1049,2910
133727,Thyrotoxicosis without goiter OR other cause,ethnic,Hispanic or Latino,2571,336,2907
195306,Gastroduodenitis,ethnic,Not Hispanic or Latino,1941,964,2905
439147,Amnesia,racial,White,1562,1341,2903
74464,Idiopathic scoliosis AND/OR kyphoscoliosis,ethnic,Hispanic or Latino,1948,952,2900
380096,Proliferative diabetic retinopathy,ethnic,Hispanic or Latino,1582,1316,2898
376085,Uncomplicated presenile dementia,ethnic,Hispanic or Latino,2567,329,2896
314754,Wheezing,racial,White,1596,1300,2896
139900,Urticaria,ethnic,Hispanic or Latino,1808,1086,2894
140214,Eruption of skin,racial,Unknown,1829,1056,2885
73553,Arthropathy,ethnic,Not Hispanic or Latino,1895,989,2884
443570,Cervicovaginal cytology: Low grade squamous intraepithelial lesion,ethnic,Hispanic or Latino,2857,25,2882
379784,Senile dementia with depression,racial,Unknown,2072,810,2882
438409,Attention deficit hyperactivity disorder,racial,White,508,2371,2879
4147961,Screening for malignant neoplasm of breast,ethnic,Not Hispanic or Latino,2850,23,2873
139099,Ingrowing nail,racial,White,1612,1256,2868
4308509,Impaired fasting glycaemia,racial,Unknown,1495,1343,2838
196991,Chronic renal disease,racial,Asian,1746,1093,2839
134438,CD - Contact dermatitis,ethnic,Not Hispanic or Latino,1447,1385,2832
375827,Acute non-suppurative otitis media - serous,racial,White,1373,1451,2824
381591,Cerebrovascular disease,racial,White,1401,1417,2818
318556,Nosebleed,ethnic,Hispanic or Latino,1242,1571,2813
316999,Cardiac arrhythmia,racial,Unknown,1757,1056,2813
378419,AD - Alzheimer's disease,ethnic,Not Hispanic or Latino,2489,324,2813
81878,Benign paroxysmal positional vertigo,ethnic,Hispanic or Latino,2086,725,2811
192667,Atrophic gastritis,racial,Unknown,2132,679,2811
257581,Exacerbation of asthma,ethnic,Not Hispanic or Latino,1500,1309,2809
197988,General abdominal pain-symptom,ethnic,Hispanic or Latino,2093,692,2785
372328,Otitis media,ethnic,Not Hispanic or Latino,1410,1366,2776
81902,Urinary tract infectious disease,ethnic,Not Hispanic or Latino,2422,352,2774
134438,CD - Contact dermatitis,racial,Unknown,1766,1005,2771
374375,Impacted cerumen,racial,Unknown,1739,1030,2769
4114314,Screening for osteoporosis,racial,White,2670,85,2755
434170,Atypical squamous cells of undetermined significance on cervical Papanicolaou smear,ethnic,Hispanic or Latino,2726,30,2756
380094,Carpal tunnel syndrome,racial,White,2183,570,2753
259055,Extrinsic asthma with asthma attack,racial,White,1279,1470,2749
372409,Sciatica neuralgia,racial,Unknown,1778,971,2749
4133029,Primigravida,racial,White,2689,53,2742
4079876,Familial combined hyperlipidemia,racial,Other Race,1523,1217,2740
4195572,"Mild major depression, single episode",ethnic,Hispanic or Latino,1578,1155,2733
30437,Gastroesophageal reflux disease with esophagitis,ethnic,Hispanic or Latino,1881,844,2725
4062484,Cervical neoplasia screening,ethnic,Not Hispanic or Latino,2684,37,2721
438878,Abnormal results of liver function studies,racial,White,1727,982,2709
4161977,Patient with cardiac pacemaker,racial,Unknown,1007,1700,2707
4311591,Cramp in limb,ethnic,Hispanic or Latino,1610,1097,2707
198964,Chronic type C viral hepatitis,racial,Unknown,948,1760,2708
377091,Fits - convulsions,racial,White,1148,1548,2696
256440,Disorder of paranasal sinuses,ethnic,Hispanic or Latino,1433,1260,2693
317009,Hyperreactive airway disease,racial,Other Race,1702,975,2677
314054,Aortic valve disease,ethnic,Hispanic or Latino,1313,1364,2677
201603,Disease of teeth AND/OR supporting structures,ethnic,Hispanic or Latino,1543,1129,2672
432597,Schizoaffective schizophrenia,ethnic,Hispanic or Latino,1849,819,2668
137682,Skin sensation disturbance,racial,White,1674,994,2668
78232,Shoulder joint pain,ethnic,Not Hispanic or Latino,1534,1129,2663
373995,Delirium,racial,Asian,2160,501,2661
443431,Disorder of menstruation,racial,White,2654,5,2659
4077577,Moderate recurrent major depression,racial,White,1249,1401,2650
436070,Vitamin D deficiency,ethnic,Hispanic or Latino,1764,883,2647
134460,Plantar fascial fibromatosis,racial,White,1822,812,2634
378253,HA - Headache,ethnic,Not Hispanic or Latino,1872,759,2631
321318,Angina,racial,Asian,2199,428,2627
255841,Chronic bronchitis,racial,Unknown,1826,798,2624
193809,Melena due to gastrointestinal hemorrhage,ethnic,Hispanic or Latino,1569,1051,2620
135360,Fainting,ethnic,Hispanic or Latino,1845,771,2616
312950,IgE-mediated allergic asthma,racial,Unknown,1884,727,2611
376085,Uncomplicated presenile dementia,racial,Unknown,1707,897,2604
73819,Painful breasts,ethnic,Hispanic or Latino,2542,62,2604
4064377,Depression screening,racial,Other Race,1511,1088,2599
197928,Menstruation absent,racial,Unknown,2597,2,2599
137497,Dermatophytosis of the body,racial,White,1438,1162,2600
197610,Ovarian cyst,racial,White,2597,0,2597
80180,Osteoarthritis,racial,Black or African American ,1734,856,2590
378427,Tear film insufficiency,racial,Unknown,2109,476,2585
444202,Abscess,racial,Unknown,1573,1005,2578
198558,Nycturia,racial,White,1868,708,2576
442604,Hypertensive heart disease,racial,Unknown,1127,1449,2576
441542,Anxiety,racial,Asian,1233,1341,2574
193782,End stage renal disease,racial,White,1104,1456,2560
80809,Rheumatoid arthritis,ethnic,Not Hispanic or Latino,2348,207,2555
194133,Low back pain,racial,Asian,1272,1283,2555
200164,Urine-induced contact dermatitis,ethnic,Hispanic or Latino,1258,1283,2541
75354,Osteochondropathy,racial,White,2385,154,2539
195321,Postmenopausal bleeding,ethnic,Hispanic or Latino,2537,0,2537
373475,Impairment level: one eye: moderate impairment: other eye: not specified,ethnic,Hispanic or Latino,1352,1185,2537
198263,Right upper quadrant pain,racial,White,1960,573,2533
440321,Helicobacter-associated disease,racial,White,1656,869,2525
380378,Epilepsy,racial,Unknown,587,1939,2526
23325,Heartburn,ethnic,Hispanic or Latino,1810,713,2523
441274,Developmental expressive language disorder,ethnic,Hispanic or Latino,412,2109,2521
373475,Impairment level: one eye: moderate impairment: other eye: not specified,racial,Unknown,1518,996,2514
375806,Idiopathic peripheral neuropathy,ethnic,Not Hispanic or Latino,794,1714,2508
140821,Spasm,racial,White,1780,722,2502
259848,Chronic rhinitis,racial,White,1396,1106,2502
201613,Chronic nonalcoholic liver disease,racial,White,1658,833,2491
196523,Diarrhea,racial,Unknown,1642,823,2465
436659,Iron deficiency anaemia,ethnic,Not Hispanic or Latino,1610,853,2463
437247,Anaemia of chronic disease,racial,White,1444,1014,2458
141693,Elevated blood-pressure reading without diagnosis of hypertension,ethnic,Not Hispanic or Latino,1297,1159,2456
377290,Legal blindness USA,ethnic,Hispanic or Latino,1157,1297,2454
440704,Chronic pain syndrome,ethnic,Hispanic or Latino,1746,706,2452
257004,Acute exacerbation of chronic obstructive airways disease,racial,Unknown,1111,1341,2452
4245252,Raised prostate specific antigen,racial,White,2,2445,2447
81112,Arthralgia of the lower leg,racial,Asian,1783,651,2434
440674,Gout,racial,Unknown,499,1930,2429
440216,Abnormal glucose tolerance test,ethnic,Hispanic or Latino,1309,1118,2427
4228802,Mild recurrent major depression,racial,Unknown,1785,639,2424
439708,Disorders of initiating and maintaining sleep,racial,Unknown,1700,720,2420
196341,Dermatophytosis of the perianal area,ethnic,Hispanic or Latino,699,1720,2419
377575,Tinnitus,ethnic,Hispanic or Latino,1681,729,2410
437092,Physiological development failure,ethnic,Hispanic or Latino,777,1626,2403
193782,End stage renal disease,racial,Unknown,1288,1116,2404
200843,Observation of frequency of urination,racial,White,1578,823,2401
436073,Psychotic disorder,ethnic,Hispanic or Latino,1955,446,2401
75650,Proteinuria,racial,Unknown,1217,1182,2399
197925,Haemorrhage of rectum and anus,ethnic,Hispanic or Latino,1242,1148,2390
4079876,Familial combined hyperlipidemia,racial,Asian,1362,1024,2386
439082,Menopausal syndrome,ethnic,Hispanic or Latino,2378,2,2380
254387,Upper respiratory tract hypersensitivity reaction,ethnic,Hispanic or Latino,1258,1116,2374
432870,Thrombocytopenia,racial,Unknown,1576,798,2374
257581,Exacerbation of asthma,racial,Unknown,1214,1150,2364
433595,Interstitial edema,ethnic,Not Hispanic or Latino,1355,1007,2362
74132,Degeneration of lumbosacral intervertebral disc,racial,White,1944,416,2360
78508,Arthralgia of the ankle and/or foot,racial,White,1573,787,2360
436665,Manic-depressive psychosis,racial,White,1516,837,2353
381270,Parkinson's disease,racial,White,1426,922,2348
376382,Tension-type headache,racial,White,1718,630,2348
439700,Inhibited sexual desire,racial,White,2,2344,2346
201820,Diabetes mellitus,ethnic,Hispanic or Latino,1231,1116,2347
374028,AAMD - Age related macular degeneration,ethnic,Hispanic or Latino,1511,830,2341
436373,DSD - Developmental speech disorder,racial,White,649,1693,2342
78835,Palindromic rheumatism of the lower leg,ethnic,Hispanic or Latino,1507,835,2342
194081,Acute cystitis,racial,White,2045,294,2339
316999,Cardiac arrhythmia,racial,White,1585,750,2335
201927,Cellulitis and abscess of leg,ethnic,Hispanic or Latino,1033,1297,2330
381591,Cerebrovascular disease,racial,Asian,1433,890,2323
133228,Dental caries,racial,White,1235,1083,2318
4263370,R.I.N.D. syndrome,ethnic,Hispanic or Latino,1279,1037,2316
4064375,Iron deficiency screening,ethnic,Not Hispanic or Latino,1217,1097,2314
432526,Needs influenza immunisation,racial,Other Race,1231,1081,2312
133436,Thyrotoxic crisis,racial,White,1730,580,2310
31967,Nausea,ethnic,Hispanic or Latino,1760,545,2305
376406,"Impairment level: blindness, one eye - low vision other eye",racial,Unknown,1711,593,2304
4092896,Stool contents abnormal,ethnic,Hispanic or Latino,1426,876,2302
435783,Schizophrenia,ethnic,Hispanic or Latino,1088,1214,2302
24134,Nonspecific pain in the neck region,racial,Unknown,1668,626,2294
256448,Chronic asthmatic bronchitis,ethnic,Hispanic or Latino,1679,612,2291
321882,Generalised atherosclerosis,ethnic,Hispanic or Latino,1157,1129,2286
200174,Disease of skin AND/OR subcutaneous tissue,racial,White,1389,897,2286
440704,Chronic pain syndrome,ethnic,Not Hispanic or Latino,840,1440,2280
140214,Eruption of skin,ethnic,Not Hispanic or Latino,1205,1072,2277
440329,Herpes zoster without complication,ethnic,Hispanic or Latino,1389,876,2265
201620,Calculus of kidney,racial,White,1364,895,2259
76161,Impotence of organic origin,racial,White,2,2238,2240
134736,Backache,racial,Asian,1244,994,2238
438120,Opioid dependence,ethnic,Hispanic or Latino,1065,1164,2229
437986,FTT - Failure to thrive,ethnic,Hispanic or Latino,1148,1081,2229
4194895,Screening for disorder,ethnic,Hispanic or Latino,1093,1134,2227
374924,Generalized convulsive epilepsy,racial,Unknown,909,1313,2222
318800,GERD - Gastro-esophageal reflux disease,racial,Black or African American ,1171,1040,2211
197928,Menstruation absent,ethnic,Not Hispanic or Latino,2013,193,2206
377254,"Multi-infarct dementia, uncomplicated",ethnic,Hispanic or Latino,1677,529,2206
443257,Swellings and lumps,ethnic,Hispanic or Latino,1465,738,2203
374923,Bell palsy,ethnic,Hispanic or Latino,929,1270,2199
78516,Arthralgia of the upper arm,ethnic,Hispanic or Latino,1249,950,2199
77074,Joint pain,racial,Unknown,1658,538,2196
312338,Benign hypertensive heart disease with congestive heart failure,racial,White,495,1700,2195
372634,Nonphysiologic vision loss,ethnic,Hispanic or Latino,1194,996,2190
317302,Coronary sinus rhythm disorder,racial,Unknown,1090,1099,2189
432869,Hemorrhagic disorder due to circulating anticoagulants,ethnic,Hispanic or Latino,1028,1162,2190
444246,Cirrhosis of liver not due to alcohol,racial,White,1044,1125,2169
257004,Acute exacerbation of chronic obstructive airways disease,racial,White,1093,1074,2167
40479192,Chronic systolic heart failure,ethnic,Hispanic or Latino,1702,465,2167
439926,Malaise and fatigue,ethnic,Not Hispanic or Latino,1320,844,2164
437041,Mother not delivered,racial,Unknown,2164,0,2164
434902,Autistic disorder of childhood onset,ethnic,Hispanic or Latino,317,1847,2164
437525,Overweight,racial,Black or African American ,948,1214,2162
75860,Costiveness,racial,Other Race,1500,658,2158
442588,OSA - Obstructive sleep apnoea,racial,White,996,1159,2155
261889,Simple chronic bronchitis,ethnic,Hispanic or Latino,1520,635,2155
312327,Acute myocardial infarction,racial,Unknown,1734,416,2150
376112,Diabetic polyneuropathy,ethnic,Not Hispanic or Latino,1431,718,2149
432870,Thrombocytopenia,racial,White,1168,978,2146
27674,N&V - Nausea and vomiting,racial,White,1419,722,2141
197607,Polymenorrhagia,racial,White,2139,0,2139
442985,Male,ethnic,Hispanic or Latino,2,2137,2139
192667,Atrophic gastritis,racial,White,1504,633,2137
201820,Diabetes mellitus,racial,White,1086,1051,2137
4113027,Dietary intake observations,ethnic,Hispanic or Latino,1127,1007,2134
320536,Abnormal EKG finding,racial,White,1182,950,2132
443801,Exercise-induced asthma,ethnic,Hispanic or Latino,1155,975,2130
73291,Palindromic rheumatism of the ankle and/or foot,ethnic,Hispanic or Latino,1401,722,2123
75614,Acrodermatitis continua,racial,White,957,1162,2119
438332,Disease of possible viral origin,racial,Unknown,941,1178,2119
378419,AD - Alzheimer's disease,racial,White,1628,488,2116
194083,Vaginitis and vulvovaginitis,ethnic,Not Hispanic or Latino,2095,21,2116
257012,Chronic rhinosinusitis,ethnic,Not Hispanic or Latino,1442,672,2114
375791,Uncomplicated senile dementia,racial,White,1051,1058,2109
4064377,Depression screening,racial,Asian,1187,920,2107
74464,Idiopathic scoliosis AND/OR kyphoscoliosis,racial,White,1431,676,2107
442256,Disorder of bursae of shoulder region,ethnic,Hispanic or Latino,1592,513,2105
312950,IgE-mediated allergic asthma,racial,White,1444,658,2102
195083,Left lower quadrant pain,ethnic,Hispanic or Latino,1594,504,2098
198678,Intestinal infectious disease,ethnic,Hispanic or Latino,1067,1026,2093
79908,Muscle strength reduced,racial,Unknown,911,1182,2093
381591,Cerebrovascular disease,racial,Black or African American ,856,1235,2091
76786,Derangement of knee,ethnic,Hispanic or Latino,1152,934,2086
433440,Dysthymia,racial,Unknown,1573,513,2086
433069,Open wound of external genital organs with complication,ethnic,Hispanic or Latino,1017,1065,2082
80180,Osteoarthritis,racial,Other Race,1507,570,2077
81611,Diverticular disease of colon,racial,White,1454,619,2073
439125,T21 - Trisomy 21,ethnic,Hispanic or Latino,736,1334,2070
381295,Age-related cataract,racial,Unknown,1180,890,2070
432967,Anemia during pregnancy - baby not yet delivered,ethnic,Hispanic or Latino,2056,0,2056
443767,Diabetic oculopathy,ethnic,Not Hispanic or Latino,1417,628,2045
380733,Otalgia,racial,White,1426,610,2036
198124,Disorder of kidney,racial,Unknown,1076,959,2035
317898,Malignant essential hypertension,ethnic,Hispanic or Latino,1610,426,2036
194696,Menorrhalgia,ethnic,Hispanic or Latino,2031,0,2031
81611,Diverticular disease of colon,racial,Unknown,1417,612,2029
30234,Cervical sprain,ethnic,Hispanic or Latino,1369,660,2029
434056,Late effects of cerebrovascular disease,ethnic,Not Hispanic or Latino,731,1288,2019
376229,Abnormal involuntary movement,ethnic,Hispanic or Latino,1364,656,2020
80189,Displacement of lumbar intervertebral disc without myelopathy,ethnic,Hispanic or Latino,1343,674,2017
438332,Disease of possible viral origin,ethnic,Not Hispanic or Latino,932,1083,2015
197032,Hyperplasia of prostate,racial,White,2,2013,2015
376683,Non proliferative diabetic retinopathy,racial,Unknown,1290,722,2012
435511,Hypercalcemia,ethnic,Hispanic or Latino,1582,430,2012
439777,Anemia,racial,Other Race,1497,506,2003
254387,Upper respiratory tract hypersensitivity reaction,racial,White,1024,978,2002
443524,Mixed incontinence,racial,Unknown,1760,239,1999
377889,Hearing loss,ethnic,Not Hispanic or Latino,1072,920,1992
374375,Impacted cerumen,ethnic,Not Hispanic or Latino,1111,879,1990
139900,Urticaria,racial,White,1221,768,1989
433736,Obesity,racial,Asian,1051,936,1987
193251,Umbilical hernia without obstruction AND without gangrene,ethnic,Hispanic or Latino,1189,798,1987
257628,Systemic lupus erythematosus,racial,White,1916,67,1983
378419,AD - Alzheimer's disease,racial,Asian,1672,308,1980
40484513,Hemiplegia of nondominant side as late effect of cerebrovascular disease,racial,Unknown,849,1129,1978
434170,Atypical squamous cells of undetermined significance on cervical Papanicolaou smear,racial,White,1934,41,1975
136788,Spinal stenosis of lumbar region,ethnic,Hispanic or Latino,1417,559,1976
374366,Sensorineural hearing loss,racial,White,1734,242,1976
376683,Non proliferative diabetic retinopathy,racial,White,989,984,1973
314658,Cardiomegaly,ethnic,Not Hispanic or Latino,1877,94,1971
376065,Neurologic disorder associated with type II diabetes mellitus,racial,Black or African American ,1631,340,1971
312922,Coronary bypass graft observation,ethnic,Hispanic or Latino,706,1263,1969
133228,Dental caries,racial,Unknown,1231,738,1969
374888,Dementia associated with another disease,racial,White,1663,304,1967
76194,Osteoarthrosis involving multiple sites but not designated as generalized,ethnic,Hispanic or Latino,1247,720,1967
375281,Acute suppurative otitis media - tympanic membrane intact,racial,Unknown,987,975,1962
444246,Cirrhosis of liver not due to alcohol,racial,Unknown,1086,874,1960
435220,Severe recurrent major depression without psychotic features,ethnic,Hispanic or Latino,1102,858,1960
312664,Influenza with respiratory manifestation other than pneumonia,ethnic,Hispanic or Latino,1125,833,1958
199866,Acute gastritis,racial,Unknown,1663,294,1957
199839,External haemorrhoids without complication,ethnic,Hispanic or Latino,1293,662,1955
381295,Age-related cataract,ethnic,Hispanic or Latino,1578,377,1955
4090651,Dialysis observation,ethnic,Hispanic or Latino,817,1127,1944
377888,CHL - Conductive hearing loss,ethnic,Hispanic or Latino,761,1182,1943
81151,Sprain of ankle joint,racial,White,1203,738,1941
442793,Diabetic complication,racial,Unknown,1056,883,1939
137063,Corns and callus,ethnic,Hispanic or Latino,1210,720,1930
442752,Myalgia,ethnic,Not Hispanic or Latino,1369,561,1930
198124,Disorder of kidney,racial,White,1033,895,1928
193326,Urge incontinence of urine,racial,White,1366,561,1927
379805,Myopia,ethnic,Hispanic or Latino,1141,784,1925
443732,Disorder associated with type II diabetes melliltus,ethnic,Hispanic or Latino,1214,708,1922
317002,Hypopiesis,ethnic,Hispanic or Latino,1143,777,1920
374034,Visual disturbance,racial,White,1155,759,1914
432526,Needs influenza immunisation,racial,Asian,1024,890,1914
436096,Chronic pain,ethnic,Not Hispanic or Latino,865,1042,1907
443454,Cerebral infarction,ethnic,Hispanic or Latino,800,1106,1906
4051114,FH: Diabetes mellitus,ethnic,Hispanic or Latino,1185,715,1900
316999,Cardiac arrhythmia,ethnic,Not Hispanic or Latino,952,945,1897
443782,Tremor,ethnic,Hispanic or Latino,315,1580,1895
443537,Deep venous thrombosis of lower extremity,ethnic,Not Hispanic or Latino,1534,354,1888
434610,Hyperkalemia,racial,White,957,929,1886
4272867,General well-being finding,ethnic,Hispanic or Latino,902,984,1886
444100,Mood disorder,ethnic,Hispanic or Latino,1099,787,1886
40484522,Hemiplegia of dominant side as late effect of cerebrovascular disease,racial,Unknown,621,1265,1886
439082,Menopausal syndrome,racial,White,1881,5,1886
437643,Gait abnormality,ethnic,Not Hispanic or Latino,1178,706,1884
24134,Nonspecific pain in the neck region,ethnic,Not Hispanic or Latino,1242,639,1881
256440,Disorder of paranasal sinuses,racial,White,1010,872,1882
441274,Developmental expressive language disorder,racial,Unknown,7,1872,1879
4165091,Lack of exercise,ethnic,Hispanic or Latino,989,888,1877
4175226,Screening for malignant neoplasm of colon,racial,Other Race,1113,761,1874
315085,Enlargement of lymph nodes,ethnic,Hispanic or Latino,1279,589,1868
444239,Postprocedural state finding,racial,White,1233,635,1868
437247,Anaemia of chronic disease,racial,Unknown,1042,826,1868
134461,Tietze disease,racial,White,1272,593,1865
4311591,Cramp in limb,racial,Unknown,943,918,1861
437541,Glaucoma,ethnic,Not Hispanic or Latino,1132,729,1861
193322,Right lower quadrant pain,ethnic,Hispanic or Latino,1442,414,1856
23325,Heartburn,racial,White,1251,600,1851
135033,Hair and hair follicle diseases,ethnic,Hispanic or Latino,1017,833,1850
4161977,Patient with cardiac pacemaker,racial,White,1205,644,1849
78472,Microscopic haematuria,racial,White,1065,784,1849
196523,Diarrhea,ethnic,Not Hispanic or Latino,865,984,1849
321588,Heart disease,ethnic,Hispanic or Latino,851,994,1845
437092,Physiological development failure,racial,White,593,1251,1844
435613,Cellulitis,ethnic,Hispanic or Latino,1079,764,1843
257007,Allergic rhinitis,racial,Asian,1090,745,1835
434613,Generalized anxiety disorder,racial,White,1281,552,1833
381292,Chronic allergic conjunctivitis,racial,Unknown,1300,534,1834
137809,Primary malignant neoplasm of female breast,racial,Unknown,1819,12,1831
317309,Peripheral arterial occlusive disease,ethnic,Hispanic or Latino,1173,656,1829
443783,Chronic disease,ethnic,Not Hispanic or Latino,1007,821,1828
81112,Arthralgia of the lower leg,racial,Black or African American ,1734,92,1826
433440,Dysthymia,racial,White,869,957,1826
312648,Benign essential hypertension,racial,Filipino,1205,619,1824
133729,Hyperparathyroidism,ethnic,Hispanic or Latino,1534,290,1824
137809,Primary malignant neoplasm of female breast,racial,White,1812,9,1821
377091,Fits - convulsions,racial,Unknown,745,1070,1815
134118,Atrophic condition of skin,ethnic,Hispanic or Latino,1005,805,1810
139057,Disease of oral soft tissues,ethnic,Hispanic or Latino,1242,566,1808
436682,Moderate mental handicap,ethnic,Hispanic or Latino,518,1283,1801
442985,Male,racial,Unknown,2,1799,1801
195771,Secondary diabetes mellitus,ethnic,Hispanic or Latino,1277,520,1797
312437,Dyspnea,racial,White,1111,685,1796
318556,Nosebleed,racial,White,731,1065,1796
133835,Dermatitis,ethnic,Hispanic or Latino,987,800,1787
375529,Infantile cerebral palsy,ethnic,Hispanic or Latino,989,796,1785
434005,Morbid obesity,racial,Other Race,1122,658,1780
140949,Scabies,ethnic,Hispanic or Latino,1065,704,1769
4194895,Screening for disorder,racial,White,819,945,1764
80824,Senile osteoporosis,ethnic,Not Hispanic or Latino,1525,239,1764
194133,Low back pain,racial,Other Race,1463,299,1762
443537,Deep venous thrombosis of lower extremity,racial,Unknown,1244,513,1757
435928,Abnormal decrease in weight,racial,White,842,911,1753
200164,Urine-induced contact dermatitis,racial,White,883,865,1748
76836,Sprain of knee and leg,ethnic,Hispanic or Latino,1019,725,1744
75617,Polyarticular osteoarthritis,racial,Other Race,1424,317,1741
375546,Combined nonsenile cataract,ethnic,Hispanic or Latino,1727,14,1741
444202,Abscess,ethnic,Not Hispanic or Latino,1005,734,1739
4088930,Confirmation of pregnancy,ethnic,Hispanic or Latino,1737,0,1737
4005823,Tobacco user,ethnic,Hispanic or Latino,534,1203,1737
436067,Schizophrenia simplex,ethnic,Hispanic or Latino,1258,476,1734
436665,Manic-depressive psychosis,ethnic,Not Hispanic or Latino,957,766,1723
440704,Chronic pain syndrome,racial,White,1003,720,1723
81878,Benign paroxysmal positional vertigo,racial,White,1306,416,1722
443776,Brachial radiculitis,ethnic,Hispanic or Latino,1546,175,1721
193809,Melena due to gastrointestinal hemorrhage,racial,White,1021,695,1716
442752,Myalgia,racial,Unknown,1408,306,1714
318736,Migraine,racial,Unknown,1564,147,1711
257011,Acute upper respiratory infection,racial,Other Race,1005,706,1711
375806,Idiopathic peripheral neuropathy,racial,Black or African American ,501,1210,1711
434902,Autistic disorder of childhood onset,racial,White,209,1502,1711
442306,Adjustment disorder with depressed mood,ethnic,Hispanic or Latino,1196,511,1707
375545,Lens opacity,ethnic,Not Hispanic or Latino,715,984,1699
31317,Can't get food down,racial,White,1012,683,1695
436962,Sleeplessness,racial,Other Race,1309,386,1695
440216,Abnormal glucose tolerance test,racial,White,844,851,1695
321596,Peripheral venous insufficiency,racial,Unknown,1293,400,1693
438867,Generalized body aches,ethnic,Hispanic or Latino,1145,545,1690
441284,Open-angle glaucoma,ethnic,Hispanic or Latino,826,863,1689
436238,Elevated levels of transaminase and lactic acid dehydrogenase,ethnic,Not Hispanic or Latino,892,789,1681
256531,Head and neck swelling,ethnic,Hispanic or Latino,1139,536,1675
80824,Senile osteoporosis,racial,Asian,1426,244,1670
438120,Opioid dependence,racial,Unknown,828,842,1670
256439,Allergic rhinitis due to pollen,ethnic,Hispanic or Latino,1012,658,1670
433753,Alcohol abuse,ethnic,Hispanic or Latino,198,1470,1668
31317,Can't get food down,racial,Unknown,649,1017,1666
77079,SS - Spinal stenosis,ethnic,Hispanic or Latino,1155,508,1663
377254,"Multi-infarct dementia, uncomplicated",racial,Unknown,651,1012,1663
374022,Hemiplegia,racial,Black or African American ,481,1178,1659
443570,Cervicovaginal cytology: Low grade squamous intraepithelial lesion,racial,White,1619,35,1654
73819,Painful breasts,racial,White,1596,58,1654
201069,"Peptic ulcer without hemorrhage, without perforation AND without obstruction",racial,Unknown,955,697,1652
76153,Low compliance bladder,ethnic,Hispanic or Latino,1125,522,1647
380378,Epilepsy,racial,Black or African American ,1116,531,1647
257683,Postnasal drip,ethnic,Hispanic or Latino,1150,497,1647
443524,Mixed incontinence,racial,White,1601,44,1645
313878,Respiratory symptoms,ethnic,Not Hispanic or Latino,902,741,1643
443865,Non-infective colitis,racial,Unknown,978,665,1643
372906,Both eyes total visual impairment,ethnic,Hispanic or Latino,798,840,1638
443238,Diabetic - poor control,racial,White,805,830,1635
140480,Impetigo,ethnic,Hispanic or Latino,695,938,1633
315558,Atherosclerosis of arteries of the extremities,ethnic,Hispanic or Latino,975,653,1628
319835,Congestive cardiac failure,racial,Asian,1097,527,1624
434750,Feeding difficulties and mismanagement,ethnic,Hispanic or Latino,649,975,1624
256451,Bronchitis,racial,Unknown,1118,506,1624
372409,Sciatica neuralgia,ethnic,Not Hispanic or Latino,1132,488,1620
256451,Bronchitis,ethnic,Not Hispanic or Latino,1012,607,1619
318712,Peripheral circulatory disorder associated with type I diabetes mellitus,ethnic,Hispanic or Latino,952,665,1617
321318,Angina,racial,Black or African American ,1587,30,1617
193253,Nephritis,racial,Unknown,991,623,1614
138102,Benign tumour of skin,ethnic,Hispanic or Latino,980,633,1613
443801,Exercise-induced asthma,racial,White,883,729,1612
375529,Infantile cerebral palsy,racial,White,826,782,1608
138278,Sprains and strains of joints and adjacent muscles,ethnic,Hispanic or Latino,897,711,1608
4276723,Finding of child weight centiles,ethnic,Hispanic or Latino,819,782,1601
443545,Nonvenomous insect bite,ethnic,Hispanic or Latino,837,764,1601
4302252,High risk pregnancy care,racial,Unknown,1601,0,1601
4175226,Screening for malignant neoplasm of colon,racial,Asian,874,725,1599
137351,Epidermoid cyst of skin,ethnic,Hispanic or Latino,936,662,1598
196341,Dermatophytosis of the perianal area,racial,White,508,1088,1596
75354,Osteochondropathy,racial,Unknown,1477,117,1594
133299,Swelling of limb,ethnic,Hispanic or Latino,1231,363,1594
439694,Hypertensive heart and renal disease with both (congestive) heart failure and renal failure,racial,Unknown,1049,541,1590
380094,Carpal tunnel syndrome,racial,Unknown,1116,474,1590
441737,Bruising,ethnic,Hispanic or Latino,1003,584,1587
137053,Seborrheic dermatitis,ethnic,Hispanic or Latino,812,775,1587
137809,Primary malignant neoplasm of female breast,ethnic,Not Hispanic or Latino,1585,0,1585
259153,Throat soreness,racial,Unknown,1033,543,1576
441534,"Severe major depression, single episode, without psychotic features",ethnic,Hispanic or Latino,975,600,1575
375791,Uncomplicated senile dementia,ethnic,Not Hispanic or Latino,1067,504,1571
261889,Simple chronic bronchitis,racial,Unknown,1134,432,1566
314054,Aortic valve disease,racial,Unknown,833,734,1567
192671,GI - Gastrointestinal haemorrhage,ethnic,Hispanic or Latino,722,844,1566
195588,Cystitis,ethnic,Hispanic or Latino,1504,60,1564
321882,Generalised atherosclerosis,racial,Unknown,591,973,1564
197911,Hernia of anterior abdominal wall without obstruction AND without gangrene,ethnic,Hispanic or Latino,1007,554,1561
4064905,Venereal disease screening,racial,Unknown,1003,559,1562
312338,Benign hypertensive heart disease with congestive heart failure,ethnic,Not Hispanic or Latino,1033,527,1560
197304,Ulcer of lower limb,ethnic,Hispanic or Latino,879,679,1558
374923,Bell palsy,racial,Unknown,817,736,1553
4228802,Mild recurrent major depression,racial,White,897,653,1550
374022,Hemiplegia,racial,Other Race,971,580,1551
373999,Diabetic oculopathy associated with type I diabetes mellitus,ethnic,Hispanic or Latino,936,612,1548
374888,Dementia associated with another disease,ethnic,Not Hispanic or Latino,1350,198,1548
441482,Administrative reason for encounter,ethnic,Hispanic or Latino,787,759,1546
435511,Hypercalcemia,racial,White,1155,389,1544
195873,Leukorrhagia,ethnic,Hispanic or Latino,1488,44,1532
4158567,Post percutaneous transluminal coronary angioplasty,ethnic,Hispanic or Latino,522,1007,1529
435783,Schizophrenia,racial,White,695,833,1528
196463,Alcoholic cirrhosis,ethnic,Hispanic or Latino,444,1081,1525
4211231,Panic disorder without agoraphobia,ethnic,Hispanic or Latino,978,547,1525
434005,Morbid obesity,racial,Black or African American ,810,711,1521
136184,Pruritic disorder,ethnic,Hispanic or Latino,964,554,1518
435372,Underweight,ethnic,Hispanic or Latino,858,653,1511
257007,Allergic rhinitis,racial,Other Race,1003,506,1509
78234,Arthralgia of the hand,racial,Unknown,991,518,1509
443587,Diastolic heart failure,ethnic,Hispanic or Latino,1012,492,1504
440383,Depressive disorder,racial,Black or African American ,869,633,1502
376707,Acute conjunctivitis,racial,Unknown,883,619,1502
444070,Tachycardia,ethnic,Hispanic or Latino,1226,274,1500
313459,Sleep apnea,ethnic,Not Hispanic or Latino,462,1035,1497
4194160,Thyroid function tests abnormal,ethnic,Hispanic or Latino,1095,398,1493
377821,Neurological disorder associated with type I diabetes mellitus,ethnic,Hispanic or Latino,1175,315,1490
432526,Needs influenza immunisation,racial,Black or African American ,662,828,1490
255573,Chronic obstructive lung disease,racial,Asian,518,971,1489
437986,FTT - Failure to thrive,racial,White,711,775,1486
440674,Gout,racial,Asian,168,1318,1486
78835,Palindromic rheumatism of the lower leg,racial,White,971,513,1484
435515,Hypo-osmolality and or hyponatremia,ethnic,Hispanic or Latino,1019,465,1484
436466,Balanoposthitis,ethnic,Hispanic or Latino,0,1477,1477
258780,Chronic obstructive bronchitis,racial,Black or African American ,1260,212,1472
434169,Abnormal findings on diagnostic imaging of breast,racial,Unknown,1472,0,1472
440329,Herpes zoster without complication,racial,White,849,621,1470
435171,Allergic state,racial,White,869,600,1469
436077,Developmental delay,ethnic,Hispanic or Latino,554,915,1469
444101,Hypertensive heart failure,ethnic,Not Hispanic or Latino,589,881,1470
443597,Chronic kidney disease stage 3,racial,Asian,706,764,1470
80767,Breast irregular nodularity,racial,Unknown,1447,23,1470
439795,Minimal cognitive impairment,racial,Unknown,580,888,1468
443350,Lower urinary tract symptoms,ethnic,Not Hispanic or Latino,0,1467,1467
197988,General abdominal pain-symptom,racial,White,1090,375,1465
317009,Hyperreactive airway disease,racial,Filipino,922,541,1463
140489,Acquired acanthosis nigricans,ethnic,Hispanic or Latino,814,646,1460
440029,Viral disease,racial,Unknown,794,667,1461
77965,Nodular tendinous disease of finger,ethnic,Hispanic or Latino,1070,389,1459
201927,Cellulitis and abscess of leg,racial,White,543,913,1456
135033,Hair and hair follicle diseases,racial,White,718,738,1456
321887,Disorder of artery,ethnic,Hispanic or Latino,826,628,1454
375552,Pterygium,ethnic,Hispanic or Latino,805,649,1454
195321,Postmenopausal bleeding,racial,White,1444,7,1451
318775,Venous embolism,ethnic,Hispanic or Latino,467,984,1451
197925,Haemorrhage of rectum and anus,racial,White,725,725,1450
74719,Foot ulcer,racial,White,460,987,1447
200687,Renal disorder associated with type I diabetes mellitus,ethnic,Hispanic or Latino,895,550,1445
437663,Fever,racial,Unknown,833,610,1443
312349,Venous varices,racial,White,1221,221,1442
257012,Chronic rhinosinusitis,racial,Unknown,994,446,1440
376979,Diabetic cataract,racial,Unknown,1026,412,1438
253797,Post-inflammatory pulmonary fibrosis,ethnic,Hispanic or Latino,432,998,1430
432597,Schizoaffective schizophrenia,racial,Unknown,704,727,1431
441407,Appetite loss - anorexia,ethnic,Hispanic or Latino,1021,403,1424
197381,Epigastric pain,racial,Unknown,1113,308,1421
318736,Migraine,ethnic,Not Hispanic or Latino,1203,214,1417
438398,Leukocytosis,ethnic,Hispanic or Latino,961,453,1414
201914,Premenopausal menorrhagia,ethnic,Hispanic or Latino,1415,0,1415
77642,Arthralgia of the forearm,ethnic,Hispanic or Latino,1003,412,1415
24609,Hypoglycaemia,ethnic,Hispanic or Latino,987,428,1415
4096215,"Hyperlipidemia, group A",racial,Other Race,1086,327,1413
439708,Disorders of initiating and maintaining sleep,ethnic,Not Hispanic or Latino,1088,322,1410
377290,Legal blindness USA,racial,White,478,932,1410
4060985,BMI 30+ - obesity,racial,Black or African American ,860,547,1407
195562,Hemorrhoids,racial,Unknown,971,437,1408
314658,Cardiomegaly,racial,White,761,644,1405
436972,Glaucoma associated with systemic syndromes,racial,Unknown,842,561,1403
196168,Irregular menstrual bleeding,racial,Unknown,1401,0,1401
75576,Colon spasm,ethnic,Hispanic or Latino,1067,334,1401
79106,Arthralgia of the pelvic region and thigh,ethnic,Not Hispanic or Latino,886,515,1401
436583,[X]Falls,racial,Unknown,913,488,1401
441534,"Severe major depression, single episode, without psychotic features",racial,Unknown,833,566,1399
29735,Candidiasis of mouth,ethnic,Hispanic or Latino,669,729,1398
132466,Lumbar sprain,ethnic,Hispanic or Latino,895,501,1396
137057,Paronychia,ethnic,Hispanic or Latino,823,570,1393
31967,Nausea,racial,White,1030,363,1393
77630,Disease of shoulder,ethnic,Hispanic or Latino,830,564,1394
315078,Palpitations,racial,Unknown,1168,225,1393
377091,Fits - convulsions,ethnic,Not Hispanic or Latino,262,1129,1391
195083,Left lower quadrant pain,racial,White,978,414,1392
433316,Giddiness,racial,Asian,909,478,1387
74464,Idiopathic scoliosis AND/OR kyphoscoliosis,ethnic,Not Hispanic or Latino,1143,242,1385
4154309,Severe recurrent major depression with psychotic features,ethnic,Hispanic or Latino,860,522,1382
437833,Hypokalaemia,ethnic,Hispanic or Latino,998,384,1382
257007,Allergic rhinitis,racial,Black or African American ,566,817,1383
201603,Disease of teeth AND/OR supporting structures,racial,White,743,637,1380
442067,Atopic dermatitis and related conditions,racial,Unknown,798,582,1380
439147,Amnesia,racial,Asian,874,506,1380
380403,External hordeolum,ethnic,Hispanic or Latino,775,605,1380
73291,Palindromic rheumatism of the ankle and/or foot,racial,White,929,446,1375
4195572,"Mild major depression, single episode",racial,Unknown,662,711,1373
4064377,Depression screening,racial,Black or African American ,681,688,1369
321052,Peripheral vascular disease,racial,Black or African American ,23,1341,1364
4079876,Familial combined hyperlipidemia,racial,Black or African American ,423,941,1364
312664,Influenza with respiratory manifestation other than pneumonia,racial,White,669,692,1361
440389,MR - Mental retardation,ethnic,Hispanic or Latino,718,644,1362
197672,Urinary incontinence,racial,Asian,1228,129,1357
318775,Venous embolism,racial,Unknown,527,828,1355
443257,Swellings and lumps,racial,White,888,467,1355
377861,Disorder of refraction AND/OR accommodation,ethnic,Not Hispanic or Latino,708,644,1352
373478,Presbyopia,ethnic,Hispanic or Latino,886,460,1346
374022,Hemiplegia,racial,Asian,761,582,1343
4110499,Allergic rhinitis NOS,ethnic,Hispanic or Latino,817,527,1344
201061,Diaphragmatic hernia,ethnic,Hispanic or Latino,1049,290,1339
439795,Minimal cognitive impairment,racial,White,382,957,1339
372309,Mononeuritis,ethnic,Hispanic or Latino,605,734,1339
436070,Vitamin D deficiency,racial,White,833,504,1337
77025,Diverticulitis of colon,ethnic,Hispanic or Latino,867,467,1334
312950,IgE-mediated allergic asthma,ethnic,Not Hispanic or Latino,1042,290,1332
80502,Osteoporosis,racial,Other Race,1221,108,1329
432967,Anemia during pregnancy - baby not yet delivered,racial,White,1329,0,1329
436067,Schizophrenia simplex,racial,White,789,538,1327
436972,Glaucoma associated with systemic syndromes,racial,White,748,580,1328
200962,Primary malignant neoplasm of prostate,racial,Unknown,0,1325,1325
4049623,"Moderate major depression, single episode",racial,White,1118,207,1325
316139,HF - Heart failure,ethnic,Hispanic or Latino,826,497,1323
30234,Cervical sprain,racial,White,922,400,1322
4062495,Glaucoma screening,ethnic,Hispanic or Latino,1079,242,1321
4272867,General well-being finding,racial,White,623,697,1320
444100,Mood disorder,racial,Unknown,844,474,1318
140480,Impetigo,racial,White,550,766,1316
4105880,Contact of sexually transmissible disorder,ethnic,Hispanic or Latino,881,435,1316
4252735,Mourning,ethnic,Hispanic or Latino,1196,120,1316
258780,Chronic obstructive bronchitis,racial,White,787,527,1314
199856,Varicose veins of lower extremity with inflammation,ethnic,Hispanic or Latino,984,329,1313
259153,Throat soreness,ethnic,Not Hispanic or Latino,810,504,1314
194411,Unilateral simple inguinal hernia,ethnic,Hispanic or Latino,338,975,1313
442067,Atopic dermatitis and related conditions,ethnic,Not Hispanic or Latino,628,683,1311
435516,Lipoprotein deficiency disorder,ethnic,Hispanic or Latino,791,518,1309
194696,Menorrhalgia,racial,White,1304,5,1309
319835,Congestive cardiac failure,racial,Black or African American ,405,904,1309
4201388,Gastrostomy present,ethnic,Hispanic or Latino,485,823,1308
134118,Atrophic condition of skin,racial,White,695,612,1307
195588,Cystitis,racial,White,1242,64,1306
377091,Fits - convulsions,racial,Other Race,30,1274,1304
443864,Multi-infarct dementia with depression,ethnic,Hispanic or Latino,1033,271,1304
436073,Psychotic disorder,racial,Unknown,1051,251,1302
134441,Chronic ulcer of skin,ethnic,Hispanic or Latino,580,715,1295
201322,Internal hemorrhoids without complication,ethnic,Hispanic or Latino,844,449,1293
74855,Genital herpes simplex,ethnic,Hispanic or Latino,860,432,1292
375281,Acute suppurative otitis media - tympanic membrane intact,ethnic,Not Hispanic or Latino,499,791,1290
312338,Benign hypertensive heart disease with congestive heart failure,racial,Black or African American ,909,380,1289
381859,Infective OE,racial,Unknown,782,506,1288
440704,Chronic pain syndrome,racial,Black or African American ,407,879,1286
201613,Chronic nonalcoholic liver disease,racial,Unknown,936,347,1283
73008,Enthesopathy,ethnic,Hispanic or Latino,874,407,1281
135360,Fainting,racial,White,789,492,1281
257683,Postnasal drip,racial,White,865,416,1281
137379,Musculoskeletal symptom,ethnic,Hispanic or Latino,784,497,1281
201620,Calculus of kidney,racial,Unknown,1030,248,1278
135473,Dermatophytosis,ethnic,Hispanic or Latino,649,630,1279
436155,Redundant prepuce and phimosis,ethnic,Hispanic or Latino,0,1277,1277
136773,Rosacea,ethnic,Hispanic or Latino,867,409,1276
196456,Cholecystolithiasis,racial,Unknown,902,375,1277
439694,Hypertensive heart and renal disease with both (congestive) heart failure and renal failure,racial,White,964,311,1275
80813,Lumbosacral spondylosis without myelopathy,ethnic,Hispanic or Latino,851,421,1272
4144997,Osteoarthritis NOS,ethnic,Hispanic or Latino,955,317,1272
140648,Onychomycosis due to dermatophyte,ethnic,Not Hispanic or Latino,600,669,1269
4298697,Multiple open wounds without complication,ethnic,Hispanic or Latino,547,720,1267
141323,Acute maxillary sinusitis,ethnic,Hispanic or Latino,952,313,1265
195007,Female stress incontinence,racial,White,1263,0,1263
255848,Pneumonia,ethnic,Not Hispanic or Latino,600,662,1262
372324,Eustachian tube disorder,ethnic,Hispanic or Latino,851,409,1260
77638,Displacement of intervertebral disc without myelopathy,ethnic,Hispanic or Latino,1116,145,1261
80809,Rheumatoid arthritis,racial,Asian,1228,28,1256
441092,Advanced maternal age gravida,ethnic,Hispanic or Latino,1254,0,1254
193322,Right lower quadrant pain,racial,White,961,292,1253
374060,Acute ill-defined cerebrovascular disease,racial,Asian,465,789,1254
257004,Acute exacerbation of chronic obstructive airways disease,ethnic,Not Hispanic or Latino,697,557,1254
380986,Senile dementia with delusion,ethnic,Hispanic or Latino,1189,62,1251
373852,Neuralgia,ethnic,Hispanic or Latino,1001,248,1249
377575,Tinnitus,racial,White,803,444,1247
78234,Arthralgia of the hand,racial,White,964,283,1247
81984,Sprain of shoulder and upper arm,ethnic,Hispanic or Latino,780,465,1245
433069,Open wound of external genital organs with complication,racial,White,472,773,1245
439125,T21 - Trisomy 21,racial,White,534,706,1240
4092896,Stool contents abnormal,racial,White,752,488,1240
436096,Chronic pain,racial,Unknown,810,428,1238
74132,Degeneration of lumbosacral intervertebral disc,ethnic,Not Hispanic or Latino,899,338,1237
444101,Hypertensive heart failure,racial,White,858,377,1235
255848,Pneumonia,racial,Unknown,674,559,1233
73553,Arthropathy,racial,Asian,476,754,1230
195453,"Colitis, enteritis and gastroenteritis presumed infectious",ethnic,Hispanic or Latino,674,557,1231
312934,Atherosclerosis of aorta,racial,White,860,366,1226
439147,Amnesia,ethnic,Not Hispanic or Latino,607,619,1226
77234,Benign tumour of colon,ethnic,Hispanic or Latino,646,570,1216
438409,Attention deficit hyperactivity disorder,ethnic,Not Hispanic or Latino,260,952,1212
4060985,BMI 30+ - obesity,racial,Asian,626,587,1213
193016,Cystic disease of kidney,ethnic,Hispanic or Latino,860,352,1212
434750,Feeding difficulties and mismanagement,racial,White,439,773,1212
437643,Gait abnormality,racial,Other Race,704,508,1212
441482,Administrative reason for encounter,racial,White,637,573,1210
372906,Both eyes total visual impairment,racial,Unknown,1065,143,1208
80951,Candidiasis of urogenital site,ethnic,Hispanic or Latino,478,729,1207
432284,Single major depressive episode,racial,Asian,350,856,1206
435613,Cellulitis,racial,White,660,545,1205
379019,Inflammation of conjunctiva,racial,Unknown,771,432,1203
78517,Arthralgia of multiple joints,racial,Unknown,906,294,1200
141095,Acne,ethnic,Not Hispanic or Latino,722,478,1200
257011,Acute upper respiratory infection,racial,Asian,564,633,1197
4308509,Impaired fasting glycaemia,ethnic,Not Hispanic or Latino,662,534,1196
201131,Pelvic mass,ethnic,Hispanic or Latino,902,294,1196
140949,Scabies,racial,White,651,543,1194
4093344,Prostate observation,ethnic,Not Hispanic or Latino,5,1189,1194
138102,Benign tumour of skin,racial,White,683,508,1191
78516,Arthralgia of the upper arm,racial,White,787,403,1190
4064905,Venereal disease screening,ethnic,Not Hispanic or Latino,745,444,1189
138278,Sprains and strains of joints and adjacent muscles,racial,White,649,536,1185
4276723,Finding of child weight centiles,racial,White,566,614,1180
201418,"Flatulence, eructation and gas pain",ethnic,Hispanic or Latino,780,398,1178
78619,"Contusion, knee",ethnic,Hispanic or Latino,773,405,1178
375415,Injury of head region,ethnic,Hispanic or Latino,584,593,1177
73754,Restless legs,ethnic,Hispanic or Latino,897,281,1178
440360,Pure hyperglyceridemia,racial,Other Race,497,679,1176
438120,Opioid dependence,racial,White,557,619,1176
377574,Presbycusis,racial,White,51,1122,1173
312437,Dyspnea,racial,Unknown,844,327,1171
4293175,"Mental state, behaviour and/or psychosocial function finding",ethnic,Hispanic or Latino,370,798,1168
436659,Iron deficiency anaemia,racial,Asian,722,446,1168
319843,Mitral valve disorder,ethnic,Hispanic or Latino,922,246,1168
198678,Intestinal infectious disease,racial,White,554,612,1166
28457,Hypertrophy of tonsils,ethnic,Hispanic or Latino,582,584,1166
133299,Swelling of limb,racial,Unknown,828,338,1166
444382,Thoracic radiculitis,ethnic,Hispanic or Latino,805,361,1166
4144997,Osteoarthritis NOS,racial,White,856,306,1162
257011,Acute upper respiratory infection,racial,Black or African American ,577,580,1157
4110499,Allergic rhinitis NOS,racial,White,646,511,1157
443454,Cerebral infarction,racial,White,460,697,1157
435928,Abnormal decrease in weight,racial,Unknown,771,386,1157
194133,Low back pain,racial,Black or African American ,672,483,1155
434613,Generalized anxiety disorder,ethnic,Not Hispanic or Latino,775,380,1155
4252735,Mourning,racial,Unknown,1072,83,1155
133727,Thyrotoxicosis without goiter OR other cause,racial,White,897,258,1155
4005823,Tobacco user,racial,White,347,805,1152
4093344,Prostate observation,racial,Unknown,5,1148,1153
317302,Coronary sinus rhythm disorder,ethnic,Not Hispanic or Latino,444,708,1152
73560,Calcaneal spur,ethnic,Hispanic or Latino,872,281,1153
436682,Moderate mental handicap,racial,Unknown,85,1063,1148
141104,Intervertebral disc disorder of lumbar region with myelopathy,ethnic,Hispanic or Latino,492,653,1145
443545,Nonvenomous insect bite,racial,White,591,552,1143
197913,Disorder of function of stomach,ethnic,Not Hispanic or Latino,830,313,1143
435171,Allergic state,ethnic,Not Hispanic or Latino,414,727,1141
314666,Healed coronary,racial,White,386,752,1138
133835,Dermatitis,racial,White,623,515,1138
193251,Umbilical hernia without obstruction AND without gangrene,racial,White,630,506,1136
4086918,Viral screening,racial,Other Race,676,460,1136
444291,Cochlear hearing loss,racial,Unknown,1007,127,1134
315085,Enlargement of lymph nodes,racial,White,665,467,1132
4311159,Midline cystocele,ethnic,Hispanic or Latino,1129,0,1129
441737,Bruising,racial,White,672,455,1127
317302,Coronary sinus rhythm disorder,racial,Asian,449,679,1128
140842,Changes in skin texture,ethnic,Hispanic or Latino,637,490,1127
196738,Male genital organ disease,ethnic,Hispanic or Latino,0,1125,1125
374028,AAMD - Age related macular degeneration,racial,Unknown,773,350,1123
72993,Primary localised osteoarthrosis,ethnic,Hispanic or Latino,704,419,1123
372613,Flaccid hemiplegia,ethnic,Hispanic or Latino,412,711,1123
75614,Acrodermatitis continua,ethnic,Not Hispanic or Latino,676,446,1122
4051114,FH: Diabetes mellitus,racial,White,644,478,1122
443732,Disorder associated with type II diabetes melliltus,racial,White,582,541,1123
134057,Disease of cardiovascular system,ethnic,Hispanic or Latino,580,538,1118
75576,Colon spasm,racial,Unknown,945,170,1115
317898,Malignant essential hypertension,racial,White,959,154,1113
314666,Healed coronary,racial,Unknown,568,545,1113
380096,Proliferative diabetic retinopathy,racial,White,568,543,1111
196456,Cholecystolithiasis,ethnic,Not Hispanic or Latino,938,173,1111
437264,Tobacco dependence syndrome,racial,Black or African American ,393,718,1111
132466,Lumbar sprain,racial,White,681,430,1111
434165,Abnormal cervical smear,ethnic,Hispanic or Latino,1106,2,1108
438120,Opioid dependence,ethnic,Not Hispanic or Latino,515,591,1106
76836,Sprain of knee and leg,racial,White,612,495,1107
314059,Right bundle branch block,ethnic,Hispanic or Latino,596,508,1104
257315,Bacterial pneumonia,ethnic,Hispanic or Latino,699,405,1104
4088930,Confirmation of pregnancy,racial,White,1093,12,1105
4113027,Dietary intake observations,racial,White,515,589,1104
140821,Spasm,ethnic,Not Hispanic or Latino,713,389,1102
436077,Developmental delay,racial,White,428,672,1100
437038,Blood in urine,racial,Unknown,706,391,1097
200962,Primary malignant neoplasm of prostate,racial,White,0,1097,1097
4194160,Thyroid function tests abnormal,racial,White,782,315,1097
199839,External haemorrhoids without complication,racial,White,679,414,1093
261325,Pulmonary emphysema,ethnic,Hispanic or Latino,616,472,1088
440389,MR - Mental retardation,racial,White,593,492,1085
4245252,Raised prostate specific antigen,racial,Unknown,0,1086,1086
320128,Essential hypertension,racial,American Indian or Alaska Native ,768,315,1083
198194,Female genital organ symptoms,racial,Unknown,1083,0,1083
198199,Pyelonephritis,ethnic,Hispanic or Latino,936,147,1083
374013,Secondary Parkinson's disease,ethnic,Hispanic or Latino,715,368,1083
438066,Chlamydial infection,ethnic,Hispanic or Latino,823,258,1081
77968,Hallux valgus AND bunion,ethnic,Hispanic or Latino,844,237,1081
139057,Disease of oral soft tissues,racial,Unknown,761,315,1076
440029,Viral disease,ethnic,Not Hispanic or Latino,547,529,1076
194175,Left upper quadrant pain,ethnic,Hispanic or Latino,828,246,1074
374888,Dementia associated with another disease,racial,Asian,909,166,1075
4062637,TB - Tuberculosis screening,racial,Other Race,607,465,1072
195007,Female stress incontinence,racial,Unknown,1072,0,1072
201078,Senile atrophic vaginitis,ethnic,Hispanic or Latino,1070,0,1070
433753,Alcohol abuse,racial,White,124,945,1069
381857,Impairment level: one eye: total impairment: other eye: not specified,ethnic,Hispanic or Latino,428,637,1065
200174,Disease of skin AND/OR subcutaneous tissue,ethnic,Not Hispanic or Latino,623,442,1065
138384,Acquired hypothyroidism,ethnic,Hispanic or Latino,837,225,1062
195012,Metrorrhagia,ethnic,Hispanic or Latino,1063,0,1063
4096215,"Hyperlipidemia, group A",racial,Black or African American ,711,352,1063
321052,Peripheral vascular disease,racial,Other Race,794,267,1061
436583,[X]Falls,racial,White,750,311,1061
4195572,"Mild major depression, single episode",racial,White,750,308,1058
201627,Abnormal vaginal bleeding,ethnic,Hispanic or Latino,1058,0,1058
194406,Urinary tract obstruction,ethnic,Hispanic or Latino,28,1028,1056
441284,Open-angle glaucoma,racial,Unknown,821,235,1056
373503,Intermittent cerebral ischaemia,racial,White,775,281,1056
195306,Gastroduodenitis,racial,Asian,761,294,1055
435796,Dehydration,ethnic,Hispanic or Latino,679,375,1054
4088920,Womb absent,ethnic,Hispanic or Latino,1051,2,1053
4170576,Pressure ulcer,ethnic,Hispanic or Latino,863,191,1054
4161977,Patient with cardiac pacemaker,ethnic,Not Hispanic or Latino,584,467,1051
436230,Blood chemistry abnormal,racial,Unknown,690,361,1051
376400,Combined form of senile cataract,ethnic,Hispanic or Latino,672,377,1049
373499,Disorder of eye region,ethnic,Hispanic or Latino,653,396,1049
197684,Dysuria,racial,Other Race,743,304,1047
195847,Gastroparesis syndrome,ethnic,Hispanic or Latino,867,179,1046
439147,Amnesia,racial,Other Race,1021,25,1046
195851,"Gastric ulcer without hemorrhage, without perforation AND without obstruction",ethnic,Hispanic or Latino,430,616,1046
321052,Peripheral vascular disease,racial,Asian,515,529,1044
141253,Disease of thyroid gland,ethnic,Hispanic or Latino,856,184,1040
439297,Nuclear senile cataract,ethnic,Hispanic or Latino,713,322,1035
4263370,R.I.N.D. syndrome,racial,White,545,488,1033
256448,Chronic asthmatic bronchitis,racial,Unknown,784,248,1032
379784,Senile dementia with depression,racial,White,876,156,1032
253797,Post-inflammatory pulmonary fibrosis,racial,White,193,837,1030
81379,Lateral epicondylitis,ethnic,Hispanic or Latino,667,363,1030
443776,Brachial radiculitis,racial,Unknown,708,322,1030
80189,Displacement of lumbar intervertebral disc without myelopathy,racial,White,621,407,1028
437663,Fever,ethnic,Not Hispanic or Latino,444,580,1024
137351,Epidermoid cyst of skin,racial,White,566,455,1021
381270,Parkinson's disease,ethnic,Not Hispanic or Latino,524,495,1019
314754,Wheezing,ethnic,Not Hispanic or Latino,573,444,1017
4171430,Screening for malignant neoplasm of rectum,racial,Unknown,449,568,1017
380986,Senile dementia with delusion,racial,White,984,30,1014
256531,Head and neck swelling,racial,White,630,382,1012
75617,Polyarticular osteoarthritis,racial,Black or African American ,718,294,1012
312349,Venous varices,racial,Unknown,881,131,1012
75337,Cellulitis and abscess of buttock,ethnic,Hispanic or Latino,513,492,1005
141095,Acne,racial,Unknown,497,508,1005
440021,Herpes simplex without complication,ethnic,Hispanic or Latino,662,343,1005
76153,Low compliance bladder,ethnic,Not Hispanic or Latino,209,794,1003
197500,Primary malignant neoplasm of colon,ethnic,Hispanic or Latino,409,593,1002
137057,Paronychia,racial,White,591,412,1003
77030,Disease of breast,ethnic,Hispanic or Latino,973,30,1003
198263,Right upper quadrant pain,racial,Unknown,835,166,1001
75650,Proteinuria,ethnic,Not Hispanic or Latino,449,552,1001
135360,Fainting,racial,Unknown,784,216,1000
321319,Cardiomyopathy,ethnic,Hispanic or Latino,656,345,1001
76786,Derangement of knee,racial,White,458,543,1001
4165091,Lack of exercise,racial,White,467,531,998
4064918,Diabetes mellitus screening,racial,Other Race,575,421,996
194081,Acute cystitis,racial,Unknown,932,64,996
77635,Disease of hand,ethnic,Hispanic or Latino,676,317,993
4141622,Asthma NOS,ethnic,Hispanic or Latino,628,361,989
440674,Gout,racial,Filipino,405,584,989
194686,Acquired renal cyst,ethnic,Hispanic or Latino,803,186,989
79908,Muscle strength reduced,racial,White,386,603,989
436940,Insulin resistance syndrome,ethnic,Hispanic or Latino,561,428,989
197913,Disorder of function of stomach,racial,Asian,938,48,986
136773,Rosacea,racial,White,665,322,987
140673,Hypothyroid,racial,Black or African American ,350,635,985
77644,Adhesive capsulitis of shoulder,ethnic,Hispanic or Latino,651,334,985
315833,Secondary cardiomyopathy,ethnic,Hispanic or Latino,711,274,985
373198,Unqualified visual loss of both eyes,ethnic,Hispanic or Latino,389,596,985
195873,Leukorrhagia,racial,White,955,25,980
436230,Blood chemistry abnormal,ethnic,Not Hispanic or Latino,589,391,980
140821,Spasm,racial,Unknown,738,239,977
77642,Arthralgia of the forearm,racial,White,651,327,978
255841,Chronic bronchitis,racial,White,584,391,975
379805,Myopia,racial,White,504,472,976
435516,Lipoprotein deficiency disorder,racial,White,580,393,973
439700,Inhibited sexual desire,racial,Unknown,0,973,973
377254,"Multi-infarct dementia, uncomplicated",ethnic,Not Hispanic or Latino,115,856,971
135360,Fainting,ethnic,Not Hispanic or Latino,787,182,969
198995,Type 1 diabetes mellitus - poor control,racial,Asian,338,630,968
432285,Recurrent major depressive episodes,racial,Other Race,796,173,969
198803,Nodular hyperplasia of prostate gland,racial,Other Race,0,968,968
196360,Primary malignant neoplasm of bladder,ethnic,Not Hispanic or Latino,2,966,968
376112,Diabetic polyneuropathy,racial,Asian,718,248,966
77074,Joint pain,ethnic,Not Hispanic or Latino,633,334,967
4101199,Hearing problem,ethnic,Hispanic or Latino,495,472,967
380096,Proliferative diabetic retinopathy,racial,Unknown,474,490,964
135772,Goiter,ethnic,Hispanic or Latino,920,44,964
137063,Corns and callus,racial,White,607,357,964
377527,Presenile dementia with depression,ethnic,Hispanic or Latino,435,529,964
443237,"Manic disorder, single episode",ethnic,Hispanic or Latino,308,653,961
141323,Acute maxillary sinusitis,racial,White,685,276,961
375252,Disorder of eye,ethnic,Hispanic or Latino,522,439,961
316999,Cardiac arrhythmia,racial,Asian,582,377,959
197032,Hyperplasia of prostate,racial,Unknown,0,959,959
312648,Benign essential hypertension,racial,American Indian or Alaska Native ,867,90,957
316822,Finding of heart murmur,racial,Unknown,681,276,957
312998,Pain in thoracic spine,ethnic,Hispanic or Latino,621,336,957
198194,Female genital organ symptoms,ethnic,Not Hispanic or Latino,955,2,957
443729,Peripheral circulatory disorder associated with type II diabetes mellitus,ethnic,Not Hispanic or Latino,237,718,955
442068,Cellulitis and abscess of forearm,ethnic,Hispanic or Latino,547,407,954
197236,Uterine fibroid,racial,Unknown,955,0,955
4090651,Dialysis observation,racial,White,435,520,955
318169,Varicose veins of lower extremity,ethnic,Hispanic or Latino,833,122,955
376382,Tension-type headache,racial,Unknown,773,179,952
440693,Continuous opioid dependence,ethnic,Hispanic or Latino,297,656,953
137682,Skin sensation disturbance,racial,Unknown,577,370,947
381292,Chronic allergic conjunctivitis,ethnic,Not Hispanic or Latino,681,267,948
442793,Diabetic complication,ethnic,Not Hispanic or Latino,531,414,945
440748,Interstitial emphysema of lung,ethnic,Hispanic or Latino,536,409,945
4298854,HIV seropositivity,ethnic,Not Hispanic or Latino,198,748,946
137053,Seborrheic dermatitis,racial,White,467,476,943
312922,Coronary bypass graft observation,racial,White,246,697,943
74855,Genital herpes simplex,racial,White,603,334,937
4062636,Bacterial disease screening,ethnic,Hispanic or Latino,840,97,937
196360,Primary malignant neoplasm of bladder,racial,Asian,0,936,936
197911,Hernia of anterior abdominal wall without obstruction AND without gangrene,racial,White,603,331,934
377091,Fits - convulsions,racial,Asian,14,920,934
4141622,Asthma NOS,racial,White,603,331,934
441840,Clinical finding,ethnic,Hispanic or Latino,614,317,931
132659,Acute apical periodontitis,ethnic,Hispanic or Latino,628,304,932
76786,Derangement of knee,racial,Unknown,437,495,932
317002,Hypopiesis,racial,White,752,179,931
378756,Conjunctival hemorrhage,ethnic,Hispanic or Latino,589,343,932
40479192,Chronic systolic heart failure,racial,Asian,605,324,929
134460,Plantar fascial fibromatosis,racial,Unknown,614,315,929
318712,Peripheral circulatory disorder associated with type I diabetes mellitus,racial,White,299,630,929
192286,Intestinal disaccharidase deficiency,ethnic,Hispanic or Latino,692,235,927
378743,Mild nonproliferative retinopathy,ethnic,Hispanic or Latino,478,449,927
74719,Foot ulcer,racial,Unknown,432,495,927
372324,Eustachian tube disorder,racial,White,607,317,924
377889,Hearing loss,racial,Asian,340,584,924
313236,Cough variant asthma,racial,Unknown,460,462,922
30437,Gastroesophageal reflux disease with esophagitis,racial,White,527,396,923
372634,Nonphysiologic vision loss,racial,White,492,430,922
432869,Hemorrhagic disorder due to circulating anticoagulants,racial,Unknown,191,729,920
199877,Mucous polyp of cervix,ethnic,Hispanic or Latino,920,0,920
138502,Vitiligo,ethnic,Hispanic or Latino,518,400,918
439846,LVF - Left ventricular failure,ethnic,Hispanic or Latino,538,380,918
78619,"Contusion, knee",racial,White,545,373,918
439141,Abnormal increase in weight,ethnic,Not Hispanic or Latino,501,414,915
376229,Abnormal involuntary movement,racial,White,428,488,916
443783,Chronic disease,racial,Asian,554,361,915
139850,Acute frontal sinusitis,ethnic,Hispanic or Latino,665,251,916
4105880,Contact of sexually transmissible disorder,racial,White,568,345,913
438867,Generalized body aches,racial,White,587,327,914
314754,Wheezing,racial,Unknown,511,400,911
433440,Dysthymia,ethnic,Not Hispanic or Latino,734,175,909
198075,Venereal wart,ethnic,Hispanic or Latino,437,472,909
439799,Leg cramps,racial,Unknown,869,35,904
4062495,Glaucoma screening,racial,White,718,186,904
438398,Leukocytosis,racial,White,633,269,902
195453,"Colitis, enteritis and gastroenteritis presumed infectious",racial,White,474,426,900
24660,Acute tonsillitis,racial,Unknown,575,324,899
374924,Generalized convulsive epilepsy,ethnic,Not Hispanic or Latino,297,603,900
4100857,Pickwickian syndrome,racial,Unknown,529,368,897
40479192,Chronic systolic heart failure,ethnic,Not Hispanic or Latino,343,554,897
197950,Cellulitis and abscess of trunk,ethnic,Hispanic or Latino,501,396,897
29735,Candidiasis of mouth,racial,White,386,511,897
380403,External hordeolum,racial,White,478,416,894
133280,Alopecia,ethnic,Hispanic or Latino,780,113,893
314054,Aortic valve disease,racial,White,283,610,893
132706,Nail disease,ethnic,Hispanic or Latino,559,334,893
432741,Abnormal immunology finding,ethnic,Hispanic or Latino,685,205,890
194984,Hepatopathy,ethnic,Hispanic or Latino,619,271,890
4158567,Post percutaneous transluminal coronary angioplasty,racial,White,290,598,888
433316,Giddiness,racial,Other Race,775,110,885
436940,Insulin resistance syndrome,racial,White,520,363,883
441628,Menopausal and postmenopausal disorders,ethnic,Hispanic or Latino,883,0,883
201826,Type 2 diabetes mellitus,racial,Native Hawaiian or Other Pacific Islander ,331,552,883
432284,Single major depressive episode,racial,Black or African American ,821,62,883
437382,Urine observation,racial,Unknown,713,170,883
435372,Underweight,racial,White,488,396,884
80767,Breast irregular nodularity,ethnic,Not Hispanic or Latino,823,58,881
77354,Primary localised osteoarthrosis of lower leg,ethnic,Not Hispanic or Latino,561,320,881
76194,Osteoarthrosis involving multiple sites but not designated as generalized,racial,White,455,423,878
77670,Chest pain,racial,Asian,587,292,879
201254,Insulin dependent diabetes mellitus,ethnic,Not Hispanic or Latino,398,481,879
4250023,Severe major depression with psychotic features,ethnic,Hispanic or Latino,531,345,876
440321,Helicobacter-associated disease,racial,Unknown,683,193,876
376406,"Impairment level: blindness, one eye - low vision other eye",ethnic,Not Hispanic or Latino,115,759,874
260134,Croup,ethnic,Hispanic or Latino,315,559,874
192279,Diabetic nephropathy,racial,Asian,338,534,872
434613,Generalized anxiety disorder,racial,Asian,828,41,869
437175,"Fall on same level from slipping, tripping or stumbling",ethnic,Hispanic or Latino,662,205,867
75911,Acquired hallux valgus,ethnic,Hispanic or Latino,357,511,868
316822,Finding of heart murmur,ethnic,Not Hispanic or Latino,584,283,867
198995,Type 1 diabetes mellitus - poor control,racial,Other Race,423,442,865
136184,Pruritic disorder,racial,White,497,368,865
140641,Verruca vulgaris,ethnic,Not Hispanic or Latino,407,458,865
201914,Premenopausal menorrhagia,racial,White,860,5,865
432867,Hyperlipidemia,racial,American Indian or Alaska Native ,662,200,862
440358,Lipoma,ethnic,Hispanic or Latino,474,389,863
76153,Low compliance bladder,racial,Unknown,676,186,862
4154309,Severe recurrent major depression with psychotic features,racial,White,359,501,860
78508,Arthralgia of the ankle and/or foot,racial,Unknown,527,334,861
432867,Hyperlipidemia,racial,Filipino,775,85,860
436072,Bipolar disorder in partial remission,ethnic,Hispanic or Latino,784,76,860
315078,Palpitations,ethnic,Not Hispanic or Latino,598,260,858
198363,Candidiasis of vagina,racial,Unknown,858,0,858
4115379,"Localised, primary osteoarthritis of the pelvic region and thigh",ethnic,Hispanic or Latino,550,308,858
436466,Balanoposthitis,racial,White,0,856,856
312723,Congenital heart disease,ethnic,Hispanic or Latino,414,439,853
256439,Allergic rhinitis due to pollen,racial,White,449,405,854
442615,Carotid artery stenosis,ethnic,Hispanic or Latino,421,432,853
80242,Current tear of medial cartilage AND/OR meniscus of knee,ethnic,Hispanic or Latino,550,301,851
198964,Chronic type C viral hepatitis,racial,Black or African American ,373,478,851
197320,ARF - Acute renal failure,ethnic,Hispanic or Latino,467,384,851
374923,Bell palsy,racial,White,437,412,849
380733,Otalgia,racial,Unknown,676,173,849
141216,MC - Molluscum contagiosum,ethnic,Hispanic or Latino,405,444,849
433599,Abnormal biochemistry finding,ethnic,Hispanic or Latino,518,331,849
437833,Hypokalaemia,racial,White,557,292,849
257907,Disorder of lung,ethnic,Hispanic or Latino,363,485,848
196463,Alcoholic cirrhosis,racial,White,265,584,849
4112525,Acute bronchiolitis NOS,ethnic,Hispanic or Latino,265,582,847
433811,Hydronephrosis,ethnic,Hispanic or Latino,460,386,846
195562,Hemorrhoids,ethnic,Not Hispanic or Latino,419,426,845
73008,Enthesopathy,racial,White,577,267,844
379019,Inflammation of conjunctiva,ethnic,Not Hispanic or Latino,488,354,842
77965,Nodular tendinous disease of finger,racial,White,619,223,842
200843,Observation of frequency of urination,racial,Unknown,561,281,842
139099,Ingrowing nail,racial,Unknown,485,357,842
137497,Dermatophytosis of the body,racial,Unknown,566,274,840
4133029,Primigravida,ethnic,Not Hispanic or Latino,791,48,839
377527,Presenile dementia with depression,racial,White,331,508,839
27674,N&V - Nausea and vomiting,racial,Unknown,612,228,840
320128,Essential hypertension,racial,Filipino,508,329,837
140489,Acquired acanthosis nigricans,racial,White,462,373,835
138825,Actinic keratosis,ethnic,Hispanic or Latino,593,242,835
73564,Complete rupture of rotator cuff,ethnic,Hispanic or Latino,255,575,830
378425,Eyelid inflammation,ethnic,Hispanic or Latino,513,317,830
197914,Chronic gastric ulcer with perforation but without obstruction,ethnic,Hispanic or Latino,817,14,831
256448,Chronic asthmatic bronchitis,racial,White,672,159,831
135473,Dermatophytosis,racial,White,396,432,828
40479192,Chronic systolic heart failure,racial,Unknown,759,69,828
441092,Advanced maternal age gravida,racial,White,817,12,829
442565,Gestational edema without hypertension,ethnic,Hispanic or Latino,828,0,828
443414,Chronic post-traumatic stress disorder,ethnic,Not Hispanic or Latino,228,600,828
136788,Spinal stenosis of lumbar region,racial,Unknown,575,251,826
440508,Congenital disease,ethnic,Hispanic or Latino,237,589,826
195501,Polycystic ovaries,ethnic,Hispanic or Latino,826,0,826
436962,Sleeplessness,racial,Black or African American ,658,168,826
374009,Organic mental disorder,ethnic,Hispanic or Latino,16,807,823
4293175,"Mental state, behaviour and/or psychosocial function finding",racial,White,258,566,824
443238,Diabetic - poor control,ethnic,Not Hispanic or Latino,414,409,823
192359,RF - Renal failure,ethnic,Hispanic or Latino,412,409,821
440389,MR - Mental retardation,racial,Unknown,69,752,821
193253,Nephritis,ethnic,Not Hispanic or Latino,373,449,822
72995,Joint contracture of hand,ethnic,Hispanic or Latino,30,789,819
198124,Disorder of kidney,ethnic,Not Hispanic or Latino,458,361,819
4149353,"Attention deficit hyperactivity disorder, predominantly inattentive type",racial,White,324,495,819
134898,Non-toxic single thyroid nodule,ethnic,Hispanic or Latino,704,113,817
80502,Osteoporosis,racial,Filipino,817,0,817
256439,Allergic rhinitis due to pollen,racial,Unknown,568,248,816
139902,Allergic urticaria,ethnic,Hispanic or Latino,511,306,817
4149353,"Attention deficit hyperactivity disorder, predominantly inattentive type",ethnic,Hispanic or Latino,274,541,815
81878,Benign paroxysmal positional vertigo,racial,Unknown,612,202,814
73840,Primary localised osteoarthrosis of shoulder region,ethnic,Hispanic or Latino,564,251,815
4154309,Severe recurrent major depression with psychotic features,ethnic,Not Hispanic or Latino,750,64,814
443350,Lower urinary tract symptoms,racial,Asian,0,814,814
132553,Herpangina,ethnic,Hispanic or Latino,345,467,812
439777,Anemia,racial,Black or African American ,591,221,812
4311591,Cramp in limb,ethnic,Not Hispanic or Latino,331,481,812
132408,Back problem,ethnic,Hispanic or Latino,667,143,810
78508,Arthralgia of the ankle and/or foot,ethnic,Not Hispanic or Latino,518,292,810
373503,Intermittent cerebral ischaemia,racial,Unknown,561,248,809
78497,Cellulitis and abscess of toe,ethnic,Hispanic or Latino,380,430,810
438480,"Abnormal glucose tolerance in mother complicating pregnancy, childbirth AND/OR puerperium",ethnic,Hispanic or Latino,810,0,810
433454,Adjustment disorder with mixed emotional features,ethnic,Hispanic or Latino,361,449,810
28060,Strept throat,racial,Unknown,495,313,808
437969,Acquired pes planus,ethnic,Hispanic or Latino,276,531,807
435220,Severe recurrent major depression without psychotic features,racial,Unknown,113,692,805
372309,Mononeuritis,racial,White,400,405,805
133141,Tinea pedis,ethnic,Not Hispanic or Latino,336,467,803
4201388,Gastrostomy present,racial,White,225,577,802
374009,Organic mental disorder,racial,Unknown,2,798,800
444101,Hypertensive heart failure,racial,Asian,566,235,801
4164770,Acute inflammatory demyelinating polyradiculoneuropathy,ethnic,Hispanic or Latino,0,800,800
78272,Sprain of wrist,ethnic,Hispanic or Latino,508,292,800
437643,Gait abnormality,racial,Asian,288,513,801
380094,Carpal tunnel syndrome,ethnic,Not Hispanic or Latino,603,196,799
4164770,Acute inflammatory demyelinating polyradiculoneuropathy,racial,Unknown,0,798,798
81893,Chronic ulcerative colitis,ethnic,Hispanic or Latino,403,396,799
375239,Cerebral degeneration,racial,Unknown,748,51,799
77670,Chest pain,racial,Other Race,340,455,795
22340,Esophageal varices without bleeding,ethnic,Hispanic or Latino,656,140,796
133436,Thyrotoxic crisis,racial,Unknown,729,67,796
443599,Paralytic syndrome of non-dominant side as late effect of stroke,racial,Unknown,0,794,794
73553,Arthropathy,racial,Other Race,541,253,794
197236,Uterine fibroid,ethnic,Not Hispanic or Latino,787,7,794
440426,Vertigo as late effect of stroke,racial,White,570,223,793
438557,Abnormal glucose level,racial,Asian,465,329,794
443599,Paralytic syndrome of non-dominant side as late effect of stroke,ethnic,Hispanic or Latino,0,794,794
133228,Dental caries,ethnic,Not Hispanic or Latino,405,386,791
74464,Idiopathic scoliosis AND/OR kyphoscoliosis,racial,Asian,759,32,791
441408,Vomiting,racial,Unknown,524,265,789
77630,Disease of shoulder,racial,White,472,317,789
439727,HIV - Human immunodeficiency virus infection,racial,Asian,99,690,789
443430,HPV - Human papillomavirus test positive,ethnic,Hispanic or Latino,782,7,789
196738,Male genital organ disease,racial,White,0,787,787
436070,Vitamin D deficiency,racial,Unknown,575,212,787
377575,Tinnitus,racial,Unknown,554,232,786
197988,General abdominal pain-symptom,racial,Unknown,603,182,785
195012,Metrorrhagia,racial,White,784,0,784
438066,Chlamydial infection,racial,White,520,265,785
76153,Low compliance bladder,racial,Asian,41,741,782
76161,Impotence of organic origin,racial,Unknown,0,782,782
75576,Colon spasm,racial,White,626,154,780
4112525,Acute bronchiolitis NOS,racial,White,237,543,780
256717,Bronchospasm,ethnic,Hispanic or Latino,483,297,780
437041,Mother not delivered,ethnic,Not Hispanic or Latino,750,30,780
444382,Thoracic radiculitis,racial,White,538,239,777
80951,Candidiasis of urogenital site,racial,White,329,449,778
443865,Non-infective colitis,ethnic,Not Hispanic or Latino,396,382,778
136788,Spinal stenosis of lumbar region,racial,White,536,239,775
133727,Thyrotoxicosis without goiter OR other cause,ethnic,Not Hispanic or Latino,288,488,776
201603,Disease of teeth AND/OR supporting structures,racial,Unknown,449,327,776
78232,Shoulder joint pain,racial,Asian,614,159,773
435656,Neonatal jaundice,ethnic,Hispanic or Latino,308,465,773
443729,Peripheral circulatory disorder associated with type II diabetes mellitus,racial,Black or African American ,18,754,772
437643,Gait abnormality,racial,Black or African American ,688,85,773
140641,Verruca vulgaris,racial,Unknown,492,281,773
437038,Blood in urine,ethnic,Not Hispanic or Latino,444,329,773
434056,Late effects of cerebrovascular disease,racial,Other Race,568,205,773
134441,Chronic ulcer of skin,racial,White,359,412,771
375415,Injury of head region,racial,White,347,423,770
433456,Acute pain,ethnic,Hispanic or Latino,474,297,771
201340,Gastritis,ethnic,Hispanic or Latino,566,202,768
432875,Anemia due to chronic blood loss,ethnic,Hispanic or Latino,738,30,768
40485064,Latent syphilis,ethnic,Hispanic or Latino,265,504,769
440021,Herpes simplex without complication,racial,White,455,313,768
81379,Lateral epicondylitis,racial,White,506,262,768
376979,Diabetic cataract,racial,White,527,239,766
440424,Aphasia,ethnic,Hispanic or Latino,235,531,766
200391,Peripheral autonomic neuropathy disease EC,ethnic,Hispanic or Latino,455,311,766
372906,Both eyes total visual impairment,racial,White,113,653,766
75614,Acrodermatitis continua,racial,Unknown,283,483,766
444132,Knee injury,ethnic,Hispanic or Latino,430,336,766
4100857,Pickwickian syndrome,ethnic,Not Hispanic or Latino,451,313,764
193782,End stage renal disease,ethnic,Not Hispanic or Latino,253,511,764
432870,Thrombocytopenia,racial,Other Race,736,25,761
444391,Pain around eye,ethnic,Hispanic or Latino,538,223,761
77234,Benign tumour of colon,racial,White,350,412,762
28060,Strept throat,ethnic,Not Hispanic or Latino,375,386,761
198803,Nodular hyperplasia of prostate gland,racial,Black or African American ,0,759,759
376117,Cataract in degenerative disorder,ethnic,Hispanic or Latino,469,290,759
136496,Cellulitis and abscess of face,ethnic,Hispanic or Latino,363,396,759
4211231,Panic disorder without agoraphobia,racial,White,426,334,760
28457,Hypertrophy of tonsils,racial,White,357,403,760
4062637,TB - Tuberculosis screening,racial,Black or African American ,331,428,759
436155,Redundant prepuce and phimosis,racial,White,0,759,759
26662,Testicular hypofunction,ethnic,Not Hispanic or Latino,5,752,757
440383,Depressive disorder,racial,Filipino,389,366,755
433031,Hallucinations,ethnic,Hispanic or Latino,499,253,752
199860,Hernia of abdominal cavity,ethnic,Hispanic or Latino,451,301,752
76161,Impotence of organic origin,ethnic,Not Hispanic or Latino,0,752,752
434073,Loss of teeth - acquired,ethnic,Hispanic or Latino,538,214,752
139906,Intervertebral disc disorder of cervical region with myelopathy,racial,Unknown,584,166,750
24609,Hypoglycaemia,racial,White,538,212,750
434610,Hyperkalemia,racial,Unknown,391,359,750
197494,Viral hepatitis C,ethnic,Hispanic or Latino,373,377,750
441264,Primary thrombocytopenia,ethnic,Hispanic or Latino,347,400,747
381859,Infective OE,ethnic,Not Hispanic or Latino,455,292,747
195321,Postmenopausal bleeding,racial,Unknown,748,0,748
434494,Closed fracture of the proximal humerus,ethnic,Hispanic or Latino,646,101,747
441836,Depressed bipolar I disorder,ethnic,Hispanic or Latino,322,426,748
436665,Manic-depressive psychosis,racial,Unknown,439,308,747
72748,Strain of rotator cuff of shoulder,ethnic,Hispanic or Latino,432,315,747
373503,Intermittent cerebral ischaemia,ethnic,Not Hispanic or Latino,147,598,745
441542,Anxiety,racial,Black or African American ,596,150,746
437655,Cryptorchism,ethnic,Hispanic or Latino,0,745,745
313459,Sleep apnea,racial,Unknown,324,421,745
443570,Cervicovaginal cytology: Low grade squamous intraepithelial lesion,racial,Unknown,745,0,745
254761,Cough,racial,Other Race,423,320,743
200845,Urinary precipitancy,ethnic,Hispanic or Latino,488,255,743
377888,CHL - Conductive hearing loss,racial,Unknown,506,237,743
259055,Extrinsic asthma with asthma attack,racial,Unknown,380,361,741
374034,Visual disturbance,racial,Unknown,444,297,741
4290927,Impairment level: low vision of both eyes,ethnic,Hispanic or Latino,416,324,740
75337,Cellulitis and abscess of buttock,racial,White,389,352,741
432738,Iceland disease,ethnic,Hispanic or Latino,504,237,741
197304,Ulcer of lower limb,racial,Unknown,432,306,738
443454,Cerebral infarction,ethnic,Not Hispanic or Latino,255,483,738
373999,Diabetic oculopathy associated with type I diabetes mellitus,racial,White,630,108,738
133727,Thyrotoxicosis without goiter OR other cause,racial,Unknown,665,74,739
76194,Osteoarthrosis involving multiple sites but not designated as generalized,racial,Unknown,573,166,739
4101660,Amputated below knee,ethnic,Hispanic or Latino,251,485,736
134057,Disease of cardiovascular system,racial,Unknown,230,506,736
81112,Arthralgia of the lower leg,racial,Other Race,504,230,734
260125,Acute bronchiolitis,ethnic,Not Hispanic or Latino,347,386,733
260427,Common cold,racial,Unknown,460,274,734
196456,Cholecystolithiasis,racial,Asian,669,64,733
380701,SDLT - Senile dementia of the Lewy body type,ethnic,Hispanic or Latino,209,524,733
444239,Postprocedural state finding,racial,Unknown,444,288,732
196168,Irregular menstrual bleeding,ethnic,Not Hispanic or Latino,725,7,732
193326,Urge incontinence of urine,racial,Unknown,619,110,729
195312,Functional voiding disorder,ethnic,Hispanic or Latino,570,159,729
23325,Heartburn,racial,Unknown,202,527,729
380701,SDLT - Senile dementia of the Lewy body type,racial,Unknown,209,520,729
140020,Viral exanthem,ethnic,Hispanic or Latino,269,460,729
4282684,Impairment level: low vision of one eye,ethnic,Hispanic or Latino,384,345,729
441874,Cerebral thrombosis,ethnic,Hispanic or Latino,679,46,725
137809,Primary malignant neoplasm of female breast,racial,Asian,725,0,725
198075,Venereal wart,racial,White,239,485,724
139906,Intervertebral disc disorder of cervical region with myelopathy,ethnic,Not Hispanic or Latino,642,83,725
441980,Closed fracture of foot,ethnic,Hispanic or Latino,131,593,724
432585,Blood coagulation disorder,ethnic,Hispanic or Latino,531,193,724
432661,Stomatitis,ethnic,Hispanic or Latino,391,334,725
134461,Tietze disease,racial,Unknown,550,173,723
444100,Mood disorder,racial,White,336,386,722
201621,Chronic cystitis,ethnic,Hispanic or Latino,644,78,722
254761,Cough,racial,Asian,414,308,722
437247,Anaemia of chronic disease,ethnic,Not Hispanic or Latino,409,311,720
201061,Diaphragmatic hernia,racial,Unknown,623,97,720
4050572,Implantation of automatic cardiac defibrillator,ethnic,Hispanic or Latino,258,462,720
443864,Multi-infarct dementia with depression,racial,Unknown,610,110,720
375545,Lens opacity,racial,Other Race,327,391,718
194175,Left upper quadrant pain,racial,White,550,168,718
433069,Open wound of external genital organs with complication,racial,Unknown,495,223,718
433968,Candidiasis,ethnic,Hispanic or Latino,442,276,718
4250023,Severe major depression with psychotic features,racial,White,444,271,715
139850,Acute frontal sinusitis,racial,White,499,216,715
375292,Perforation of tympanic membrane,ethnic,Hispanic or Latino,449,267,716
201927,Cellulitis and abscess of leg,racial,Unknown,368,345,713
4103642,Amputated toe,ethnic,Hispanic or Latino,131,580,711
4103471,Observation of body mass index,racial,American Indian or Alaska Native ,453,258,711
4094448,Pregnancy test negative,ethnic,Hispanic or Latino,711,0,711
137682,Skin sensation disturbance,ethnic,Not Hispanic or Latino,446,265,711
141104,Intervertebral disc disorder of lumbar region with myelopathy,racial,White,336,373,709
378427,Tear film insufficiency,racial,White,511,198,709
197032,Hyperplasia of prostate,ethnic,Not Hispanic or Latino,0,708,708
435928,Abnormal decrease in weight,ethnic,Not Hispanic or Latino,384,322,706
434165,Abnormal cervical smear,racial,White,704,2,706
435783,Schizophrenia,ethnic,Not Hispanic or Latino,361,343,704
254662,Pulmonary infarction,ethnic,Hispanic or Latino,375,329,704
192242,Acute hepatitis C,ethnic,Hispanic or Latino,191,513,704
74464,Idiopathic scoliosis AND/OR kyphoscoliosis,racial,Unknown,467,237,704
138825,Actinic keratosis,racial,White,462,242,704
4114314,Screening for osteoporosis,ethnic,Not Hispanic or Latino,651,53,704
198101,Lipoma of skin and subcutaneous tissue (excluding face),ethnic,Hispanic or Latino,455,248,703
433595,Interstitial edema,racial,Asian,232,472,704
197672,Urinary incontinence,racial,Other Race,596,108,704
314658,Cardiomegaly,racial,Black or African American ,685,16,701
135360,Fainting,racial,Asian,628,74,702
313236,Cough variant asthma,ethnic,Not Hispanic or Latino,405,297,702
31967,Nausea,racial,Unknown,554,147,701
376707,Acute conjunctivitis,ethnic,Not Hispanic or Latino,393,306,699
74635,Lumbosacral root lesion,ethnic,Hispanic or Latino,375,324,699
200031,Viral hepatitis B with hepatic coma,ethnic,Not Hispanic or Latino,695,2,697
200485,Decubitus ulcer of buttock,ethnic,Hispanic or Latino,504,193,697
321318,Angina,racial,Other Race,283,414,697
442588,OSA - Obstructive sleep apnoea,racial,Unknown,338,359,697
201131,Pelvic mass,racial,White,481,216,697
381549,Migraine with aura,ethnic,Hispanic or Latino,653,41,694
133810,Secondary hyperparathyroidism of renal origin,ethnic,Hispanic or Latino,398,297,695
134159,Precordial pain,ethnic,Hispanic or Latino,474,221,695
200031,Viral hepatitis B with hepatic coma,racial,Asian,695,0,695
381270,Parkinson's disease,racial,Asian,444,248,692
4167406,Eye disorder screening,ethnic,Hispanic or Latino,359,334,693
4152047,Lipid screening,ethnic,Hispanic or Latino,476,216,692
201078,Senile atrophic vaginitis,racial,White,683,9,692
4298697,Multiple open wounds without complication,racial,White,306,386,692
76786,Derangement of knee,ethnic,Not Hispanic or Latino,237,455,692
443431,Disorder of menstruation,racial,Unknown,692,0,692
74725,Displacement of cervical intervertebral disc without myelopathy,ethnic,Hispanic or Latino,511,182,693
444070,Tachycardia,racial,White,446,244,690
197607,Polymenorrhagia,racial,Unknown,690,0,690
260134,Croup,racial,White,232,458,690
135772,Goiter,racial,White,642,48,690
377279,"Profound impairment, one eye",ethnic,Hispanic or Latino,329,361,690
437382,Urine observation,ethnic,Not Hispanic or Latino,554,136,690
373995,Delirium,racial,White,290,400,690
254443,Sicca syndrome,ethnic,Hispanic or Latino,626,64,690
442588,OSA - Obstructive sleep apnoea,ethnic,Not Hispanic or Latino,237,451,688
75346,Disorder of meniscus of knee,ethnic,Not Hispanic or Latino,679,9,688
72993,Primary localised osteoarthrosis,racial,Unknown,327,361,688
435216,Disorder associated with type I diabetes mellitus,ethnic,Hispanic or Latino,428,260,688
4154309,Severe recurrent major depression with psychotic features,racial,Asian,688,0,688
434169,Abnormal findings on diagnostic imaging of breast,ethnic,Not Hispanic or Latino,681,5,686
433736,Obesity,racial,American Indian or Alaska Native ,506,179,685
201826,Type 2 diabetes mellitus,racial,American Indian or Alaska Native ,501,184,685
4311591,Cramp in limb,racial,Asian,242,444,686
201322,Internal hemorrhoids without complication,racial,White,412,271,683
197676,Hepatomegaly,ethnic,Hispanic or Latino,529,154,683
440360,Pure hyperglyceridemia,racial,Asian,225,458,683
133298,Musculoskeletal disorder of the neck,ethnic,Hispanic or Latino,495,189,684
4133029,Primigravida,racial,Unknown,681,0,681
30437,Gastroesophageal reflux disease with esophagitis,racial,Unknown,421,260,681
443587,Diastolic heart failure,racial,Unknown,400,278,678
432876,Bipolar I disorder,racial,White,446,232,678
138604,"Contusion of face, scalp and neck, excluding eye(s)",ethnic,Hispanic or Latino,336,343,679
74114,Cellulitis and abscess of foot excluding toe,ethnic,Hispanic or Latino,301,377,678
440693,Continuous opioid dependence,racial,White,239,439,678
374888,Dementia associated with another disease,racial,Other Race,642,37,679
4175226,Screening for malignant neoplasm of colon,racial,Black or African American ,361,315,676
260123,Acute inflammation of sinus,racial,Other Race,384,292,676
138384,Acquired hypothyroidism,racial,White,501,175,676
4029488,Hepatic encephalopathy,ethnic,Hispanic or Latino,32,644,676
80502,Osteoporosis,racial,Black or African American ,674,2,676
197610,Ovarian cyst,racial,Unknown,674,0,674
135287,Non-neoplastic naevus,ethnic,Hispanic or Latino,361,311,672
379801,Trigeminal neuralgia,ethnic,Hispanic or Latino,538,133,671
201418,"Flatulence, eructation and gas pain",racial,White,428,244,672
316084,Lymphadenitis,ethnic,Hispanic or Latino,373,297,670
444291,Cochlear hearing loss,ethnic,Hispanic or Latino,439,228,667
444239,Postprocedural state finding,ethnic,Not Hispanic or Latino,481,186,667
195596,Chronic pancreatitis,ethnic,Hispanic or Latino,396,271,667
194686,Acquired renal cyst,racial,Unknown,616,51,667
4311159,Midline cystocele,racial,White,667,0,667
377552,Moderate nonproliferative diabetic retinopathy,ethnic,Hispanic or Latino,449,219,668
80813,Lumbosacral spondylosis without myelopathy,racial,Unknown,455,212,667
81151,Sprain of ankle joint,racial,Unknown,437,230,667
380986,Senile dementia with delusion,ethnic,Not Hispanic or Latino,665,0,665
198199,Pyelonephritis,racial,White,566,99,665
373995,Delirium,racial,Other Race,106,559,665
442256,Disorder of bursae of shoulder region,racial,White,419,246,665
77968,Hallux valgus AND bunion,racial,White,504,159,663
199839,External haemorrhoids without complication,racial,Unknown,485,177,662
74396,TMJ - Temporomandibular joint disorder,ethnic,Hispanic or Latino,550,113,663
77642,Arthralgia of the forearm,ethnic,Not Hispanic or Latino,543,120,663
77030,Disease of breast,racial,White,653,7,660
319843,Mitral valve disorder,ethnic,Not Hispanic or Latino,283,377,660
193874,Bed wetting,ethnic,Hispanic or Latino,294,366,660
77025,Diverticulitis of colon,racial,White,492,166,658
4114314,Screening for osteoporosis,racial,Unknown,626,32,658
432571,Malignant lymphoma,ethnic,Hispanic or Latino,527,131,658
4059014,Spontaneous bruising,ethnic,Hispanic or Latino,426,230,656
441874,Cerebral thrombosis,racial,Unknown,639,16,655
377821,Neurological disorder associated with type I diabetes mellitus,racial,Unknown,520,133,653
4109880,Varicose veins of the leg with ulcer,ethnic,Hispanic or Latino,373,278,651
4088920,Womb absent,racial,White,651,0,651
444070,Tachycardia,racial,Unknown,568,83,651
375552,Pterygium,racial,White,331,320,651
140842,Changes in skin texture,racial,White,361,288,649
377821,Neurological disorder associated with type I diabetes mellitus,racial,White,552,94,646
197494,Viral hepatitis C,racial,White,278,368,646
134736,Backache,racial,Other Race,393,253,646
254662,Pulmonary infarction,racial,White,347,297,644
4171430,Screening for malignant neoplasm of rectum,ethnic,Not Hispanic or Latino,336,308,644
4086918,Viral screening,racial,Asian,340,304,644
4211231,Panic disorder without agoraphobia,racial,Unknown,421,223,644
4103471,Observation of body mass index,racial,Filipino,354,290,644
201620,Calculus of kidney,ethnic,Not Hispanic or Latino,343,301,644
201069,"Peptic ulcer without hemorrhage, without perforation AND without obstruction",ethnic,Not Hispanic or Latino,545,99,644
374948,Acute nonsuppurative otitis media,ethnic,Hispanic or Latino,242,403,645
4201387,Tracheostomy in situ,ethnic,Hispanic or Latino,251,391,642
73553,Arthropathy,racial,Black or African American ,591,51,642
138379,"Chronic lymphoid leukemia, disease",ethnic,Not Hispanic or Latino,230,412,642
138463,Oral aphthae,ethnic,Hispanic or Latino,375,267,642
199877,Mucous polyp of cervix,racial,White,639,2,641
442068,Cellulitis and abscess of forearm,racial,White,320,322,642
199856,Varicose veins of lower extremity with inflammation,racial,White,506,133,639
4096347,Gouty arthropathy,ethnic,Hispanic or Latino,184,455,639
78835,Palindromic rheumatism of the lower leg,racial,Unknown,419,221,640
4005823,Tobacco user,ethnic,Not Hispanic or Latino,200,439,639
195306,Gastroduodenitis,racial,Other Race,462,175,637
4245252,Raised prostate specific antigen,ethnic,Not Hispanic or Latino,0,637,637
435782,Chronic schizophrenic,ethnic,Hispanic or Latino,294,343,637
443729,Peripheral circulatory disorder associated with type II diabetes mellitus,racial,Other Race,612,25,637
319041,Orthostatic hypotension,ethnic,Hispanic or Latino,490,147,637
376406,"Impairment level: blindness, one eye - low vision other eye",racial,Asian,115,522,637
381295,Age-related cataract,racial,White,534,101,635
380415,Acute swimmer's ear,ethnic,Hispanic or Latino,366,269,635
435508,Adrenal cortical hypofunction,ethnic,Hispanic or Latino,550,85,635
432284,Single major depressive episode,racial,Other Race,518,117,635
317302,Coronary sinus rhythm disorder,racial,White,340,292,632
197381,Epigastric pain,ethnic,Not Hispanic or Latino,435,198,633
261325,Pulmonary emphysema,racial,Unknown,391,242,633
193809,Melena due to gastrointestinal hemorrhage,racial,Unknown,430,202,632
4168213,Chest pain on breathing,ethnic,Hispanic or Latino,407,225,632
440329,Herpes zoster without complication,racial,Unknown,483,150,633
436073,Psychotic disorder,ethnic,Not Hispanic or Latino,350,283,633
439082,Menopausal syndrome,ethnic,Not Hispanic or Latino,628,2,630
133727,Thyrotoxicosis without goiter OR other cause,racial,Asian,179,451,630
438406,"Major depressive disorder, single episode, severe with psychotic features",ethnic,Hispanic or Latino,175,455,630
320128,Essential hypertension,racial,Native Hawaiian or Other Pacific Islander ,352,278,630
439125,T21 - Trisomy 21,racial,Unknown,92,538,630
435023,Mild hyperemesis-not delivered,ethnic,Hispanic or Latino,630,0,630
75637,Acquired postural kyphosis,ethnic,Hispanic or Latino,596,32,628
432738,Iceland disease,racial,White,343,285,628
312922,Coronary bypass graft observation,racial,Unknown,161,467,628
132659,Acute apical periodontitis,racial,White,375,253,628
444112,Integumentary system finding,ethnic,Hispanic or Latino,398,230,628
312437,Dyspnea,ethnic,Not Hispanic or Latino,426,200,626
374060,Acute ill-defined cerebrovascular disease,racial,Black or African American ,221,405,626
134870,Pityriasis versicolor,ethnic,Hispanic or Latino,400,225,625
312723,Congenital heart disease,racial,White,297,327,624
312648,Benign essential hypertension,racial,Native Hawaiian or Other Pacific Islander ,152,472,624
381316,CVA - Cerebrovascular accident,ethnic,Hispanic or Latino,317,306,623
74138,Pathological fracture of vertebra,ethnic,Hispanic or Latino,607,14,621
312327,Acute myocardial infarction,racial,White,223,398,621
197925,Haemorrhage of rectum and anus,racial,Unknown,324,297,621
80816,Intervertebral disc degeneration,ethnic,Hispanic or Latino,324,297,621
439253,"Bipolar affective disorder, currently depressed, mild",racial,White,566,55,621
200962,Primary malignant neoplasm of prostate,ethnic,Not Hispanic or Latino,0,621,621
4049623,"Moderate major depression, single episode",racial,Other Race,216,403,619
133298,Musculoskeletal disorder of the neck,racial,White,398,221,619
437969,Acquired pes planus,racial,White,207,412,619
201899,Unilateral recurrent inguinal hernia,ethnic,Hispanic or Latino,37,582,619
318712,Peripheral circulatory disorder associated with type I diabetes mellitus,racial,Unknown,412,207,619
4084229,Primary gout,ethnic,Hispanic or Latino,115,504,619
434613,Generalized anxiety disorder,racial,Other Race,492,127,619
442013,Burn,ethnic,Hispanic or Latino,386,230,616
194411,Unilateral simple inguinal hernia,racial,White,67,550,617
79908,Muscle strength reduced,ethnic,Not Hispanic or Latino,71,545,616
381581,Chalazion,ethnic,Hispanic or Latino,359,258,617
193251,Umbilical hernia without obstruction AND without gangrene,racial,Unknown,352,262,614
442565,Gestational edema without hypertension,racial,White,614,0,614
192279,Diabetic nephropathy,racial,Other Race,421,193,614
80816,Intervertebral disc degeneration,racial,White,329,285,614
320536,Abnormal EKG finding,racial,Unknown,354,260,614
4062637,TB - Tuberculosis screening,racial,Asian,317,297,614
321588,Heart disease,racial,Unknown,582,32,614
443585,Abrasion AND/OR friction burn of multiple sites,ethnic,Hispanic or Latino,269,345,614
81984,Sprain of shoulder and upper arm,racial,White,357,258,615
373995,Delirium,racial,Black or African American ,566,46,612
377277,Impairment level: total impairment of both eyes,ethnic,Hispanic or Latino,393,219,612
374013,Secondary Parkinson's disease,racial,White,446,166,612
442604,Hypertensive heart disease,racial,White,366,246,612
138519,Spondylosis without myelopathy,ethnic,Hispanic or Latino,317,294,611
435515,Hypo-osmolality and or hyponatremia,racial,White,317,294,611
443414,Chronic post-traumatic stress disorder,racial,Asian,64,545,609
141253,Disease of thyroid gland,racial,White,485,124,609
200174,Disease of skin AND/OR subcutaneous tissue,racial,Unknown,430,179,609
197610,Ovarian cyst,ethnic,Not Hispanic or Latino,610,0,610
437264,Tobacco dependence syndrome,racial,Other Race,232,375,607
141932,Senile hyperkeratosis,ethnic,Hispanic or Latino,338,269,607
440076,SS - Short stature,ethnic,Hispanic or Latino,198,409,607
198363,Candidiasis of vagina,ethnic,Not Hispanic or Latino,591,16,607
443563,Arteriosclerosis in coronary artery bypass graft,ethnic,Hispanic or Latino,163,442,605
4185302,Chronic myocardial ischemia,ethnic,Hispanic or Latino,478,127,605
375545,Lens opacity,racial,Black or African American ,60,545,605
439253,"Bipolar affective disorder, currently depressed, mild",ethnic,Hispanic or Latino,557,48,605
321596,Peripheral venous insufficiency,racial,White,432,173,605
197320,ARF - Acute renal failure,racial,White,276,329,605
132553,Herpangina,racial,White,237,368,605
432869,Hemorrhagic disorder due to circulating anticoagulants,racial,White,596,7,603
4062484,Cervical neoplasia screening,racial,Other Race,603,0,603
442774,Intermittent claudication,ethnic,Hispanic or Latino,363,239,602
73560,Calcaneal spur,racial,White,488,115,603
375546,Combined nonsenile cataract,racial,White,603,0,603
4008683,Anxiety neurosis,ethnic,Hispanic or Latino,416,186,602
375239,Cerebral degeneration,ethnic,Hispanic or Latino,483,120,603
4046893,Lifestyle,ethnic,Hispanic or Latino,262,338,600
195771,Secondary diabetes mellitus,racial,White,370,230,600
4299535,Pregnancy confirmed,ethnic,Not Hispanic or Latino,570,30,600
436373,DSD - Developmental speech disorder,racial,Unknown,143,458,601
434752,Positive serological AND/OR viral culture findings for human immunodeficiency virus,ethnic,Hispanic or Latino,85,515,600
312998,Pain in thoracic spine,racial,White,380,221,601
198520,Lumbar spondylosis with myelopathy,ethnic,Hispanic or Latino,518,83,601
437092,Physiological development failure,racial,Unknown,400,200,600
260427,Common cold,ethnic,Not Hispanic or Latino,311,290,601
374028,AAMD - Age related macular degeneration,racial,White,347,253,600
435224,Leukopenia,ethnic,Hispanic or Latino,435,163,598
433456,Acute pain,racial,White,368,230,598
199866,Acute gastritis,ethnic,Not Hispanic or Latino,239,359,598
192606,Paraplegia,ethnic,Hispanic or Latino,288,311,599
437478,Bite of nonvenomous arthropod,ethnic,Hispanic or Latino,304,294,598
439297,Nuclear senile cataract,racial,Unknown,414,184,598
197500,Primary malignant neoplasm of colon,ethnic,Not Hispanic or Latino,382,216,598
73564,Complete rupture of rotator cuff,racial,Unknown,71,527,598
192676,Cervical intraepithelial neoplasia grade 1,ethnic,Hispanic or Latino,596,2,598
200219,Abdominal pain,racial,Other Race,380,216,596
443414,Chronic post-traumatic stress disorder,ethnic,Hispanic or Latino,451,145,596
373852,Neuralgia,racial,White,451,145,596
432876,Bipolar I disorder,ethnic,Hispanic or Latino,363,232,595
373198,Unqualified visual loss of both eyes,racial,Unknown,12,584,596
133444,Thyroiditis,ethnic,Hispanic or Latino,87,508,595
444101,Hypertensive heart failure,racial,Black or African American ,28,566,594
75860,Costiveness,racial,Black or African American ,350,244,594
320746,Cardiomyopathy associated with another disorder,ethnic,Hispanic or Latino,538,55,593
441840,Clinical finding,racial,White,407,186,593
75095,Closed fracture of ankle,ethnic,Hispanic or Latino,382,212,594
435782,Chronic schizophrenic,racial,White,110,481,591
81893,Chronic ulcerative colitis,racial,White,313,278,591
375791,Uncomplicated senile dementia,racial,Filipino,228,363,591
4103638,Amputated - transfemoral,ethnic,Not Hispanic or Latino,23,568,591
201627,Abnormal vaginal bleeding,racial,White,591,0,591
435524,Sleep disorder,ethnic,Hispanic or Latino,258,334,592
433811,Hydronephrosis,racial,White,274,315,589
432741,Abnormal immunology finding,racial,White,460,129,589
259848,Chronic rhinitis,ethnic,Not Hispanic or Latino,331,258,589
436072,Bipolar disorder in partial remission,racial,White,538,51,589
373999,Diabetic oculopathy associated with type I diabetes mellitus,racial,Unknown,156,432,588
314658,Cardiomegaly,racial,Asian,573,16,589
4110815,"Sensorineural hearing loss, bilateral",ethnic,Hispanic or Latino,363,223,586
435510,Hypocalcemia,ethnic,Hispanic or Latino,396,191,587
318556,Nosebleed,racial,Unknown,265,322,587
81251,Neoplasm of breast,ethnic,Hispanic or Latino,587,0,587
195306,Gastroduodenitis,racial,Black or African American ,347,239,586
4094448,Pregnancy test negative,racial,White,584,2,586
79936,Polyuria,ethnic,Hispanic or Latino,258,327,585
436682,Moderate mental handicap,racial,White,389,196,585
257315,Bacterial pneumonia,racial,White,361,223,584
378419,AD - Alzheimer's disease,racial,Other Race,23,561,584
198558,Nycturia,ethnic,Not Hispanic or Latino,483,101,584
259848,Chronic rhinitis,racial,Unknown,343,242,585
193809,Melena due to gastrointestinal hemorrhage,ethnic,Not Hispanic or Latino,276,306,582
443430,HPV - Human papillomavirus test positive,racial,White,573,9,582
436583,[X]Falls,ethnic,Not Hispanic or Latino,329,253,582
4113027,Dietary intake observations,racial,Unknown,357,225,582
443617,Conduct disorder,ethnic,Hispanic or Latino,152,430,582
74729,Ganglion and synovial cyst,ethnic,Hispanic or Latino,419,163,582
442286,Abscess of digit,ethnic,Hispanic or Latino,350,230,580
192450,Not passing urine,ethnic,Hispanic or Latino,221,359,580
138379,"Chronic lymphoid leukemia, disease",racial,Asian,214,366,580
74138,Pathological fracture of vertebra,racial,Unknown,580,0,580
4174977,Diabetic retinopathy,ethnic,Hispanic or Latino,322,258,580
443622,Aneurysm of thoracic aorta,ethnic,Not Hispanic or Latino,58,522,580
141216,MC - Molluscum contagiosum,racial,White,242,336,578
437902,Teeth development and eruption disorders,ethnic,Hispanic or Latino,285,292,577
436785,Spinal stenosis in cervical region,ethnic,Not Hispanic or Latino,359,219,578
375529,Infantile cerebral palsy,ethnic,Not Hispanic or Latino,271,306,577
312327,Acute myocardial infarction,racial,Black or African American ,561,16,577
319034,Hypertensive heart disease without congestive heart failure,racial,Unknown,559,18,577
4299535,Pregnancy confirmed,racial,Unknown,577,0,577
375827,Acute non-suppurative otitis media - serous,racial,Unknown,251,327,578
440685,"Nondependent alcohol abuse, episodic",ethnic,Hispanic or Latino,122,453,575
192359,RF - Renal failure,racial,White,265,311,576
197950,Cellulitis and abscess of trunk,racial,White,262,313,575
78497,Cellulitis and abscess of toe,racial,White,246,327,573
440358,Lipoma,racial,White,345,228,573
442282,Urinary casts,ethnic,Hispanic or Latino,465,108,573
133729,Hyperparathyroidism,racial,White,414,159,573
75036,Primary localized osteoarthrosis of hand,ethnic,Hispanic or Latino,515,58,573
441408,Vomiting,ethnic,Not Hispanic or Latino,292,278,570
378756,Conjunctival hemorrhage,racial,White,377,193,570
4103574,Chronic depression,ethnic,Hispanic or Latino,437,133,570
137379,Musculoskeletal symptom,racial,Unknown,327,242,569
374341,Huntington's chorea,ethnic,Hispanic or Latino,488,81,569
435534,"Nondependent alcohol abuse, continuous",ethnic,Hispanic or Latino,74,495,569
4171434,Immunization refused,ethnic,Hispanic or Latino,354,214,568
374034,Visual disturbance,ethnic,Not Hispanic or Latino,334,235,569
443587,Diastolic heart failure,racial,White,421,145,566
4064918,Diabetes mellitus screening,racial,Asian,306,260,566
4091532,Bowel observation,ethnic,Hispanic or Latino,299,267,566
319034,Hypertensive heart disease without congestive heart failure,ethnic,Hispanic or Latino,527,39,566
194092,Uterine prolapse without vaginal wall prolapse,ethnic,Hispanic or Latino,564,0,564
441407,Appetite loss - anorexia,racial,Unknown,437,127,564
433400,Emergency contraception,ethnic,Hispanic or Latino,561,2,563
73291,Palindromic rheumatism of the ankle and/or foot,racial,Unknown,398,166,564
316139,HF - Heart failure,racial,Unknown,446,117,563
4103471,Observation of body mass index,racial,Native Hawaiian or Other Pacific Islander ,347,216,563
435511,Hypercalcemia,racial,Unknown,435,127,562
80180,Osteoarthritis,racial,Filipino,550,12,562
133280,Alopecia,racial,White,462,99,561
443431,Disorder of menstruation,ethnic,Not Hispanic or Latino,557,5,562
435613,Cellulitis,racial,Unknown,327,235,562
192242,Acute hepatitis C,racial,White,189,373,562
40484513,Hemiplegia of nondominant side as late effect of cerebrovascular disease,racial,White,485,74,559
373499,Disorder of eye region,racial,Unknown,361,198,559
317309,Peripheral arterial occlusive disease,racial,White,311,246,557
435511,Hypercalcemia,ethnic,Not Hispanic or Latino,336,221,557
440693,Continuous opioid dependence,ethnic,Not Hispanic or Latino,258,299,557
443257,Swellings and lumps,racial,Unknown,396,161,557
4103638,Amputated - transfemoral,racial,Black or African American ,0,557,557
372634,Nonphysiologic vision loss,ethnic,Not Hispanic or Latino,478,78,556
435796,Dehydration,racial,White,331,225,556
440078,"Bipolar affective disorder, current episode manic",racial,White,166,391,557
24660,Acute tonsillitis,ethnic,Not Hispanic or Latino,301,255,556
78472,Microscopic haematuria,racial,Unknown,294,262,556
439799,Leg cramps,ethnic,Hispanic or Latino,460,94,554
192278,Type II diabetes mellitus - poor control,racial,American Indian or Alaska Native ,375,179,554
201093,Infection of skin AND/OR subcutaneous tissue,ethnic,Hispanic or Latino,308,246,554
433750,"Single major depressive episode, in full remission",ethnic,Hispanic or Latino,419,133,552
198520,Lumbar spondylosis with myelopathy,racial,White,534,18,552
136496,Cellulitis and abscess of face,racial,White,297,255,552
437541,Glaucoma,racial,Asian,281,271,552
375545,Lens opacity,racial,Asian,288,262,550
4079876,Familial combined hyperlipidemia,racial,American Indian or Alaska Native ,299,251,550
4263370,R.I.N.D. syndrome,racial,Unknown,370,179,549
199078,Vaginal wall prolapse,ethnic,Hispanic or Latino,547,0,547
432867,Hyperlipidemia,racial,Native Hawaiian or Other Pacific Islander ,127,421,548
72748,Strain of rotator cuff of shoulder,racial,White,334,214,548
132740,Positive skin test reaction,ethnic,Not Hispanic or Latino,331,216,547
314131,Degeneration of cervical intervertebral disc,ethnic,Hispanic or Latino,359,189,548
376085,Uncomplicated presenile dementia,racial,Asian,488,60,548
315831,Chronic pulmonary heart disease,ethnic,Hispanic or Latino,435,113,548
441544,Specific nonpsychotic mental disorders following organic brain damage,ethnic,Hispanic or Latino,366,182,548
437655,Cryptorchism,racial,White,0,545,545
4062636,Bacterial disease screening,racial,White,474,71,545
192360,Cyst and pseudocyst of pancreas,ethnic,Hispanic or Latino,492,53,545
25297,Acute pharyngitis,racial,Other Race,292,253,545
438867,Generalized body aches,racial,Unknown,373,173,546
77066,Derangement of medial meniscus,ethnic,Hispanic or Latino,117,428,545
435243,Alcohol dependence,ethnic,Hispanic or Latino,60,485,545
40480002,Aphasia as late effect of cerebrovascular disease,ethnic,Hispanic or Latino,299,246,545
134438,CD - Contact dermatitis,racial,Asian,228,317,545
73754,Restless legs,racial,White,414,129,543
319843,Mitral valve disorder,racial,Asian,177,366,543
439697,Hypertensive renal disease with renal failure,ethnic,Hispanic or Latino,495,48,543
75354,Osteochondropathy,ethnic,Not Hispanic or Latino,492,51,543
440525,Prematurity of fetus,ethnic,Hispanic or Latino,271,271,542
76836,Sprain of knee and leg,racial,Unknown,380,163,543
320536,Abnormal EKG finding,ethnic,Not Hispanic or Latino,274,269,543
381017,Ametropic amblyopia,ethnic,Hispanic or Latino,370,173,543
376085,Uncomplicated presenile dementia,ethnic,Not Hispanic or Latino,488,55,543
444100,Mood disorder,ethnic,Not Hispanic or Latino,313,230,543
434170,Atypical squamous cells of undetermined significance on cervical Papanicolaou smear,racial,Unknown,541,2,543
316084,Lymphadenitis,racial,White,288,255,543
74725,Displacement of cervical intervertebral disc without myelopathy,racial,Unknown,455,85,540
4064905,Venereal disease screening,racial,Other Race,267,274,541
436033,Syphilis,ethnic,Hispanic or Latino,189,352,541
201061,Diaphragmatic hernia,racial,White,375,166,541
81931,Psoriasis with arthropathy,ethnic,Hispanic or Latino,308,232,540
139900,Urticaria,racial,Unknown,329,209,538
373478,Presbyopia,racial,White,345,193,538
40484513,Hemiplegia of nondominant side as late effect of cerebrovascular disease,ethnic,Not Hispanic or Latino,127,412,539
437175,"Fall on same level from slipping, tripping or stumbling",racial,Unknown,419,120,539
141693,Elevated blood-pressure reading without diagnosis of hypertension,racial,Other Race,292,246,538
74458,Enthesopathy of knee region,ethnic,Hispanic or Latino,520,18,538
432870,Thrombocytopenia,ethnic,Not Hispanic or Latino,152,386,538
4080568,Problem behaviour,ethnic,Hispanic or Latino,156,380,536
40484522,Hemiplegia of dominant side as late effect of cerebrovascular disease,racial,Other Race,453,83,536
374022,Hemiplegia,racial,Filipino,536,0,536
435262,Primary open angle glaucoma,ethnic,Hispanic or Latino,384,152,536
437246,Vitamin B deficiency,ethnic,Hispanic or Latino,375,161,536
438557,Abnormal glucose level,racial,Other Race,340,196,536
435783,Schizophrenia,racial,Unknown,405,129,534
134438,CD - Contact dermatitis,racial,Black or African American ,255,278,533
432545,Bacterial disease,ethnic,Hispanic or Latino,416,117,533
440693,Continuous opioid dependence,racial,Unknown,205,329,534
443237,"Manic disorder, single episode",racial,Unknown,308,225,533
433985,Hypercarotinemia,ethnic,Hispanic or Latino,219,315,534
440083,Acute stress disorder,ethnic,Hispanic or Latino,403,131,534
378425,Eyelid inflammation,racial,White,290,242,532
441980,Closed fracture of foot,racial,Unknown,35,497,532
78473,Solitary cyst of breast,ethnic,Hispanic or Latino,531,0,531
437046,Complete abortion,ethnic,Hispanic or Latino,531,0,531
193874,Bed wetting,racial,White,232,297,529
79908,Muscle strength reduced,racial,Asian,25,504,529
78272,Sprain of wrist,racial,White,334,196,530
138502,Vitiligo,racial,White,290,239,529
137063,Corns and callus,racial,Unknown,306,221,527
137053,Seborrheic dermatitis,racial,Unknown,278,248,526
200843,Observation of frequency of urination,ethnic,Not Hispanic or Latino,281,246,527
321319,Cardiomyopathy,racial,White,363,163,526
200687,Renal disorder associated with type I diabetes mellitus,racial,White,271,253,524
74458,Enthesopathy of knee region,racial,White,506,18,524
437986,FTT - Failure to thrive,ethnic,Not Hispanic or Latino,170,354,524
195501,Polycystic ovaries,racial,White,522,2,524
443238,Diabetic - poor control,racial,Other Race,478,46,524
374366,Sensorineural hearing loss,ethnic,Not Hispanic or Latino,313,212,525
138176,Acute gingivitis,ethnic,Hispanic or Latino,299,225,524
194406,Urinary tract obstruction,racial,White,35,490,525
436096,Chronic pain,racial,Black or African American ,173,352,525
312327,Acute myocardial infarction,ethnic,Not Hispanic or Latino,370,152,522
139057,Disease of oral soft tissues,racial,White,352,170,522
4206460,Problem,ethnic,Hispanic or Latino,207,315,522
433577,Hammer toe,ethnic,Hispanic or Latino,299,223,522
318169,Varicose veins of lower extremity,ethnic,Not Hispanic or Latino,16,504,520
81611,Diverticular disease of colon,ethnic,Not Hispanic or Latino,152,368,520
375791,Uncomplicated senile dementia,racial,Asian,435,85,520
432285,Recurrent major depressive episodes,racial,Asian,345,175,520
439700,Inhibited sexual desire,ethnic,Not Hispanic or Latino,0,520,520
140673,Hypothyroid,racial,Filipino,451,67,518
444132,Knee injury,racial,White,262,255,517
200763,Chronic hepatitis,ethnic,Hispanic or Latino,237,281,518
201613,Chronic nonalcoholic liver disease,ethnic,Not Hispanic or Latino,313,205,518
4287544,Manic bipolar I disorder,ethnic,Not Hispanic or Latino,409,108,517
194997,Prostatitis,ethnic,Hispanic or Latino,0,518,518
24134,Nonspecific pain in the neck region,racial,Asian,398,120,518
315085,Enlargement of lymph nodes,racial,Unknown,426,92,518
440704,Chronic pain syndrome,racial,Unknown,262,253,515
140648,Onychomycosis due to dermatophyte,racial,Other Race,209,306,515
379769,Benign brain tumour,ethnic,Not Hispanic or Latino,511,5,516
192671,GI - Gastrointestinal haemorrhage,racial,White,271,244,515
374375,Impacted cerumen,racial,Asian,274,239,513
377802,Late effects of poliomyelitis,ethnic,Hispanic or Latino,391,122,513
197684,Dysuria,racial,Asian,338,175,513
194990,Inflammatory disorder of liver,ethnic,Hispanic or Latino,288,225,513
4302252,High risk pregnancy care,ethnic,Not Hispanic or Latino,508,5,513
4165091,Lack of exercise,racial,Unknown,297,216,513
40484522,Hemiplegia of dominant side as late effect of cerebrovascular disease,ethnic,Not Hispanic or Latino,251,262,513
199075,Neurogenic bladder,ethnic,Hispanic or Latino,290,223,513
77139,Open wound of finger without complication,ethnic,Hispanic or Latino,244,267,511
436067,Schizophrenia simplex,racial,Unknown,453,58,511
134159,Precordial pain,racial,White,347,163,510
4046500,Acute peptic ulcer with hemorrhage,ethnic,Not Hispanic or Latino,504,7,511
201069,"Peptic ulcer without hemorrhage, without perforation AND without obstruction",racial,Asian,432,78,510
376112,Diabetic polyneuropathy,racial,Other Race,248,262,510
379769,Benign brain tumour,racial,Asian,511,0,511
440748,Interstitial emphysema of lung,racial,White,170,340,510
77644,Adhesive capsulitis of shoulder,racial,White,299,209,508
194574,Chronic type B viral hepatitis,ethnic,Hispanic or Latino,400,108,508
31317,Can't get food down,ethnic,Not Hispanic or Latino,196,313,509
4139420,Foreign body in auditory canal,ethnic,Hispanic or Latino,258,251,509
433031,Hallucinations,racial,White,299,209,508
4008683,Anxiety neurosis,racial,White,343,166,509
374044,Droopy eyelid,ethnic,Hispanic or Latino,283,225,508
377885,Disorder of eye movements,ethnic,Hispanic or Latino,265,244,509
377254,"Multi-infarct dementia, uncomplicated",racial,White,301,205,506
197500,Primary malignant neoplasm of colon,racial,White,232,274,506
135852,Teething syndrome,ethnic,Hispanic or Latino,193,313,506
136788,Spinal stenosis of lumbar region,ethnic,Not Hispanic or Latino,453,53,506
196341,Dermatophytosis of the perianal area,racial,Unknown,161,343,504
321887,Disorder of artery,racial,Unknown,311,193,504
314665,Atrial flutter,ethnic,Hispanic or Latino,242,262,504
440508,Congenital disease,racial,White,221,283,504
141508,Dermatophytosis of scalp or beard,ethnic,Hispanic or Latino,177,327,504
318169,Varicose veins of lower extremity,racial,Asian,0,504,504
372634,Nonphysiologic vision loss,racial,Unknown,292,212,504
4046500,Acute peptic ulcer with hemorrhage,racial,Black or African American ,504,0,504
194406,Urinary tract obstruction,racial,Unknown,0,504,504
139902,Allergic urticaria,racial,White,301,200,501
141917,Balanitis xerotica obliterans,ethnic,Hispanic or Latino,0,501,501
4086918,Viral screening,racial,Black or African American ,269,232,501
4107655,Observations relating to psychosocial functioning,ethnic,Hispanic or Latino,340,161,501
30437,Gastroesophageal reflux disease with esophagitis,ethnic,Not Hispanic or Latino,285,214,499
314131,Degeneration of cervical intervertebral disc,racial,White,347,152,499
199074,Acute pancreatitis,ethnic,Hispanic or Latino,269,230,499
259055,Extrinsic asthma with asthma attack,ethnic,Not Hispanic or Latino,202,297,499
315558,Atherosclerosis of arteries of the extremities,racial,Unknown,244,255,499
257628,Systemic lupus erythematosus,racial,Unknown,391,108,499
437409,Intracranial injury,ethnic,Hispanic or Latino,25,472,497
379805,Myopia,racial,Unknown,306,191,497
4101199,Hearing problem,racial,White,223,274,497
260139,Acute bronchitis,racial,Other Race,292,205,497
198678,Intestinal infectious disease,racial,Unknown,311,186,497
139099,Ingrowing nail,ethnic,Not Hispanic or Latino,262,235,497
443728,Mass of chest wall,ethnic,Hispanic or Latino,221,276,497
79072,Inflammatory disorder of breast,ethnic,Hispanic or Latino,490,7,497
195596,Chronic pancreatitis,racial,White,313,184,497
377861,Disorder of refraction AND/OR accommodation,racial,Other Race,237,258,495
381292,Chronic allergic conjunctivitis,racial,Asian,442,53,495
140020,Viral exanthem,racial,White,182,313,495
196726,Cholelithiasis AND acute cholecystitis without obstruction,racial,Unknown,152,343,495
435243,Alcohol dependence,ethnic,Not Hispanic or Latino,25,469,494
194083,Vaginitis and vulvovaginitis,racial,Other Race,495,0,495
442752,Myalgia,racial,Asian,83,412,495
256440,Disorder of paranasal sinuses,ethnic,Not Hispanic or Latino,292,202,494
194984,Hepatopathy,racial,White,285,207,492
313217,Atrial fibrillation,racial,Other Race,161,331,492
132408,Back problem,racial,White,357,136,493
256448,Chronic asthmatic bronchitis,ethnic,Not Hispanic or Latino,235,258,493
435220,Severe recurrent major depression without psychotic features,racial,White,347,145,492
375252,Disorder of eye,racial,White,251,242,493
192606,Paraplegia,racial,White,191,301,492
257628,Systemic lupus erythematosus,ethnic,Not Hispanic or Latino,455,37,492
374341,Huntington's chorea,racial,White,409,83,492
440389,MR - Mental retardation,ethnic,Not Hispanic or Latino,384,108,492
376400,Combined form of senile cataract,racial,Unknown,308,184,492
435508,Adrenal cortical hypofunction,racial,White,400,92,492
198558,Nycturia,racial,Asian,474,18,492
4287544,Manic bipolar I disorder,racial,White,444,48,492
76191,Disease of upper arm,ethnic,Hispanic or Latino,377,113,490
432865,Acute exacerbation of subchronic schizoaffective schizophrenia,ethnic,Hispanic or Latino,490,0,490
434610,Hyperkalemia,ethnic,Not Hispanic or Latino,251,239,490
381549,Migraine with aura,racial,White,455,35,490
377279,"Profound impairment, one eye",racial,Unknown,423,67,490
380986,Senile dementia with delusion,racial,Filipino,490,0,490
201518,Primary malignant neoplasm of lower limb,racial,Asian,488,0,488
134460,Plantar fascial fibromatosis,ethnic,Not Hispanic or Latino,311,177,488
373747,Extrapyramidal disease,ethnic,Hispanic or Latino,106,382,488
432838,Primary malignant neoplasm of cardia of stomach,ethnic,Hispanic or Latino,488,0,488
436954,Drug abuse,racial,White,173,315,488
200845,Urinary precipitancy,racial,White,299,189,488
316437,Cerebral atherosclerosis,ethnic,Hispanic or Latino,301,186,487
77638,Displacement of intervertebral disc without myelopathy,racial,Unknown,421,67,488
201518,Primary malignant neoplasm of lower limb,ethnic,Not Hispanic or Latino,488,0,488
440748,Interstitial emphysema of lung,racial,Unknown,366,122,488
197684,Dysuria,racial,Black or African American ,327,161,488
434752,Positive serological AND/OR viral culture findings for human immunodeficiency virus,racial,White,71,416,487
4340380,Hepatitis C carrier,ethnic,Hispanic or Latino,166,322,488
317898,Malignant essential hypertension,ethnic,Not Hispanic or Latino,94,393,487
432838,Primary malignant neoplasm of cardia of stomach,racial,White,488,0,488
195083,Left lower quadrant pain,racial,Unknown,384,101,485
193782,End stage renal disease,racial,Other Race,179,306,485
4171556,Ankle ulcer,ethnic,Hispanic or Latino,322,163,485
436067,Schizophrenia simplex,ethnic,Not Hispanic or Latino,136,350,486
443622,Aneurysm of thoracic aorta,racial,Asian,0,485,485
260125,Acute bronchiolitis,racial,Unknown,225,260,485
4051114,FH: Diabetes mellitus,racial,Unknown,331,154,485
197607,Polymenorrhagia,ethnic,Not Hispanic or Latino,485,0,485
374366,Sensorineural hearing loss,racial,Asian,278,207,485
134870,Pityriasis versicolor,racial,White,292,191,483
137497,Dermatophytosis of the body,ethnic,Not Hispanic or Latino,267,216,483
200528,Ascites,ethnic,Hispanic or Latino,285,198,483
376683,Non proliferative diabetic retinopathy,ethnic,Not Hispanic or Latino,391,92,483
440076,SS - Short stature,racial,White,138,345,483
320746,Cardiomyopathy associated with another disorder,racial,Unknown,472,12,484
443344,Barrett esophagus,ethnic,Hispanic or Latino,173,308,481
315833,Secondary cardiomyopathy,racial,Other Race,478,2,480
4311591,Cramp in limb,racial,White,338,143,481
314666,Healed coronary,ethnic,Not Hispanic or Latino,189,292,481
4070671,"Middle ear anomaly, excluding ossicles",ethnic,Hispanic or Latino,0,481,481
435171,Allergic state,racial,Unknown,281,200,481
440238,Closed fracture of metatarsal bone,ethnic,Hispanic or Latino,320,161,481
4091532,Bowel observation,racial,White,278,202,480
200485,Decubitus ulcer of buttock,racial,Unknown,370,108,478
198263,Right upper quadrant pain,ethnic,Not Hispanic or Latino,375,104,479
4079876,Familial combined hyperlipidemia,racial,Filipino,269,209,478
317898,Malignant essential hypertension,racial,Unknown,373,106,479
78517,Arthralgia of multiple joints,ethnic,Not Hispanic or Latino,357,122,479
372309,Mononeuritis,racial,Unknown,175,304,479
73840,Primary localised osteoarthrosis of shoulder region,racial,Unknown,304,175,479
4152047,Lipid screening,racial,White,322,154,476
317002,Hypopiesis,racial,Unknown,322,154,476
73819,Painful breasts,racial,Unknown,476,0,476
136184,Pruritic disorder,racial,Unknown,324,152,476
80242,Current tear of medial cartilage AND/OR meniscus of knee,racial,White,255,221,476
438480,"Abnormal glucose tolerance in mother complicating pregnancy, childbirth AND/OR puerperium",racial,White,474,0,474
201322,Internal hemorrhoids without complication,racial,Unknown,347,127,474
257004,Acute exacerbation of chronic obstructive airways disease,racial,Other Race,444,30,474
438332,Disease of possible viral origin,racial,Other Race,225,248,473
72465,Closed fracture of one or more phalanges of hand,ethnic,Hispanic or Latino,196,278,474
436785,Spinal stenosis in cervical region,racial,Asian,317,156,473
434467,Ostium secundum type atrial septal defect,ethnic,Hispanic or Latino,294,179,473
4170137,Non-suppurative otitis media,ethnic,Hispanic or Latino,281,191,472
193782,End stage renal disease,racial,Asian,152,320,472
4064375,Iron deficiency screening,racial,Other Race,260,212,472
313502,Benign hypertensive heart disease without congestive heart failure,ethnic,Hispanic or Latino,317,154,471
260139,Acute bronchitis,racial,Asian,327,145,472
26662,Testicular hypofunction,racial,Unknown,0,472,472
316535,Closed fracture of dorsal vertebra without spinal cord injury,ethnic,Hispanic or Latino,442,28,470
260123,Acute inflammation of sinus,racial,Black or African American ,228,242,470
4092896,Stool contents abnormal,racial,Unknown,288,182,470
443776,Brachial radiculitis,racial,White,357,113,470
312950,IgE-mediated allergic asthma,racial,Black or African American ,405,64,469
437264,Tobacco dependence syndrome,racial,Asian,106,363,469
372903,Retinal edema,ethnic,Hispanic or Latino,363,104,467
27674,N&V - Nausea and vomiting,ethnic,Not Hispanic or Latino,308,159,467
195847,Gastroparesis syndrome,racial,Unknown,357,110,467
4087756,Late latent syphilis,ethnic,Hispanic or Latino,62,405,467
4147961,Screening for malignant neoplasm of breast,racial,Other Race,465,0,465
443597,Chronic kidney disease stage 3,racial,Black or African American ,246,219,465
30234,Cervical sprain,racial,Unknown,311,154,465
76153,Low compliance bladder,racial,White,430,35,465
193016,Cystic disease of kidney,racial,Unknown,354,110,464
314971,Chronic respiratory failure,ethnic,Hispanic or Latino,248,216,464
4141481,"Hand, foot and mouth disease",ethnic,Hispanic or Latino,177,288,465
142026,Disorder of cardiovascular prostheses and implants,ethnic,Hispanic or Latino,455,9,464
317898,Malignant essential hypertension,racial,Other Race,465,0,465
137379,Musculoskeletal symptom,racial,White,271,193,464
438878,Abnormal results of liver function studies,ethnic,Not Hispanic or Latino,205,260,465
4252735,Mourning,racial,White,442,23,465
138479,Thyroid dysfunction during pregnancy - baby not yet delivered,ethnic,Hispanic or Latino,465,0,465
432895,Cortical senile cataract,ethnic,Hispanic or Latino,338,127,465
434902,Autistic disorder of childhood onset,ethnic,Not Hispanic or Latino,48,416,464
436665,Manic-depressive psychosis,racial,Black or African American ,69,393,462
442077,Anxiety disorder,ethnic,Hispanic or Latino,384,78,462
434170,Atypical squamous cells of undetermined significance on cervical Papanicolaou smear,ethnic,Not Hispanic or Latino,449,14,463
133299,Swelling of limb,racial,White,304,159,463
313459,Sleep apnea,racial,Asian,7,455,462
138463,Oral aphthae,racial,White,228,232,460
443767,Diabetic oculopathy,racial,Asian,269,191,460
192731,Digestive symptom,ethnic,Hispanic or Latino,251,209,460
4150307,Dental restoration observation,ethnic,Hispanic or Latino,336,124,460
441628,Menopausal and postmenopausal disorders,racial,White,460,0,460
440674,Gout,racial,Other Race,74,386,460
378253,HA - Headache,racial,Other Race,336,124,460
314059,Right bundle branch block,racial,Unknown,209,251,460
195771,Secondary diabetes mellitus,racial,Unknown,324,136,460
138525,Pain in limb,racial,Asian,198,262,460
4171434,Immunization refused,racial,White,278,182,460
80824,Senile osteoporosis,racial,Other Race,281,179,460
433440,Dysthymia,racial,Asian,455,2,457
316994,Malignant hypertensive heart disease with congestive cardiac failure,ethnic,Hispanic or Latino,382,76,458
138604,"Contusion of face, scalp and neck, excluding eye(s)",racial,White,235,223,458
201927,Cellulitis and abscess of leg,ethnic,Not Hispanic or Latino,202,255,457
432881,Pancytopenia,ethnic,Hispanic or Latino,301,156,457
4115379,"Localised, primary osteoarthritis of the pelvic region and thigh",racial,White,343,115,458
257012,Chronic rhinosinusitis,racial,Black or African American ,366,92,458
436233,Delayed milestone,ethnic,Hispanic or Latino,193,262,455
81723,Contusion of hand,ethnic,Hispanic or Latino,239,216,455
201603,Disease of teeth AND/OR supporting structures,ethnic,Not Hispanic or Latino,246,209,455
75004,Frank hematuria,ethnic,Hispanic or Latino,104,352,456
376114,Severe nonproliferative diabetic retinopathy,ethnic,Hispanic or Latino,184,269,453
4116452,Generalized osteoarthritis NOS,ethnic,Hispanic or Latino,347,106,453
377290,Legal blindness USA,racial,Unknown,106,347,453
436954,Drug abuse,ethnic,Hispanic or Latino,150,304,454
80189,Displacement of lumbar intervertebral disc without myelopathy,ethnic,Not Hispanic or Latino,267,186,453
443776,Brachial radiculitis,ethnic,Not Hispanic or Latino,129,324,453
441407,Appetite loss - anorexia,racial,White,232,221,453
432875,Anemia due to chronic blood loss,racial,White,442,12,454
443454,Cerebral infarction,racial,Asian,39,414,453
378743,Mild nonproliferative retinopathy,racial,White,200,253,453
440069,Drug dependence,ethnic,Hispanic or Latino,258,193,451
80800,Polymyositis,ethnic,Hispanic or Latino,451,0,451
443537,Deep venous thrombosis of lower extremity,racial,Asian,437,14,451
78804,Schimmelbusch's disease,ethnic,Hispanic or Latino,449,2,451
197914,Chronic gastric ulcer with perforation but without obstruction,racial,White,451,0,451
443597,Chronic kidney disease stage 3,racial,Other Race,278,173,451
253009,Thoracogenic scoliosis,ethnic,Hispanic or Latino,2,449,451
196463,Alcoholic cirrhosis,racial,Unknown,179,271,450
433163,Deficiency of macronutrients,ethnic,Hispanic or Latino,317,131,448
4185302,Chronic myocardial ischemia,racial,Unknown,428,21,449
80189,Displacement of lumbar intervertebral disc without myelopathy,racial,Unknown,251,198,449
437525,Overweight,racial,American Indian or Alaska Native ,331,117,448
253009,Thoracogenic scoliosis,racial,Unknown,0,449,449
4206460,Problem,racial,White,175,274,449
137977,Icteric,ethnic,Hispanic or Latino,184,265,449
255573,Chronic obstructive lung disease,racial,Other Race,368,81,449
255841,Chronic bronchitis,ethnic,Not Hispanic or Latino,320,129,449
443617,Conduct disorder,racial,White,113,336,449
375528,Spastic hemiplegia,ethnic,Hispanic or Latino,198,251,449
439795,Minimal cognitive impairment,ethnic,Not Hispanic or Latino,156,290,446
373478,Presbyopia,racial,Unknown,288,159,447
254761,Cough,racial,Black or African American ,253,193,446
142026,Disorder of cardiovascular prostheses and implants,racial,Unknown,444,2,446
138525,Pain in limb,racial,Black or African American ,189,258,447
444129,Wrist injury,ethnic,Hispanic or Latino,225,221,446
444391,Pain around eye,racial,White,315,131,446
4290927,Impairment level: low vision of both eyes,racial,White,189,258,447
375529,Infantile cerebral palsy,racial,Unknown,301,145,446
443454,Cerebral infarction,racial,Unknown,265,179,444
380415,Acute swimmer's ear,racial,White,248,196,444
4263748,Recurrent major depression in complete remission,ethnic,Hispanic or Latino,214,230,444
433968,Candidiasis,racial,White,292,150,442
132706,Nail disease,racial,White,258,184,442
193522,Acute prostatitis,ethnic,Hispanic or Latino,0,442,442
260123,Acute inflammation of sinus,racial,Asian,230,212,442
432453,General clinical state finding,ethnic,Hispanic or Latino,334,108,442
135287,Non-neoplastic naevus,racial,White,239,202,441
432661,Stomatitis,racial,White,271,168,439
81151,Sprain of ankle joint,ethnic,Not Hispanic or Latino,276,163,439
40485064,Latent syphilis,racial,White,58,382,440
257581,Exacerbation of asthma,racial,Black or African American ,198,242,440
320128,Essential hypertension,racial,Asian Indian,373,64,437
435023,Mild hyperemesis-not delivered,racial,White,437,0,437
381857,Impairment level: one eye: total impairment: other eye: not specified,racial,Unknown,156,281,437
74396,TMJ - Temporomandibular joint disorder,racial,White,370,67,437
377889,Hearing loss,racial,Other Race,242,196,438
377527,Presenile dementia with depression,racial,Unknown,412,23,435
256440,Disorder of paranasal sinuses,racial,Unknown,258,177,435
435656,Neonatal jaundice,racial,White,182,253,435
78516,Arthralgia of the upper arm,racial,Unknown,327,108,435
134736,Backache,racial,Black or African American ,219,216,435
197795,Acute hepatitis B,ethnic,Not Hispanic or Latino,416,18,434
197304,Ulcer of lower limb,racial,White,258,177,435
436033,Syphilis,racial,White,117,317,434
442615,Carotid artery stenosis,racial,Unknown,290,145,435
444093,Patient status finding,ethnic,Hispanic or Latino,281,154,435
374013,Secondary Parkinson's disease,racial,Unknown,269,166,435
312922,Coronary bypass graft observation,ethnic,Not Hispanic or Latino,108,324,432
196726,Cholelithiasis AND acute cholecystitis without obstruction,ethnic,Hispanic or Latino,428,5,433
442604,Hypertensive heart disease,ethnic,Not Hispanic or Latino,368,64,432
439221,"Adverse effect, due to correct medicinal substance properly administered",ethnic,Hispanic or Latino,242,191,433
80495,Palindromic rheumatism of the pelvic region and thigh,ethnic,Hispanic or Latino,357,76,433
432795,Traumatic AND/OR non-traumatic injury,ethnic,Hispanic or Latino,212,221,433
435534,"Nondependent alcohol abuse, continuous",racial,White,97,336,433
440465,Postpartum state,ethnic,Hispanic or Latino,423,7,430
133835,Dermatitis,racial,Unknown,267,163,430
4096215,"Hyperlipidemia, group A",racial,Filipino,373,58,431
77635,Disease of hand,racial,White,324,106,430
4090651,Dialysis observation,racial,Unknown,299,131,430
40479192,Chronic systolic heart failure,racial,Other Race,202,228,430
437409,Intracranial injury,racial,Unknown,0,430,430
195851,"Gastric ulcer without hemorrhage, without perforation AND without obstruction",racial,White,76,354,430
4292726,Contact - infectious disease,ethnic,Hispanic or Latino,255,175,430
197500,Primary malignant neoplasm of colon,racial,Asian,271,159,430
76611,Injury of shoulder region,ethnic,Hispanic or Latino,246,184,430
444246,Cirrhosis of liver not due to alcohol,racial,Asian,412,18,430
134438,CD - Contact dermatitis,racial,Other Race,235,193,428
319843,Mitral valve disorder,racial,Unknown,322,106,428
256717,Bronchospasm,racial,White,255,173,428
317890,Mitral and aortic stenosis,ethnic,Hispanic or Latino,391,37,428
197911,Hernia of anterior abdominal wall without obstruction AND without gangrene,racial,Unknown,251,177,428
192360,Cyst and pseudocyst of pancreas,racial,White,426,2,428
433595,Interstitial edema,racial,Other Race,350,78,428
197795,Acute hepatitis B,racial,Asian,421,7,428
317890,Mitral and aortic stenosis,racial,Unknown,391,37,428
79864,Hematuria syndrome,ethnic,Hispanic or Latino,173,255,428
438409,Attention deficit hyperactivity disorder,racial,Unknown,74,354,428
441284,Open-angle glaucoma,ethnic,Not Hispanic or Latino,324,104,428
441835,Chronic schizoaffective schizophrenia,racial,White,359,69,428
200687,Renal disorder associated with type I diabetes mellitus,racial,Unknown,184,242,426
74635,Lumbosacral root lesion,racial,White,278,147,425
435510,Hypocalcemia,racial,White,253,170,423
254443,Sicca syndrome,racial,White,414,9,423
433736,Obesity,racial,Native Hawaiian or Other Pacific Islander ,196,228,424
441264,Primary thrombocytopenia,racial,White,168,255,423
442256,Disorder of bursae of shoulder region,racial,Unknown,235,189,424
194574,Chronic type B viral hepatitis,racial,White,288,136,424
432612,Mild mental handicap,ethnic,Hispanic or Latino,159,265,424
372906,Both eyes total visual impairment,ethnic,Not Hispanic or Latino,380,41,421
139900,Urticaria,ethnic,Not Hispanic or Latino,258,163,421
200962,Primary malignant neoplasm of prostate,racial,Other Race,0,421,421
433195,Transient arterial retinal occlusion,ethnic,Hispanic or Latino,5,416,421
257004,Acute exacerbation of chronic obstructive airways disease,racial,Black or African American ,267,154,421
437478,Bite of nonvenomous arthropod,racial,White,225,196,421
78232,Shoulder joint pain,racial,Other Race,283,138,421
443237,"Manic disorder, single episode",racial,Other Race,0,421,421
192671,GI - Gastrointestinal haemorrhage,racial,Unknown,253,168,421
435839,Lymphatic oedema,ethnic,Hispanic or Latino,290,129,419
377527,Presenile dementia with depression,ethnic,Not Hispanic or Latino,416,2,418
193016,Cystic disease of kidney,racial,White,267,152,419
192286,Intestinal disaccharidase deficiency,racial,White,308,110,418
376683,Non proliferative diabetic retinopathy,racial,Asian,361,58,419
442764,Anal pain,ethnic,Hispanic or Latino,230,189,419
437233,Plasmacytic myeloma,ethnic,Hispanic or Latino,347,71,418
440424,Aphasia,racial,Unknown,97,322,419
374948,Acute nonsuppurative otitis media,racial,White,145,274,419
4105330,Chronic undifferentiated schizophrenia,ethnic,Hispanic or Latino,138,281,419
76482,MA - Missed abortion,ethnic,Hispanic or Latino,416,0,416
434056,Late effects of cerebrovascular disease,racial,Black or African American ,223,193,416
442013,Burn,racial,White,244,173,417
195867,Noninflammatory vaginal disorders,ethnic,Hispanic or Latino,416,0,416
194696,Menorrhalgia,racial,Unknown,416,0,416
321887,Disorder of artery,racial,White,251,166,417
196158,Disease of penis,ethnic,Hispanic or Latino,0,416,416
137213,Fungal dermatosis,ethnic,Hispanic or Latino,258,159,417
4295261,Postmenopausal state,ethnic,Hispanic or Latino,416,0,416
435535,Aggressive type unsocialized behavior disorder,racial,White,366,51,417
4060985,BMI 30+ - obesity,racial,American Indian or Alaska Native ,343,74,417
4319325,Acquired deformity of trunk,ethnic,Hispanic or Latino,308,108,416
316139,HF - Heart failure,racial,White,205,212,417
380733,Otalgia,ethnic,Not Hispanic or Latino,313,101,414
4108817,"Tricuspid valve disorders, non-rheumatic",ethnic,Hispanic or Latino,403,12,415
81902,Urinary tract infectious disease,racial,Other Race,343,71,414
4049623,"Moderate major depression, single episode",racial,Unknown,235,179,414
135615,Pityriasis,ethnic,Hispanic or Latino,209,205,414
140821,Spasm,racial,Other Race,64,350,414
433400,Emergency contraception,racial,White,412,2,414
79884,Galactorrhea not associated with childbirth,ethnic,Hispanic or Latino,414,0,414
135030,Discoloration of skin,ethnic,Hispanic or Latino,285,129,414
135033,Hair and hair follicle diseases,ethnic,Not Hispanic or Latino,186,228,414
200962,Primary malignant neoplasm of prostate,racial,Asian,0,414,414
372328,Otitis media,racial,Other Race,198,214,412
440078,"Bipolar affective disorder, current episode manic",ethnic,Hispanic or Latino,35,377,412
319845,Pulmonary valve disease,ethnic,Hispanic or Latino,393,18,411
433195,Transient arterial retinal occlusion,racial,Unknown,0,412,412
134898,Non-toxic single thyroid nodule,racial,White,352,60,412
22340,Esophageal varices without bleeding,racial,Asian,412,0,412
4104864,Migraine NOS,ethnic,Hispanic or Latino,354,58,412
198185,Chronic renal failure syndrome,ethnic,Hispanic or Latino,200,209,409
315947,Thoracic back sprain,ethnic,Hispanic or Latino,271,138,409
133729,Hyperparathyroidism,racial,Unknown,276,133,409
193552,Furuncle of skin AND/OR subcutaneous tissue,ethnic,Hispanic or Latino,235,175,410
440438,Anodontia,ethnic,Hispanic or Latino,359,51,410
442286,Abscess of digit,racial,White,230,177,407
197925,Haemorrhage of rectum and anus,ethnic,Not Hispanic or Latino,184,223,407
198995,Type 1 diabetes mellitus - poor control,racial,Black or African American ,239,168,407
439080,Dyspareunia,ethnic,Hispanic or Latino,403,5,408
193251,Umbilical hernia without obstruction AND without gangrene,ethnic,Not Hispanic or Latino,186,221,407
4158567,Post percutaneous transluminal coronary angioplasty,ethnic,Not Hispanic or Latino,147,258,405
4096215,"Hyperlipidemia, group A",racial,American Indian or Alaska Native ,375,30,405
433599,Abnormal biochemistry finding,racial,White,198,207,405
440382,LD - Learning difficulties,ethnic,Hispanic or Latino,177,228,405
376117,Cataract in degenerative disorder,racial,Unknown,301,104,405
441628,Menopausal and postmenopausal disorders,racial,Unknown,405,0,405
133299,Swelling of limb,ethnic,Not Hispanic or Latino,138,267,405
201914,Premenopausal menorrhagia,racial,Unknown,405,0,405
443864,Multi-infarct dementia with depression,racial,White,329,76,405
74729,Ganglion and synovial cyst,racial,White,294,110,404
138479,Thyroid dysfunction during pregnancy - baby not yet delivered,racial,White,400,2,402
198101,Lipoma of skin and subcutaneous tissue (excluding face),racial,White,255,147,402
192676,Cervical intraepithelial neoplasia grade 1,racial,White,398,5,403
312664,Influenza with respiratory manifestation other than pneumonia,racial,Unknown,262,140,402
137053,Seborrheic dermatitis,ethnic,Not Hispanic or Latino,193,209,402
373499,Disorder of eye region,racial,White,237,166,403
433942,Accident whilst engaged in household activity,ethnic,Hispanic or Latino,288,115,403
75346,Disorder of meniscus of knee,racial,Black or African American ,403,0,403
134118,Atrophic condition of skin,racial,Unknown,221,179,400
442615,Carotid artery stenosis,racial,White,152,248,400
195007,Female stress incontinence,ethnic,Not Hispanic or Latino,400,0,400
375552,Pterygium,racial,Unknown,205,196,401
432571,Malignant lymphoma,racial,Unknown,370,30,400
133794,Chronic gingivitis,ethnic,Hispanic or Latino,216,184,400
199860,Hernia of abdominal cavity,racial,White,156,244,400
437677,Abnormal findings on diagnostic imaging of lung,ethnic,Hispanic or Latino,219,182,401
136184,Pruritic disorder,ethnic,Not Hispanic or Latino,235,163,398
373475,Impairment level: one eye: moderate impairment: other eye: not specified,ethnic,Not Hispanic or Latino,398,0,398
140027,Herpetic gingivostomatitis,ethnic,Hispanic or Latino,271,127,398
315558,Atherosclerosis of arteries of the extremities,racial,White,163,235,398
138525,Pain in limb,racial,Other Race,271,127,398
443585,Abrasion AND/OR friction burn of multiple sites,racial,White,175,223,398
443570,Cervicovaginal cytology: Low grade squamous intraepithelial lesion,ethnic,Not Hispanic or Latino,389,9,398
73649,Contusion of finger,ethnic,Hispanic or Latino,246,152,398
435524,Sleep disorder,racial,White,150,248,398
440383,Depressive disorder,racial,American Indian or Alaska Native ,338,60,398
77066,Derangement of medial meniscus,racial,Unknown,37,361,398
438406,"Major depressive disorder, single episode, severe with psychotic features",racial,Unknown,398,0,398
436222,Altered mental status,ethnic,Hispanic or Latino,271,124,395
435535,Aggressive type unsocialized behavior disorder,ethnic,Not Hispanic or Latino,359,37,396
198124,Disorder of kidney,racial,Asian,150,246,396
439858,"Gastrojejunal ulcer without hemorrhage, without perforation AND without obstruction",ethnic,Hispanic or Latino,0,396,396
199913,Acquired deformity of ankle AND/OR foot,ethnic,Hispanic or Latino,97,299,396
4064381,Nephropathy screening,ethnic,Hispanic or Latino,235,161,396
81931,Psoriasis with arthropathy,racial,Unknown,212,184,396
321314,Abdominal aortic aneurysm without rupture,ethnic,Hispanic or Latino,60,336,396
4005823,Tobacco user,racial,Unknown,163,232,395
439926,Malaise and fatigue,racial,Other Race,290,106,396
4053045,Dog bite,ethnic,Hispanic or Latino,260,136,396
195306,Gastroduodenitis,racial,Filipino,386,9,395
435243,Alcohol dependence,racial,White,51,343,394
194081,Acute cystitis,ethnic,Not Hispanic or Latino,308,85,393
439697,Hypertensive renal disease with renal failure,racial,Unknown,380,14,394
4096347,Gouty arthropathy,ethnic,Not Hispanic or Latino,124,269,393
4201390,Colostomy present,ethnic,Hispanic or Latino,265,129,394
4088930,Confirmation of pregnancy,racial,Unknown,393,0,393
30133,Acute laryngitis,ethnic,Hispanic or Latino,308,85,393
256449,Bronchiectasis,ethnic,Not Hispanic or Latino,393,0,393
439005,Chronic alcoholism in remission,ethnic,Hispanic or Latino,94,299,393
317309,Peripheral arterial occlusive disease,racial,Unknown,246,147,393
75911,Acquired hallux valgus,racial,Other Race,5,389,394
201069,"Peptic ulcer without hemorrhage, without perforation AND without obstruction",racial,White,133,260,393
197914,Chronic gastric ulcer with perforation but without obstruction,racial,Unknown,393,0,393
440748,Interstitial emphysema of lung,ethnic,Not Hispanic or Latino,143,251,394
137626,Seborrhoeic eczema of scalp,ethnic,Hispanic or Latino,200,191,391
436073,Psychotic disorder,racial,White,198,193,391
256449,Bronchiectasis,racial,Asian,391,0,391
432876,Bipolar I disorder,ethnic,Not Hispanic or Latino,230,161,391
314059,Right bundle branch block,racial,White,193,198,391
257907,Disorder of lung,racial,White,191,200,391
439926,Malaise and fatigue,racial,Asian,223,168,391
138239,Observation of limb structure,ethnic,Hispanic or Latino,219,173,392
4149353,"Attention deficit hyperactivity disorder, predominantly inattentive type",ethnic,Not Hispanic or Latino,232,159,391
200445,Chronic prostatitis,ethnic,Hispanic or Latino,0,391,391
133414,Candidiasis of skin and nails,ethnic,Hispanic or Latino,283,108,391
435515,Hypo-osmolality and or hyponatremia,racial,Unknown,313,78,391
192279,Diabetic nephropathy,racial,Black or African American ,163,228,391
373198,Unqualified visual loss of both eyes,racial,White,375,16,391
441284,Open-angle glaucoma,racial,Asian,297,94,391
372613,Flaccid hemiplegia,racial,Unknown,375,16,391
257315,Bacterial pneumonia,racial,Unknown,237,152,389
79908,Muscle strength reduced,racial,Other Race,143,246,389
138102,Benign tumour of skin,ethnic,Not Hispanic or Latino,205,184,389
435243,Alcohol dependence,racial,Black or African American ,0,389,389
257581,Exacerbation of asthma,racial,Other Race,214,175,389
438727,Atypical depressive disorder,ethnic,Hispanic or Latino,274,113,387
196991,Chronic renal disease,racial,Other Race,230,156,386
315286,Chronic ischemic heart disease,ethnic,Hispanic or Latino,51,336,387
375292,Perforation of tympanic membrane,racial,White,242,145,387
441482,Administrative reason for encounter,ethnic,Not Hispanic or Latino,200,186,386
255573,Chronic obstructive lung disease,racial,Black or African American ,138,248,386
4263370,R.I.N.D. syndrome,ethnic,Not Hispanic or Latino,202,184,386
4195572,"Mild major depression, single episode",ethnic,Not Hispanic or Latino,221,166,387
135893,Decubitus ulcer of heel,ethnic,Hispanic or Latino,271,115,386
372309,Mononeuritis,ethnic,Not Hispanic or Latino,117,269,386
81175,Contusion of chest,ethnic,Hispanic or Latino,196,191,387
201909,Female infertility,ethnic,Hispanic or Latino,386,0,386
77965,Nodular tendinous disease of finger,racial,Unknown,255,131,386
444112,Integumentary system finding,racial,White,223,161,384
78193,Epididymo-orchitis,ethnic,Hispanic or Latino,0,384,384
201826,Type 2 diabetes mellitus,racial,Filipino,251,133,384
140214,Eruption of skin,racial,Asian,196,189,385
78236,Muscle wasting disorder,ethnic,Hispanic or Latino,51,334,385
312338,Benign hypertensive heart disease with congestive heart failure,racial,Other Race,380,5,385
317898,Malignant essential hypertension,racial,Asian,25,359,384
4084229,Primary gout,racial,White,62,322,384
434887,Disorders of bilirubin excretion,ethnic,Hispanic or Latino,67,315,382
141253,Disease of thyroid gland,racial,Unknown,313,69,382
436245,Atypical glandular cells on vaginal Papanicolaou smear,ethnic,Hispanic or Latino,382,0,382
75614,Acrodermatitis continua,racial,Asian,329,53,382
312664,Influenza with respiratory manifestation other than pneumonia,ethnic,Not Hispanic or Latino,133,248,381
438398,Leukocytosis,racial,Unknown,248,133,381
201093,Infection of skin AND/OR subcutaneous tissue,racial,White,212,170,382
434750,Feeding difficulties and mismanagement,ethnic,Not Hispanic or Latino,175,207,382
4096347,Gouty arthropathy,racial,Unknown,136,246,382
439858,"Gastrojejunal ulcer without hemorrhage, without perforation AND without obstruction",racial,Unknown,0,382,382
200219,Abdominal pain,racial,Black or African American ,225,156,381
381028,Acute suppurative otitis media - tympanic membrane ruptured,ethnic,Hispanic or Latino,177,202,379
194990,Inflammatory disorder of liver,ethnic,Not Hispanic or Latino,76,304,380
137351,Epidermoid cyst of skin,racial,Unknown,228,152,380
81984,Sprain of shoulder and upper arm,racial,Unknown,248,131,379
436238,Elevated levels of transaminase and lactic acid dehydrogenase,racial,Other Race,209,170,379
377877,Convergent squint,ethnic,Hispanic or Latino,212,168,380
380111,Acute atopic conjunctivitis,ethnic,Hispanic or Latino,253,127,380
433736,Obesity,racial,Filipino,255,124,379
436785,Spinal stenosis in cervical region,ethnic,Hispanic or Latino,223,156,379
81902,Urinary tract infectious disease,racial,Asian,345,35,380
436070,Vitamin D deficiency,ethnic,Not Hispanic or Latino,281,99,380
75344,Intervertebral disc disorder,ethnic,Hispanic or Latino,156,221,377
433454,Adjustment disorder with mixed emotional features,racial,White,152,225,377
433751,Prolonged depressive adjustment reaction,ethnic,Hispanic or Latino,347,30,377
440076,SS - Short stature,ethnic,Not Hispanic or Latino,322,55,377
81390,Idiopathic osteoporosis,ethnic,Hispanic or Latino,375,2,377
314054,Aortic valve disease,ethnic,Not Hispanic or Latino,308,69,377
76191,Disease of upper arm,racial,White,262,115,377
376961,Disturbance of consciousness,ethnic,Hispanic or Latino,209,168,377
444247,Venous thrombosis,ethnic,Hispanic or Latino,163,214,377
381857,Impairment level: one eye: total impairment: other eye: not specified,racial,White,193,182,375
4276723,Finding of child weight centiles,ethnic,Not Hispanic or Latino,207,168,375
318169,Varicose veins of lower extremity,racial,Unknown,366,9,375
74582,Primary malignant neoplasm of rectum,ethnic,Hispanic or Latino,278,97,375
73045,Hand sprain,ethnic,Hispanic or Latino,237,138,375
138176,Acute gingivitis,racial,White,223,152,375
440674,Gout,racial,Black or African American ,276,99,375
4167406,Eye disorder screening,racial,White,202,173,375
192731,Digestive symptom,racial,White,228,147,375
441276,Nondependent alcohol abuse in remission,ethnic,Hispanic or Latino,25,350,375
436373,DSD - Developmental speech disorder,ethnic,Not Hispanic or Latino,99,276,375
80813,Lumbosacral spondylosis without myelopathy,racial,White,242,133,375
134118,Atrophic condition of skin,ethnic,Not Hispanic or Latino,207,168,375
376686,Polyneuropathy associated with another disorder,ethnic,Hispanic or Latino,209,163,372
316999,Cardiac arrhythmia,racial,Filipino,7,366,373
4201387,Tracheostomy in situ,racial,White,92,281,373
376422,Mucopurulent conjunctivitis,ethnic,Hispanic or Latino,225,147,372
194092,Uterine prolapse without vaginal wall prolapse,racial,White,373,0,373
435224,Leukopenia,racial,White,255,117,372
140949,Scabies,racial,Unknown,244,129,373
195079,Functional urinary incontinence,ethnic,Hispanic or Latino,193,179,372
4168217,Generalized hyperhidrosis,ethnic,Hispanic or Latino,267,106,373
4168213,Chest pain on breathing,racial,White,237,136,373
137785,Verruca plantaris,ethnic,Hispanic or Latino,244,129,373
193322,Right lower quadrant pain,racial,Unknown,288,85,373
4018734,Sprain of costal cartilage,ethnic,Hispanic or Latino,219,152,371
373724,Neoplasm of brain,ethnic,Hispanic or Latino,219,152,371
77403,Closed fracture of vertebral column without spinal cord injury,ethnic,Hispanic or Latino,212,159,371
441835,Chronic schizoaffective schizophrenia,ethnic,Hispanic or Latino,331,39,370
437390,Hypoxaemia,ethnic,Hispanic or Latino,207,163,370
433454,Adjustment disorder with mixed emotional features,racial,Unknown,193,177,370
381581,Chalazion,racial,White,219,152,371
78835,Palindromic rheumatism of the lower leg,ethnic,Not Hispanic or Latino,255,115,370
77079,SS - Spinal stenosis,racial,Unknown,299,71,370
74114,Cellulitis and abscess of foot excluding toe,racial,White,163,207,370
434172,Insomnia with sleep apnoea,ethnic,Hispanic or Latino,0,370,370
201069,"Peptic ulcer without hemorrhage, without perforation AND without obstruction",racial,Other Race,239,131,370
439082,Menopausal syndrome,racial,Unknown,370,0,370
75095,Closed fracture of ankle,racial,White,242,127,369
435171,Allergic state,racial,Filipino,5,363,368
374357,Acquired stenosis of nasolacrimal duct,ethnic,Hispanic or Latino,173,196,369
133436,Thyrotoxic crisis,ethnic,Not Hispanic or Latino,336,32,368
440329,Herpes zoster without complication,ethnic,Not Hispanic or Latino,154,214,368
381017,Ametropic amblyopia,racial,White,276,92,368
139906,Intervertebral disc disorder of cervical region with myelopathy,ethnic,Hispanic or Latino,163,205,368
376103,Retinopathy,ethnic,Hispanic or Latino,219,150,369
198803,Nodular hyperplasia of prostate gland,racial,Filipino,0,366,366
75004,Frank hematuria,racial,White,90,276,366
194997,Prostatitis,racial,White,0,366,366
442306,Adjustment disorder with depressed mood,racial,Unknown,292,74,366
377552,Moderate nonproliferative diabetic retinopathy,racial,Unknown,299,67,366
140489,Acquired acanthosis nigricans,racial,Unknown,237,129,366
77025,Diverticulitis of colon,racial,Unknown,237,129,366
376382,Tension-type headache,ethnic,Not Hispanic or Latino,255,108,363
140842,Changes in skin texture,racial,Unknown,212,152,364
74719,Foot ulcer,ethnic,Not Hispanic or Latino,145,219,364
437833,Hypokalaemia,ethnic,Not Hispanic or Latino,292,71,363
25297,Acute pharyngitis,racial,Asian,173,191,364
443422,Scleroderma,ethnic,Hispanic or Latino,163,200,363
40481920,Periumbilical pain,ethnic,Hispanic or Latino,274,90,364
442306,Adjustment disorder with depressed mood,racial,White,244,120,364
318169,Varicose veins of lower extremity,racial,White,269,92,361
4028716,Idiopathic thrombocythemia,ethnic,Hispanic or Latino,274,87,361
377802,Late effects of poliomyelitis,racial,Unknown,269,92,361
4046893,Lifestyle,racial,White,124,237,361
4064375,Iron deficiency screening,racial,Asian,170,191,361
374888,Dementia associated with another disease,racial,Black or African American ,347,14,361
440083,Acute stress disorder,racial,White,283,78,361
432597,Schizoaffective schizophrenia,ethnic,Not Hispanic or Latino,283,78,361
134453,Inflammation of bursa,ethnic,Hispanic or Latino,200,161,361
261889,Simple chronic bronchitis,racial,White,202,156,358
4056329,Vaginitis and vulvovaginitis NOS,ethnic,Hispanic or Latino,359,0,359
4022073,Dependance on wheel chair,racial,White,143,216,359
256531,Head and neck swelling,racial,Unknown,269,87,356
443801,Exercise-induced asthma,racial,Unknown,212,145,357
256531,Head and neck swelling,ethnic,Not Hispanic or Latino,221,136,357
4066163,Ureteric colic,ethnic,Hispanic or Latino,189,168,357
435782,Chronic schizophrenic,ethnic,Not Hispanic or Latino,124,232,356
379012,Monoplegia of upper limb,ethnic,Hispanic or Latino,51,306,357
31967,Nausea,ethnic,Not Hispanic or Latino,278,78,356
194700,"Diabetes mellitus in mother complicating pregnancy, childbirth AND/OR puerperium",ethnic,Hispanic or Latino,357,0,357
434467,Ostium secundum type atrial septal defect,racial,White,202,154,356
441207,Drug reaction,ethnic,Hispanic or Latino,237,120,357
4161978,Patient on oxygen,ethnic,Hispanic or Latino,228,129,357
435171,Allergic state,racial,Asian,122,232,354
141038,Diastolic dysfunction,ethnic,Hispanic or Latino,168,186,354
4307254,Closed fracture,ethnic,Hispanic or Latino,232,122,354
433985,Hypercarotinemia,racial,White,150,205,355
4139420,Foreign body in auditory canal,racial,White,161,193,354
443801,Exercise-induced asthma,ethnic,Not Hispanic or Latino,200,154,354
195312,Functional voiding disorder,racial,White,269,83,352
77079,SS - Spinal stenosis,racial,White,120,232,352
141104,Intervertebral disc disorder of lumbar region with myelopathy,ethnic,Not Hispanic or Latino,193,159,352
192278,Type II diabetes mellitus - poor control,racial,Native Hawaiian or Other Pacific Islander ,115,237,352
437165,Motor vehicle traffic accident,ethnic,Hispanic or Latino,223,129,352
133810,Secondary hyperparathyroidism of renal origin,racial,Unknown,216,136,352
440321,Helicobacter-associated disease,ethnic,Not Hispanic or Latino,230,122,352
4107655,Observations relating to psychosocial functioning,racial,White,244,108,352
73008,Enthesopathy,racial,Unknown,248,104,352
201131,Pelvic mass,racial,Unknown,315,37,352
375415,Injury of head region,ethnic,Not Hispanic or Latino,74,278,352
80816,Intervertebral disc degeneration,ethnic,Not Hispanic or Latino,216,136,352
373747,Extrapyramidal disease,racial,Unknown,23,327,350
4175028,Irritant gastritis,ethnic,Hispanic or Latino,223,127,350
140214,Eruption of skin,racial,Other Race,239,110,349
132466,Lumbar sprain,ethnic,Not Hispanic or Latino,207,143,350
194083,Vaginitis and vulvovaginitis,racial,Black or African American ,350,0,350
375791,Uncomplicated senile dementia,racial,Other Race,136,214,350
440216,Abnormal glucose tolerance test,racial,Unknown,230,120,350
439708,Disorders of initiating and maintaining sleep,racial,Black or African American ,336,14,350
4340380,Hepatitis C carrier,racial,White,150,200,350
432612,Mild mental handicap,racial,White,110,239,349
4174977,Diabetic retinopathy,racial,Unknown,219,129,348
254058,Acute bronchiolitis due to respiratory syncytial virus,ethnic,Hispanic or Latino,133,214,347
200169,Pruritus ani,ethnic,Hispanic or Latino,168,179,347
441534,"Severe major depression, single episode, without psychotic features",ethnic,Not Hispanic or Latino,347,0,347
321319,Cardiomyopathy,racial,Unknown,200,147,347
4194895,Screening for disorder,racial,Unknown,189,159,348
443782,Tremor,ethnic,Not Hispanic or Latino,76,271,347
140842,Changes in skin texture,ethnic,Not Hispanic or Latino,53,294,347
4161977,Patient with cardiac pacemaker,racial,Asian,161,184,345
376713,Cerebral hemorrhage,ethnic,Not Hispanic or Latino,336,9,345
133424,Primary malignant neoplasm of thyroid gland,ethnic,Hispanic or Latino,239,106,345
135777,Neoplasm of uncertain behaviour of skin,ethnic,Hispanic or Latino,267,78,345
141941,Cervical spondylosis without myelopathy,ethnic,Hispanic or Latino,237,108,345
79864,Hematuria syndrome,racial,White,140,205,345
200219,Abdominal pain,racial,Asian,258,85,343
136788,Spinal stenosis of lumbar region,racial,Asian,340,2,342
4185471,Disorder of pigmentation,ethnic,Hispanic or Latino,223,120,343
436583,[X]Falls,racial,Asian,159,184,343
30234,Cervical sprain,ethnic,Not Hispanic or Latino,246,97,343
40484028,Dental caries extending into dentine,ethnic,Hispanic or Latino,248,94,342
198185,Chronic renal failure syndrome,racial,White,177,166,343
199856,Varicose veins of lower extremity with inflammation,racial,Unknown,186,156,342
441737,Bruising,racial,Unknown,235,108,343
437528,"Bipolar affective disorder, currently depressed, moderate",racial,White,156,184,340
72465,Closed fracture of one or more phalanges of hand,racial,White,131,209,340
77310,Deep vein phlebitis and thrombophlebitis of the leg,ethnic,Hispanic or Latino,133,207,340
4059014,Spontaneous bruising,racial,White,219,122,341
436253,Sprain of foot,ethnic,Hispanic or Latino,209,131,340
4256640,Body mass index 40+ - severely obese,racial,White,239,101,340
74719,Foot ulcer,racial,Other Race,161,179,340
196359,Primary malignant neoplasm of uterine cervix,ethnic,Hispanic or Latino,340,0,340
442774,Intermittent claudication,ethnic,Not Hispanic or Latino,48,292,340
4057825,Constipation NOS,ethnic,Hispanic or Latino,214,127,341
135473,Dermatophytosis,racial,Unknown,225,115,340
434005,Morbid obesity,racial,Asian,173,168,341
444129,Wrist injury,racial,White,196,145,341
318800,GERD - Gastro-esophageal reflux disease,racial,Asian Indian,308,32,340
379801,Trigeminal neuralgia,racial,White,244,97,341
26823,Oral phase dysphagia,ethnic,Hispanic or Latino,39,299,338
377559,Vernal conjunctivitis,ethnic,Hispanic or Latino,304,35,339
315947,Thoracic back sprain,racial,White,196,143,339
380986,Senile dementia with delusion,racial,Unknown,329,9,338
4050572,Implantation of automatic cardiac defibrillator,racial,Unknown,90,248,338
377885,Disorder of eye movements,racial,White,163,175,338
4012570,High risk sexual behavior,ethnic,Hispanic or Latino,168,170,338
25297,Acute pharyngitis,racial,Black or African American ,186,152,338
137945,Pressure ulcer stage 2,ethnic,Hispanic or Latino,313,25,338
443732,Disorder associated with type II diabetes melliltus,racial,Unknown,262,76,338
432447,Atypical glandular cells on cervical Papanicolaou smear,ethnic,Hispanic or Latino,338,0,338
434742,Congenital abnormality of skull and face bones,ethnic,Hispanic or Latino,221,115,336
137626,Seborrhoeic eczema of scalp,racial,White,154,182,336
442139,Primary bronchial cancer,ethnic,Hispanic or Latino,159,177,336
4170137,Non-suppurative otitis media,racial,White,205,131,336
4087756,Late latent syphilis,racial,White,46,290,336
4088777,Vagina observation,ethnic,Hispanic or Latino,336,0,336
77079,SS - Spinal stenosis,ethnic,Not Hispanic or Latino,334,2,336
141932,Senile hyperkeratosis,racial,White,179,156,335
133141,Tinea pedis,racial,Other Race,136,200,336
437251,Benign neoplasm of pituitary gland and craniopharyngeal duct,ethnic,Hispanic or Latino,163,173,336
79898,Cellulitis and abscess of finger,ethnic,Hispanic or Latino,152,184,336
77642,Arthralgia of the forearm,racial,Asian,324,9,333
4050572,Implantation of automatic cardiac defibrillator,racial,White,179,154,333
437092,Physiological development failure,ethnic,Not Hispanic or Latino,83,251,334
192854,Interstitial uterine fibroid,ethnic,Hispanic or Latino,334,0,334
80809,Rheumatoid arthritis,racial,Other Race,320,14,334
135033,Hair and hair follicle diseases,racial,Unknown,225,108,333
375826,Central hearing loss,ethnic,Hispanic or Latino,205,129,334
442793,Diabetic complication,racial,Other Race,85,248,333
4022073,Dependance on wheel chair,ethnic,Hispanic or Latino,214,120,334
318712,Peripheral circulatory disorder associated with type I diabetes mellitus,ethnic,Not Hispanic or Latino,12,322,334
443732,Disorder associated with type II diabetes melliltus,ethnic,Not Hispanic or Latino,99,235,334
380403,External hordeolum,racial,Unknown,209,124,333
444382,Thoracic radiculitis,ethnic,Not Hispanic or Latino,225,108,333
320752,Influenza with non-respiratory manifestation,ethnic,Hispanic or Latino,184,150,334
440383,Depressive disorder,racial,Native Hawaiian or Other Pacific Islander ,32,301,333
40484522,Hemiplegia of dominant side as late effect of cerebrovascular disease,racial,White,101,230,331
437833,Hypokalaemia,racial,Other Race,331,0,331
320073,Neutrophil count below reference range,ethnic,Hispanic or Latino,251,81,332
4064918,Diabetes mellitus screening,racial,Black or African American ,154,177,331
195873,Leukorrhagia,racial,Unknown,324,7,331
197500,Primary malignant neoplasm of colon,racial,Unknown,41,290,331
372328,Otitis media,racial,Black or African American ,184,147,331
75344,Intervertebral disc disorder,racial,White,129,202,331
135892,Erythematous condition,ethnic,Hispanic or Latino,237,94,331
318222,Acute adenitis,ethnic,Hispanic or Latino,198,133,331
4256640,Body mass index 40+ - severely obese,ethnic,Hispanic or Latino,242,90,332
434502,Closed fracture of phalanx of toe,ethnic,Hispanic or Latino,232,99,331
440360,Pure hyperglyceridemia,racial,American Indian or Alaska Native ,235,97,332
76836,Sprain of knee and leg,ethnic,Not Hispanic or Latino,205,127,332
140480,Impetigo,ethnic,Not Hispanic or Latino,150,182,332
72993,Primary localised osteoarthrosis,racial,White,283,46,329
440076,SS - Short stature,racial,Asian,313,16,329
4092896,Stool contents abnormal,ethnic,Not Hispanic or Latino,205,124,329
437525,Overweight,racial,Native Hawaiian or Other Pacific Islander ,242,87,329
437394,Closed fracture of lower end of forearm,ethnic,Hispanic or Latino,175,154,329
4080568,Problem behaviour,racial,White,71,258,329
437525,Overweight,racial,Filipino,202,127,329
380734,External ear conductive hearing loss,ethnic,Hispanic or Latino,32,297,329
380941,Herpetic meningoencephalitis,ethnic,Hispanic or Latino,5,324,329
137785,Verruca plantaris,racial,White,184,145,329
197675,Bowel incontinence,ethnic,Hispanic or Latino,299,30,329
140190,Disorder of back,ethnic,Hispanic or Latino,301,28,329
4298697,Multiple open wounds without complication,racial,Unknown,168,159,327
78232,Shoulder joint pain,racial,Black or African American ,113,214,327
377560,Internal hordeolum,ethnic,Hispanic or Latino,186,140,326
435227,Nutritional deficiency,ethnic,Hispanic or Latino,170,156,326
377559,Vernal conjunctivitis,racial,Unknown,320,7,327
139888,Threatened premature labor - not delivered,ethnic,Hispanic or Latino,327,0,327
4292726,Contact - infectious disease,racial,White,193,133,326
318556,Nosebleed,ethnic,Not Hispanic or Latino,113,214,327
443677,Open wound of knee and/or leg and/or ankle,ethnic,Hispanic or Latino,189,138,327
132408,Back problem,racial,Unknown,313,14,327
443414,Chronic post-traumatic stress disorder,racial,White,232,94,326
376713,Cerebral hemorrhage,racial,Black or African American ,320,7,327
441946,Calcific tendinitis of shoulder,ethnic,Hispanic or Latino,301,25,326
321882,Generalised atherosclerosis,racial,Other Race,324,0,324
252658,Intrinsic asthma without status asthmaticus,ethnic,Hispanic or Latino,225,99,324
435220,Severe recurrent major depression without psychotic features,ethnic,Not Hispanic or Latino,248,76,324
75576,Colon spasm,ethnic,Not Hispanic or Latino,260,64,324
435515,Hypo-osmolality and or hyponatremia,racial,Other Race,320,5,325
434902,Autistic disorder of childhood onset,racial,Unknown,76,248,324
254443,Sicca syndrome,racial,Asian,324,0,324
444246,Cirrhosis of liver not due to alcohol,ethnic,Not Hispanic or Latino,60,265,325
195321,Postmenopausal bleeding,ethnic,Not Hispanic or Latino,317,7,324
132835,Pediculosis capitis,ethnic,Hispanic or Latino,288,37,325
433595,Interstitial edema,racial,Black or African American ,214,110,324
40484522,Hemiplegia of dominant side as late effect of cerebrovascular disease,racial,Asian,251,74,325
443767,Diabetic oculopathy,racial,Black or African American ,87,237,324
200763,Chronic hepatitis,racial,White,136,189,325
433516,Duodenitis,ethnic,Hispanic or Latino,317,7,324
257581,Exacerbation of asthma,racial,Asian,133,191,324
4062495,Glaucoma screening,ethnic,Not Hispanic or Latino,258,67,325
74513,Open wound of foot without mention of complication,ethnic,Hispanic or Latino,104,221,325
443564,Malignant neoplasm of bone,ethnic,Hispanic or Latino,260,62,322
81454,Injury of finger,ethnic,Hispanic or Latino,152,170,322
4103722,Cataract NOS,ethnic,Hispanic or Latino,168,154,322
139850,Acute frontal sinusitis,ethnic,Not Hispanic or Latino,228,94,322
4282684,Impairment level: low vision of one eye,racial,Unknown,7,315,322
260139,Acute bronchitis,racial,Black or African American ,170,152,322
434073,Loss of teeth - acquired,racial,Unknown,260,62,322
440238,Closed fracture of metatarsal bone,racial,White,232,90,322
441544,Specific nonpsychotic mental disorders following organic brain damage,racial,Asian,322,0,322
254443,Sicca syndrome,ethnic,Not Hispanic or Latino,322,0,322
4064375,Iron deficiency screening,racial,Black or African American ,152,170,322
438878,Abnormal results of liver function studies,racial,Unknown,219,104,323
441544,Specific nonpsychotic mental disorders following organic brain damage,ethnic,Not Hispanic or Latino,322,0,322
438332,Disease of possible viral origin,racial,Black or African American ,154,168,322
435262,Primary open angle glaucoma,racial,Unknown,246,74,320
433751,Prolonged depressive adjustment reaction,racial,White,306,14,320
201340,Gastritis,racial,White,219,101,320
198062,"Infectious colitis, enteritis and gastroenteritis",ethnic,Hispanic or Latino,189,131,320
439777,Anemia,racial,Filipino,14,306,320
380941,Herpetic meningoencephalitis,racial,Unknown,0,320,320
377277,Impairment level: total impairment of both eyes,racial,Unknown,251,69,320
198964,Chronic type C viral hepatitis,racial,Asian,12,308,320
315276,Vitreous hemorrhage,ethnic,Hispanic or Latino,269,51,320
198985,Primary malignant neoplasm of kidney,ethnic,Hispanic or Latino,173,147,320
434056,Late effects of cerebrovascular disease,racial,Asian,138,182,320
437046,Complete abortion,racial,White,317,0,317
4276723,Finding of child weight centiles,racial,Unknown,202,115,317
436298,Adverse reaction to food,ethnic,Hispanic or Latino,133,184,317
194686,Acquired renal cyst,racial,White,166,152,318
254068,Upper respiratory disease,ethnic,Hispanic or Latino,200,117,317
192278,Type II diabetes mellitus - poor control,racial,Filipino,262,55,317
434016,"Nondependent opioid abuse, continuous",ethnic,Hispanic or Latino,131,186,317
439297,Nuclear senile cataract,racial,White,221,97,318
313878,Respiratory symptoms,racial,Other Race,198,120,318
132706,Nail disease,racial,Unknown,193,122,315
315085,Enlargement of lymph nodes,ethnic,Not Hispanic or Latino,202,113,315
436073,Psychotic disorder,racial,Black or African American ,297,18,315
4201388,Gastrostomy present,ethnic,Not Hispanic or Latino,124,191,315
435216,Disorder associated with type I diabetes mellitus,racial,White,122,193,315
141323,Acute maxillary sinusitis,ethnic,Not Hispanic or Latino,235,81,316
81670,Congenital anomaly of spine,ethnic,Not Hispanic or Latino,301,14,315
4112831,Extrinsic asthma NOS,ethnic,Hispanic or Latino,207,108,315
197928,Menstruation absent,racial,Other Race,315,0,315
314665,Atrial flutter,racial,White,136,179,315
381312,Neural hearing loss,ethnic,Hispanic or Latino,99,216,315
4308509,Impaired fasting glycaemia,racial,Asian,223,92,315
440530,Oropharyngeal dysphagia,ethnic,Hispanic or Latino,87,228,315
81723,Contusion of hand,racial,White,156,159,315
436944,Chronic paranoid schizophrenia,ethnic,Hispanic or Latino,140,173,313
373503,Intermittent cerebral ischaemia,racial,Asian,9,304,313
317248,Disorder of hematopoietic structure,ethnic,Hispanic or Latino,177,136,313
80815,Mucous cyst of skin,ethnic,Hispanic or Latino,237,76,313
4103574,Chronic depression,racial,White,246,67,313
4116452,Generalized osteoarthritis NOS,racial,White,200,113,313
254058,Acute bronchiolitis due to respiratory syncytial virus,racial,White,108,205,313
436155,Redundant prepuce and phimosis,racial,Unknown,0,313,313
4161977,Patient with cardiac pacemaker,racial,Black or African American ,186,127,313
437584,Ataxia,ethnic,Hispanic or Latino,156,156,312
4112831,Extrinsic asthma NOS,racial,White,212,101,313
77395,Current tear of semilunar cartilage,ethnic,Hispanic or Latino,189,122,311
4103642,Amputated toe,racial,Unknown,28,283,311
136516,Congenital pes planus,ethnic,Hispanic or Latino,129,182,311
4146239,Pruritus of genital organs,ethnic,Hispanic or Latino,283,28,311
80824,Senile osteoporosis,racial,American Indian or Alaska Native ,311,0,311
4204904,Education about sexually transmitted disease prevention,ethnic,Hispanic or Latino,271,39,310
377861,Disorder of refraction AND/OR accommodation,racial,Asian,133,177,310
437246,Vitamin B deficiency,racial,White,219,92,311
442774,Intermittent claudication,racial,White,147,163,310
134461,Tietze disease,ethnic,Not Hispanic or Latino,205,106,311
72737,Microcalcifications of the breast,ethnic,Hispanic or Latino,311,0,311
198400,Haemangioma of skin and subcutaneous tissue,ethnic,Hispanic or Latino,214,97,311
377279,"Profound impairment, one eye",racial,White,101,209,310
4115379,"Localised, primary osteoarthritis of the pelvic region and thigh",racial,Unknown,173,138,311
4287544,Manic bipolar I disorder,ethnic,Hispanic or Latino,225,83,308
140673,Hypothyroid,racial,American Indian or Alaska Native ,288,21,309
77630,Disease of shoulder,racial,Unknown,207,101,308
4175028,Irritant gastritis,racial,White,189,120,309
440382,LD - Learning difficulties,racial,White,154,154,308
379012,Monoplegia of upper limb,racial,White,12,297,309
380038,Viral conjunctivitis,ethnic,Hispanic or Latino,173,136,309
74855,Genital herpes simplex,ethnic,Not Hispanic or Latino,209,97,306
372409,Sciatica neuralgia,racial,Other Race,232,74,306
77234,Benign tumour of colon,racial,Unknown,150,156,306
436882,[X]Fall involving bed,ethnic,Hispanic or Latino,230,76,306
443728,Mass of chest wall,racial,White,101,205,306
196341,Dermatophytosis of the perianal area,ethnic,Not Hispanic or Latino,131,175,306
432517,Posttraumatic wound infection,ethnic,Hispanic or Latino,127,179,306
381301,Chronic serous otitis media,ethnic,Hispanic or Latino,161,145,306
193552,Furuncle of skin AND/OR subcutaneous tissue,racial,White,168,138,306
314131,Degeneration of cervical intervertebral disc,ethnic,Not Hispanic or Latino,202,104,306
140214,Eruption of skin,racial,Black or African American ,127,179,306
316437,Cerebral atherosclerosis,racial,Unknown,179,127,306
200528,Ascites,racial,White,170,136,306
200164,Urine-induced contact dermatitis,ethnic,Not Hispanic or Latino,175,131,306
437677,Abnormal findings on diagnostic imaging of lung,racial,White,191,115,306
201899,Unilateral recurrent inguinal hernia,racial,White,32,271,303
255919,Finding of head and neck region,ethnic,Hispanic or Latino,154,150,304
4105880,Contact of sexually transmissible disorder,racial,Unknown,242,62,304
133835,Dermatitis,ethnic,Not Hispanic or Latino,145,159,304
439654,Partial epilepsy with impairment of consciousness,ethnic,Hispanic or Latino,90,214,304
437247,Anaemia of chronic disease,racial,Asian,133,170,303
438867,Generalized body aches,ethnic,Not Hispanic or Latino,163,140,303
375827,Acute non-suppurative otitis media - serous,ethnic,Not Hispanic or Latino,179,124,303
133299,Swelling of limb,racial,Asian,46,258,304
439654,Partial epilepsy with impairment of consciousness,racial,White,110,193,303
137548,Cervical root lesion,ethnic,Hispanic or Latino,223,81,304
75091,Closed fracture of carpal bone,ethnic,Hispanic or Latino,186,115,301
434005,Morbid obesity,racial,Filipino,147,154,301
192242,Acute hepatitis C,ethnic,Not Hispanic or Latino,104,198,302
196523,Diarrhea,racial,Black or African American ,90,212,302
141693,Elevated blood-pressure reading without diagnosis of hypertension,racial,Asian,152,150,302
257683,Postnasal drip,ethnic,Not Hispanic or Latino,225,76,301
4250023,Severe major depression with psychotic features,racial,Unknown,292,9,301
437541,Glaucoma,racial,Native Hawaiian or Other Pacific Islander ,0,301,301
439937,C-reactive protein abnormal,ethnic,Hispanic or Latino,202,99,301
375545,Lens opacity,racial,Filipino,12,290,302
436665,Manic-depressive psychosis,racial,Other Race,292,9,301
380097,Diabetic macular edema,ethnic,Hispanic or Latino,161,138,299
434622,Deficiency anemias,ethnic,Hispanic or Latino,198,101,299
443545,Nonvenomous insect bite,racial,Unknown,156,143,299
378743,Mild nonproliferative retinopathy,racial,Unknown,184,115,299
441974,Closed fracture of forearm,ethnic,Hispanic or Latino,143,156,299
441542,Anxiety,racial,Asian Indian,297,2,299
140949,Scabies,ethnic,Not Hispanic or Latino,150,150,300
195867,Noninflammatory vaginal disorders,racial,White,297,2,299
439777,Anemia,racial,American Indian or Alaska Native ,288,12,300
77635,Disease of hand,racial,Unknown,170,129,299
77139,Open wound of finger without complication,racial,White,117,182,299
433516,Duodenitis,racial,American Indian or Alaska Native ,299,0,299
197494,Viral hepatitis C,ethnic,Not Hispanic or Latino,117,182,299
76725,Fissure in ano,ethnic,Hispanic or Latino,179,120,299
378253,HA - Headache,racial,Black or African American ,161,138,299
443571,Cervicovaginal cytology: High grade squamous intraepithelial lesion or carcinoma,ethnic,Hispanic or Latino,297,2,299
444211,Disease of thigh,ethnic,Hispanic or Latino,189,110,299
81670,Congenital anomaly of spine,racial,Asian,294,2,296
77963,Achilles tendinitis,ethnic,Hispanic or Latino,198,99,297
141104,Intervertebral disc disorder of lumbar region with myelopathy,racial,Unknown,106,191,297
80809,Rheumatoid arthritis,racial,Asian Indian,297,0,297
79106,Arthralgia of the pelvic region and thigh,racial,Black or African American ,223,74,297
436972,Glaucoma associated with systemic syndromes,ethnic,Not Hispanic or Latino,143,154,297
195771,Secondary diabetes mellitus,racial,Other Race,285,12,297
376425,Chronic non-suppurative otitis media,ethnic,Hispanic or Latino,260,37,297
81175,Contusion of chest,racial,White,175,122,297
4105880,Contact of sexually transmissible disorder,ethnic,Not Hispanic or Latino,205,92,297
434005,Morbid obesity,racial,American Indian or Alaska Native ,255,41,296
30753,Esophagitis,ethnic,Hispanic or Latino,200,97,297
139906,Intervertebral disc disorder of cervical region with myelopathy,racial,White,207,90,297
436075,Adjustment disorder with anxious mood,ethnic,Hispanic or Latino,200,97,297
30770,Chronic peptic ulcer with hemorrhage but without obstruction,ethnic,Not Hispanic or Latino,294,2,296
439926,Malaise and fatigue,racial,Black or African American ,138,159,297
434500,Closed fracture of neck of femur,ethnic,Hispanic or Latino,156,140,296
136575,Nonvenomous insect bite with infection,ethnic,Hispanic or Latino,136,161,297
78474,Hypertrophy of breast,ethnic,Hispanic or Latino,35,260,295
443767,Diabetic oculopathy,racial,Other Race,97,198,295
372634,Nonphysiologic vision loss,racial,Black or African American ,265,30,295
200391,Peripheral autonomic neuropathy disease EC,racial,Unknown,173,122,295
437833,Hypokalaemia,racial,Unknown,221,74,295
261325,Pulmonary emphysema,ethnic,Not Hispanic or Latino,104,191,295
4175226,Screening for malignant neoplasm of colon,racial,American Indian or Alaska Native ,186,108,294
441534,"Severe major depression, single episode, without psychotic features",racial,Asian,294,0,294
444093,Patient status finding,racial,White,166,129,295
436233,Delayed milestone,racial,White,124,170,294
40484513,Hemiplegia of nondominant side as late effect of cerebrovascular disease,racial,Black or African American ,55,239,294
316211,Acquired spondylolisthesis,ethnic,Hispanic or Latino,179,115,294
30770,Chronic peptic ulcer with hemorrhage but without obstruction,racial,Black or African American ,294,0,294
75346,Disorder of meniscus of knee,racial,Unknown,281,14,295
436336,Herpes zoster with nervous system complication,ethnic,Hispanic or Latino,108,186,294
24818,Neck injury,ethnic,Hispanic or Latino,147,145,292
441422,Closed fracture of humerus,ethnic,Hispanic or Latino,253,39,292
441838,Personality disorder,ethnic,Hispanic or Latino,212,81,293
79936,Polyuria,racial,White,117,175,292
192671,GI - Gastrointestinal haemorrhage,racial,Filipino,0,292,292
4308509,Impaired fasting glycaemia,racial,Other Race,127,166,293
443344,Barrett esophagus,racial,White,113,179,292
4079876,Familial combined hyperlipidemia,racial,Native Hawaiian or Other Pacific Islander ,170,122,292
137809,Primary malignant neoplasm of female breast,racial,Black or African American ,292,0,292
442068,Cellulitis and abscess of forearm,racial,Unknown,221,71,292
376425,Chronic non-suppurative otitis media,racial,White,262,30,292
440216,Abnormal glucose tolerance test,ethnic,Not Hispanic or Latino,147,145,292
443782,Tremor,racial,White,159,133,292
136760,Transient hypertension of pregnancy - not delivered,ethnic,Hispanic or Latino,292,0,292
442067,Atopic dermatitis and related conditions,racial,Asian,108,184,292
192450,Not passing urine,racial,White,87,202,289
74188,Closed fracture of rib,ethnic,Hispanic or Latino,179,110,289
196044,Primary malignant neoplasm of stomach,ethnic,Hispanic or Latino,64,225,289
74451,Palindromic rheumatism of the forearm,ethnic,Hispanic or Latino,221,69,290
76725,Fissure in ano,racial,White,156,133,289
436659,Iron deficiency anaemia,racial,Black or African American ,251,39,290
74582,Primary malignant neoplasm of rectum,racial,White,248,41,289
140190,Disorder of back,racial,Unknown,281,9,290
135858,Disorder of lip,ethnic,Hispanic or Latino,184,106,290
441836,Depressed bipolar I disorder,racial,Other Race,0,290,290
195083,Left lower quadrant pain,ethnic,Not Hispanic or Latino,177,110,287
196360,Primary malignant neoplasm of bladder,ethnic,Hispanic or Latino,16,271,287
4201388,Gastrostomy present,racial,Unknown,108,179,287
132446,Congenital anomaly of skin,ethnic,Hispanic or Latino,161,127,288
4272867,General well-being finding,ethnic,Not Hispanic or Latino,147,140,287
81611,Diverticular disease of colon,racial,Asian,7,281,288
440360,Pure hyperglyceridemia,racial,Black or African American ,113,175,288
193522,Acute prostatitis,racial,White,0,288,288
432967,Anemia during pregnancy - baby not yet delivered,racial,Unknown,288,0,288
4096347,Gouty arthropathy,racial,White,9,278,287
81251,Neoplasm of breast,racial,Other Race,288,0,288
443257,Swellings and lumps,ethnic,Not Hispanic or Latino,184,104,288
442604,Hypertensive heart disease,racial,Asian,253,35,288
141508,Dermatophytosis of scalp or beard,racial,White,101,186,287
313007,MR - Congenital mitral regurgitation,ethnic,Not Hispanic or Latino,285,2,287
136368,Non-toxic multinodular goiter,ethnic,Hispanic or Latino,260,28,288
196523,Diarrhea,racial,Other Race,150,138,288
433753,Alcohol abuse,racial,Unknown,78,207,285
317009,Hyperreactive airway disease,racial,Native Hawaiian or Other Pacific Islander ,87,198,285
4077577,Moderate recurrent major depression,ethnic,Not Hispanic or Latino,182,104,286
443783,Chronic disease,racial,Black or African American ,117,168,285
435372,Underweight,racial,Unknown,189,97,286
317893,Paroxysmal supraventricular tachycardia,ethnic,Hispanic or Latino,251,35,286
436659,Iron deficiency anaemia,racial,Other Race,278,7,285
436445,Abrasion of teeth,ethnic,Hispanic or Latino,152,133,285
439846,LVF - Left ventricular failure,racial,Unknown,62,223,285
439224,Drug allergy,ethnic,Hispanic or Latino,150,136,286
442282,Urinary casts,racial,White,225,60,285
442308,Abrasion AND/OR friction burn of thigh without infection,ethnic,Hispanic or Latino,179,106,285
434097,Twin pregnancy with antenatal problem,ethnic,Hispanic or Latino,285,0,285
313007,MR - Congenital mitral regurgitation,racial,Asian,285,0,285
140027,Herpetic gingivostomatitis,racial,White,173,113,286
194093,Postcoital bleeding,ethnic,Hispanic or Latino,276,9,285
197913,Disorder of function of stomach,racial,Other Race,159,127,286
137820,Postoperative hypothyroidism,ethnic,Hispanic or Latino,228,58,286
4298854,HIV seropositivity,racial,Black or African American ,60,225,285
201418,"Flatulence, eructation and gas pain",racial,Unknown,219,67,286
381028,Acute suppurative otitis media - tympanic membrane ruptured,racial,White,129,156,285
77965,Nodular tendinous disease of finger,ethnic,Not Hispanic or Latino,163,120,283
316998,Left bundle branch block,ethnic,Hispanic or Latino,212,71,283
381301,Chronic serous otitis media,racial,White,145,138,283
138278,Sprains and strains of joints and adjacent muscles,racial,Unknown,168,115,283
78804,Schimmelbusch's disease,racial,White,281,2,283
138102,Benign tumour of skin,racial,Unknown,184,99,283
441918,"Emotional AND/OR mental disease in mother complicating pregnancy, childbirth AND/OR puerperium",ethnic,Hispanic or Latino,269,14,283
199074,Acute pancreatitis,racial,White,166,117,283
432795,Traumatic AND/OR non-traumatic injury,racial,White,129,154,283
135852,Teething syndrome,racial,White,120,163,283
4103574,Chronic depression,racial,Unknown,184,99,283
381445,Avulsion of eye,ethnic,Hispanic or Latino,283,0,283
381445,Avulsion of eye,racial,Unknown,283,0,283
313217,Atrial fibrillation,racial,Filipino,30,253,283
74855,Genital herpes simplex,racial,Unknown,205,78,283
438727,Atypical depressive disorder,racial,White,182,99,281
434462,VSD - Ventricular septal defect,ethnic,Hispanic or Latino,133,147,280
77079,SS - Spinal stenosis,racial,Asian,281,0,281
4272867,General well-being finding,racial,Unknown,161,120,281
374919,Disseminated sclerosis,ethnic,Not Hispanic or Latino,196,85,281
434119,Hidradenitis,ethnic,Hispanic or Latino,225,55,280
78235,Disorder of coccyx,ethnic,Hispanic or Latino,239,41,280
440078,"Bipolar affective disorder, current episode manic",ethnic,Not Hispanic or Latino,145,136,281
254061,Pleural effusion,ethnic,Hispanic or Latino,113,168,281
441482,Administrative reason for encounter,racial,Unknown,120,161,281
438536,Congenital anomaly of jaw,ethnic,Hispanic or Latino,69,212,281
375806,Idiopathic peripheral neuropathy,racial,Other Race,200,81,281
81454,Injury of finger,racial,White,113,168,281
4088777,Vagina observation,racial,White,281,0,281
4158567,Post percutaneous transluminal coronary angioplasty,racial,Unknown,150,131,281
134441,Chronic ulcer of skin,racial,Unknown,163,117,280
194175,Left upper quadrant pain,racial,Unknown,202,76,278
4062636,Bacterial disease screening,racial,Unknown,253,25,278
30133,Acute laryngitis,racial,White,214,64,278
199878,Light and infrequent menstruation,ethnic,Hispanic or Latino,278,0,278
4194895,Screening for disorder,ethnic,Not Hispanic or Latino,113,166,279
194475,Singultus,ethnic,Hispanic or Latino,0,278,278
80495,Palindromic rheumatism of the pelvic region and thigh,racial,White,235,44,279
73045,Hand sprain,racial,White,161,117,278
73301,Synovitis/tenosynovitis - wrist,ethnic,Hispanic or Latino,242,37,279
132835,Pediculosis capitis,racial,White,253,25,278
318800,GERD - Gastro-esophageal reflux disease,racial,American Indian or Alaska Native ,177,101,278
313878,Respiratory symptoms,racial,Asian,104,175,279
314423,"Benign essential hypertension complicating pregnancy, childbirth and the puerperium - not delivered",ethnic,Hispanic or Latino,278,0,278
378419,AD - Alzheimer's disease,racial,Black or African American ,278,0,278
133729,Hyperparathyroidism,racial,Other Race,269,7,276
4093344,Prostate observation,racial,Asian,2,274,276
374060,Acute ill-defined cerebrovascular disease,racial,Filipino,276,0,276
81459,Unilateral traumatic amputation of foot with complication,ethnic,Hispanic or Latino,0,276,276
4228802,Mild recurrent major depression,ethnic,Not Hispanic or Latino,237,39,276
201340,Gastritis,racial,Unknown,225,51,276
253788,Nasal polyp,ethnic,Hispanic or Latino,175,101,276
432881,Pancytopenia,racial,White,129,147,276
440438,Anodontia,racial,White,255,21,276
320420,Vitreous degeneration,ethnic,Hispanic or Latino,193,83,276
433315,Feeding difficulties in newborn,ethnic,Hispanic or Latino,108,168,276
195314,Nephrotic syndrome,ethnic,Hispanic or Latino,138,138,276
4141481,"Hand, foot and mouth disease",racial,White,106,170,276
76503,Joint contracture of shoulder,ethnic,Hispanic or Latino,276,0,276
435613,Cellulitis,ethnic,Not Hispanic or Latino,140,136,276
436077,Developmental delay,ethnic,Not Hispanic or Latino,113,163,276
77354,Primary localised osteoarthrosis of lower leg,racial,Other Race,184,92,276
434073,Loss of teeth - acquired,racial,White,191,85,276
4295261,Postmenopausal state,racial,White,276,0,276
198964,Chronic type C viral hepatitis,racial,Other Race,127,150,277
435237,Reactive psychoses,ethnic,Not Hispanic or Latino,276,0,276
194696,Menorrhalgia,ethnic,Not Hispanic or Latino,271,5,276
4282684,Impairment level: low vision of one eye,racial,White,258,18,276
40480002,Aphasia as late effect of cerebrovascular disease,racial,Unknown,140,136,276
440129,Hypertrophy of nasal turbinates,ethnic,Hispanic or Latino,115,161,276
199078,Vaginal wall prolapse,racial,White,276,0,276
141253,Disease of thyroid gland,ethnic,Not Hispanic or Latino,205,71,276
138278,Sprains and strains of joints and adjacent muscles,ethnic,Not Hispanic or Latino,147,129,276
194990,Inflammatory disorder of liver,racial,White,136,140,276
138825,Actinic keratosis,ethnic,Not Hispanic or Latino,127,147,274
4164707,Canceled operative procedure,ethnic,Hispanic or Latino,145,129,274
4298854,HIV seropositivity,racial,Unknown,51,223,274
438066,Chlamydial infection,ethnic,Not Hispanic or Latino,173,101,274
257012,Chronic rhinosinusitis,racial,Other Race,200,74,274
81426,Closed fracture of clavicle,ethnic,Hispanic or Latino,136,138,274
4086928,IUCD status,ethnic,Hispanic or Latino,274,0,274
442077,Anxiety disorder,racial,White,163,110,273
319041,Orthostatic hypotension,racial,White,182,92,274
436658,Vitamin deficiency,ethnic,Hispanic or Latino,230,44,274
136773,Rosacea,ethnic,Not Hispanic or Latino,163,110,273
376406,"Impairment level: blindness, one eye - low vision other eye",racial,Other Race,0,271,271
321315,Trifascicular block,ethnic,Not Hispanic or Latino,0,271,271
321315,Trifascicular block,racial,Asian,0,271,271
139850,Acute frontal sinusitis,racial,Unknown,232,39,271
319843,Mitral valve disorder,racial,White,193,78,271
435237,Reactive psychoses,racial,Asian,271,0,271
432526,Needs influenza immunisation,racial,American Indian or Alaska Native ,170,101,271
77644,Adhesive capsulitis of shoulder,racial,Unknown,202,69,271
319835,Congestive cardiac failure,racial,Other Race,163,108,271
440525,Prematurity of fetus,racial,White,140,131,271
26823,Oral phase dysphagia,racial,Unknown,7,265,272
379832,Mixed conductive and sensorineural deafness,ethnic,Hispanic or Latino,168,104,272
78516,Arthralgia of the upper arm,ethnic,Not Hispanic or Latino,129,143,272
78193,Epididymo-orchitis,racial,White,0,271,271
437902,Teeth development and eruption disorders,racial,White,140,131,271
381591,Cerebrovascular disease,racial,Other Race,0,271,271
40479192,Chronic systolic heart failure,racial,Black or African American ,44,228,272
4109880,Varicose veins of the leg with ulcer,racial,White,159,113,272
77642,Arthralgia of the forearm,racial,Unknown,193,78,271
28457,Hypertrophy of tonsils,racial,Unknown,166,106,272
4147961,Screening for malignant neoplasm of breast,racial,Asian,271,0,271
4105330,Chronic undifferentiated schizophrenia,racial,White,7,265,272
439183,Concussion,ethnic,Hispanic or Latino,127,143,270
320073,Neutrophil count below reference range,racial,White,182,87,269
372423,Reduction deformities of brain,ethnic,Hispanic or Latino,207,62,269
197988,General abdominal pain-symptom,ethnic,Not Hispanic or Latino,200,69,269
256439,Allergic rhinitis due to pollen,ethnic,Not Hispanic or Latino,159,110,269
199075,Neurogenic bladder,racial,White,92,177,269
317009,Hyperreactive airway disease,racial,American Indian or Alaska Native ,145,124,269
201627,Abnormal vaginal bleeding,racial,Unknown,269,0,269
435796,Dehydration,racial,Unknown,175,94,269
435839,Lymphatic oedema,racial,White,138,131,269
257907,Disorder of lung,racial,Unknown,78,191,269
440426,Vertigo as late effect of stroke,ethnic,Not Hispanic or Latino,235,35,270
4012491,Difficulty chewing,ethnic,Hispanic or Latino,200,67,267
318222,Acute adenitis,racial,White,161,106,267
376112,Diabetic polyneuropathy,racial,Black or African American ,186,81,267
193322,Right lower quadrant pain,ethnic,Not Hispanic or Latino,193,74,267
440069,Drug dependence,racial,White,131,136,267
443545,Nonvenomous insect bite,ethnic,Not Hispanic or Latino,133,133,266
438733,Profound mental handicap,racial,White,74,193,267
75863,Chronic interstitial cystitis,ethnic,Hispanic or Latino,253,14,267
375246,Mononeuritis of upper limb,ethnic,Hispanic or Latino,113,154,267
138384,Acquired hypothyroidism,racial,Unknown,182,85,267
192450,Not passing urine,racial,Unknown,115,152,267
77234,Benign tumour of colon,ethnic,Not Hispanic or Latino,131,136,267
439125,T21 - Trisomy 21,ethnic,Not Hispanic or Latino,156,108,264
28385,Disorder of posterior pituitary,ethnic,Hispanic or Latino,166,99,265
4110815,"Sensorineural hearing loss, bilateral",racial,Unknown,159,106,265
80187,Medial epicondylitis,ethnic,Hispanic or Latino,163,101,264
438409,Attention deficit hyperactivity disorder,racial,Black or African American ,44,221,265
314369,Malignant hypertensive heart disease without congestive heart failure,ethnic,Hispanic or Latino,147,117,264
313023,Neonatal chronic respiratory disease,ethnic,Hispanic or Latino,143,122,265
73754,Restless legs,racial,Unknown,147,117,264
432875,Anemia due to chronic blood loss,racial,Unknown,253,12,265
40490423,Incontinence without sensory awareness,ethnic,Hispanic or Latino,239,25,264
197236,Uterine fibroid,racial,Black or African American ,265,0,265
4088930,Confirmation of pregnancy,ethnic,Not Hispanic or Latino,253,12,265
377001,Unruptured cerebral aneurysm,ethnic,Hispanic or Latino,143,122,265
436246,Low libido,ethnic,Hispanic or Latino,94,170,264
443537,Deep venous thrombosis of lower extremity,racial,American Indian or Alaska Native ,159,106,265
73819,Painful breasts,ethnic,Not Hispanic or Latino,258,7,265
4018734,Sprain of costal cartilage,racial,White,131,133,264
374375,Impacted cerumen,racial,Other Race,129,133,262
376946,Senile delirium,ethnic,Not Hispanic or Latino,262,0,262
141917,Balanitis xerotica obliterans,racial,White,0,262,262
141663,Osteomyelitis,ethnic,Hispanic or Latino,81,182,263
321596,Peripheral venous insufficiency,ethnic,Not Hispanic or Latino,170,92,262
442256,Disorder of bursae of shoulder region,racial,Other Race,246,16,262
376229,Abnormal involuntary movement,racial,Unknown,173,90,263
77340,Genitourinary tract infection in pregnancy,ethnic,Hispanic or Latino,262,0,262
137057,Paronychia,racial,Unknown,154,108,262
134603,CML - Chronic myeloid leukaemia,ethnic,Hispanic or Latino,76,186,262
4147497,Nervous system and sense organ diseases,ethnic,Hispanic or Latino,159,104,263
436245,Atypical glandular cells on vaginal Papanicolaou smear,racial,White,260,0,260
434165,Abnormal cervical smear,racial,Unknown,260,0,260
4093344,Prostate observation,racial,Other Race,0,260,260
138113,Cyst of thyroid,ethnic,Hispanic or Latino,246,14,260
443524,Mixed incontinence,ethnic,Not Hispanic or Latino,253,7,260
79804,Myotonic dystrophy,ethnic,Hispanic or Latino,41,219,260
377888,CHL - Conductive hearing loss,racial,White,120,140,260
438332,Disease of possible viral origin,racial,Asian,104,156,260
442067,Atopic dermatitis and related conditions,racial,Black or African American ,166,94,260
441737,Bruising,ethnic,Not Hispanic or Latino,154,106,260
261325,Pulmonary emphysema,racial,White,140,120,260
4030270,Proliferative polycythemia,ethnic,Hispanic or Latino,113,147,260
438567,Adult failure to thrive syndrome,ethnic,Hispanic or Latino,230,30,260
312349,Venous varices,ethnic,Not Hispanic or Latino,168,92,260
442752,Myalgia,racial,Other Race,237,23,260
196473,Hypertrophy of uterus,ethnic,Hispanic or Latino,260,0,260
440465,Postpartum state,racial,White,251,7,258
78472,Microscopic haematuria,ethnic,Not Hispanic or Latino,166,92,258
442764,Anal pain,racial,White,115,143,258
432295,Pernicious anemia,ethnic,Hispanic or Latino,136,122,258
440525,Prematurity of fetus,ethnic,Not Hispanic or Latino,99,159,258
197676,Hepatomegaly,racial,Asian,258,0,258
74725,Displacement of cervical intervertebral disc without myelopathy,racial,White,81,177,258
443732,Disorder associated with type II diabetes melliltus,racial,Asian,39,219,258
78219,Cellulitis and abscess of hand excluding digits,ethnic,Hispanic or Latino,110,147,257
77670,Chest pain,racial,Black or African American ,117,140,257
79072,Inflammatory disorder of breast,racial,White,248,9,257
439706,Psychosis with origin in childhood,ethnic,Hispanic or Latino,51,207,258
434164,Glycosuria,ethnic,Hispanic or Latino,170,87,257
135772,Goiter,ethnic,Not Hispanic or Latino,214,44,258
436466,Balanoposthitis,racial,Unknown,0,258,258
4311159,Midline cystocele,racial,Unknown,258,0,258
195906,Disorder of lumbar spine,ethnic,Hispanic or Latino,113,143,256
439846,LVF - Left ventricular failure,racial,White,136,120,256
194984,Hepatopathy,racial,Unknown,170,85,255
76482,MA - Missed abortion,racial,White,251,5,256
444070,Tachycardia,ethnic,Not Hispanic or Latino,136,120,256
197676,Hepatomegaly,racial,White,131,124,255
372328,Otitis media,racial,Asian,113,143,256
4194160,Thyroid function tests abnormal,ethnic,Not Hispanic or Latino,122,133,255
434622,Deficiency anemias,racial,White,170,85,255
196158,Disease of penis,racial,White,0,255,255
4093048,Reduction deformity of leg,ethnic,Hispanic or Latino,191,64,255
433456,Acute pain,ethnic,Not Hispanic or Latino,161,94,255
137213,Fungal dermatosis,racial,White,140,115,255
78473,Solitary cyst of breast,racial,White,253,2,255
4096347,Gouty arthropathy,racial,Asian,90,166,256
437902,Teeth development and eruption disorders,racial,Unknown,108,147,255
440685,"Nondependent alcohol abuse, episodic",racial,White,48,207,255
320752,Influenza with non-respiratory manifestation,racial,White,117,138,255
440071,Gout associated problems,ethnic,Hispanic or Latino,2,253,255
436298,Adverse reaction to food,racial,White,113,143,256
81878,Benign paroxysmal positional vertigo,ethnic,Not Hispanic or Latino,179,74,253
257011,Acute upper respiratory infection,racial,Filipino,127,127,254
436075,Adjustment disorder with anxious mood,racial,White,173,81,254
254387,Upper respiratory tract hypersensitivity reaction,racial,Unknown,175,78,253
440922,Diabetic on insulin,ethnic,Hispanic or Latino,161,92,253
377560,Internal hordeolum,racial,White,133,120,253
4210149,Substance abuse counseling,racial,White,156,97,253
80242,Current tear of medial cartilage AND/OR meniscus of knee,racial,Unknown,205,48,253
134312,Iatrogenic hypothyroidism,ethnic,Hispanic or Latino,248,5,253
29735,Candidiasis of mouth,ethnic,Not Hispanic or Latino,117,136,253
253788,Nasal polyp,racial,White,168,85,253
24609,Hypoglycaemia,racial,Unknown,124,129,253
134057,Disease of cardiovascular system,racial,White,138,115,253
78619,"Contusion, knee",racial,Unknown,191,62,253
4186238,Louse infestation,ethnic,Hispanic or Latino,198,55,253
194411,Unilateral simple inguinal hernia,ethnic,Not Hispanic or Latino,9,244,253
81459,Unilateral traumatic amputation of foot with complication,racial,Unknown,0,253,253
378425,Eyelid inflammation,racial,Unknown,179,74,253
75036,Primary localized osteoarthrosis of hand,racial,Unknown,223,28,251
439141,Abnormal increase in weight,racial,Other Race,131,120,251
436677,"Brief situational non-psychotic disorder, NOS",ethnic,Hispanic or Latino,159,92,251
443580,Systolic heart failure,ethnic,Hispanic or Latino,97,154,251
194133,Low back pain,racial,American Indian or Alaska Native ,154,97,251
437113,Asthenia,ethnic,Hispanic or Latino,145,106,251
378253,HA - Headache,racial,Asian,186,64,250
438733,Profound mental handicap,ethnic,Hispanic or Latino,60,191,251
197320,ARF - Acute renal failure,ethnic,Not Hispanic or Latino,101,150,251
434119,Hidradenitis,racial,White,207,44,251
442139,Primary bronchial cancer,racial,White,154,97,251
435933,Closed fracture of lumbar vertebra without spinal cord injury,ethnic,Hispanic or Latino,173,78,251
79884,Galactorrhea not associated with childbirth,racial,White,251,0,251
137627,Prickly heat,ethnic,Hispanic or Latino,115,136,251
4025514,Unspecified peptic ulcer,ethnic,Hispanic or Latino,122,129,251
432545,Bacterial disease,racial,White,198,51,249
141095,Acne,racial,Asian,152,97,249
4048191,Enlargement of tonsil or adenoid,ethnic,Hispanic or Latino,90,159,249
135615,Pityriasis,racial,White,140,108,248
194411,Unilateral simple inguinal hernia,racial,Unknown,37,212,249
81379,Lateral epicondylitis,ethnic,Not Hispanic or Latino,147,101,248
80578,Superficial injury of finger with infection,racial,Unknown,248,0,248
437579,Paroxysmal ventricular tachycardia,ethnic,Hispanic or Latino,202,46,248
316429,Ectopics,ethnic,Hispanic or Latino,136,113,249
436919,Primary malignant neoplasm of unspecified site,racial,White,225,23,248
317302,Coronary sinus rhythm disorder,racial,Other Race,28,221,249
198400,Haemangioma of skin and subcutaneous tissue,racial,White,156,92,248
137548,Cervical root lesion,racial,White,131,117,248
4101660,Amputated below knee,ethnic,Not Hispanic or Latino,5,244,249
441974,Closed fracture of forearm,racial,White,127,122,249
441207,Drug reaction,racial,White,147,101,248
141323,Acute maxillary sinusitis,racial,Unknown,184,64,248
376946,Senile delirium,racial,Black or African American ,248,0,248
195588,Cystitis,ethnic,Not Hispanic or Latino,214,35,249
40484028,Dental caries extending into dentine,racial,Unknown,189,60,249
376229,Abnormal involuntary movement,ethnic,Not Hispanic or Latino,122,127,249
437528,"Bipolar affective disorder, currently depressed, moderate",ethnic,Hispanic or Latino,143,106,249
313878,Respiratory symptoms,racial,Black or African American ,170,78,248
135030,Discoloration of skin,racial,White,156,90,246
74816,Contusion of toe,ethnic,Hispanic or Latino,156,90,246
434097,Twin pregnancy with antenatal problem,racial,White,244,2,246
4064377,Depression screening,racial,American Indian or Alaska Native ,159,87,246
436839,Closed fracture of metacarpal bone,ethnic,Hispanic or Latino,94,152,246
316428,Hypertrophic obstructive cardiomyopathy,ethnic,Hispanic or Latino,90,156,246
140480,Impetigo,racial,Unknown,124,122,246
378679,Acute poliomyelitis,racial,Unknown,246,0,246
436073,Psychotic disorder,racial,Other Race,58,189,247
443571,Cervicovaginal cytology: High grade squamous intraepithelial lesion or carcinoma,racial,White,230,16,246
439013,Insomnia disorder related to another mental disorder,ethnic,Hispanic or Latino,221,23,244
434742,Congenital abnormality of skull and face bones,racial,White,140,104,244
194018,"Functional enuresis, NOS",ethnic,Hispanic or Latino,85,159,244
442068,Cellulitis and abscess of forearm,ethnic,Not Hispanic or Latino,138,106,244
201078,Senile atrophic vaginitis,racial,Unknown,244,0,244
192687,Vulvovaginitis associated with another disease,ethnic,Hispanic or Latino,244,0,244
314054,Aortic valve disease,racial,Black or African American ,244,0,244
4059014,Spontaneous bruising,racial,Unknown,173,71,244
439080,Dyspareunia,racial,White,239,5,244
137063,Corns and callus,ethnic,Not Hispanic or Latino,129,115,244
441838,Personality disorder,racial,Unknown,212,30,242
442067,Atopic dermatitis and related conditions,racial,Other Race,78,163,241
444413,Pyrexial convulsion,ethnic,Hispanic or Latino,115,127,242
317248,Disorder of hematopoietic structure,racial,White,124,117,241
440129,Hypertrophy of nasal turbinates,racial,White,94,147,241
199866,Acute gastritis,racial,Black or African American ,46,196,242
196738,Male genital organ disease,ethnic,Not Hispanic or Latino,0,242,242
435651,Atypical squamous cells on cervical Papanicolaou smear cannot exclude high grade squamous intraepithelial lesion,ethnic,Hispanic or Latino,242,0,242
194990,Inflammatory disorder of liver,racial,Unknown,104,138,242
4090651,Dialysis observation,ethnic,Not Hispanic or Latino,207,35,242
4096665,Diabetes mellitus with no mention of complication,ethnic,Hispanic or Latino,131,110,241
4053045,Dog bite,racial,White,145,97,242
195562,Hemorrhoids,racial,Asian,106,136,242
198199,Pyelonephritis,racial,Unknown,207,35,242
136773,Rosacea,racial,Unknown,173,69,242
194611,CIN 3 - Cervical intraepithelial neoplasia grade 3,ethnic,Hispanic or Latino,242,0,242
73090,Superficial bruising of foot,ethnic,Hispanic or Latino,161,81,242
433736,Obesity,racial,American Indian,106,136,242
443782,Tremor,racial,Unknown,129,113,242
377277,Impairment level: total impairment of both eyes,racial,White,124,115,239
372324,Eustachian tube disorder,racial,Unknown,166,74,240
197950,Cellulitis and abscess of trunk,racial,Unknown,156,83,239
436253,Sprain of foot,racial,White,145,94,239
132466,Lumbar sprain,racial,Unknown,175,64,239
73560,Calcaneal spur,racial,Unknown,179,60,239
79898,Cellulitis and abscess of finger,racial,White,122,117,239
440685,"Nondependent alcohol abuse, episodic",racial,Unknown,74,166,240
379784,Senile dementia with depression,racial,Other Race,0,239,239
441276,Nondependent alcohol abuse in remission,racial,White,41,198,239
192854,Interstitial uterine fibroid,racial,White,239,0,239
443782,Tremor,racial,Asian,5,235,240
318775,Venous embolism,racial,White,159,81,240
192367,Dysplasia of cervix,ethnic,Hispanic or Latino,237,0,237
4062484,Cervical neoplasia screening,racial,Asian,237,0,237
432308,Mononeuritis of lower limb,ethnic,Hispanic or Latino,161,76,237
432285,Recurrent major depressive episodes,racial,Black or African American ,184,53,237
378414,Separation of retinal layers,ethnic,Hispanic or Latino,138,99,237
4230642,Acquired deformity of chest,ethnic,Hispanic or Latino,235,2,237
434887,Disorders of bilirubin excretion,racial,White,53,184,237
4108533,Unspecified otalgia,ethnic,Hispanic or Latino,170,67,237
77074,Joint pain,racial,Other Race,122,115,237
80815,Mucous cyst of skin,racial,White,184,53,237
78474,Hypertrophy of breast,racial,White,16,221,237
376406,"Impairment level: blindness, one eye - low vision other eye",racial,Black or African American ,0,237,237
377877,Convergent squint,racial,White,131,106,237
435790,Spurious polycythaemia,ethnic,Hispanic or Latino,69,168,237
434153,Chromosomopathy,ethnic,Hispanic or Latino,90,147,237
374905,Non-organic sleep disorder,ethnic,Hispanic or Latino,124,113,237
4305589,"Neoplasm, benign",ethnic,Hispanic or Latino,161,76,237
78236,Muscle wasting disorder,racial,Unknown,5,232,237
80573,Contusion of ankle,ethnic,Hispanic or Latino,131,106,237
4326601,Anorectal abscess,ethnic,Hispanic or Latino,85,150,235
315286,Chronic ischemic heart disease,racial,Unknown,18,216,234
140966,Benign neoplasm of skin of face,ethnic,Hispanic or Latino,140,94,234
443350,Lower urinary tract symptoms,racial,Other Race,0,235,235
4171556,Ankle ulcer,racial,White,120,115,235
80813,Lumbosacral spondylosis without myelopathy,ethnic,Not Hispanic or Latino,133,101,234
196738,Male genital organ disease,racial,Unknown,0,235,235
261687,Hemoptysis,ethnic,Hispanic or Latino,143,92,235
443913,Congenital anomaly of trachea,ethnic,Hispanic or Latino,44,191,235
78237,Bicipital tenosynovitis,ethnic,Hispanic or Latino,138,97,235
137977,Icteric,racial,White,122,113,235
436659,Iron deficiency anaemia,racial,American Indian or Alaska Native ,214,21,235
440021,Herpes simplex without complication,ethnic,Not Hispanic or Latino,143,92,235
137548,Cervical root lesion,ethnic,Not Hispanic or Latino,67,168,235
4263748,Recurrent major depression in complete remission,racial,White,143,92,235
436919,Primary malignant neoplasm of unspecified site,ethnic,Hispanic or Latino,173,60,233
4096215,"Hyperlipidemia, group A",racial,Native Hawaiian or Other Pacific Islander ,129,104,233
200164,Urine-induced contact dermatitis,racial,Unknown,124,108,232
4101660,Amputated below knee,racial,White,51,182,233
442774,Intermittent claudication,racial,Unknown,175,58,233
439251,"Bipolar affective disorder, currently depressed, in full remission",ethnic,Hispanic or Latino,232,0,232
199075,Neurogenic bladder,racial,Unknown,202,30,232
81670,Congenital anomaly of spine,ethnic,Hispanic or Latino,168,64,232
372914,Optic atrophy,ethnic,Hispanic or Latino,131,101,232
73291,Palindromic rheumatism of the ankle and/or foot,ethnic,Not Hispanic or Latino,168,64,232
4103471,Observation of body mass index,racial,American Indian,161,71,232
4092879,Absent kidney,ethnic,Hispanic or Latino,150,83,233
377910,Deviated nasal septum,ethnic,Hispanic or Latino,83,150,233
433740,Immunodeficiency disorder,ethnic,Hispanic or Latino,21,212,233
433577,Hammer toe,racial,White,129,104,233
437264,Tobacco dependence syndrome,racial,American Indian or Alaska Native ,133,99,232
200169,Pruritus ani,racial,White,110,122,232
381316,CVA - Cerebrovascular accident,racial,White,145,87,232
4188027,Food allergy,ethnic,Hispanic or Latino,136,97,233
437394,Closed fracture of lower end of forearm,racial,White,133,99,232
434821,SIRS - System inflammatory response syndrome,ethnic,Hispanic or Latino,140,92,232
257907,Disorder of lung,ethnic,Not Hispanic or Latino,92,140,232
30437,Gastroesophageal reflux disease with esophagitis,racial,Asian,110,122,232
436298,Adverse reaction to food,ethnic,Not Hispanic or Latino,90,143,233
315564,Aortic valve regurgitation,ethnic,Not Hispanic or Latino,223,9,232
76506,Effusion of joint of lower leg,ethnic,Hispanic or Latino,140,92,232
73649,Contusion of finger,racial,White,161,71,232
195851,"Gastric ulcer without hemorrhage, without perforation AND without obstruction",racial,Unknown,214,18,232
381316,CVA - Cerebrovascular accident,racial,Unknown,101,131,232
135892,Erythematous condition,racial,White,166,67,233
443564,Malignant neoplasm of bone,racial,Other Race,230,0,230
140842,Changes in skin texture,racial,Black or African American ,5,225,230
432738,Iceland disease,racial,Unknown,173,58,231
374639,Chronic headache disorder,ethnic,Hispanic or Latino,35,196,231
4305080,Abnormal breathing,ethnic,Not Hispanic or Latino,221,9,230
441092,Advanced maternal age gravida,ethnic,Not Hispanic or Latino,219,12,231
81902,Urinary tract infectious disease,racial,Black or African American ,205,25,230
254662,Pulmonary infarction,ethnic,Not Hispanic or Latino,85,145,230
376400,Combined form of senile cataract,racial,White,133,97,230
195603,Vulval and/or perineal noninflammatory disorders,ethnic,Hispanic or Latino,225,5,230
435262,Primary open angle glaucoma,ethnic,Not Hispanic or Latino,212,18,230
377574,Presbycusis,ethnic,Not Hispanic or Latino,30,200,230
76611,Injury of shoulder region,racial,White,101,129,230
132446,Congenital anomaly of skin,racial,White,97,133,230
4066163,Ureteric colic,racial,White,189,41,230
80045,Primary malignant neoplasm of anus,ethnic,Hispanic or Latino,209,21,230
4293175,"Mental state, behaviour and/or psychosocial function finding",ethnic,Not Hispanic or Latino,39,191,230
196523,Diarrhea,racial,Asian,71,159,230
254068,Upper respiratory disease,racial,White,140,90,230
4057825,Constipation NOS,racial,White,131,97,228
134898,Non-toxic single thyroid nodule,ethnic,Not Hispanic or Latino,177,51,228
432597,Schizoaffective schizophrenia,racial,White,154,74,228
321882,Generalised atherosclerosis,racial,White,159,69,228
132659,Acute apical periodontitis,ethnic,Not Hispanic or Latino,115,113,228
77030,Disease of breast,racial,Unknown,228,0,228
137351,Epidermoid cyst of skin,ethnic,Not Hispanic or Latino,110,117,227
436238,Elevated levels of transaminase and lactic acid dehydrogenase,racial,Asian,159,69,228
75337,Cellulitis and abscess of buttock,racial,Unknown,108,120,228
441417,Lack of coordination,ethnic,Not Hispanic or Latino,7,221,228
438066,Chlamydial infection,racial,Unknown,200,28,228
197023,Bilateral inguinal hernia,ethnic,Hispanic or Latino,5,223,228
432526,Needs influenza immunisation,racial,Filipino,115,113,228
437671,Abnormal feces,ethnic,Hispanic or Latino,193,35,228
4103723,Other refraction and accommodation disorders,ethnic,Hispanic or Latino,163,64,227
313502,Benign hypertensive heart disease without congestive heart failure,racial,White,150,78,228
4103642,Amputated toe,racial,White,69,159,228
443442,Finding of vaginal vault smear result,ethnic,Hispanic or Latino,228,0,228
73562,Solitary sacroiliitis,ethnic,Hispanic or Latino,64,163,227
376117,Cataract in degenerative disorder,racial,White,120,108,228
133298,Musculoskeletal disorder of the neck,ethnic,Not Hispanic or Latino,101,127,228
196473,Hypertrophy of uterus,racial,White,228,0,228
320128,Essential hypertension,racial,American Indian,179,48,227
378735,Migraine without aura,ethnic,Hispanic or Latino,177,51,228
257683,Postnasal drip,racial,Unknown,175,51,226
441407,Appetite loss - anorexia,ethnic,Not Hispanic or Latino,120,106,226
138825,Actinic keratosis,racial,Unknown,166,60,226
377886,Chronic purulent otitis media,ethnic,Hispanic or Latino,90,136,226
195873,Leukorrhagia,ethnic,Not Hispanic or Latino,219,7,226
432791,Urticaria-angio-oedema,ethnic,Hispanic or Latino,138,87,225
194913,Idiopathic peripheral autonomic neuropathy,ethnic,Hispanic or Latino,133,92,225
443422,Scleroderma,racial,Unknown,18,207,225
259153,Throat soreness,racial,Other Race,106,120,226
73754,Restless legs,ethnic,Not Hispanic or Latino,175,51,226
376085,Uncomplicated presenile dementia,racial,White,159,67,226
4025514,Unspecified peptic ulcer,racial,Unknown,110,115,225
373503,Intermittent cerebral ischaemia,racial,Black or African American ,0,225,225
435515,Hypo-osmolality and or hyponatremia,ethnic,Not Hispanic or Latino,131,94,225
440071,Gout associated problems,racial,Unknown,2,223,225
433968,Candidiasis,racial,Unknown,173,53,226
78234,Arthralgia of the hand,ethnic,Not Hispanic or Latino,150,76,226
376709,Discharge of eye,ethnic,Hispanic or Latino,127,99,226
255848,Pneumonia,racial,Asian,83,143,226
373475,Impairment level: one eye: moderate impairment: other eye: not specified,racial,Black or African American ,223,0,223
373478,Presbyopia,ethnic,Not Hispanic or Latino,127,97,224
314963,Giant cell arteritis,ethnic,Hispanic or Latino,205,18,223
4104864,Migraine NOS,racial,Unknown,196,28,224
315078,Palpitations,racial,Asian,147,76,223
312998,Pain in thoracic spine,racial,Unknown,147,76,223
201914,Premenopausal menorrhagia,ethnic,Not Hispanic or Latino,219,5,224
442774,Intermittent claudication,racial,Asian,30,193,223
77968,Hallux valgus AND bunion,racial,Unknown,186,37,223
192956,Cholecystitis,ethnic,Hispanic or Latino,163,60,223
315564,Aortic valve regurgitation,racial,Black or African American ,223,0,223
440426,Vertigo as late effect of stroke,racial,Other Race,209,14,223
200763,Chronic hepatitis,racial,Unknown,133,90,223
75911,Acquired hallux valgus,racial,White,159,64,223
441701,Sprain of hip joint,ethnic,Hispanic or Latino,140,83,223
74513,Open wound of foot without mention of complication,racial,White,53,170,223
77421,Open wound of hand except fingers without complication,ethnic,Hispanic or Latino,108,115,223
40479575,Dysphasia as late effect of cerebrovascular disease,ethnic,Hispanic or Latino,186,37,223
74132,Degeneration of lumbosacral intervertebral disc,racial,Asian,25,198,223
197032,Hyperplasia of prostate,racial,Asian,0,221,221
436539,Closed fracture of patella,ethnic,Hispanic or Latino,186,35,221
374919,Disseminated sclerosis,ethnic,Hispanic or Latino,202,18,220
197320,ARF - Acute renal failure,racial,Unknown,140,81,221
439221,"Adverse effect, due to correct medicinal substance properly administered",racial,White,133,87,220
139188,Open wound of scalp without complication,ethnic,Hispanic or Latino,78,143,221
193253,Nephritis,racial,Black or African American ,81,140,221
432571,Malignant lymphoma,racial,White,124,97,221
141932,Senile hyperkeratosis,racial,Unknown,136,85,221
40480431,Speech and language developmental delay due to hearing loss,ethnic,Hispanic or Latino,41,179,220
316822,Finding of heart murmur,racial,Asian,152,69,221
257007,Allergic rhinitis,racial,American Indian or Alaska Native ,182,39,221
4210149,Substance abuse counseling,ethnic,Hispanic or Latino,131,90,221
4305080,Abnormal breathing,racial,Asian,214,7,221
78619,"Contusion, knee",ethnic,Not Hispanic or Latino,120,101,221
435783,Schizophrenia,racial,Black or African American ,156,64,220
4211231,Panic disorder without agoraphobia,ethnic,Not Hispanic or Latino,150,71,221
195453,"Colitis, enteritis and gastroenteritis presumed infectious",racial,Unknown,129,92,221
26662,Testicular hypofunction,racial,Black or African American ,5,216,221
313502,Benign hypertensive heart disease without congestive heart failure,racial,Unknown,140,81,221
192680,Portal hypertension,ethnic,Hispanic or Latino,147,74,221
134159,Precordial pain,ethnic,Not Hispanic or Latino,58,163,221
197911,Hernia of anterior abdominal wall without obstruction AND without gangrene,ethnic,Not Hispanic or Latino,97,122,219
432738,Iceland disease,ethnic,Not Hispanic or Latino,97,122,219
441507,"Early latent syphilis, positive serology, negative cerebrospinal fluid, less than 2 years after infection",ethnic,Hispanic or Latino,35,184,219
27587,Disturbance of salivary secretion,ethnic,Hispanic or Latino,163,55,218
137379,Musculoskeletal symptom,ethnic,Not Hispanic or Latino,145,74,219
320136,Disease of respiratory system,ethnic,Hispanic or Latino,108,110,218
437256,Hereditary factor XI deficiency disease,ethnic,Hispanic or Latino,219,0,219
440905,Toxic effect of venom,ethnic,Hispanic or Latino,131,87,218
440529,Abnormal findings on diagnostic imaging of urinary organs,ethnic,Hispanic or Latino,161,58,219
437256,Hereditary factor XI deficiency disease,racial,Other Race,219,0,219
195906,Disorder of lumbar spine,racial,White,69,150,219
132740,Positive skin test reaction,racial,Asian,163,55,218
315833,Secondary cardiomyopathy,racial,Unknown,104,115,219
133280,Alopecia,racial,Unknown,184,35,219
192239,Post-herpetic polyneuropathy,ethnic,Hispanic or Latino,104,115,219
377574,Presbycusis,racial,Asian,28,191,219
77630,Disease of shoulder,ethnic,Not Hispanic or Latino,150,69,219
378427,Tear film insufficiency,ethnic,Not Hispanic or Latino,168,51,219
77403,Closed fracture of vertebral column without spinal cord injury,racial,Unknown,122,97,219
440530,Oropharyngeal dysphagia,racial,Unknown,18,200,218
438244,Congenital hydrocephalus,ethnic,Hispanic or Latino,124,94,218
198528,Acquired unequal leg length,ethnic,Hispanic or Latino,71,147,218
438469,"Duodenal ulcer without hemorrhage, without perforation AND without obstruction",racial,Unknown,12,207,219
4064905,Venereal disease screening,racial,Black or African American ,163,53,216
374919,Disseminated sclerosis,racial,White,173,44,217
4056329,Vaginitis and vulvovaginitis NOS,racial,White,214,2,216
28385,Disorder of posterior pituitary,racial,White,150,67,217
256451,Bronchitis,racial,Other Race,145,71,216
439183,Concussion,racial,White,127,90,217
132659,Acute apical periodontitis,racial,Unknown,156,60,216
435216,Disorder associated with type I diabetes mellitus,racial,Unknown,46,170,216
141933,Alopecia areata,ethnic,Hispanic or Latino,133,83,216
312358,CGN - Chronic glomerulonephritis,ethnic,Hispanic or Latino,117,99,216
380378,Epilepsy,racial,Asian,21,196,217
4101660,Amputated below knee,racial,Black or African American ,0,216,216
73843,Synovial cyst of popliteal space,ethnic,Hispanic or Latino,161,55,216
40481920,Periumbilical pain,racial,White,161,55,216
374060,Acute ill-defined cerebrovascular disease,racial,Native Hawaiian or Other Pacific Islander ,0,216,216
4179963,Family history of malignant neoplasm of breast,ethnic,Hispanic or Latino,216,0,216
439120,Aseptic necrosis of head AND/OR neck of femur,ethnic,Hispanic or Latino,87,129,216
380111,Acute atopic conjunctivitis,racial,White,122,94,216
4051114,FH: Diabetes mellitus,ethnic,Not Hispanic or Latino,97,120,217
141213,Scarlet fever,ethnic,Hispanic or Latino,117,99,216
436785,Spinal stenosis in cervical region,racial,White,133,83,216
436118,After-cataract with vision obscured,ethnic,Hispanic or Latino,145,71,216
4164707,Canceled operative procedure,racial,White,129,87,216
438527,"Juvenile osteochondrosis of lower extremity, excluding foot",ethnic,Hispanic or Latino,41,175,216
135777,Neoplasm of uncertain behaviour of skin,racial,White,143,71,214
78272,Sprain of wrist,racial,Unknown,110,104,214
73301,Synovitis/tenosynovitis - wrist,racial,White,191,23,214
381308,Abscess of eyelid,ethnic,Hispanic or Latino,124,90,214
318736,Migraine,racial,Other Race,193,21,214
192667,Atrophic gastritis,ethnic,Not Hispanic or Latino,117,97,214
442282,Urinary casts,racial,Unknown,175,39,214
4204904,Education about sexually transmitted disease prevention,racial,White,177,37,214
440009,Complication of implant,ethnic,Hispanic or Latino,55,159,214
372629,Nonexudative age-related macular degeneration,ethnic,Hispanic or Latino,168,46,214
377294,Exotropia,ethnic,Hispanic or Latino,99,115,214
441980,Closed fracture of foot,racial,White,113,101,214
4064381,Nephropathy screening,racial,White,113,101,214
75860,Costiveness,racial,Filipino,166,48,214
133228,Dental caries,racial,Asian,110,104,214
374924,Generalized convulsive epilepsy,racial,Other Race,85,129,214
136237,Cardiovascular system problem,ethnic,Hispanic or Latino,150,64,214
260125,Acute bronchiolitis,racial,Other Race,145,69,214
435220,Severe recurrent major depression without psychotic features,racial,Asian,175,39,214
4147466,Panic disorder with agoraphobia,racial,White,163,51,214
442308,Abrasion AND/OR friction burn of thigh without infection,racial,White,145,69,214
200445,Chronic prostatitis,racial,White,0,212,212
134718,Hirsutism,ethnic,Hispanic or Latino,212,0,212
374044,Droopy eyelid,racial,Unknown,147,64,211
77968,Hallux valgus AND bunion,ethnic,Not Hispanic or Latino,154,58,212
4101199,Hearing problem,racial,Unknown,124,87,211
40490423,Incontinence without sensory awareness,racial,White,189,23,212
74194,Back sprain,ethnic,Hispanic or Latino,136,76,212
4110499,Allergic rhinitis NOS,racial,Unknown,184,28,212
315831,Chronic pulmonary heart disease,racial,Unknown,179,32,211
136057,Benign neoplasm of skin of trunk,racial,White,101,110,211
436230,Blood chemistry abnormal,racial,Asian,131,81,212
74725,Displacement of cervical intervertebral disc without myelopathy,ethnic,Not Hispanic or Latino,110,101,211
134453,Inflammation of bursa,racial,White,94,117,211
317585,Aortic aneurysm,ethnic,Hispanic or Latino,46,166,212
321314,Abdominal aortic aneurysm without rupture,racial,Unknown,18,193,211
133794,Chronic gingivitis,racial,White,127,85,212
372903,Retinal edema,racial,Unknown,166,46,212
196735,Acute pyelonephritis without medullary necrosis,ethnic,Hispanic or Latino,145,67,212
373638,Superficial injury of cornea,ethnic,Hispanic or Latino,94,117,211
432526,Needs influenza immunisation,racial,Native Hawaiian or Other Pacific Islander ,99,113,212
439406,Allergy to animal,ethnic,Hispanic or Latino,113,99,212
314754,Wheezing,racial,Other Race,101,110,211
194611,CIN 3 - Cervical intraepithelial neoplasia grade 3,racial,White,209,0,209
192438,Abdominal mass,ethnic,Hispanic or Latino,198,12,210
136184,Pruritic disorder,racial,Asian,113,97,210
436730,"Appendicitis, unqualified",ethnic,Hispanic or Latino,71,138,209
135473,Dermatophytosis,ethnic,Not Hispanic or Latino,131,78,209
436670,MD - Metabolic disorders,ethnic,Hispanic or Latino,94,115,209
79804,Myotonic dystrophy,racial,Unknown,0,209,209
437528,"Bipolar affective disorder, currently depressed, moderate",ethnic,Not Hispanic or Latino,51,159,210
30753,Esophagitis,racial,White,143,67,210
4250023,Severe major depression with psychotic features,ethnic,Not Hispanic or Latino,129,81,210
200687,Renal disorder associated with type I diabetes mellitus,ethnic,Not Hispanic or Latino,110,99,209
194093,Postcoital bleeding,racial,White,193,16,209
197928,Menstruation absent,racial,Black or African American ,209,0,209
374060,Acute ill-defined cerebrovascular disease,racial,Other Race,5,205,210
73241,Anal and rectal polyp,ethnic,Hispanic or Latino,83,127,210
376406,"Impairment level: blindness, one eye - low vision other eye",racial,White,182,28,210
4088920,Womb absent,racial,Unknown,209,0,209
26935,Disorder of endocrine testis,ethnic,Hispanic or Latino,0,209,209
138821,Seborrhea,ethnic,Hispanic or Latino,85,124,209
135215,Hashimoto thyroiditis,ethnic,Hispanic or Latino,209,0,209
134603,CML - Chronic myeloid leukaemia,racial,Unknown,32,177,209
441274,Developmental expressive language disorder,racial,White,90,120,210
315523,Hemoglobin S-F disease,racial,Asian,207,0,207
432588,Megaloblastic anemia due to vitamin B>12< deficiency,ethnic,Hispanic or Latino,140,67,207
197032,Hyperplasia of prostate,racial,Other Race,0,207,207
432590,Delusional disorder,ethnic,Hispanic or Latino,117,90,207
133414,Candidiasis of skin and nails,racial,White,145,62,207
437233,Plasmacytic myeloma,racial,Unknown,179,28,207
440088,Academic underachievement disorder,ethnic,Hispanic or Latino,69,138,207
136575,Nonvenomous insect bite with infection,racial,White,106,101,207
444382,Thoracic radiculitis,racial,Unknown,104,104,208
433811,Hydronephrosis,ethnic,Not Hispanic or Latino,90,117,207
141941,Cervical spondylosis without myelopathy,racial,White,136,71,207
314971,Chronic respiratory failure,racial,Unknown,106,101,207
134671,Dental abscess without a sinus,ethnic,Hispanic or Latino,101,106,207
257011,Acute upper respiratory infection,racial,American Indian or Alaska Native ,143,64,207
74635,Lumbosacral root lesion,racial,Unknown,71,136,207
29735,Candidiasis of mouth,racial,Unknown,150,58,208
434502,Closed fracture of phalanx of toe,racial,White,131,76,207
432585,Blood coagulation disorder,ethnic,Not Hispanic or Latino,32,175,207
315523,Hemoglobin S-F disease,ethnic,Not Hispanic or Latino,207,0,207
200763,Chronic hepatitis,ethnic,Not Hispanic or Latino,85,122,207
194990,Inflammatory disorder of liver,racial,Asian,5,202,207
133810,Secondary hyperparathyroidism of renal origin,racial,White,99,108,207
434172,Insomnia with sleep apnoea,ethnic,Not Hispanic or Latino,90,117,207
201254,Insulin dependent diabetes mellitus,racial,Other Race,182,23,205
380403,External hordeolum,ethnic,Not Hispanic or Latino,101,104,205
193170,Renal glycosuria,ethnic,Hispanic or Latino,205,0,205
134898,Non-toxic single thyroid nodule,racial,Unknown,177,28,205
197928,Menstruation absent,racial,Asian,202,2,204
140362,Hypoparathyroidism,ethnic,Hispanic or Latino,129,76,205
194574,Chronic type B viral hepatitis,ethnic,Not Hispanic or Latino,35,170,205
441274,Developmental expressive language disorder,ethnic,Not Hispanic or Latino,179,25,204
134718,Hirsutism,racial,White,205,0,205
198985,Primary malignant neoplasm of kidney,ethnic,Not Hispanic or Latino,104,101,205
435790,Spurious polycythaemia,racial,White,41,163,204
434016,"Nondependent opioid abuse, continuous",racial,Unknown,117,87,204
375252,Disorder of eye,racial,Unknown,133,71,204
443238,Diabetic - poor control,racial,Asian,48,156,204
437688,Abnormal findings on antenatal screening of mother,ethnic,Hispanic or Latino,205,0,205
437390,Hypoxaemia,racial,White,104,101,205
435262,Primary open angle glaucoma,racial,Black or African American ,200,5,205
4319325,Acquired deformity of trunk,racial,White,161,44,205
193170,Renal glycosuria,racial,Unknown,205,0,205
79873,Urolith,ethnic,Hispanic or Latino,131,74,205
4298697,Multiple open wounds without complication,ethnic,Not Hispanic or Latino,106,99,205
196359,Primary malignant neoplasm of uterine cervix,racial,White,205,0,205
4174977,Diabetic retinopathy,racial,White,97,108,205
432661,Stomatitis,racial,Unknown,90,113,203
138502,Vitiligo,racial,Unknown,152,51,203
81390,Idiopathic osteoporosis,racial,Unknown,202,0,202
441274,Developmental expressive language disorder,racial,Black or African American ,179,23,202
436222,Altered mental status,racial,White,115,87,202
194382,External haemorrhoid,ethnic,Hispanic or Latino,152,51,203
442262,Blister of toe without infection,ethnic,Hispanic or Latino,92,110,202
440021,Herpes simplex without complication,racial,Unknown,143,60,203
321689,Apneic,ethnic,Hispanic or Latino,113,90,203
377286,VFD - Visual field defect,ethnic,Hispanic or Latino,39,163,202
373766,Retinopathy of prematurity,ethnic,Hispanic or Latino,90,113,203
375528,Spastic hemiplegia,racial,Unknown,196,7,203
77963,Achilles tendinitis,racial,White,104,99,203
439013,Insomnia disorder related to another mental disorder,racial,White,191,12,203
435082,Closed fracture nasal bone,ethnic,Hispanic or Latino,113,90,203
439696,Hypertensive heart and renal disease with (congestive) heart failure,ethnic,Hispanic or Latino,44,159,203
4170576,Pressure ulcer,racial,White,129,71,200
136057,Benign neoplasm of skin of trunk,ethnic,Hispanic or Latino,87,113,200
432870,Thrombocytopenia,racial,Asian,28,173,201
136516,Congenital pes planus,racial,White,94,106,200
133857,Acquired deformity of limb,ethnic,Hispanic or Latino,90,110,200
4173811,Congenital quadriplegia,ethnic,Hispanic or Latino,46,154,200
196463,Alcoholic cirrhosis,ethnic,Not Hispanic or Latino,124,76,200
436954,Drug abuse,ethnic,Not Hispanic or Latino,83,117,200
194406,Urinary tract obstruction,ethnic,Not Hispanic or Latino,7,193,200
201519,Ca liver - primary,ethnic,Hispanic or Latino,21,179,200
196734,Disease of prostate,ethnic,Hispanic or Latino,0,200,200
375415,Injury of head region,racial,Asian,5,196,201
4116452,Generalized osteoarthritis NOS,racial,Unknown,189,12,201
193016,Cystic disease of kidney,racial,Asian,182,18,200
199839,External haemorrhoids without complication,ethnic,Not Hispanic or Latino,124,76,200
132344,Gingival and periodontal disease,ethnic,Hispanic or Latino,101,99,200
201820,Diabetes mellitus,racial,Unknown,117,83,200
443729,Peripheral circulatory disorder associated with type II diabetes mellitus,racial,Asian,48,152,200
443414,Chronic post-traumatic stress disorder,racial,Other Race,196,5,201
4239301,Unwanted pregnancy,ethnic,Hispanic or Latino,198,0,198
433456,Acute pain,racial,Unknown,110,87,197
141693,Elevated blood-pressure reading without diagnosis of hypertension,racial,Black or African American ,92,106,198
24966,OV - Oesophageal varices,ethnic,Hispanic or Latino,152,46,198
4293175,"Mental state, behaviour and/or psychosocial function finding",racial,Unknown,74,124,198
140673,Hypothyroid,racial,Native Hawaiian or Other Pacific Islander ,159,39,198
75389,Current tear of lateral cartilage AND/OR meniscus of knee,ethnic,Hispanic or Latino,122,76,198
442425,Lumbar post-laminectomy syndrome,ethnic,Hispanic or Latino,7,191,198
312998,Pain in thoracic spine,ethnic,Not Hispanic or Latino,133,64,197
433753,Alcohol abuse,ethnic,Not Hispanic or Latino,32,166,198
435657,Sleep problem,ethnic,Hispanic or Latino,156,41,197
438460,Edentulous alveolar ridge atrophy,ethnic,Hispanic or Latino,140,58,198
139888,Threatened premature labor - not delivered,racial,White,198,0,198
437251,Benign neoplasm of pituitary gland and craniopharyngeal duct,racial,White,83,115,198
81144,Sprain of medial collateral ligament of knee,ethnic,Hispanic or Latino,120,78,198
81670,Congenital anomaly of spine,racial,White,150,48,198
195771,Secondary diabetes mellitus,ethnic,Not Hispanic or Latino,78,120,198
444100,Mood disorder,racial,Asian,166,32,198
4186238,Louse infestation,racial,White,163,35,198
24818,Neck injury,racial,White,92,106,198
375292,Perforation of tympanic membrane,racial,Unknown,136,62,198
444239,Postprocedural state finding,racial,Other Race,117,81,198
314423,"Benign essential hypertension complicating pregnancy, childbirth and the puerperium - not delivered",racial,White,198,0,198
141232,MM - Malignant melanoma of skin,ethnic,Hispanic or Latino,143,55,198
252658,Intrinsic asthma without status asthmaticus,racial,Unknown,152,44,196
72418,Scoliosis deformity of spine,ethnic,Hispanic or Latino,104,92,196
440424,Aphasia,ethnic,Not Hispanic or Latino,124,71,195
138239,Observation of limb structure,racial,White,108,87,195
438557,Abnormal glucose level,racial,Black or African American ,106,90,196
4022073,Dependance on wheel chair,ethnic,Not Hispanic or Latino,35,161,196
312934,Atherosclerosis of aorta,ethnic,Not Hispanic or Latino,120,76,196
196991,Chronic renal disease,racial,Black or African American ,44,152,196
439799,Leg cramps,racial,White,133,62,195
24134,Nonspecific pain in the neck region,racial,Other Race,136,60,196
132408,Back problem,ethnic,Not Hispanic or Latino,127,69,196
374044,Droopy eyelid,racial,White,106,90,196
192286,Intestinal disaccharidase deficiency,racial,Unknown,136,60,196
4103722,Cataract NOS,racial,White,97,99,196
81186,Contusion of wrist,ethnic,Hispanic or Latino,138,58,196
192671,GI - Gastrointestinal haemorrhage,ethnic,Not Hispanic or Latino,97,99,196
4096665,Diabetes mellitus with no mention of complication,racial,White,113,83,196
441836,Depressed bipolar I disorder,racial,White,143,53,196
378756,Conjunctival hemorrhage,racial,Unknown,120,76,196
439695,Hypertensive heart and renal disease with renal failure,ethnic,Hispanic or Latino,92,104,196
443790,Multi-infarct dementia with delusions,ethnic,Hispanic or Latino,156,39,195
198985,Primary malignant neoplasm of kidney,racial,White,145,51,196
74816,Contusion of toe,racial,White,124,71,195
141095,Acne,racial,Other Race,92,104,196
196360,Primary malignant neoplasm of bladder,racial,Unknown,2,193,195
4201390,Colostomy present,racial,White,136,60,196
376400,Combined form of senile cataract,racial,Asian,90,106,196
381592,Chronic mucoid otitis media,ethnic,Hispanic or Latino,110,85,195
441417,Lack of coordination,racial,Asian,5,191,196
435093,Closed fracture of femur,ethnic,Hispanic or Latino,122,74,196
316428,Hypertrophic obstructive cardiomyopathy,racial,White,81,115,196
441428,Closed fracture of lateral malleolus,ethnic,Hispanic or Latino,161,32,193
372324,Eustachian tube disorder,ethnic,Not Hispanic or Latino,120,74,194
4280828,"Carrier, infectious agent",ethnic,Hispanic or Latino,150,44,194
257012,Chronic rhinosinusitis,racial,Asian,150,44,194
141090,PG - Pyogenic granuloma,ethnic,Hispanic or Latino,85,108,193
436677,"Brief situational non-psychotic disorder, NOS",ethnic,Not Hispanic or Latino,18,175,193
200391,Peripheral autonomic neuropathy disease EC,racial,White,94,99,193
441422,Closed fracture of humerus,racial,White,145,48,193
195314,Nephrotic syndrome,racial,White,110,83,193
74451,Palindromic rheumatism of the forearm,racial,White,159,35,194
72748,Strain of rotator cuff of shoulder,ethnic,Not Hispanic or Latino,94,99,193
439708,Disorders of initiating and maintaining sleep,racial,Asian,145,48,193
198464,Incisional hernia,ethnic,Hispanic or Latino,133,60,193
24134,Nonspecific pain in the neck region,racial,Black or African American ,175,18,193
40484513,Hemiplegia of nondominant side as late effect of cerebrovascular disease,racial,Asian,21,173,194
26711,Chronic pharyngitis,ethnic,Hispanic or Latino,106,87,193
200527,Splenomegaly,ethnic,Hispanic or Latino,113,81,194
30978,Hereditary leptocytosis,ethnic,Hispanic or Latino,129,64,193
4114314,Screening for osteoporosis,racial,Asian,168,25,193
195847,Gastroparesis syndrome,racial,White,154,39,193
195079,Functional urinary incontinence,racial,Unknown,39,154,193
444211,Disease of thigh,racial,White,143,51,194
141038,Diastolic dysfunction,racial,Unknown,81,113,194
195501,Polycystic ovaries,racial,Unknown,193,0,193
4146239,Pruritus of genital organs,racial,White,175,18,193
321319,Cardiomyopathy,ethnic,Not Hispanic or Latino,71,122,193
137809,Primary malignant neoplasm of female breast,racial,Other Race,193,0,193
194700,"Diabetes mellitus in mother complicating pregnancy, childbirth AND/OR puerperium",racial,White,193,0,193
379805,Myopia,ethnic,Not Hispanic or Latino,83,108,191
135858,Disorder of lip,racial,White,129,62,191
432895,Cortical senile cataract,racial,White,110,81,191
77673,Sign or symptom of the urinary system,ethnic,Hispanic or Latino,90,101,191
435928,Abnormal decrease in weight,racial,Black or African American ,97,94,191
441818,Haemangioma,ethnic,Hispanic or Latino,138,53,191
74728,Synovitis and tenosynovitis,ethnic,Hispanic or Latino,117,74,191
4093048,Reduction deformity of leg,racial,Unknown,191,0,191
141232,MM - Malignant melanoma of skin,racial,White,129,62,191
73231,Arthralgia of temporomandibular joint,ethnic,Hispanic or Latino,154,37,191
77310,Deep vein phlebitis and thrombophlebitis of the leg,racial,White,51,140,191
376683,Non proliferative diabetic retinopathy,racial,Other Race,99,92,191
4049623,"Moderate major depression, single episode",ethnic,Not Hispanic or Latino,145,46,191
197236,Uterine fibroid,racial,Other Race,191,0,191
435796,Dehydration,ethnic,Not Hispanic or Latino,76,115,191
434376,Acute myocardial infarction of anterior wall,ethnic,Not Hispanic or Latino,173,18,191
433577,Hammer toe,racial,Unknown,97,94,191
255848,Pneumonia,racial,Black or African American ,71,120,191
192367,Dysplasia of cervix,racial,White,191,0,191
193530,Follicular cyst of ovary,ethnic,Hispanic or Latino,191,0,191
138389,Benign neoplasm of scalp and skin of neck,ethnic,Hispanic or Latino,117,74,191
4326601,Anorectal abscess,racial,White,74,117,191
4066376,Pilonidal sinus with abscess,ethnic,Hispanic or Latino,99,92,191
4228802,Mild recurrent major depression,racial,Other Race,179,12,191
374040,Ill-defined disorder of eye,ethnic,Hispanic or Latino,122,69,191
432741,Abnormal immunology finding,racial,Unknown,156,35,191
434494,Closed fracture of the proximal humerus,racial,White,108,83,191
75091,Closed fracture of carpal bone,racial,White,115,76,191
435534,"Nondependent alcohol abuse, continuous",ethnic,Not Hispanic or Latino,74,117,191
194913,Idiopathic peripheral autonomic neuropathy,racial,Asian,189,0,189
4161978,Patient on oxygen,racial,Unknown,106,83,189
443783,Chronic disease,racial,Other Race,117,71,188
373503,Intermittent cerebral ischaemia,racial,Other Race,179,9,188
256717,Bronchospasm,racial,Unknown,145,44,189
201894,Acute intestinal vascular insufficiency,ethnic,Hispanic or Latino,2,186,188
78219,Cellulitis and abscess of hand excluding digits,racial,White,71,117,188
4194160,Thyroid function tests abnormal,racial,Unknown,150,39,189
76685,MG - Myasthenia gravis,racial,White,69,120,189
378135,Facial nerve disorder,ethnic,Hispanic or Latino,168,21,189
319041,Orthostatic hypotension,racial,Unknown,152,37,189
72778,Open wound of toe(s) without mention of complication,ethnic,Hispanic or Latino,108,81,189
375826,Central hearing loss,racial,White,117,71,188
256448,Chronic asthmatic bronchitis,racial,Black or African American ,14,175,189
437663,Fever,racial,Other Race,115,74,189
376979,Diabetic cataract,ethnic,Not Hispanic or Latino,108,81,189
77734,Contusion of lower leg,ethnic,Hispanic or Latino,143,46,189
75095,Closed fracture of ankle,racial,Unknown,117,71,188
81539,Mitochondrial disease,ethnic,Hispanic or Latino,85,104,189
255891,Lupus erythematosus,racial,White,166,23,189
194913,Idiopathic peripheral autonomic neuropathy,ethnic,Not Hispanic or Latino,189,0,189
440814,Torticollis,ethnic,Hispanic or Latino,87,101,188
192675,Biliary cirrhosis,ethnic,Hispanic or Latino,156,32,188
4062484,Cervical neoplasia screening,racial,Black or African American ,189,0,189
194995,Disorder of ureter,ethnic,Hispanic or Latino,138,51,189
443537,Deep venous thrombosis of lower extremity,racial,Other Race,99,87,186
192359,RF - Renal failure,racial,Unknown,108,78,186
40479575,Dysphasia as late effect of cerebrovascular disease,racial,Unknown,156,30,186
443238,Diabetic - poor control,racial,Black or African American ,71,115,186
40484522,Hemiplegia of dominant side as late effect of cerebrovascular disease,racial,Black or African American ,0,186,186
4173811,Congenital quadriplegia,racial,White,37,150,187
78237,Bicipital tenosynovitis,racial,White,108,78,186
196165,Cervical intraepithelial neoplasia grade 2,ethnic,Hispanic or Latino,186,0,186
433095,Fall on or from steps,ethnic,Hispanic or Latino,122,64,186
135893,Decubitus ulcer of heel,racial,Unknown,120,67,187
197378,Overflow incontinence of urine,ethnic,Hispanic or Latino,138,48,186
78497,Cellulitis and abscess of toe,racial,Unknown,117,69,186
377279,"Profound impairment, one eye",ethnic,Not Hispanic or Latino,62,124,186
432923,SAH - Subarachnoid haemorrhage,ethnic,Hispanic or Latino,159,28,187
200485,Decubitus ulcer of buttock,racial,White,99,87,186
4201390,Colostomy present,racial,Unknown,133,53,186
438536,Congenital anomaly of jaw,racial,White,55,131,186
141663,Osteomyelitis,racial,White,60,127,187
199744,Carcinoma liver and/or biliary system,ethnic,Hispanic or Latino,127,60,187
75863,Chronic interstitial cystitis,racial,White,186,0,186
140648,Onychomycosis due to dermatophyte,racial,Black or African American ,53,133,186
314379,First degree atrioventricular block,ethnic,Hispanic or Latino,94,92,186
135333,Pressure sore,ethnic,Hispanic or Latino,120,67,187
257905,Mucopurulent chronic bronchitis,ethnic,Hispanic or Latino,166,21,187
137829,Erythroid aplasia,ethnic,Hispanic or Latino,156,30,186
441092,Advanced maternal age gravida,racial,Unknown,184,0,184
436944,Chronic paranoid schizophrenia,racial,Unknown,113,71,184
376400,Combined form of senile cataract,ethnic,Not Hispanic or Latino,87,97,184
444202,Abscess,racial,Other Race,94,90,184
440374,Obsessive compulsive disorder,racial,White,48,136,184
198846,Enthesopathy of hip region,ethnic,Hispanic or Latino,133,51,184
73564,Complete rupture of rotator cuff,racial,White,150,35,185
316999,Cardiac arrhythmia,racial,Black or African American ,170,14,184
195596,Chronic pancreatitis,ethnic,Not Hispanic or Latino,62,122,184
377575,Tinnitus,ethnic,Not Hispanic or Latino,71,113,184
442597,Meteorism,ethnic,Hispanic or Latino,173,12,185
437175,"Fall on same level from slipping, tripping or stumbling",racial,White,145,39,184
201894,Acute intestinal vascular insufficiency,racial,Unknown,2,182,184
73571,Pathological fracture,ethnic,Hispanic or Latino,101,83,184
259865,Cyst of Bartholin's gland duct,ethnic,Hispanic or Latino,184,0,184
196163,Cervicitis and endocervicitis,ethnic,Hispanic or Latino,184,0,184
4028716,Idiopathic thrombocythemia,racial,White,133,51,184
78831,Disease of ankle,ethnic,Hispanic or Latino,131,53,184
442623,Abrasion AND/OR friction burn of scalp without infection,ethnic,Hispanic or Latino,76,108,184
439147,Amnesia,racial,Black or African American ,182,2,184
374034,Visual disturbance,racial,Other Race,99,85,184
380038,Viral conjunctivitis,racial,White,122,62,184
197484,Diarrhea of presumed infectious origin,ethnic,Hispanic or Latino,113,71,184
314971,Chronic respiratory failure,racial,White,81,104,185
4109880,Varicose veins of the leg with ulcer,racial,Unknown,83,99,182
443878,Injury of superior mesenteric artery,ethnic,Hispanic or Latino,0,182,182
434016,"Nondependent opioid abuse, continuous",racial,White,74,108,182
200845,Urinary precipitancy,racial,Unknown,124,58,182
438134,Excessive sleep,ethnic,Hispanic or Latino,110,71,181
443344,Barrett esophagus,racial,Unknown,51,131,182
321587,Bilateral bundle branch block,ethnic,Hispanic or Latino,177,5,182
137967,"Muscle, ligament and fascia disorders",ethnic,Hispanic or Latino,113,69,182
30978,Hereditary leptocytosis,racial,White,117,64,181
4150307,Dental restoration observation,racial,White,133,48,181
435933,Closed fracture of lumbar vertebra without spinal cord injury,ethnic,Not Hispanic or Latino,64,117,181
317002,Hypopiesis,ethnic,Not Hispanic or Latino,62,120,182
4048191,Enlargement of tonsil or adenoid,racial,White,67,115,182
434462,VSD - Ventricular septal defect,racial,White,62,120,182
4050572,Implantation of automatic cardiac defibrillator,ethnic,Not Hispanic or Latino,62,120,182
196858,Late effect of fracture of neck of femur,ethnic,Hispanic or Latino,182,0,182
315831,Chronic pulmonary heart disease,racial,White,140,41,181
139902,Allergic urticaria,racial,Unknown,113,69,182
379010,Macular retinal puckering,ethnic,Hispanic or Latino,150,32,182
200483,Disease of pelvis,ethnic,Hispanic or Latino,136,46,182
443878,Injury of superior mesenteric artery,racial,Unknown,0,182,182
255891,Lupus erythematosus,ethnic,Hispanic or Latino,173,9,182
381270,Parkinson's disease,racial,Other Race,23,159,182
201826,Type 2 diabetes mellitus,racial,American Indian,113,69,182
376979,Diabetic cataract,racial,Other Race,166,16,182
436677,"Brief situational non-psychotic disorder, NOS",racial,White,104,78,182
444239,Postprocedural state finding,racial,Asian,124,58,182
433942,Accident whilst engaged in household activity,racial,Unknown,138,44,182
80767,Breast irregular nodularity,racial,Asian,182,0,182
433033,Abnormal cervical Papanicolaou smear,ethnic,Hispanic or Latino,182,0,182
78473,Solitary cyst of breast,racial,Unknown,182,0,182
4064377,Depression screening,racial,Native Hawaiian or Other Pacific Islander ,110,71,181
193326,Urge incontinence of urine,ethnic,Not Hispanic or Latino,133,46,179
381444,Black eye,ethnic,Hispanic or Latino,90,90,180
315296,Preinfarction syndrome,ethnic,Hispanic or Latino,78,101,179
135772,Goiter,racial,Unknown,154,25,179
4307254,Closed fracture,racial,White,108,71,179
133228,Dental caries,racial,Other Race,94,85,179
258453,Acute upper respiratory infection of multiple sites,ethnic,Hispanic or Latino,115,64,179
76786,Derangement of knee,racial,Black or African American ,94,85,179
441918,"Emotional AND/OR mental disease in mother complicating pregnancy, childbirth AND/OR puerperium",racial,White,175,5,180
4064377,Depression screening,racial,Filipino,110,69,179
81144,Sprain of medial collateral ligament of knee,racial,White,99,81,180
195977,Contusion of trunk,ethnic,Hispanic or Latino,117,62,179
435224,Leukopenia,racial,Unknown,156,23,179
434272,Varicella infection,ethnic,Hispanic or Latino,92,87,179
40480431,Speech and language developmental delay due to hearing loss,racial,White,30,150,180
376422,Mucopurulent conjunctivitis,racial,White,104,76,180
434016,"Nondependent opioid abuse, continuous",ethnic,Not Hispanic or Latino,122,58,180
199062,"Acute gastric ulcer without hemorrhage, without perforation AND without obstruction",ethnic,Hispanic or Latino,133,46,179
4185471,Disorder of pigmentation,racial,White,122,58,180
196858,Late effect of fracture of neck of femur,racial,Unknown,179,0,179
376686,Polyneuropathy associated with another disorder,racial,Unknown,90,90,180
198124,Disorder of kidney,racial,Other Race,136,44,180
198075,Venereal wart,ethnic,Not Hispanic or Latino,64,115,179
254443,Sicca syndrome,racial,Unknown,124,55,179
373852,Neuralgia,ethnic,Not Hispanic or Latino,120,60,180
439120,Aseptic necrosis of head AND/OR neck of femur,racial,White,58,122,180
4064925,Hypertension screening,ethnic,Hispanic or Latino,129,51,180
436336,Herpes zoster with nervous system complication,racial,White,78,101,179
432881,Pancytopenia,racial,Unknown,122,58,180
137820,Postoperative hypothyroidism,racial,White,138,41,179
133729,Hyperparathyroidism,ethnic,Not Hispanic or Latino,110,69,179
375281,Acute suppurative otitis media - tympanic membrane intact,racial,Other Race,113,67,180
377821,Neurological disorder associated with type I diabetes mellitus,ethnic,Not Hispanic or Latino,113,67,180
436839,Closed fracture of metacarpal bone,racial,White,55,122,177
81984,Sprain of shoulder and upper arm,ethnic,Not Hispanic or Latino,122,55,177
314665,Atrial flutter,ethnic,Not Hispanic or Latino,60,117,177
136496,Cellulitis and abscess of face,racial,Unknown,78,99,177
440029,Viral disease,racial,Other Race,90,87,177
377888,CHL - Conductive hearing loss,ethnic,Not Hispanic or Latino,99,78,177
376680,Generalized nonconvulsive epilepsy,racial,Unknown,177,0,177
439251,"Bipolar affective disorder, currently depressed, in full remission",racial,Unknown,177,0,177
22340,Esophageal varices without bleeding,racial,White,106,71,177
438688,Sarcoidosis,racial,Unknown,177,0,177
377861,Disorder of refraction AND/OR accommodation,racial,Black or African American ,87,90,177
73341,Closed fracture of head of radius,ethnic,Hispanic or Latino,117,60,177
437038,Blood in urine,racial,Asian,76,101,177
201131,Pelvic mass,ethnic,Not Hispanic or Latino,138,39,177
80573,Contusion of ankle,racial,White,94,83,177
199878,Light and infrequent menstruation,racial,White,170,7,177
439937,C-reactive protein abnormal,racial,White,127,51,178
132740,Positive skin test reaction,racial,Other Race,127,51,178
318174,Phlebitis,ethnic,Hispanic or Latino,5,173,178
136760,Transient hypertension of pregnancy - not delivered,racial,White,175,2,177
374923,Bell palsy,ethnic,Not Hispanic or Latino,108,69,177
4060985,BMI 30+ - obesity,racial,Native Hawaiian or Other Pacific Islander ,97,81,178
75095,Closed fracture of ankle,ethnic,Not Hispanic or Latino,138,39,177
135287,Non-neoplastic naevus,racial,Unknown,122,55,177
372309,Mononeuritis,racial,Black or African American ,14,163,177
380415,Acute swimmer's ear,racial,Unknown,113,64,177
198062,"Infectious colitis, enteritis and gastroenteritis",racial,White,81,97,178
193256,Alcoholic fatty liver,ethnic,Hispanic or Latino,23,154,177
315833,Secondary cardiomyopathy,racial,White,69,108,177
256716,Asthma with status asthmaticus,racial,White,87,90,177
381592,Chronic mucoid otitis media,racial,White,92,85,177
432517,Posttraumatic wound infection,racial,Unknown,78,99,177
435928,Abnormal decrease in weight,racial,Asian,94,83,177
376063,Benign neoplasm of cerebral meninges,ethnic,Hispanic or Latino,143,35,178
26935,Disorder of endocrine testis,racial,White,0,177,177
433750,"Single major depressive episode, in full remission",racial,Unknown,113,64,177
75650,Proteinuria,racial,Other Race,74,104,178
133853,Osteomyelitis of ankle AND/OR foot,ethnic,Hispanic or Latino,133,44,177
134441,Chronic ulcer of skin,racial,Other Race,14,163,177
75337,Cellulitis and abscess of buttock,ethnic,Not Hispanic or Latino,108,69,177
254387,Upper respiratory tract hypersensitivity reaction,ethnic,Not Hispanic or Latino,76,101,177
137951,Acquired keratoderma,ethnic,Hispanic or Latino,150,28,178
81379,Lateral epicondylitis,racial,Unknown,108,69,177
195501,Polycystic ovaries,ethnic,Not Hispanic or Latino,175,2,177
40482247,Organic sleep apnea,racial,Unknown,177,0,177
4084229,Primary gout,ethnic,Not Hispanic or Latino,32,143,175
437891,PPHT - Primary pulmonary hypertension,ethnic,Hispanic or Latino,173,2,175
133424,Primary malignant neoplasm of thyroid gland,racial,White,143,32,175
199074,Acute pancreatitis,racial,Unknown,97,78,175
81426,Closed fracture of clavicle,racial,White,74,101,175
440377,Paralysis,racial,Unknown,173,2,175
79833,Meniere's disease,racial,White,161,14,175
318736,Migraine,racial,Asian,163,12,175
194018,"Functional enuresis, NOS",racial,White,37,138,175
441284,Open-angle glaucoma,racial,White,115,60,175
374317,Alcohol-induced psychosis,racial,Unknown,99,76,175
138519,Spondylosis without myelopathy,racial,White,161,14,175
321314,Abdominal aortic aneurysm without rupture,racial,White,41,133,174
439224,Drug allergy,racial,White,71,104,175
312723,Congenital heart disease,ethnic,Not Hispanic or Latino,81,94,175
4012570,High risk sexual behavior,racial,White,106,69,175
79127,Congenital spondylolisthesis,ethnic,Hispanic or Latino,138,37,175
257007,Allergic rhinitis,racial,Filipino,92,83,175
40491340,Closed fracture of tibia,ethnic,Hispanic or Latino,131,44,175
200445,Chronic prostatitis,racial,Unknown,0,175,175
376686,Polyneuropathy associated with another disorder,racial,White,108,67,175
78832,Intervertebral disc disorder with myelopathy,ethnic,Not Hispanic or Latino,37,138,175
434500,Closed fracture of neck of femur,racial,Unknown,87,87,174
73090,Superficial bruising of foot,racial,White,97,78,175
432741,Abnormal immunology finding,ethnic,Not Hispanic or Latino,129,46,175
80951,Candidiasis of urogenital site,ethnic,Not Hispanic or Latino,81,94,175
4179214,Family history of malignant neoplasm of gastrointestinal tract,ethnic,Hispanic or Latino,117,58,175
196061,Benign tumour of stomach,ethnic,Not Hispanic or Latino,173,0,173
196165,Cervical intraepithelial neoplasia grade 2,racial,White,173,0,173
40480435,Spastic hemiplegia of nondominant side,ethnic,Hispanic or Latino,156,16,172
256716,Asthma with status asthmaticus,ethnic,Hispanic or Latino,85,87,172
434172,Insomnia with sleep apnoea,racial,Asian,90,83,173
80187,Medial epicondylitis,racial,White,101,71,172
381295,Age-related cataract,ethnic,Not Hispanic or Latino,138,35,173
375806,Idiopathic peripheral neuropathy,racial,Asian,140,32,172
437992,Abnormal results of kidney function studies,racial,White,71,101,172
4147961,Screening for malignant neoplasm of breast,racial,American Indian or Alaska Native ,173,0,173
441264,Primary thrombocytopenia,racial,Unknown,78,94,172
442615,Carotid artery stenosis,ethnic,Not Hispanic or Latino,110,62,172
197494,Viral hepatitis C,racial,Unknown,104,69,173
320746,Cardiomyopathy associated with another disorder,racial,White,67,106,173
4263748,Recurrent major depression in complete remission,racial,Unknown,39,133,172
4261613,Educational problem,ethnic,Hispanic or Latino,62,110,172
376124,Pinguecula,ethnic,Hispanic or Latino,99,74,173
376961,Disturbance of consciousness,racial,Unknown,104,69,173
4108533,Unspecified otalgia,racial,White,115,58,173
260131,Bronchial disorder,ethnic,Hispanic or Latino,110,62,172
194083,Vaginitis and vulvovaginitis,racial,Asian,173,0,173
196061,Benign tumour of stomach,racial,Asian,170,2,172
77421,Open wound of hand except fingers without complication,racial,White,74,99,173
376208,Soft tissue disorder,ethnic,Hispanic or Latino,81,92,173
197036,Vesicoureteral reflux,ethnic,Hispanic or Latino,99,74,173
440424,Aphasia,racial,White,115,58,173
194175,Left upper quadrant pain,ethnic,Not Hispanic or Latino,108,64,172
72737,Microcalcifications of the breast,racial,White,168,5,173
434164,Glycosuria,racial,White,115,58,173
77030,Disease of breast,ethnic,Not Hispanic or Latino,173,0,173
437541,Glaucoma,racial,Black or African American ,140,32,172
80004,Hand injury,ethnic,Hispanic or Latino,85,87,172
434752,Positive serological AND/OR viral culture findings for human immunodeficiency virus,ethnic,Not Hispanic or Latino,28,145,173
201688,Urinary hesitancy,ethnic,Hispanic or Latino,60,113,173
440358,Lipoma,racial,Unknown,99,71,170
4273095,Acute tracheitis without obstruction,racial,White,23,147,170
381581,Chalazion,racial,Unknown,85,85,170
132393,Pressure ulcer stage 1,ethnic,Hispanic or Latino,90,81,171
4201387,Tracheostomy in situ,ethnic,Not Hispanic or Latino,120,51,171
443790,Multi-infarct dementia with delusions,racial,Unknown,136,35,171
78272,Sprain of wrist,ethnic,Not Hispanic or Latino,101,69,170
4059157,Family circumstance NOS,ethnic,Hispanic or Latino,120,51,171
440279,Accident,ethnic,Hispanic or Latino,90,81,171
433811,Hydronephrosis,racial,Unknown,101,69,170
373786,Abnormal vision,ethnic,Hispanic or Latino,58,113,171
443677,Open wound of knee and/or leg and/or ankle,racial,White,71,99,170
135923,CP - Cleft palate,ethnic,Hispanic or Latino,69,101,170
4210149,Substance abuse counseling,ethnic,Not Hispanic or Latino,78,92,170
133551,Vesicular eczema of hands and/or feet,ethnic,Hispanic or Latino,110,60,170
140259,Open wound of face without complication,ethnic,Hispanic or Latino,51,120,171
194152,Renal agenesis and dysgenesis,ethnic,Hispanic or Latino,120,51,171
318174,Phlebitis,racial,White,0,170,170
4103723,Other refraction and accommodation disorders,racial,White,136,35,171
434153,Chromosomopathy,racial,White,67,104,171
4252735,Mourning,ethnic,Not Hispanic or Latino,152,18,170
254591,Secondary malignant tumour of lung,ethnic,Hispanic or Latino,62,108,170
40485064,Latent syphilis,racial,Unknown,90,81,171
194411,Unilateral simple inguinal hernia,racial,Other Race,0,170,170
201621,Chronic cystitis,racial,White,152,18,170
29056,Sialoadenitis,ethnic,Hispanic or Latino,87,83,170
443409,On examination - left lower abdominal mass,ethnic,Hispanic or Latino,154,14,168
78529,Kyphoscoliosis and scoliosis,ethnic,Hispanic or Latino,78,90,168
201606,Crohn's disease,racial,White,106,62,168
26727,Vomiting blood,ethnic,Hispanic or Latino,85,83,168
4245252,Raised prostate specific antigen,racial,Other Race,0,168,168
439706,Psychosis with origin in childhood,racial,White,7,161,168
197318,Cholesterolosis of gallbladder,ethnic,Hispanic or Latino,101,67,168
4110815,"Sensorineural hearing loss, bilateral",racial,White,101,67,168
436238,Elevated levels of transaminase and lactic acid dehydrogenase,racial,Black or African American ,37,131,168
375415,Injury of head region,racial,Unknown,99,69,168
198678,Intestinal infectious disease,ethnic,Not Hispanic or Latino,78,90,168
440695,Encopresis,ethnic,Hispanic or Latino,46,122,168
441840,Clinical finding,racial,Unknown,120,48,168
373478,Presbyopia,racial,Asian,71,97,168
374028,AAMD - Age related macular degeneration,ethnic,Not Hispanic or Latino,67,101,168
4273095,Acute tracheitis without obstruction,ethnic,Hispanic or Latino,21,147,168
376966,Exudative age-related macular degeneration,ethnic,Hispanic or Latino,133,35,168
313459,Sleep apnea,racial,Black or African American ,87,81,168
4195572,"Mild major depression, single episode",racial,Asian,53,115,168
435651,Atypical squamous cells on cervical Papanicolaou smear cannot exclude high grade squamous intraepithelial lesion,racial,White,161,7,168
255573,Chronic obstructive lung disease,racial,American Indian or Alaska Native ,99,69,168
201909,Female infertility,racial,White,168,0,168
77987,Respiratory observations of chest,ethnic,Hispanic or Latino,99,69,168
374375,Impacted cerumen,racial,Black or African American ,97,71,168
201826,Type 2 diabetes mellitus,racial,Asian Indian,71,97,168
444132,Knee injury,ethnic,Not Hispanic or Latino,97,71,168
81931,Psoriasis with arthropathy,racial,White,106,62,168
201418,"Flatulence, eructation and gas pain",ethnic,Not Hispanic or Latino,120,48,168
444247,Venous thrombosis,racial,White,104,64,168
252365,MGN - Membranous glomerulonephritis,ethnic,Hispanic or Latino,131,37,168
441969,Radiology result abnormal,ethnic,Hispanic or Latino,101,64,165
433163,Deficiency of macronutrients,racial,Unknown,131,35,166
138113,Cyst of thyroid,racial,White,154,12,166
141305,Unilateral sensorineural hearing loss with unrestricted hearing on the contralateral side,ethnic,Hispanic or Latino,99,67,166
441258,Anemia in neoplastic disease,ethnic,Hispanic or Latino,161,5,166
23325,Heartburn,ethnic,Not Hispanic or Latino,76,90,166
441507,"Early latent syphilis, positive serology, negative cerebrospinal fluid, less than 2 years after infection",racial,White,2,163,165
432285,Recurrent major depressive episodes,racial,American Indian or Alaska Native ,154,12,166
26711,Chronic pharyngitis,racial,White,85,81,166
381001,Subjective visual disturbance,ethnic,Hispanic or Latino,150,16,166
443563,Arteriosclerosis in coronary artery bypass graft,ethnic,Not Hispanic or Latino,46,120,166
376965,Hypertensive retinopathy,ethnic,Hispanic or Latino,122,44,166
78228,Joint derangement,ethnic,Hispanic or Latino,69,97,166
435508,Adrenal cortical hypofunction,racial,Unknown,156,9,165
4147497,Nervous system and sense organ diseases,racial,White,108,58,166
437165,Motor vehicle traffic accident,racial,White,99,67,166
4016352,Tuberculosis contact,ethnic,Hispanic or Latino,106,60,166
435788,Disorder of phosphorus metabolism,ethnic,Hispanic or Latino,120,46,166
443865,Non-infective colitis,racial,Other Race,106,60,166
313219,Phlebitis and thrombophlebitis,ethnic,Hispanic or Latino,129,37,166
4084229,Primary gout,racial,Unknown,55,110,165
137945,Pressure ulcer stage 2,racial,Unknown,159,7,166
376224,Spina bifida without hydrocephalus,ethnic,Hispanic or Latino,74,92,166
4168213,Chest pain on breathing,ethnic,Not Hispanic or Latino,60,106,166
141095,Acne,racial,Black or African American ,81,85,166
438727,Atypical depressive disorder,racial,Unknown,131,35,166
435810,After-cataract,ethnic,Hispanic or Latino,110,55,165
40480435,Spastic hemiplegia of nondominant side,racial,Unknown,156,9,165
433031,Hallucinations,racial,Unknown,138,28,166
40481345,Monoplegia of upper limb of dominant side,racial,White,0,166,166
40481345,Monoplegia of upper limb of dominant side,ethnic,Hispanic or Latino,0,166,166
4179963,Family history of malignant neoplasm of breast,racial,White,161,2,163
256451,Bronchitis,racial,Black or African American ,113,51,164
432585,Blood coagulation disorder,racial,White,113,51,164
4046893,Lifestyle,racial,Unknown,94,69,163
4240902,Allergy to peanuts,ethnic,Hispanic or Latino,51,113,164
4216894,Precipitous drop in hematocrit,racial,Unknown,163,0,163
374357,Acquired stenosis of nasolacrimal duct,racial,White,101,62,163
438480,"Abnormal glucose tolerance in mother complicating pregnancy, childbirth AND/OR puerperium",racial,Unknown,163,0,163
258482,Abscess of Bartholin's gland,ethnic,Hispanic or Latino,163,0,163
28779,Oesophageal varices with bleeding,ethnic,Hispanic or Latino,69,94,163
26378,Hyperpituitarism,ethnic,Hispanic or Latino,152,12,164
140641,Verruca vulgaris,racial,Asian,78,85,163
140966,Benign neoplasm of skin of face,racial,White,83,81,164
378161,Disorder of ear,ethnic,Hispanic or Latino,113,51,164
78517,Arthralgia of multiple joints,racial,Other Race,124,39,163
4340379,Hepatitis B carrier,ethnic,Not Hispanic or Latino,60,104,164
380986,Senile dementia with delusion,racial,Asian,163,0,163
374924,Generalized convulsive epilepsy,racial,Black or African American ,23,140,163
434165,Abnormal cervical smear,ethnic,Not Hispanic or Latino,163,0,163
437753,Seen by surgical fitting - service,ethnic,Hispanic or Latino,163,0,163
4216894,Precipitous drop in hematocrit,ethnic,Hispanic or Latino,163,0,163
255919,Finding of head and neck region,racial,White,71,92,163
372608,Amnestic disorder,ethnic,Hispanic or Latino,163,0,163
441691,Atypical squamous cells of undetermined significance on vaginal Papanicolaou smear,ethnic,Hispanic or Latino,163,0,163
440233,Strain of supraspinatus muscle AND/OR tendon,ethnic,Hispanic or Latino,113,51,164
433069,Open wound of external genital organs with complication,ethnic,Not Hispanic or Latino,71,92,163
134324,Lipodystrophy,racial,White,16,147,163
376680,Generalized nonconvulsive epilepsy,ethnic,Hispanic or Latino,124,39,163
440905,Toxic effect of venom,racial,White,113,48,161
441258,Anemia in neoplastic disease,racial,Unknown,161,0,161
377910,Deviated nasal septum,racial,White,85,76,161
378425,Eyelid inflammation,ethnic,Not Hispanic or Latino,67,94,161
138604,"Contusion of face, scalp and neck, excluding eye(s)",racial,Unknown,74,87,161
377886,Chronic purulent otitis media,racial,White,60,101,161
4116452,Generalized osteoarthritis NOS,ethnic,Not Hispanic or Latino,127,35,162
194286,"Malignant neoplasm of corpus uteri, excluding isthmus",ethnic,Hispanic or Latino,161,0,161
316822,Finding of heart murmur,racial,Other Race,83,78,161
200845,Urinary precipitancy,ethnic,Not Hispanic or Latino,108,53,161
441542,Anxiety,racial,American Indian or Alaska Native ,53,108,161
314666,Healed coronary,racial,Other Race,104,58,162
440529,Abnormal findings on diagnostic imaging of urinary organs,racial,White,115,46,161
77310,Deep vein phlebitis and thrombophlebitis of the leg,racial,Unknown,78,83,161
192606,Paraplegia,ethnic,Not Hispanic or Latino,9,152,161
438406,"Major depressive disorder, single episode, severe with psychotic features",racial,Other Race,161,0,161
24609,Hypoglycaemia,ethnic,Not Hispanic or Latino,97,64,161
77066,Derangement of medial meniscus,racial,White,94,67,161
376120,"Keratoconjunctivitis sicca, not specified as Sjogren's",ethnic,Hispanic or Latino,150,12,162
76611,Injury of shoulder region,racial,Unknown,104,58,162
434005,Morbid obesity,racial,Native Hawaiian or Other Pacific Islander ,55,106,161
197381,Epigastric pain,racial,Other Race,94,67,161
443414,Chronic post-traumatic stress disorder,racial,Unknown,122,39,161
77354,Primary localised osteoarthrosis of lower leg,racial,Asian,85,76,161
256451,Bronchitis,racial,Asian,97,64,161
4147961,Screening for malignant neoplasm of breast,racial,Black or African American ,161,0,161
254061,Pleural effusion,racial,White,76,83,159
4296205,Second degree burn,ethnic,Hispanic or Latino,76,83,159
441840,Clinical finding,ethnic,Not Hispanic or Latino,122,37,159
376112,Diabetic polyneuropathy,racial,Native Hawaiian or Other Pacific Islander ,0,159,159
4179925,Basic learning problem,ethnic,Hispanic or Latino,58,101,159
80045,Primary malignant neoplasm of anus,racial,White,152,7,159
199913,Acquired deformity of ankle AND/OR foot,racial,White,85,74,159
201449,Unilateral traumatic amputation of leg below knee without complication,ethnic,Hispanic or Latino,147,12,159
442256,Disorder of bursae of shoulder region,ethnic,Not Hispanic or Latino,76,83,159
373852,Neuralgia,racial,Unknown,120,39,159
78162,Peripheral vertigo,ethnic,Hispanic or Latino,115,44,159
77403,Closed fracture of vertebral column without spinal cord injury,racial,White,85,74,159
435262,Primary open angle glaucoma,racial,White,104,55,159
199860,Hernia of abdominal cavity,racial,Unknown,85,74,159
134324,Lipodystrophy,ethnic,Hispanic or Latino,14,145,159
437251,Benign neoplasm of pituitary gland and craniopharyngeal duct,ethnic,Not Hispanic or Latino,44,115,159
133280,Alopecia,ethnic,Not Hispanic or Latino,85,74,159
434972,Developmental abnormality of tooth size and form,ethnic,Hispanic or Latino,106,53,159
197676,Hepatomegaly,racial,Unknown,133,25,158
440647,Sexually transmitted infectious disease,ethnic,Hispanic or Latino,71,87,158
73300,Radial styloid tenosynovitis,ethnic,Hispanic or Latino,131,28,159
443563,Arteriosclerosis in coronary artery bypass graft,racial,White,44,115,159
198846,Enthesopathy of hip region,racial,White,136,23,159
255348,Polymyalgia rheumatica,ethnic,Hispanic or Latino,124,35,159
198995,Type 1 diabetes mellitus - poor control,racial,Filipino,81,78,159
433315,Feeding difficulties in newborn,racial,White,46,113,159
138821,Seborrhea,racial,White,55,104,159
437541,Glaucoma,racial,Other Race,133,25,158
433507,Loss of teeth due to local periodontal disease,ethnic,Hispanic or Latino,0,159,159
77340,Genitourinary tract infection in pregnancy,racial,White,156,2,158
4154309,Severe recurrent major depression with psychotic features,racial,Unknown,147,12,159
136496,Cellulitis and abscess of face,ethnic,Not Hispanic or Latino,85,74,159
80816,Intervertebral disc degeneration,racial,Unknown,83,76,159
440374,Obsessive compulsive disorder,ethnic,Not Hispanic or Latino,85,71,156
437382,Urine observation,racial,Asian,131,25,156
4062636,Bacterial disease screening,ethnic,Not Hispanic or Latino,147,9,156
76506,Effusion of joint of lower leg,racial,White,104,53,157
261687,Hemoptysis,racial,White,90,67,157
443524,Mixed incontinence,racial,Black or African American ,156,0,156
136198,Cervical spondylosis with myelopathy,ethnic,Hispanic or Latino,92,64,156
321314,Abdominal aortic aneurysm without rupture,ethnic,Not Hispanic or Latino,32,124,156
4066376,Pilonidal sinus with abscess,racial,White,81,76,157
443728,Mass of chest wall,ethnic,Not Hispanic or Latino,90,67,157
4171556,Ankle ulcer,racial,Unknown,124,32,156
4094448,Pregnancy test negative,ethnic,Not Hispanic or Latino,154,2,156
444413,Pyrexial convulsion,racial,White,81,76,157
376103,Retinopathy,racial,Unknown,101,55,156
4239301,Unwanted pregnancy,racial,White,156,0,156
201606,Crohn's disease,ethnic,Hispanic or Latino,99,58,157
4142479,Hyperthyroidism,ethnic,Hispanic or Latino,90,67,157
380096,Proliferative diabetic retinopathy,ethnic,Not Hispanic or Latino,76,81,157
436677,"Brief situational non-psychotic disorder, NOS",racial,Black or African American ,5,152,157
72469,Closed dislocation of shoulder region,ethnic,Hispanic or Latino,67,90,157
439166,Closed fracture of radius,ethnic,Hispanic or Latino,85,71,156
440083,Acute stress disorder,racial,Unknown,124,32,156
81186,Contusion of wrist,racial,White,136,21,157
4060985,BMI 30+ - obesity,racial,American Indian,92,64,156
72778,Open wound of toe(s) without mention of complication,racial,White,101,55,156
255848,Pneumonia,racial,Other Race,81,76,157
316211,Acquired spondylolisthesis,racial,White,101,55,156
197795,Acute hepatitis B,ethnic,Hispanic or Latino,101,55,156
200450,Disease of urethra,ethnic,Hispanic or Latino,94,62,156
4152813,Family disruption,ethnic,Hispanic or Latino,78,78,156
193666,Hip injury,ethnic,Hispanic or Latino,110,46,156
4261613,Educational problem,racial,White,64,90,154
192242,Acute hepatitis C,racial,Unknown,30,124,154
193807,Anorectal fistula,ethnic,Hispanic or Latino,30,124,154
4292726,Contact - infectious disease,ethnic,Not Hispanic or Latino,74,81,155
137829,Erythroid aplasia,racial,Unknown,147,7,154
432295,Pernicious anemia,racial,White,51,104,155
198995,Type 1 diabetes mellitus - poor control,racial,American Indian or Alaska Native ,110,44,154
4196960,Varicocele,ethnic,Hispanic or Latino,5,150,155
376103,Retinopathy,racial,White,85,69,154
436962,Sleeplessness,racial,Asian Indian,150,5,155
435082,Closed fracture nasal bone,racial,White,90,64,154
440519,Premature - weight 1000g-2499g or gestation of 28-37weeks,ethnic,Hispanic or Latino,81,74,155
440921,Traumatic injury,ethnic,Hispanic or Latino,87,67,154
196436,Internal haemorrhoid,ethnic,Hispanic or Latino,67,87,154
78236,Muscle wasting disorder,racial,White,39,115,154
4103638,Amputated - transfemoral,ethnic,Hispanic or Latino,69,85,154
376663,Vitamin A deficiency with conjunctival xerosis,ethnic,Hispanic or Latino,154,0,154
198101,Lipoma of skin and subcutaneous tissue (excluding face),racial,Unknown,87,67,154
379019,Inflammation of conjunctiva,racial,Asian,94,60,154
4104853,Epileptic seizures - clonic,ethnic,Hispanic or Latino,99,55,154
252658,Intrinsic asthma without status asthmaticus,racial,White,92,62,154
435171,Allergic state,racial,Black or African American ,122,32,154
30978,Hereditary leptocytosis,ethnic,Not Hispanic or Latino,129,25,154
75650,Proteinuria,racial,Asian,78,76,154
433507,Loss of teeth due to local periodontal disease,racial,White,0,154,154
4112816,Other respiratory system diseases,ethnic,Hispanic or Latino,67,87,154
442588,OSA - Obstructive sleep apnoea,racial,Other Race,21,133,154
316998,Left bundle branch block,racial,Unknown,99,55,154
438460,Edentulous alveolar ridge atrophy,racial,Unknown,113,41,154
316127,Vitreous opacities,ethnic,Hispanic or Latino,108,46,154
437986,FTT - Failure to thrive,racial,Unknown,76,78,154
135027,"Carbuncle of leg, except foot",ethnic,Hispanic or Latino,78,76,154
376663,Vitamin A deficiency with conjunctival xerosis,racial,Unknown,154,0,154
432585,Blood coagulation disorder,racial,Other Race,0,154,154
4114314,Screening for osteoporosis,racial,Other Race,150,2,152
433822,Complication related to pregnancy,ethnic,Hispanic or Latino,152,0,152
141932,Senile hyperkeratosis,ethnic,Not Hispanic or Latino,94,58,152
134159,Precordial pain,racial,Unknown,92,60,152
4030270,Proliferative polycythemia,racial,White,120,32,152
4014230,Ankle sprain NOS,ethnic,Hispanic or Latino,60,92,152
201072,Benign prostatic hypertrophy without outflow obstruction,ethnic,Hispanic or Latino,0,152,152
135893,Decubitus ulcer of heel,racial,White,147,5,152
4088920,Womb absent,ethnic,Not Hispanic or Latino,152,0,152
440029,Viral disease,racial,Black or African American ,71,81,152
137967,"Muscle, ligament and fascia disorders",racial,White,99,53,152
141213,Scarlet fever,racial,White,81,71,152
74396,TMJ - Temporomandibular joint disorder,racial,Unknown,124,28,152
81112,Arthralgia of the lower leg,racial,American Indian or Alaska Native ,140,12,152
318397,Chronic idiopathic thrombocytopenic purpura,ethnic,Hispanic or Latino,78,74,152
436209,Fracture of fibula,ethnic,Hispanic or Latino,113,39,152
432791,Urticaria-angio-oedema,racial,White,85,67,152
4066820,Ingestion dermatitis due to food,ethnic,Hispanic or Latino,101,51,152
259043,Emphysematous bleb of lung,ethnic,Hispanic or Latino,150,2,152
134144,Cleft palate with cleft lip,ethnic,Hispanic or Latino,53,99,152
75637,Acquired postural kyphosis,racial,White,145,7,152
432453,General clinical state finding,racial,White,97,55,152
78605,Superficial bruising of elbow,ethnic,Hispanic or Latino,85,67,152
78832,Intervertebral disc disorder with myelopathy,racial,Black or African American ,23,129,152
440985,Phobia,ethnic,Hispanic or Latino,143,9,152
444132,Knee injury,racial,Unknown,97,55,152
442306,Adjustment disorder with depressed mood,racial,Other Race,122,30,152
201070,Cholelithiasis AND cholecystitis without obstruction,ethnic,Not Hispanic or Latino,150,2,152
443876,Obsessive compulsive personality disorder,racial,Unknown,152,0,152
438398,Leukocytosis,ethnic,Not Hispanic or Latino,71,81,152
75911,Acquired hallux valgus,racial,Unknown,117,35,152
433701,Mycosis,ethnic,Hispanic or Latino,92,60,152
140821,Spasm,racial,Asian,78,74,152
193807,Anorectal fistula,racial,White,18,133,151
434821,SIRS - System inflammatory response syndrome,racial,White,85,64,149
440953,Cysticercosis,ethnic,Hispanic or Latino,129,21,150
438567,Adult failure to thrive syndrome,racial,Other Race,150,0,150
197724,Unilateral traumatic amputation of foot without complication,ethnic,Hispanic or Latino,136,14,150
435950,Closed Colles' fracture,ethnic,Hispanic or Latino,129,21,150
141371,PR - Pityriasis rosea,ethnic,Hispanic or Latino,87,62,149
432801,"Injury undetermined whether accidentally or purposely inflicted, fall from natural site",ethnic,Hispanic or Latino,122,28,150
197950,Cellulitis and abscess of trunk,ethnic,Not Hispanic or Latino,92,58,150
134671,Dental abscess without a sinus,racial,White,97,53,150
4179214,Family history of malignant neoplasm of gastrointestinal tract,racial,White,117,32,149
437663,Fever,racial,Black or African American ,62,87,149
138225,Disease of sebaceous glands,ethnic,Hispanic or Latino,78,71,149
374919,Disseminated sclerosis,racial,Unknown,150,0,150
193787,Varicose veins of lower extremity with ulcer AND inflammation,ethnic,Hispanic or Latino,67,83,150
432585,Blood coagulation disorder,racial,Black or African American ,7,143,150
72993,Primary localised osteoarthrosis,ethnic,Not Hispanic or Latino,44,106,150
444246,Cirrhosis of liver not due to alcohol,racial,Other Race,150,0,150
201530,"Diabetes mellitus, adult onset, with hyperosmolar coma",ethnic,Hispanic or Latino,115,35,150
381017,Ametropic amblyopia,racial,Unknown,90,60,150
432941,Disease of tongue,ethnic,Hispanic or Latino,99,51,150
4168217,Generalized hyperhidrosis,racial,Unknown,117,32,149
195312,Functional voiding disorder,racial,Unknown,129,21,150
432541,Primary tuberculosis,racial,Asian Indian,150,0,150
441408,Vomiting,racial,Other Race,78,71,149
373766,Retinopathy of prematurity,racial,White,85,64,149
432541,Primary tuberculosis,ethnic,Not Hispanic or Latino,150,0,150
138519,Spondylosis without myelopathy,racial,Unknown,143,7,150
440977,Megaloblastic anemia due to folate deficiency,ethnic,Hispanic or Latino,87,62,149
80156,Asymptomatic bacteriuria in pregnancy,ethnic,Hispanic or Latino,150,0,150
259043,Emphysematous bleb of lung,racial,Other Race,150,0,150
201070,Cholelithiasis AND cholecystitis without obstruction,racial,Asian,150,0,150
254662,Pulmonary infarction,racial,Unknown,122,28,150
374036,Chronic conjunctivitis,ethnic,Hispanic or Latino,81,69,150
139188,Open wound of scalp without complication,racial,White,48,99,147
195590,Urethral stricture,ethnic,Hispanic or Latino,7,140,147
253797,Post-inflammatory pulmonary fibrosis,racial,Unknown,106,41,147
441701,Sprain of hip joint,racial,White,92,55,147
432967,Anemia during pregnancy - baby not yet delivered,ethnic,Not Hispanic or Latino,147,0,147
312950,IgE-mediated allergic asthma,racial,Asian Indian,147,0,147
432308,Mononeuritis of lower limb,racial,White,81,67,148
436445,Abrasion of teeth,racial,White,76,71,147
77638,Displacement of intervertebral disc without myelopathy,racial,White,113,35,148
201613,Chronic nonalcoholic liver disease,racial,Asian,106,41,147
437995,Closed ill-defined fractures of upper limb,ethnic,Hispanic or Latino,127,21,148
138389,Benign neoplasm of scalp and skin of neck,racial,White,90,58,148
74188,Closed fracture of rib,racial,Unknown,101,46,147
74114,Cellulitis and abscess of foot excluding toe,racial,Unknown,83,64,147
4196362,Genetic counselling,ethnic,Hispanic or Latino,138,9,147
435534,"Nondependent alcohol abuse, continuous",racial,Unknown,30,117,147
253815,Ulceration of vulva,ethnic,Hispanic or Latino,147,0,147
440922,Diabetic on insulin,racial,White,85,62,147
442623,Abrasion AND/OR friction burn of scalp without infection,racial,White,60,87,147
74729,Ganglion and synovial cyst,racial,Unknown,108,39,147
136934,Primary hyperparathyroidism,ethnic,Hispanic or Latino,104,44,148
377554,Hereditary peripheral neuropathy,racial,White,136,12,148
134452,Miners' elbow,ethnic,Hispanic or Latino,39,108,147
4103471,Observation of body mass index,racial,Asian Indian,94,53,147
439708,Disorders of initiating and maintaining sleep,racial,Other Race,97,51,148
443422,Scleroderma,racial,White,145,2,147
257004,Acute exacerbation of chronic obstructive airways disease,racial,Asian Indian,147,0,147
4029488,Hepatic encephalopathy,racial,Unknown,2,145,147
436246,Low libido,racial,White,30,117,147
433000,Patellar tendonitis,ethnic,Hispanic or Latino,64,83,147
4188027,Food allergy,racial,White,69,78,147
443115,Closed fracture finger proximal phalanx,ethnic,Hispanic or Latino,51,97,148
4062650,Malnutrition screening,racial,White,14,133,147
4062488,Thyroid disorder screening,ethnic,Hispanic or Latino,108,39,147
436812,Tongue tie,ethnic,Hispanic or Latino,16,131,147
433599,Abnormal biochemistry finding,racial,Unknown,101,46,147
80809,Rheumatoid arthritis,racial,Black or African American ,94,53,147
379801,Trigeminal neuralgia,racial,Unknown,133,14,147
433968,Candidiasis,ethnic,Not Hispanic or Latino,94,53,147
435227,Nutritional deficiency,racial,White,87,60,147
317309,Peripheral arterial occlusive disease,ethnic,Not Hispanic or Latino,71,76,147
201998,Unilateral traumatic amputation of leg at OR above knee without complication,ethnic,Hispanic or Latino,124,23,147
443577,Asymmetric sensorineural hearing loss,ethnic,Hispanic or Latino,97,51,148
444297,Vertiginous syndrome,racial,Unknown,140,7,147
443430,HPV - Human papillomavirus test positive,racial,Unknown,143,5,148
4145627,Biliary calculus,ethnic,Hispanic or Latino,133,14,147
432454,Excessive thirst,ethnic,Hispanic or Latino,64,83,147
439002,Eating disorder,ethnic,Hispanic or Latino,97,51,148
432595,Amyloidosis,ethnic,Hispanic or Latino,147,0,147
437891,PPHT - Primary pulmonary hypertension,racial,Unknown,145,2,147
141216,MC - Molluscum contagiosum,racial,Unknown,97,51,148
373724,Neoplasm of brain,racial,White,87,60,147
195588,Cystitis,racial,Unknown,143,5,148
138994,MDS - Myelodysplastic syndrome,ethnic,Hispanic or Latino,117,30,147
140259,Open wound of face without complication,racial,White,46,99,145
4062495,Glaucoma screening,racial,Unknown,124,21,145
30968,Diabetes insipidus,ethnic,Hispanic or Latino,94,51,145
4064377,Depression screening,racial,American Indian,90,55,145
438480,"Abnormal glucose tolerance in mother complicating pregnancy, childbirth AND/OR puerperium",ethnic,Not Hispanic or Latino,145,0,145
440358,Lipoma,ethnic,Not Hispanic or Latino,92,53,145
437390,Hypoxaemia,racial,Unknown,81,64,145
372886,Refractory migraine with aura,ethnic,Hispanic or Latino,136,9,145
75389,Current tear of lateral cartilage AND/OR meniscus of knee,racial,White,92,53,145
80568,Traumatic amputation of finger without mention of complication,ethnic,Hispanic or Latino,14,131,145
192676,Cervical intraepithelial neoplasia grade 1,racial,Unknown,145,0,145
81250,Carcinoma in situ of breast,ethnic,Hispanic or Latino,145,0,145
4062650,Malnutrition screening,ethnic,Hispanic or Latino,12,133,145
437251,Benign neoplasm of pituitary gland and craniopharyngeal duct,racial,Unknown,60,85,145
432739,Red blood cell disorder,ethnic,Hispanic or Latino,87,58,145
436446,Cracked tooth syndrome,ethnic,Hispanic or Latino,67,78,145
201519,Ca liver - primary,racial,White,2,143,145
376979,Diabetic cataract,racial,Asian,83,62,145
436882,[X]Fall involving bed,racial,Unknown,101,44,145
443587,Diastolic heart failure,ethnic,Not Hispanic or Latino,67,78,145
72748,Strain of rotator cuff of shoulder,racial,Unknown,106,39,145
79072,Inflammatory disorder of breast,racial,Unknown,131,14,145
321588,Heart disease,ethnic,Not Hispanic or Latino,21,124,145
80225,Sprain of ligament of lumbosacral joint,ethnic,Hispanic or Latino,74,71,145
4206460,Problem,ethnic,Not Hispanic or Latino,55,90,145
4280828,"Carrier, infectious agent",racial,White,99,46,145
198194,Female genital organ symptoms,racial,Other Race,145,0,145
378416,Retinal disorder,ethnic,Hispanic or Latino,110,32,142
4310768,Fall on steps,ethnic,Hispanic or Latino,110,32,142
440385,Obstructive hydrocephalus,ethnic,Hispanic or Latino,46,97,143
441264,Primary thrombocytopenia,ethnic,Not Hispanic or Latino,21,122,143
376525,Audiogram abnormal,ethnic,Hispanic or Latino,58,85,143
441628,Menopausal and postmenopausal disorders,ethnic,Not Hispanic or Latino,143,0,143
441830,Disorder of fluid AND/OR electrolyte,ethnic,Hispanic or Latino,81,62,143
436078,Malnutrition of moderate degree (Gomez: 60% to less than 75% of standard weight),ethnic,Hispanic or Latino,113,30,143
442793,Diabetic complication,racial,Asian,76,67,143
132397,Pilonidal cyst with no abscess,ethnic,Hispanic or Latino,28,115,143
141917,Balanitis xerotica obliterans,racial,Unknown,0,143,143
77025,Diverticulitis of colon,ethnic,Not Hispanic or Latino,69,74,143
444202,Abscess,racial,Asian,90,53,143
4104864,Migraine NOS,racial,White,117,25,142
80004,Hand injury,racial,White,69,74,143
194984,Hepatopathy,ethnic,Not Hispanic or Latino,87,55,142
312922,Coronary bypass graft observation,racial,Asian,58,85,143
440012,Fall from chair or bed,ethnic,Hispanic or Latino,104,39,143
443943,Herpes zoster,ethnic,Hispanic or Latino,62,81,143
138384,Acquired hypothyroidism,ethnic,Not Hispanic or Latino,81,62,143
377853,Chronic tension-type headache,ethnic,Hispanic or Latino,110,32,142
378424,Astigmatism,ethnic,Hispanic or Latino,87,55,142
444211,Disease of thigh,racial,Unknown,71,71,142
381591,Cerebrovascular disease,racial,Filipino,138,5,143
434339,Adolescent - emotional problem,ethnic,Hispanic or Latino,51,92,143
198683,Viral hepatitis B without hepatic coma,ethnic,Not Hispanic or Latino,71,71,142
138525,Pain in limb,racial,American Indian or Alaska Native ,129,14,143
314665,Atrial flutter,racial,Unknown,44,99,143
4158567,Post percutaneous transluminal coronary angioplasty,racial,Asian,32,110,142
30365,Panhypopituitarism,ethnic,Hispanic or Latino,108,35,143
195240,Monoplegia of lower limb,ethnic,Hispanic or Latino,124,18,142
4062484,Cervical neoplasia screening,racial,American Indian or Alaska Native ,140,0,140
433163,Deficiency of macronutrients,racial,White,108,32,140
141933,Alopecia areata,racial,White,83,58,141
192279,Diabetic nephropathy,racial,American Indian or Alaska Native ,140,0,140
433595,Interstitial edema,racial,American Indian or Alaska Native ,85,55,140
201899,Unilateral recurrent inguinal hernia,racial,Unknown,2,138,140
439081,Premenstrual tension syndrome,ethnic,Hispanic or Latino,140,0,140
74723,Arthropathy associated with a neurological disorder,ethnic,Hispanic or Latino,64,76,140
4152047,Lipid screening,racial,Unknown,108,32,140
443585,Abrasion AND/OR friction burn of multiple sites,racial,Unknown,62,78,140
441969,Radiology result abnormal,racial,White,92,48,140
137785,Verruca plantaris,ethnic,Not Hispanic or Latino,55,85,140
198715,Premature menopause,ethnic,Hispanic or Latino,140,0,140
76685,MG - Myasthenia gravis,ethnic,Not Hispanic or Latino,30,110,140
436155,Redundant prepuce and phimosis,ethnic,Not Hispanic or Latino,0,140,140
4152047,Lipid screening,ethnic,Not Hispanic or Latino,106,35,141
443774,"Disease condition determination, uncontrolled",ethnic,Hispanic or Latino,60,81,141
81611,Diverticular disease of colon,racial,Other Race,48,92,140
313217,Atrial fibrillation,racial,Native Hawaiian or Other Pacific Islander ,2,138,140
437233,Plasmacytic myeloma,racial,White,124,16,140
442077,Anxiety disorder,ethnic,Not Hispanic or Latino,81,60,141
137627,Prickly heat,racial,White,62,78,140
441428,Closed fracture of lateral malleolus,racial,White,101,39,140
433400,Emergency contraception,racial,Unknown,140,0,140
133857,Acquired deformity of limb,racial,White,62,78,140
73560,Calcaneal spur,ethnic,Not Hispanic or Latino,87,53,140
81378,Chondromalacia of patella,ethnic,Hispanic or Latino,83,58,141
4168213,Chest pain on breathing,racial,Unknown,97,44,141
4340379,Hepatitis B carrier,ethnic,Hispanic or Latino,76,64,140
4171434,Immunization refused,ethnic,Not Hispanic or Latino,99,41,140
316995,Coronary occlusion,ethnic,Hispanic or Latino,124,16,140
376680,Generalized nonconvulsive epilepsy,racial,White,108,32,140
138463,Oral aphthae,racial,Unknown,101,39,140
81893,Chronic ulcerative colitis,racial,Unknown,30,110,140
4245252,Raised prostate specific antigen,racial,Asian,0,138,138
4107655,Observations relating to psychosocial functioning,racial,Unknown,81,58,139
257907,Disorder of lung,racial,Asian,48,90,138
439697,Hypertensive renal disease with renal failure,racial,White,117,21,138
433596,Abnormal sputum,ethnic,Hispanic or Latino,87,51,138
73241,Anal and rectal polyp,racial,White,37,101,138
4103725,Refraction or accommodation disorder NOS,ethnic,Hispanic or Latino,81,58,139
436651,Hodgkin's disease of extranodal AND/OR solid organ site,ethnic,Hispanic or Latino,108,30,138
4146248,Rheumatoid arthritis and other inflammatory polyarthropathies,ethnic,Hispanic or Latino,122,16,138
79936,Polyuria,racial,Unknown,69,69,138
319826,Secondary hypertension,ethnic,Hispanic or Latino,138,0,138
198464,Incisional hernia,racial,White,106,32,138
444112,Integumentary system finding,racial,Unknown,69,69,138
443454,Cerebral infarction,racial,Black or African American ,124,14,138
75091,Closed fracture of carpal bone,racial,Unknown,101,37,138
379019,Inflammation of conjunctiva,racial,Other Race,78,60,138
314131,Degeneration of cervical intervertebral disc,racial,Unknown,90,48,138
4048727,Neoplasm screening,ethnic,Hispanic or Latino,67,71,138
435788,Disorder of phosphorus metabolism,racial,Unknown,97,41,138
195259,Entrapment of lateral cutaneous nerve of thigh,ethnic,Hispanic or Latino,104,35,139
381308,Abscess of eyelid,racial,White,83,55,138
136237,Cardiovascular system problem,racial,White,90,48,138
4012491,Difficulty chewing,racial,Unknown,97,41,138
197684,Dysuria,racial,American Indian or Alaska Native ,106,32,138
443580,Systolic heart failure,racial,White,60,78,138
441417,Lack of coordination,ethnic,Hispanic or Latino,85,53,138
435933,Closed fracture of lumbar vertebra without spinal cord injury,racial,Unknown,101,37,138
436944,Chronic paranoid schizophrenia,racial,White,28,110,138
377552,Moderate nonproliferative diabetic retinopathy,racial,White,32,106,138
78200,Benign mammary dysplasia,ethnic,Hispanic or Latino,136,2,138
440388,[X]Developmental co - ordination disorder,ethnic,Hispanic or Latino,25,113,138
441407,Appetite loss - anorexia,racial,Asian,74,64,138
133298,Musculoskeletal disorder of the neck,racial,Unknown,104,35,139
135923,CP - Cleft palate,racial,White,39,99,138
436230,Blood chemistry abnormal,racial,Other Race,99,39,138
4103725,Refraction or accommodation disorder NOS,racial,White,81,58,139
73840,Primary localised osteoarthrosis of shoulder region,racial,White,99,39,138
134870,Pityriasis versicolor,racial,Unknown,87,51,138
372914,Optic atrophy,racial,Unknown,92,46,138
316429,Ectopics,racial,White,74,64,138
192687,Vulvovaginitis associated with another disease,racial,White,136,0,136
4305589,"Neoplasm, benign",racial,White,104,32,136
139099,Ingrowing nail,racial,Other Race,53,83,136
444391,Pain around eye,racial,Unknown,94,41,135
436658,Vitamin deficiency,racial,Unknown,106,30,136
4175226,Screening for malignant neoplasm of colon,racial,Filipino,94,41,135
381859,Infective OE,racial,Other Race,67,69,136
443753,Abrasion AND/OR friction burn of wrist without infection,ethnic,Hispanic or Latino,51,85,136
313221,Rheumatic aortic stenosis,ethnic,Hispanic or Latino,115,21,136
437478,Bite of nonvenomous arthropod,ethnic,Not Hispanic or Latino,81,55,136
315078,Palpitations,racial,Other Race,108,28,136
141216,MC - Molluscum contagiosum,ethnic,Not Hispanic or Latino,44,92,136
40480002,Aphasia as late effect of cerebrovascular disease,racial,White,58,78,136
440695,Encopresis,racial,White,30,106,136
317893,Paroxysmal supraventricular tachycardia,ethnic,Not Hispanic or Latino,101,35,136
73008,Enthesopathy,ethnic,Not Hispanic or Latino,81,55,136
437478,Bite of nonvenomous arthropod,racial,Unknown,71,64,135
197304,Ulcer of lower limb,racial,Other Race,12,124,136
4142479,Hyperthyroidism,racial,White,74,62,136
433033,Abnormal cervical Papanicolaou smear,racial,White,136,0,136
80504,Acquired genu valgum,ethnic,Hispanic or Latino,87,48,135
380097,Diabetic macular edema,racial,White,74,62,136
140821,Spasm,racial,Black or African American ,81,55,136
434084,Abscess of vulva,ethnic,Hispanic or Latino,136,0,136
436670,MD - Metabolic disorders,racial,White,55,81,136
439221,"Adverse effect, due to correct medicinal substance properly administered",racial,Unknown,76,60,136
321689,Apneic,racial,White,41,94,135
437992,Abnormal results of kidney function studies,ethnic,Not Hispanic or Latino,41,94,135
137057,Paronychia,ethnic,Not Hispanic or Latino,90,46,136
194997,Prostatitis,racial,Unknown,0,136,136
133794,Chronic gingivitis,racial,Unknown,62,74,136
438527,"Juvenile osteochondrosis of lower extremity, excluding foot",racial,White,30,106,136
198075,Venereal wart,racial,Unknown,97,39,136
440374,Obsessive compulsive disorder,ethnic,Hispanic or Latino,46,90,136
198985,Primary malignant neoplasm of kidney,racial,Unknown,5,131,136
439406,Allergy to animal,racial,White,76,60,136
440814,Torticollis,racial,White,53,83,136
137682,Skin sensation disturbance,racial,Other Race,85,51,136
81378,Chondromalacia of patella,racial,White,97,37,134
437525,Overweight,racial,American Indian,85,48,133
4247802,Muscular dystrophy,racial,White,39,94,133
433000,Patellar tendonitis,racial,White,74,60,134
201449,Unilateral traumatic amputation of leg below knee without complication,ethnic,Not Hispanic or Latino,0,133,133
374027,Lesion of ulnar nerve,ethnic,Hispanic or Latino,35,99,134
433877,Finding of cerebrospinal fluid: chemical content - general,ethnic,Hispanic or Latino,133,0,133
4105330,Chronic undifferentiated schizophrenia,racial,Unknown,131,2,133
194574,Chronic type B viral hepatitis,racial,Asian,39,94,133
198978,Acute gonorrhea of lower genitourinary tract,ethnic,Hispanic or Latino,62,71,133
28457,Hypertrophy of tonsils,ethnic,Not Hispanic or Latino,53,81,134
73231,Arthralgia of temporomandibular joint,racial,White,99,35,134
440385,Obstructive hydrocephalus,racial,White,30,104,134
80951,Candidiasis of urogenital site,racial,Unknown,41,92,133
378135,Facial nerve disorder,racial,Unknown,133,0,133
257011,Acute upper respiratory infection,racial,Native Hawaiian or Other Pacific Islander ,37,97,134
437832,Malnutrition of mild degree (Gomez: 75% to less than 90% of standard weight),ethnic,Hispanic or Latino,117,16,133
79106,Arthralgia of the pelvic region and thigh,racial,Other Race,99,35,134
199067,Inflammatory disease of female pelvic organs AND/OR tissues,ethnic,Hispanic or Latino,133,0,133
4147466,Panic disorder with agoraphobia,ethnic,Hispanic or Latino,122,12,134
433877,Finding of cerebrospinal fluid: chemical content - general,racial,Other Race,133,0,133
440202,Multiple congenital malformations,ethnic,Hispanic or Latino,76,58,134
193512,Embolism and thrombosis of the renal vein,ethnic,Hispanic or Latino,110,23,133
80180,Osteoarthritis,racial,American Indian or Alaska Native ,108,25,133
73575,Deformity of toe,ethnic,Hispanic or Latino,69,64,133
440457,Threatened abortion,ethnic,Hispanic or Latino,133,0,133
373638,Superficial injury of cornea,racial,White,48,85,133
195862,Urethritis,ethnic,Hispanic or Latino,18,115,133
193512,Embolism and thrombosis of the renal vein,racial,White,110,23,133
432588,Megaloblastic anemia due to vitamin B>12< deficiency,racial,White,81,53,134
4252594,Subconjunctival injection,ethnic,Hispanic or Latino,76,58,134
377554,Hereditary peripheral neuropathy,ethnic,Not Hispanic or Latino,133,0,133
75637,Acquired postural kyphosis,racial,Unknown,122,12,134
441532,Monoclonal paraproteinaemia,ethnic,Hispanic or Latino,39,94,133
442116,Allergy to eggs,ethnic,Hispanic or Latino,44,90,134
432869,Hemorrhagic disorder due to circulating anticoagulants,ethnic,Not Hispanic or Latino,0,133,133
192956,Cholecystitis,racial,White,117,16,133
381295,Age-related cataract,racial,Asian,113,21,134
80225,Sprain of ligament of lumbosacral joint,racial,White,76,58,134
75863,Chronic interstitial cystitis,racial,Unknown,129,5,134
78235,Disorder of coccyx,racial,White,110,23,133
4112816,Other respiratory system diseases,racial,White,69,64,133
200783,Previous cesarean section,ethnic,Hispanic or Latino,133,0,133
434003,GSD - Glycogen storage disease,ethnic,Hispanic or Latino,131,2,133
440069,Drug dependence,ethnic,Not Hispanic or Latino,46,87,133
375549,Double pterygium,ethnic,Hispanic or Latino,62,71,133
74194,Back sprain,racial,White,74,60,134
432923,SAH - Subarachnoid haemorrhage,racial,Unknown,115,16,131
441788,Human papilloma virus infection,ethnic,Hispanic or Latino,117,14,131
435372,Underweight,ethnic,Not Hispanic or Latino,81,51,132
435783,Schizophrenia,racial,Other Race,23,108,131
378427,Tear film insufficiency,racial,Asian,94,37,131
4176874,Infantile melanodontia,ethnic,Hispanic or Latino,46,85,131
376966,Exudative age-related macular degeneration,racial,Unknown,113,18,131
77635,Disease of hand,ethnic,Not Hispanic or Latino,129,2,131
79884,Galactorrhea not associated with childbirth,racial,Unknown,131,0,131
442077,Anxiety disorder,racial,Unknown,124,7,131
381306,Deaf mutism,ethnic,Hispanic or Latino,106,25,131
4057825,Constipation NOS,racial,Unknown,85,46,131
437038,Blood in urine,racial,Other Race,110,21,131
4100857,Pickwickian syndrome,racial,Black or African American ,78,53,131
201605,Unilateral inguinal hernia with gangrene,racial,Other Race,0,131,131
432729,Crying infant,ethnic,Hispanic or Latino,41,90,131
372423,Reduction deformities of brain,racial,Unknown,120,12,132
372887,Disease of brain,ethnic,Hispanic or Latino,16,115,131
200970,CIS - Carcinoma in situ of prostate,ethnic,Hispanic or Latino,0,131,131
443350,Lower urinary tract symptoms,racial,Black or African American ,0,131,131
192438,Abdominal mass,racial,White,124,7,131
133569,Fasciitis,ethnic,Hispanic or Latino,85,46,131
259865,Cyst of Bartholin's gland duct,racial,White,127,5,132
433946,Fall on same level due to impact against another person,ethnic,Hispanic or Latino,81,51,132
197044,Female infertility associated with anovulation,ethnic,Hispanic or Latino,131,0,131
439081,Premenstrual tension syndrome,racial,White,127,5,132
437671,Abnormal feces,racial,Unknown,127,5,132
193688,Clostridium difficile infection,ethnic,Hispanic or Latino,51,81,132
442013,Burn,racial,Unknown,90,41,131
201605,Unilateral inguinal hernia with gangrene,ethnic,Hispanic or Latino,0,131,131
4059157,Family circumstance NOS,racial,White,92,39,131
201449,Unilateral traumatic amputation of leg below knee without complication,racial,Black or African American ,0,131,131
81539,Mitochondrial disease,racial,White,76,55,131
435933,Closed fracture of lumbar vertebra without spinal cord injury,racial,White,41,90,131
377254,"Multi-infarct dementia, uncomplicated",racial,Asian,76,55,131
195453,"Colitis, enteritis and gastroenteritis presumed infectious",ethnic,Not Hispanic or Latino,76,55,131
4062488,Thyroid disorder screening,racial,White,108,23,131
192239,Post-herpetic polyneuropathy,racial,White,90,41,131
4101602,Henoch-Schonlein purpura,ethnic,Hispanic or Latino,74,58,132
4144103,Influenza NOS,ethnic,Hispanic or Latino,81,48,129
313459,Sleep apnea,racial,Other Race,14,115,129
434003,GSD - Glycogen storage disease,racial,Unknown,129,0,129
376065,Neurologic disorder associated with type II diabetes mellitus,racial,Filipino,74,55,129
81902,Urinary tract infectious disease,racial,American Indian or Alaska Native ,120,9,129
194152,Renal agenesis and dysgenesis,racial,White,83,46,129
321588,Heart disease,racial,White,78,51,129
4086928,IUCD status,racial,White,129,0,129
434327,Cannabis abuse,ethnic,Hispanic or Latino,28,101,129
439314,Thrombophlebitis of the femoral vein,ethnic,Hispanic or Latino,16,113,129
440940,Methicillin resistant Staphylococcus aureus infection,ethnic,Hispanic or Latino,74,55,129
193518,Intestinal obstruction,ethnic,Hispanic or Latino,74,55,129
316139,HF - Heart failure,ethnic,Not Hispanic or Latino,58,71,129
433125,Infection due to Staphylocccus aureus,ethnic,Hispanic or Latino,87,41,128
260131,Bronchial disorder,racial,White,97,32,129
201070,Cholelithiasis AND cholecystitis without obstruction,ethnic,Hispanic or Latino,127,2,129
198124,Disorder of kidney,racial,Black or African American ,94,35,129
132706,Nail disease,ethnic,Not Hispanic or Latino,83,46,129
435782,Chronic schizophrenic,racial,Unknown,110,18,128
374358,Dermatochalasis,ethnic,Hispanic or Latino,108,21,129
4175807,Rheumatic disease of tricuspid valve,ethnic,Hispanic or Latino,81,48,129
372903,Retinal edema,racial,White,85,44,129
376961,Disturbance of consciousness,racial,White,71,58,129
432730,Dysphonia,ethnic,Hispanic or Latino,85,44,129
440321,Helicobacter-associated disease,racial,Other Race,85,44,129
253788,Nasal polyp,ethnic,Not Hispanic or Latino,78,51,129
4110046,Obstructive chronic bronchitis NOS,ethnic,Hispanic or Latino,81,48,129
201093,Infection of skin AND/OR subcutaneous tissue,ethnic,Not Hispanic or Latino,87,41,128
138463,Oral aphthae,ethnic,Not Hispanic or Latino,87,41,128
442588,OSA - Obstructive sleep apnoea,racial,Black or African American ,48,81,129
4066163,Ureteric colic,racial,Unknown,7,122,129
139841,Chronic frontal sinusitis,ethnic,Hispanic or Latino,108,21,129
432869,Hemorrhagic disorder due to circulating anticoagulants,racial,Black or African American ,0,129,129
440238,Closed fracture of metatarsal bone,ethnic,Not Hispanic or Latino,92,37,129
140266,Superficial bruising of back,ethnic,Hispanic or Latino,69,60,129
444297,Vertiginous syndrome,ethnic,Not Hispanic or Latino,124,5,129
438120,Opioid dependence,racial,Black or African American ,39,90,129
439696,Hypertensive heart and renal disease with (congestive) heart failure,racial,White,28,101,129
438557,Abnormal glucose level,racial,American Indian or Alaska Native ,60,69,129
79116,Disorder of tendon of shoulder region,ethnic,Hispanic or Latino,78,51,129
74188,Closed fracture of rib,racial,White,55,74,129
197914,Chronic gastric ulcer with perforation but without obstruction,racial,Asian,115,14,129
436263,Broken tooth without complication,ethnic,Hispanic or Latino,81,48,129
40484513,Hemiplegia of nondominant side as late effect of cerebrovascular disease,racial,Other Race,129,0,129
376713,Cerebral hemorrhage,ethnic,Hispanic or Latino,62,67,129
195603,Vulval and/or perineal noninflammatory disorders,racial,White,122,5,127
435524,Sleep disorder,racial,Unknown,76,51,127
443228,"Abrasion or friction burn of foot and toe, without mention of infection",ethnic,Hispanic or Latino,78,48,126
375281,Acute suppurative otitis media - tympanic membrane intact,racial,Black or African American ,67,60,127
196044,Primary malignant neoplasm of stomach,racial,White,35,92,127
320835,TOF - Tetralogy of Fallot,racial,White,44,83,127
443913,Congenital anomaly of trachea,racial,White,25,101,126
75346,Disorder of meniscus of knee,ethnic,Hispanic or Latino,51,76,127
439005,Chronic alcoholism in remission,racial,White,39,87,126
79106,Arthralgia of the pelvic region and thigh,racial,Asian,90,37,127
4185302,Chronic myocardial ischemia,racial,White,41,85,126
4016352,Tuberculosis contact,racial,White,87,39,126
4166776,Dupuytren contracture,ethnic,Hispanic or Latino,39,87,126
134765,General body deterioration,ethnic,Hispanic or Latino,53,74,127
440202,Multiple congenital malformations,racial,White,58,69,127
432869,Hemorrhagic disorder due to circulating anticoagulants,racial,Other Race,0,127,127
432594,Osteomalacia,ethnic,Hispanic or Latino,127,0,127
78149,Congenital hereditary muscular dystrophy,ethnic,Hispanic or Latino,18,108,126
377085,Congenital anomaly of brain,ethnic,Hispanic or Latino,58,69,127
75623,Old disruption of anterior cruciate ligament,racial,White,64,62,126
195012,Metrorrhagia,ethnic,Not Hispanic or Latino,127,0,127
436730,"Appendicitis, unqualified",racial,White,51,76,127
437382,Urine observation,racial,Other Race,94,32,126
193874,Bed wetting,ethnic,Not Hispanic or Latino,37,90,127
77644,Adhesive capsulitis of shoulder,ethnic,Not Hispanic or Latino,92,35,127
443115,Closed fracture finger proximal phalanx,racial,White,35,92,127
4240902,Allergy to peanuts,racial,White,35,92,127
434272,Varicella infection,racial,White,62,64,126
197206,Balantidiasis,ethnic,Hispanic or Latino,0,127,127
201045,Thrombosed external haemorrhoids,ethnic,Hispanic or Latino,78,48,126
320835,TOF - Tetralogy of Fallot,ethnic,Hispanic or Latino,44,83,127
74728,Synovitis and tenosynovitis,racial,White,69,58,127
440078,"Bipolar affective disorder, current episode manic",racial,Black or African American ,14,113,127
376114,Severe nonproliferative diabetic retinopathy,racial,Unknown,51,76,127
380097,Diabetic macular edema,racial,Unknown,67,60,127
436919,Primary malignant neoplasm of unspecified site,ethnic,Not Hispanic or Latino,110,16,126
4168217,Generalized hyperhidrosis,racial,White,62,64,126
442270,Disease of duodenum,ethnic,Hispanic or Latino,67,60,127
437828,Disorder of calcium metabolism,ethnic,Hispanic or Latino,83,44,127
198978,Acute gonorrhea of lower genitourinary tract,racial,White,55,71,126
79833,Meniere's disease,ethnic,Hispanic or Latino,115,12,127
4144103,Influenza NOS,racial,White,81,46,127
377279,"Profound impairment, one eye",racial,Black or African American ,21,106,127
314666,Healed coronary,racial,Black or African American ,78,46,124
138896,Open wound of forehead without complication,ethnic,Hispanic or Latino,60,64,124
432739,Red blood cell disorder,racial,White,69,55,124
135618,Prurigo,ethnic,Hispanic or Latino,78,46,124
260123,Acute inflammation of sinus,racial,American Indian or Alaska Native ,78,46,124
199860,Hernia of abdominal cavity,ethnic,Not Hispanic or Latino,12,113,125
258780,Chronic obstructive bronchitis,racial,Other Race,104,21,125
443622,Aneurysm of thoracic aorta,racial,White,87,37,124
195590,Urethral stricture,racial,White,25,99,124
442794,Poisoning by wasp sting,ethnic,Hispanic or Latino,60,64,124
4147164,Hematologic malignancy,ethnic,Hispanic or Latino,94,30,124
4308509,Impaired fasting glycaemia,racial,Black or African American ,48,76,124
4149382,Endocrine/metabolic screening,ethnic,Hispanic or Latino,90,35,125
133228,Dental caries,racial,Black or African American ,58,67,125
78497,Cellulitis and abscess of toe,ethnic,Not Hispanic or Latino,69,55,124
314968,Varices,ethnic,Hispanic or Latino,108,16,124
437097,Congenital anomaly of cartilage,ethnic,Hispanic or Latino,9,115,124
72576,Benign tumour of breast,ethnic,Hispanic or Latino,124,0,124
377287,Phlyctenular keratoconjunctivitis,ethnic,Hispanic or Latino,120,5,125
320536,Abnormal EKG finding,racial,Asian,48,76,124
433095,Fall on or from steps,racial,Unknown,83,41,124
444090,Disease of foot,ethnic,Hispanic or Latino,81,44,125
439697,Hypertensive renal disease with renal failure,ethnic,Not Hispanic or Latino,99,25,124
197607,Polymenorrhagia,racial,Other Race,124,0,124
23220,Chronic tonsillitis,ethnic,Hispanic or Latino,83,41,124
78831,Disease of ankle,racial,White,71,53,124
444202,Abscess,racial,Black or African American ,55,69,124
437579,Paroxysmal ventricular tachycardia,racial,Unknown,122,2,124
253954,PTB - Pulmonary tuberculosis,ethnic,Hispanic or Latino,87,37,124
4139420,Foreign body in auditory canal,racial,Unknown,58,67,125
4080568,Problem behaviour,racial,Unknown,41,83,124
73843,Synovial cyst of popliteal space,racial,Unknown,113,12,125
199067,Inflammatory disease of female pelvic organs AND/OR tissues,racial,White,124,0,124
193530,Follicular cyst of ovary,racial,White,124,0,124
317576,Coronary arteriosclerosis,racial,American Indian or Alaska Native ,25,99,124
134870,Pityriasis versicolor,ethnic,Not Hispanic or Latino,58,67,125
77139,Open wound of finger without complication,racial,Unknown,81,44,125
4287544,Manic bipolar I disorder,racial,Unknown,104,21,125
4295261,Postmenopausal state,ethnic,Not Hispanic or Latino,122,0,122
4170576,Pressure ulcer,racial,Unknown,92,30,122
132397,Pilonidal cyst with no abscess,racial,White,21,101,122
196163,Cervicitis and endocervicitis,racial,White,117,5,122
4103722,Cataract NOS,racial,Unknown,67,55,122
134460,Plantar fascial fibromatosis,racial,Other Race,108,14,122
437663,Fever,racial,Asian,58,64,122
4149353,"Attention deficit hyperactivity disorder, predominantly inattentive type",racial,Unknown,64,58,122
132572,Chronic myeloid leukaemia in remission,racial,Unknown,122,0,122
436096,Chronic pain,racial,Asian,92,30,122
439928,Gangrenous disorder,ethnic,Hispanic or Latino,23,99,122
4247802,Muscular dystrophy,ethnic,Hispanic or Latino,37,85,122
379769,Benign brain tumour,ethnic,Hispanic or Latino,94,28,122
314379,First degree atrioventricular block,racial,White,78,44,122
137951,Acquired keratoderma,racial,White,99,23,122
134736,Backache,racial,American Indian or Alaska Native ,85,37,122
140273,"Contusion, forearm area",ethnic,Hispanic or Latino,78,44,122
4005823,Tobacco user,racial,Other Race,35,87,122
437113,Asthenia,racial,White,67,55,122
434309,Sexual precocity,ethnic,Hispanic or Latino,97,25,122
138519,Spondylosis without myelopathy,ethnic,Not Hispanic or Latino,83,39,122
136368,Non-toxic multinodular goiter,racial,White,94,28,122
257315,Bacterial pneumonia,ethnic,Not Hispanic or Latino,76,46,122
193809,Melena due to gastrointestinal hemorrhage,racial,Asian,23,99,122
135615,Pityriasis,racial,Unknown,41,81,122
4144876,Contact dermatitis and other eczemas,ethnic,Hispanic or Latino,62,60,122
138148,Plantar nerve lesion,ethnic,Hispanic or Latino,97,25,122
140266,Superficial bruising of back,racial,White,67,55,122
317893,Paroxysmal supraventricular tachycardia,racial,White,76,46,122
134441,Chronic ulcer of skin,ethnic,Not Hispanic or Latino,23,99,122
437247,Anaemia of chronic disease,racial,Other Race,60,62,122
432863,Acquired coagulation factor deficiency,ethnic,Hispanic or Latino,67,55,122
76161,Impotence of organic origin,racial,Other Race,0,122,122
81893,Chronic ulcerative colitis,ethnic,Not Hispanic or Latino,78,44,122
374950,Oedema of eyelid,ethnic,Hispanic or Latino,62,60,122
132572,Chronic myeloid leukaemia in remission,ethnic,Hispanic or Latino,122,0,122
433942,Accident whilst engaged in household activity,racial,White,76,46,122
4107655,Observations relating to psychosocial functioning,ethnic,Not Hispanic or Latino,60,62,122
198199,Pyelonephritis,ethnic,Not Hispanic or Latino,94,28,122
441818,Haemangioma,racial,White,71,51,122
433599,Abnormal biochemistry finding,ethnic,Not Hispanic or Latino,48,74,122
434750,Feeding difficulties and mismanagement,racial,Unknown,53,69,122
373474,Seeing double,ethnic,Hispanic or Latino,32,90,122
376208,Soft tissue disorder,racial,Unknown,55,67,122
434675,Complication of gastrostomy,ethnic,Hispanic or Latino,55,67,122
139057,Disease of oral soft tissues,ethnic,Not Hispanic or Latino,87,35,122
380094,Carpal tunnel syndrome,racial,Other Race,117,5,122
444090,Disease of foot,racial,White,81,41,122
436882,[X]Fall involving bed,racial,White,97,25,122
193253,Nephritis,racial,Other Race,81,41,122
4144997,Osteoarthritis NOS,racial,Unknown,106,16,122
4164707,Canceled operative procedure,ethnic,Not Hispanic or Latino,74,48,122
201061,Diaphragmatic hernia,ethnic,Not Hispanic or Latino,64,58,122
441534,"Severe major depression, single episode, without psychotic features",racial,White,97,23,120
133853,Osteomyelitis of ankle AND/OR foot,racial,Unknown,115,5,120
4170137,Non-suppurative otitis media,ethnic,Not Hispanic or Latino,60,60,120
437584,Ataxia,racial,Unknown,23,97,120
78228,Joint derangement,racial,White,28,92,120
441691,Atypical squamous cells of undetermined significance on vaginal Papanicolaou smear,racial,White,120,0,120
138176,Acute gingivitis,racial,Unknown,51,69,120
22340,Esophageal varices without bleeding,racial,Unknown,106,14,120
77074,Joint pain,racial,Asian,62,58,120
442753,Furuncle of trunk,ethnic,Hispanic or Latino,58,62,120
4111392,Angina pectoris NOS,ethnic,Hispanic or Latino,71,48,119
141371,PR - Pityriasis rosea,racial,White,62,58,120
442752,Myalgia,racial,Black or African American ,101,18,119
4053045,Dog bite,racial,Unknown,83,37,120
440846,"Blood coagulation disorder, categorized by value of screening test",ethnic,Hispanic or Latino,83,37,120
432545,Bacterial disease,racial,Unknown,99,21,120
261326,Viral pneumonia,ethnic,Hispanic or Latino,51,69,120
200452,Disease of female genital organ,ethnic,Hispanic or Latino,117,2,119
194475,Singultus,racial,White,2,117,119
73923,"Contusion, upper arm",ethnic,Hispanic or Latino,90,30,120
75344,Intervertebral disc disorder,ethnic,Not Hispanic or Latino,28,92,120
4092879,Absent kidney,racial,White,67,53,120
432876,Bipolar I disorder,racial,Unknown,32,87,119
135777,Neoplasm of uncertain behaviour of skin,racial,Unknown,99,21,120
377287,Phlyctenular keratoconjunctivitis,racial,Unknown,117,2,119
4024013,Sensory nervous system finding,ethnic,Hispanic or Latino,78,41,119
435783,Schizophrenia,racial,Asian,18,101,119
442286,Abscess of digit,racial,Unknown,90,30,120
260139,Acute bronchitis,racial,American Indian or Alaska Native ,99,21,120
438879,Closed bimalleolar fracture,ethnic,Hispanic or Latino,92,28,120
4202322,Amputated big toe,ethnic,Hispanic or Latino,18,101,119
72986,Disease of lower leg,ethnic,Hispanic or Latino,55,64,119
4150307,Dental restoration observation,ethnic,Not Hispanic or Latino,83,37,120
73300,Radial styloid tenosynovitis,racial,White,101,18,119
376415,Hypermetropia,ethnic,Hispanic or Latino,46,74,120
75623,Old disruption of anterior cruciate ligament,ethnic,Hispanic or Latino,53,67,120
195562,Hemorrhoids,racial,Other Race,71,48,119
4014230,Ankle sprain NOS,racial,White,58,62,120
443585,Abrasion AND/OR friction burn of multiple sites,ethnic,Not Hispanic or Latino,58,62,120
74472,Congenital deformity of foot,ethnic,Hispanic or Latino,25,94,119
81942,Enthesopathy of ankle AND/OR tarsus,ethnic,Hispanic or Latino,67,53,120
438418,Meningitis with clear cerebrospinal fluid,ethnic,Hispanic or Latino,0,120,120
432586,Mental disorder,ethnic,Hispanic or Latino,71,48,119
438418,Meningitis with clear cerebrospinal fluid,racial,Unknown,0,120,120
197610,Ovarian cyst,racial,Other Race,120,0,120
432441,Finding of length of gestation,ethnic,Hispanic or Latino,76,44,120
4103640,Amputated foot,ethnic,Hispanic or Latino,0,120,120
375822,Neonatal obstruction of nasolacrimal duct,ethnic,Hispanic or Latino,53,67,120
432447,Atypical glandular cells on cervical Papanicolaou smear,racial,White,120,0,120
435224,Leukopenia,ethnic,Not Hispanic or Latino,58,60,118
441085,Elderly primip,ethnic,Hispanic or Latino,117,0,117
436176,Spontaneous abortion without complication,ethnic,Hispanic or Latino,117,0,117
77373,Congenital deformity of hip joint,ethnic,Hispanic or Latino,76,41,117
441836,Depressed bipolar I disorder,ethnic,Not Hispanic or Latino,81,37,118
4028716,Idiopathic thrombocythemia,racial,Unknown,92,25,117
192372,Placenta praevia without haemorrhage - not delivered,ethnic,Hispanic or Latino,117,0,117
198363,Candidiasis of vagina,racial,Other Race,117,0,117
316376,Eosinophilia,ethnic,Hispanic or Latino,39,78,117
200528,Ascites,racial,Unknown,78,39,117
194686,Acquired renal cyst,ethnic,Not Hispanic or Latino,71,46,117
135027,"Carbuncle of leg, except foot",racial,White,58,60,118
316376,Eosinophilia,racial,White,37,81,118
372629,Nonexudative age-related macular degeneration,racial,Unknown,97,21,118
381290,Ocular hypertension,ethnic,Hispanic or Latino,97,21,118
434902,Autistic disorder of childhood onset,racial,Asian,5,113,118
313023,Neonatal chronic respiratory disease,racial,White,41,76,117
440431,Pneumonia due to Mycoplasma pneumoniae,ethnic,Hispanic or Latino,53,64,117
375292,Perforation of tympanic membrane,ethnic,Not Hispanic or Latino,76,41,117
4201387,Tracheostomy in situ,racial,Unknown,71,46,117
4028716,Idiopathic thrombocythemia,ethnic,Not Hispanic or Latino,62,55,117
72990,Localised osteoarthrosis uncertain if primary OR secondary,ethnic,Hispanic or Latino,101,16,117
4028641,Pregnancy and drug dependence,ethnic,Hispanic or Latino,117,0,117
253815,Ulceration of vulva,racial,White,117,0,117
440927,High risk drug monitoring status,ethnic,Hispanic or Latino,90,28,118
376224,Spina bifida without hydrocephalus,racial,White,23,94,117
4062637,TB - Tuberculosis screening,racial,American Indian or Alaska Native ,76,41,117
433125,Infection due to Staphylocccus aureus,racial,White,71,46,117
318775,Venous embolism,ethnic,Not Hispanic or Latino,97,21,118
432295,Pernicious anemia,racial,Unknown,85,32,117
373475,Impairment level: one eye: moderate impairment: other eye: not specified,racial,Other Race,0,117,117
437528,"Bipolar affective disorder, currently depressed, moderate",racial,Unknown,74,44,118
440424,Aphasia,racial,Black or African American ,115,2,117
201093,Infection of skin AND/OR subcutaneous tissue,racial,Unknown,48,69,117
436096,Chronic pain,racial,Other Race,48,69,117
377091,Fits - convulsions,racial,Black or African American ,48,69,117
436072,Bipolar disorder in partial remission,racial,Unknown,113,5,118
200051,Primary malignant neoplasm of ovary,ethnic,Hispanic or Latino,117,0,117
313209,Left bundle branch hemiblock,ethnic,Hispanic or Latino,67,51,118
374905,Non-organic sleep disorder,racial,Unknown,30,87,117
442565,Gestational edema without hypertension,racial,Unknown,117,0,117
442286,Abscess of digit,ethnic,Not Hispanic or Latino,76,41,117
4173498,FH: Heart disorder,ethnic,Hispanic or Latino,48,69,117
193016,Cystic disease of kidney,ethnic,Not Hispanic or Latino,76,41,117
199876,Prolapse of female genital organs,ethnic,Hispanic or Latino,117,0,117
440647,Sexually transmitted infectious disease,racial,White,39,78,117
136497,Scar conditions and fibrosis of skin,ethnic,Hispanic or Latino,83,35,118
442584,Carbuncle of buttock,racial,White,76,41,117
375504,Psychoactive substance-induced organic mental disorder,ethnic,Hispanic or Latino,76,41,117
75051,Derangement of posterior horn of medial meniscus,ethnic,Hispanic or Latino,71,46,117
4179925,Basic learning problem,racial,White,37,81,118
133294,Prepatellar bursitis,ethnic,Hispanic or Latino,48,69,117
432863,Acquired coagulation factor deficiency,racial,Unknown,62,55,117
436222,Altered mental status,racial,Asian,117,0,117
4145627,Biliary calculus,racial,White,110,5,115
259848,Chronic rhinitis,racial,Asian,39,76,115
436222,Altered mental status,racial,Unknown,78,37,115
318772,Disease of pericardium,ethnic,Hispanic or Latino,83,32,115
434467,Ostium secundum type atrial septal defect,ethnic,Not Hispanic or Latino,81,35,116
76786,Derangement of knee,racial,Asian,23,92,115
133424,Primary malignant neoplasm of thyroid gland,racial,Unknown,39,76,115
433750,"Single major depressive episode, in full remission",racial,White,85,30,115
433533,Incomplete spontaneous abortion with no mention of complication,ethnic,Hispanic or Latino,115,0,115
78508,Arthralgia of the ankle and/or foot,racial,Asian,94,21,115
433596,Abnormal sputum,racial,White,55,60,115
433316,Giddiness,racial,Black or African American ,60,55,115
4173498,FH: Heart disorder,racial,White,44,71,115
192606,Paraplegia,racial,Unknown,74,41,115
439141,Abnormal increase in weight,racial,Filipino,99,16,115
380731,OE - Otitis externa,ethnic,Hispanic or Latino,41,74,115
376114,Severe nonproliferative diabetic retinopathy,racial,White,28,87,115
380839,TS - Tuberous sclerosis,ethnic,Hispanic or Latino,99,16,115
374025,Retinal haemorrhages,ethnic,Hispanic or Latino,76,39,115
133810,Secondary hyperparathyroidism of renal origin,ethnic,Not Hispanic or Latino,44,71,115
377286,VFD - Visual field defect,racial,Unknown,12,104,116
198683,Viral hepatitis B without hepatic coma,racial,Asian,53,62,115
140027,Herpetic gingivostomatitis,ethnic,Not Hispanic or Latino,81,35,116
193688,Clostridium difficile infection,racial,White,58,58,116
255891,Lupus erythematosus,ethnic,Not Hispanic or Latino,87,28,115
435227,Nutritional deficiency,racial,Unknown,74,41,115
376208,Soft tissue disorder,ethnic,Not Hispanic or Latino,25,90,115
376422,Mucopurulent conjunctivitis,racial,Unknown,90,25,115
137945,Pressure ulcer stage 2,racial,White,106,9,115
432454,Excessive thirst,racial,White,53,62,115
197914,Chronic gastric ulcer with perforation but without obstruction,ethnic,Not Hispanic or Latino,115,0,115
434169,Abnormal findings on diagnostic imaging of breast,racial,Asian,115,0,115
432554,Human immunodeficiency virus II infection,racial,White,46,69,115
201909,Female infertility,racial,Unknown,115,0,115
23798,Acute laryngopharyngitis,ethnic,Hispanic or Latino,74,41,115
437655,Cryptorchism,ethnic,Not Hispanic or Latino,0,115,115
74729,Ganglion and synovial cyst,ethnic,Not Hispanic or Latino,83,32,115
197500,Primary malignant neoplasm of colon,racial,Black or African American ,94,21,115
134144,Cleft palate with cleft lip,racial,White,60,55,115
81251,Neoplasm of breast,racial,Unknown,115,0,115
197917,Disorder of biliary tract,ethnic,Hispanic or Latino,69,46,115
72418,Scoliosis deformity of spine,racial,White,62,53,115
377085,Congenital anomaly of brain,racial,White,55,60,115
316084,Lymphadenitis,ethnic,Not Hispanic or Latino,53,62,115
439795,Minimal cognitive impairment,racial,Asian,115,0,115
72715,Exostosis,ethnic,Hispanic or Latino,87,28,115
4185471,Disorder of pigmentation,racial,Unknown,55,60,115
193165,Adrenal disease,ethnic,Hispanic or Latino,87,28,115
376105,Krampfe salaam attacks,ethnic,Hispanic or Latino,85,30,115
437097,Congenital anomaly of cartilage,racial,White,0,115,115
195596,Chronic pancreatitis,racial,Unknown,81,35,116
439791,Emotional upset,ethnic,Hispanic or Latino,83,32,115
439314,Thrombophlebitis of the femoral vein,racial,White,0,115,115
440228,Closed fracture of lower end of humerus,ethnic,Hispanic or Latino,81,35,116
436076,Adjustment disorder with mixed disturbance of emotions AND conduct,ethnic,Hispanic or Latino,106,9,115
4147466,Panic disorder with agoraphobia,ethnic,Not Hispanic or Latino,76,39,115
320420,Vitreous degeneration,racial,Unknown,104,12,116
200970,CIS - Carcinoma in situ of prostate,racial,White,0,115,115
441946,Calcific tendinitis of shoulder,racial,White,99,16,115
440238,Closed fracture of metatarsal bone,racial,Unknown,101,14,115
442584,Carbuncle of buttock,ethnic,Hispanic or Latino,69,46,115
374028,AAMD - Age related macular degeneration,racial,Other Race,25,87,112
75052,Enthesopathy of wrist AND/OR carpus,ethnic,Hispanic or Latino,92,21,113
75354,Osteochondropathy,racial,Asian,81,32,113
442604,Hypertensive heart disease,racial,Native Hawaiian or Other Pacific Islander ,110,2,112
40481920,Periumbilical pain,racial,Unknown,78,35,113
436235,Taste sense altered,ethnic,Hispanic or Latino,99,14,113
134116,Dermatitis due to drug AND/OR medicine taken internally,ethnic,Hispanic or Latino,67,46,113
440686,Residual schizophrenia in remission,ethnic,Hispanic or Latino,16,97,113
73649,Contusion of finger,racial,Unknown,69,44,113
74189,Sprain of cruciate ligament of knee,ethnic,Hispanic or Latino,69,44,113
434500,Closed fracture of neck of femur,racial,White,67,46,113
4299574,Factitious skin disease,ethnic,Hispanic or Latino,92,21,113
434502,Closed fracture of phalanx of toe,racial,Unknown,92,21,113
196456,Cholecystolithiasis,racial,Other Race,78,35,113
435553,Watery eye,ethnic,Hispanic or Latino,85,28,113
138225,Disease of sebaceous glands,racial,White,67,46,113
192963,Disease of pancreas,ethnic,Hispanic or Latino,81,32,113
442764,Anal pain,racial,Unknown,81,32,113
372409,Sciatica neuralgia,racial,Asian,90,23,113
200483,Disease of pelvis,racial,White,87,25,112
4161978,Patient on oxygen,racial,White,81,32,113
81106,Acquired genu varum,ethnic,Hispanic or Latino,41,71,112
136368,Non-toxic multinodular goiter,racial,Unknown,113,0,113
440508,Congenital disease,ethnic,Not Hispanic or Latino,46,67,113
443865,Non-infective colitis,racial,Black or African American ,35,78,113
380415,Acute swimmer's ear,ethnic,Not Hispanic or Latino,58,55,113
75004,Frank hematuria,racial,Unknown,32,81,113
134159,Precordial pain,racial,Black or African American ,5,108,113
4091532,Bowel observation,ethnic,Not Hispanic or Latino,78,35,113
4028641,Pregnancy and drug dependence,racial,White,113,0,113
4066820,Ingestion dermatitis due to food,racial,White,74,39,113
197332,Incomplete uterovaginal prolapse,ethnic,Hispanic or Latino,113,0,113
138239,Observation of limb structure,racial,Unknown,71,41,112
78236,Muscle wasting disorder,ethnic,Not Hispanic or Latino,16,97,113
443677,Open wound of knee and/or leg and/or ankle,racial,Unknown,94,18,112
4104853,Epileptic seizures - clonic,racial,White,64,48,112
439154,Abnormal findings on diagnostic imaging of skull and head,ethnic,Hispanic or Latino,48,64,112
141941,Cervical spondylosis without myelopathy,racial,Unknown,83,30,113
194092,Uterine prolapse without vaginal wall prolapse,racial,Unknown,113,0,113
198964,Chronic type C viral hepatitis,racial,American Indian or Alaska Native ,62,51,113
374028,AAMD - Age related macular degeneration,racial,Asian,14,99,113
78273,Closed fracture multiple ribs,ethnic,Hispanic or Latino,71,41,112
437584,Ataxia,racial,White,58,55,113
4147164,Hematologic malignancy,racial,White,94,18,112
376065,Neurologic disorder associated with type II diabetes mellitus,racial,American Indian or Alaska Native ,60,53,113
260134,Croup,ethnic,Not Hispanic or Latino,46,67,113
312648,Benign essential hypertension,racial,Asian Indian,62,51,113
442262,Blister of toe without infection,racial,White,58,53,111
432895,Cortical senile cataract,racial,Unknown,62,48,110
434084,Abscess of vulva,racial,White,110,0,110
192854,Interstitial uterine fibroid,racial,Unknown,110,0,110
440088,Academic underachievement disorder,racial,Unknown,41,69,110
439791,Emotional upset,racial,White,78,32,110
433822,Complication related to pregnancy,racial,White,108,2,110
443728,Mass of chest wall,racial,Unknown,83,28,111
380103,Retinal detachment with retinal defect,ethnic,Hispanic or Latino,81,30,111
442792,Pes anserinus bursitis,ethnic,Hispanic or Latino,67,44,111
440029,Viral disease,racial,Asian,44,67,111
374358,Dermatochalasis,racial,Unknown,90,21,111
195862,Urethritis,racial,White,16,94,110
4296205,Second degree burn,racial,White,51,60,111
77734,Contusion of lower leg,racial,White,81,30,111
434309,Sexual precocity,racial,White,76,35,111
432730,Dysphonia,racial,White,78,32,110
380702,Cerebral cysts,ethnic,Hispanic or Latino,64,46,110
434657,Weakness of face muscles,ethnic,Hispanic or Latino,64,46,110
321588,Heart disease,racial,Other Race,110,0,110
77072,Joint effusion of ankle AND/OR foot,ethnic,Hispanic or Latino,62,48,110
439727,HIV - Human immunodeficiency virus infection,racial,American Indian or Alaska Native ,85,25,110
435516,Lipoprotein deficiency disorder,racial,Unknown,64,46,110
74451,Palindromic rheumatism of the forearm,racial,Unknown,71,39,110
440977,Megaloblastic anemia due to folate deficiency,racial,Unknown,58,53,111
440751,Peritonsillar abscess,ethnic,Hispanic or Latino,64,46,110
4340380,Hepatitis C carrier,ethnic,Not Hispanic or Latino,41,69,110
380111,Acute atopic conjunctivitis,racial,Unknown,87,23,110
315922,Patent ductus arteriosus,ethnic,Hispanic or Latino,35,76,111
442753,Furuncle of trunk,racial,White,48,62,110
77395,Current tear of semilunar cartilage,racial,White,71,39,110
443865,Non-infective colitis,racial,Asian,39,71,110
76482,MA - Missed abortion,racial,Unknown,110,0,110
433992,"Bipolar affective disorder, currently manic, moderate",ethnic,Not Hispanic or Latino,7,104,111
434490,Shivering,ethnic,Hispanic or Latino,85,25,110
434610,Hyperkalemia,racial,Asian,64,46,110
72465,Closed fracture of one or more phalanges of hand,racial,Unknown,58,53,111
141758,Spinal cord injury without spinal bone injury,ethnic,Hispanic or Latino,0,110,110
437986,FTT - Failure to thrive,racial,Other Race,60,51,111
4077577,Moderate recurrent major depression,racial,Other Race,99,12,111
4113027,Dietary intake observations,ethnic,Not Hispanic or Latino,48,62,110
376709,Discharge of eye,racial,Unknown,83,28,111
193253,Nephritis,racial,Asian,60,51,111
80497,Disorder of cervical spine,ethnic,Hispanic or Latino,58,53,111
314962,Raynaud disease,ethnic,Hispanic or Latino,94,16,110
377888,CHL - Conductive hearing loss,racial,Asian,97,14,111
315831,Chronic pulmonary heart disease,ethnic,Not Hispanic or Latino,53,58,111
376680,Generalized nonconvulsive epilepsy,ethnic,Not Hispanic or Latino,101,9,110
138841,Disorder of sacrum,ethnic,Hispanic or Latino,69,41,110
437969,Acquired pes planus,ethnic,Not Hispanic or Latino,39,71,110
261325,Pulmonary emphysema,racial,Black or African American ,32,78,110
197672,Urinary incontinence,racial,Black or African American ,85,25,110
436812,Tongue tie,racial,White,16,94,110
316995,Coronary occlusion,racial,Unknown,108,2,110
433450,Paranoid schizophrenia,ethnic,Hispanic or Latino,44,67,111
26378,Hyperpituitarism,racial,White,90,21,111
434008,White blood cell disorder,racial,White,83,28,111
134668,Chronic maxillary sinusitis,ethnic,Hispanic or Latino,74,37,111
376104,Posttraumatic headache,ethnic,Hispanic or Latino,67,44,111
256722,Bronchopneumonia,ethnic,Hispanic or Latino,60,48,108
321596,Peripheral venous insufficiency,racial,Black or African American ,106,2,108
27587,Disturbance of salivary secretion,racial,White,81,28,109
256440,Disorder of paranasal sinuses,racial,Other Race,85,23,108
133835,Dermatitis,racial,Asian,39,69,108
4002644,Rotator cuff shoulder syndrome and allied disorders,ethnic,Hispanic or Latino,51,58,109
376125,Disorder of eyelid,ethnic,Hispanic or Latino,58,51,109
380094,Carpal tunnel syndrome,racial,Asian,71,37,108
136775,Contact dermatitis due to solar radiation,ethnic,Hispanic or Latino,62,46,108
196735,Acute pyelonephritis without medullary necrosis,racial,White,87,21,108
434339,Adolescent - emotional problem,racial,White,41,67,108
440694,"Nondependent mixed drug abuse, episodic",racial,White,51,58,109
77234,Benign tumour of colon,racial,Asian,64,44,108
316999,Cardiac arrhythmia,racial,Other Race,44,64,108
4103574,Chronic depression,ethnic,Not Hispanic or Latino,55,53,108
72726,Light-for-dates with signs of fetal malnutrition,ethnic,Not Hispanic or Latino,0,108,108
40479192,Chronic systolic heart failure,racial,White,53,55,108
373472,Pigmentary retinal dystrophy,ethnic,Hispanic or Latino,108,0,108
256449,Bronchiectasis,ethnic,Hispanic or Latino,104,5,109
378165,Nystagmus,ethnic,Hispanic or Latino,64,44,108
4155526,Acute otitis media with effusion,ethnic,Hispanic or Latino,37,71,108
312437,Dyspnea,racial,Other Race,46,62,108
29056,Sialoadenitis,racial,White,60,48,108
313023,Neonatal chronic respiratory disease,ethnic,Not Hispanic or Latino,16,92,108
373747,Extrapyramidal disease,racial,White,67,41,108
4144876,Contact dermatitis and other eczemas,racial,White,58,51,109
198194,Female genital organ symptoms,racial,Asian,108,0,108
443442,Finding of vaginal vault smear result,racial,White,108,0,108
24966,OV - Oesophageal varices,racial,White,74,35,109
436785,Spinal stenosis in cervical region,racial,Unknown,76,32,108
134671,Dental abscess without a sinus,ethnic,Not Hispanic or Latino,90,18,108
435093,Closed fracture of femur,racial,White,23,85,108
134074,Oral soft tissue cellulitis,ethnic,Hispanic or Latino,74,35,109
4340379,Hepatitis B carrier,racial,White,67,41,108
197223,Enterobiasis,ethnic,Hispanic or Latino,58,51,109
4201388,Gastrostomy present,racial,Asian,51,58,109
4340379,Hepatitis B carrier,racial,Asian,23,85,108
199877,Mucous polyp of cervix,ethnic,Not Hispanic or Latino,106,2,108
72726,Light-for-dates with signs of fetal malnutrition,racial,White,0,108,108
30163,Cellulitis and abscess of neck,ethnic,Hispanic or Latino,39,69,108
141758,Spinal cord injury without spinal bone injury,racial,Unknown,0,108,108
255841,Chronic bronchitis,racial,Asian,67,41,108
321596,Peripheral venous insufficiency,racial,Other Race,97,12,109
76161,Impotence of organic origin,racial,Black or African American ,0,108,108
433400,Emergency contraception,ethnic,Not Hispanic or Latino,106,2,108
4252594,Subconjunctival injection,racial,White,62,46,108
321588,Heart disease,racial,Black or African American ,5,104,109
440276,"Infection AND/OR inflammatory reaction due to internal prosthetic device, implant AND/OR graft",ethnic,Hispanic or Latino,85,23,108
438836,Poliomyelitis osteopathy of the lower leg,ethnic,Hispanic or Latino,23,85,108
197981,Abdominal tenderness,ethnic,Hispanic or Latino,76,32,108
435243,Alcohol dependence,racial,Unknown,5,104,109
314369,Malignant hypertensive heart disease without congestive heart failure,racial,Unknown,69,39,108
4048727,Neoplasm screening,racial,White,41,67,108
195012,Metrorrhagia,racial,Unknown,108,0,108
433752,Impulse control disorder,ethnic,Not Hispanic or Latino,0,108,108
257778,Pertussis,ethnic,Hispanic or Latino,71,37,108
77635,Disease of hand,racial,Other Race,58,51,109
4295261,Postmenopausal state,racial,Unknown,108,0,108
438727,Atypical depressive disorder,ethnic,Not Hispanic or Latino,62,46,108
4141492,Other ill-defined heart disease,ethnic,Hispanic or Latino,99,9,108
435524,Sleep disorder,ethnic,Not Hispanic or Latino,53,53,106
434327,Cannabis abuse,racial,White,28,78,106
440233,Strain of supraspinatus muscle AND/OR tendon,racial,White,87,18,105
438155,Optic disc glaucomatous atrophy,ethnic,Hispanic or Latino,41,64,105
378735,Migraine without aura,racial,White,78,28,106
72993,Primary localised osteoarthrosis,racial,Black or African American ,2,104,106
193666,Hip injury,racial,White,58,48,106
316437,Cerebral atherosclerosis,racial,Black or African American ,106,0,106
76194,Osteoarthrosis involving multiple sites but not designated as generalized,ethnic,Not Hispanic or Latino,101,5,106
436077,Developmental delay,racial,Black or African American ,32,74,106
75650,Proteinuria,racial,Black or African American ,46,60,106
437986,FTT - Failure to thrive,racial,Asian,25,81,106
377001,Unruptured cerebral aneurysm,racial,White,12,94,106
135340,Pressure ulcer stage 3,ethnic,Hispanic or Latino,46,60,106
137785,Verruca plantaris,racial,Unknown,83,23,106
201916,Ureteric stone,ethnic,Hispanic or Latino,48,58,106
74469,Light-for-dates without mention of fetal malnutrition,racial,White,12,94,106
439871,Haemospermia,ethnic,Hispanic or Latino,0,106,106
439799,Leg cramps,ethnic,Not Hispanic or Latino,81,25,106
375252,Disorder of eye,ethnic,Not Hispanic or Latino,62,44,106
81723,Contusion of hand,racial,Unknown,62,44,106
4110047,Chronic bronchitis NOS,ethnic,Hispanic or Latino,46,60,106
434972,Developmental abnormality of tooth size and form,racial,Unknown,71,35,106
375246,Mononeuritis of upper limb,racial,Unknown,106,0,106
192683,Uterovaginal prolapse,ethnic,Hispanic or Latino,106,0,106
316437,Cerebral atherosclerosis,ethnic,Not Hispanic or Latino,106,0,106
196734,Disease of prostate,racial,White,0,106,106
80497,Disorder of cervical spine,racial,White,58,48,106
374317,Alcohol-induced psychosis,ethnic,Hispanic or Latino,2,104,106
314754,Wheezing,racial,Asian,53,53,106
256717,Bronchospasm,ethnic,Not Hispanic or Latino,55,51,106
443617,Conduct disorder,racial,Unknown,32,74,106
78193,Epididymo-orchitis,racial,Unknown,0,106,106
434752,Positive serological AND/OR viral culture findings for human immunodeficiency virus,racial,Black or African American ,21,85,106
442609,Friction blister without infection,ethnic,Hispanic or Latino,60,46,106
440985,Phobia,racial,Unknown,106,0,106
437969,Acquired pes planus,racial,Unknown,46,60,106
372634,Nonphysiologic vision loss,racial,Other Race,83,23,106
433985,Hypercarotinemia,racial,Unknown,25,81,106
199877,Mucous polyp of cervix,racial,Unknown,106,0,106
437474,Postoperative infection,ethnic,Hispanic or Latino,90,16,106
433742,Latent schizophrenia,racial,Unknown,99,7,106
437992,Abnormal results of kidney function studies,ethnic,Hispanic or Latino,53,53,106
193165,Adrenal disease,racial,White,90,16,106
30978,Hereditary leptocytosis,racial,Asian,97,9,106
434376,Acute myocardial infarction of anterior wall,racial,Black or African American ,106,0,106
77987,Respiratory observations of chest,racial,White,69,37,106
436466,Balanoposthitis,ethnic,Not Hispanic or Latino,0,106,106
192360,Cyst and pseudocyst of pancreas,racial,Unknown,83,23,106
75863,Chronic interstitial cystitis,ethnic,Not Hispanic or Latino,106,0,106
439166,Closed fracture of radius,racial,White,44,62,106
4100857,Pickwickian syndrome,racial,Other Race,62,44,106
201313,Hypertensive renal disease,ethnic,Hispanic or Latino,78,28,106
78235,Disorder of coccyx,racial,Unknown,87,18,105
4204904,Education about sexually transmitted disease prevention,ethnic,Not Hispanic or Latino,69,35,104
4044391,Diabetic neuropathy,ethnic,Hispanic or Latino,78,25,103
136198,Cervical spondylosis with myelopathy,racial,White,51,53,104
436067,Schizophrenia simplex,racial,Other Race,92,12,104
436375,Sodium and water depletion,ethnic,Hispanic or Latino,101,2,103
26727,Vomiting blood,racial,White,46,58,104
192667,Atrophic gastritis,racial,Other Race,92,12,104
79833,Meniere's disease,ethnic,Not Hispanic or Latino,99,5,104
437116,Closed fracture of distal end of radius,ethnic,Hispanic or Latino,67,37,104
435023,Mild hyperemesis-not delivered,racial,Unknown,104,0,104
437092,Physiological development failure,racial,Black or African American ,16,87,103
81390,Idiopathic osteoporosis,racial,White,101,2,103
4094448,Pregnancy test negative,racial,Unknown,104,0,104
312327,Acute myocardial infarction,racial,Other Race,44,60,104
133810,Secondary hyperparathyroidism of renal origin,racial,Asian,30,74,104
4139420,Foreign body in auditory canal,ethnic,Not Hispanic or Latino,37,67,104
443943,Herpes zoster,racial,White,35,69,104
195867,Noninflammatory vaginal disorders,ethnic,Not Hispanic or Latino,101,2,103
134453,Inflammation of bursa,racial,Unknown,69,35,104
260125,Acute bronchiolitis,racial,Asian,32,71,103
375557,Cerebral embolism,ethnic,Hispanic or Latino,87,16,103
436166,Mild hyperemesis gravidarum,ethnic,Hispanic or Latino,104,0,104
440216,Abnormal glucose tolerance test,racial,Asian,46,58,104
4055758,Temporomandibular joint disorder NOS,ethnic,Hispanic or Latino,81,23,104
40485064,Latent syphilis,ethnic,Not Hispanic or Latino,30,74,104
30753,Esophagitis,racial,Unknown,78,25,103
199744,Carcinoma liver and/or biliary system,racial,Unknown,99,5,104
198528,Acquired unequal leg length,racial,Unknown,21,83,104
4108982,Cataract associated with other syndromes,ethnic,Hispanic or Latino,76,28,104
312950,IgE-mediated allergic asthma,racial,Other Race,30,74,104
436118,After-cataract with vision obscured,racial,Unknown,64,39,103
4196362,Genetic counselling,racial,White,104,0,104
201621,Chronic cystitis,racial,Unknown,60,44,104
139841,Chronic frontal sinusitis,racial,White,78,25,103
4152813,Family disruption,racial,White,58,46,104
196168,Irregular menstrual bleeding,racial,Other Race,104,0,104
378735,Migraine without aura,racial,Unknown,83,21,104
436278,Superficial bruising of thigh,ethnic,Hispanic or Latino,69,35,104
4139681,Allergy to dairy product,ethnic,Hispanic or Latino,25,78,103
195977,Contusion of trunk,racial,White,60,44,104
259055,Extrinsic asthma with asthma attack,racial,Black or African American ,90,14,104
72618,Disorder of muscle,ethnic,Hispanic or Latino,71,32,103
432898,Severe mental handicap,racial,White,5,99,104
78508,Arthralgia of the ankle and/or foot,racial,Other Race,74,30,104
436209,Fracture of fibula,racial,White,67,37,104
4201388,Gastrostomy present,racial,Black or African American ,25,78,103
135030,Discoloration of skin,racial,Unknown,90,14,104
381292,Chronic allergic conjunctivitis,racial,Other Race,58,46,104
4110046,Obstructive chronic bronchitis NOS,racial,White,78,25,103
377294,Exotropia,racial,White,53,51,104
318556,Nosebleed,racial,Other Race,67,37,104
133551,Vesicular eczema of hands and/or feet,racial,White,41,62,103
259849,Pneumonia with infectious diseases EC,ethnic,Hispanic or Latino,78,25,103
201998,Unilateral traumatic amputation of leg at OR above knee without complication,racial,Other Race,101,0,101
73575,Deformity of toe,racial,White,60,41,101
440704,Chronic pain syndrome,racial,Asian,0,101,101
76887,Disorders of urogenital prostheses or implants,ethnic,Hispanic or Latino,90,12,102
439002,Eating disorder,racial,White,69,32,101
439700,Inhibited sexual desire,racial,Other Race,0,101,101
374034,Visual disturbance,racial,Asian,46,55,101
40490888,Herniation of rectum into vagina,ethnic,Hispanic or Latino,101,0,101
432585,Blood coagulation disorder,racial,Unknown,90,12,102
4056329,Vaginitis and vulvovaginitis NOS,racial,Unknown,101,0,101
437046,Complete abortion,racial,Unknown,101,0,101
199978,Contusion of lower limb,ethnic,Hispanic or Latino,48,53,101
133569,Fasciitis,racial,White,67,35,102
138994,MDS - Myelodysplastic syndrome,racial,White,78,23,101
434750,Feeding difficulties and mismanagement,racial,Asian,62,39,101
374040,Ill-defined disorder of eye,racial,White,51,51,102
435511,Hypercalcemia,racial,Asian,55,46,101
198528,Acquired unequal leg length,racial,White,41,60,101
78890,Sprain of elbow and forearm,ethnic,Hispanic or Latino,67,35,102
195312,Functional voiding disorder,ethnic,Not Hispanic or Latino,69,32,101
134735,Chronic osteomyelitis,ethnic,Hispanic or Latino,53,48,101
74189,Sprain of cruciate ligament of knee,racial,White,64,37,101
441532,Monoclonal paraproteinaemia,racial,Unknown,30,71,101
381591,Cerebrovascular disease,racial,Native Hawaiian or Other Pacific Islander ,0,101,101
136185,Abnormal granulation tissue,ethnic,Hispanic or Latino,64,37,101
444211,Disease of thigh,ethnic,Not Hispanic or Latino,78,23,101
4101199,Hearing problem,ethnic,Not Hispanic or Latino,48,53,101
78505,"Localised, primary osteoarthritis of the ankle and/or foot",ethnic,Hispanic or Latino,97,5,102
437942,Caesarean delivery - delivered,ethnic,Hispanic or Latino,101,0,101
201613,Chronic nonalcoholic liver disease,racial,Other Race,71,30,101
434854,FP - Food poisoning,ethnic,Hispanic or Latino,60,41,101
137682,Skin sensation disturbance,racial,Asian,58,44,102
435785,Meningitis,ethnic,Hispanic or Latino,41,60,101
194382,External haemorrhoid,racial,White,69,32,101
197023,Bilateral inguinal hernia,racial,Unknown,0,101,101
80156,Asymptomatic bacteriuria in pregnancy,racial,White,99,2,101
4028253,Neoplasm of digestive system,ethnic,Hispanic or Latino,78,23,101
377889,Hearing loss,racial,Black or African American ,71,30,101
439777,Anemia,racial,Native Hawaiian or Other Pacific Islander ,23,78,101
380731,OE - Otitis externa,racial,White,35,67,102
200783,Previous cesarean section,racial,White,101,0,101
201072,Benign prostatic hypertrophy without outflow obstruction,racial,White,0,101,101
76791,Acquired deformity of hip,racial,White,51,51,102
73301,Synovitis/tenosynovitis - wrist,ethnic,Not Hispanic or Latino,92,9,101
4139681,Allergy to dairy product,racial,White,39,62,101
441561,Low tension glaucoma,ethnic,Not Hispanic or Latino,99,2,101
381306,Deaf mutism,ethnic,Not Hispanic or Latino,64,37,101
200174,Disease of skin AND/OR subcutaneous tissue,racial,Other Race,85,16,101
434750,Feeding difficulties and mismanagement,racial,Black or African American ,58,44,102
441561,Low tension glaucoma,racial,Black or African American ,99,2,101
77234,Benign tumour of colon,racial,Other Race,87,14,101
140648,Onychomycosis due to dermatophyte,racial,Asian,67,35,102
78786,Pleurisy,ethnic,Hispanic or Latino,76,25,101
134057,Disease of cardiovascular system,ethnic,Not Hispanic or Latino,58,44,102
374937,Impairment level: better eye: near-total impairment: lesser-eye: not further specified,ethnic,Hispanic or Latino,99,2,101
437176,Late effect of accidental fall,ethnic,Hispanic or Latino,55,46,101
435933,Closed fracture of lumbar vertebra without spinal cord injury,racial,Asian,35,67,102
201612,ALD - Alcoholic liver disease,ethnic,Hispanic or Latino,32,69,101
201254,Insulin dependent diabetes mellitus,racial,Black or African American ,78,23,101
4115379,"Localised, primary osteoarthritis of the pelvic region and thigh",ethnic,Not Hispanic or Latino,97,5,102
196625,Viral hepatitis A without hepatic coma,ethnic,Hispanic or Latino,60,41,101
4016359,Streptococcus carrier,ethnic,Hispanic or Latino,99,2,101
433881,Additional general conditions of patient,ethnic,Hispanic or Latino,78,23,101
200174,Disease of skin AND/OR subcutaneous tissue,racial,Asian,53,48,101
4173498,FH: Heart disorder,ethnic,Not Hispanic or Latino,39,62,101
138896,Open wound of forehead without complication,racial,White,51,48,99
441085,Elderly primip,racial,White,99,0,99
315276,Vitreous hemorrhage,racial,White,55,44,99
80504,Acquired genu valgum,racial,White,55,44,99
192680,Portal hypertension,racial,White,58,41,99
81175,Contusion of chest,ethnic,Not Hispanic or Latino,62,37,99
201688,Urinary hesitancy,racial,White,25,74,99
433742,Latent schizophrenia,ethnic,Not Hispanic or Latino,99,0,99
134442,Thibierge-Weissenbach syndrome,ethnic,Hispanic or Latino,64,35,99
444391,Pain around eye,ethnic,Not Hispanic or Latino,58,41,99
4276723,Finding of child weight centiles,racial,Asian,67,32,99
434770,Closed fracture of bones of trunk,racial,Unknown,99,0,99
30365,Panhypopituitarism,racial,White,78,21,99
375529,Infantile cerebral palsy,racial,Black or African American ,30,69,99
441126,Monosomy and deletion from autosome,ethnic,Hispanic or Latino,55,44,99
199074,Acute pancreatitis,ethnic,Not Hispanic or Latino,48,51,99
81250,Carcinoma in situ of breast,racial,White,99,0,99
444382,Thoracic radiculitis,racial,Asian,87,12,99
321462,Cardiac complications of care,ethnic,Hispanic or Latino,18,81,99
75051,Derangement of posterior horn of medial meniscus,racial,White,64,35,99
4012570,High risk sexual behavior,racial,Unknown,37,62,99
78149,Congenital hereditary muscular dystrophy,racial,Unknown,9,90,99
434770,Closed fracture of bones of trunk,ethnic,Hispanic or Latino,99,0,99
443933,Nicotiana tabacum poisoning,racial,White,60,39,99
439125,T21 - Trisomy 21,racial,Other Race,69,30,99
434008,White blood cell disorder,ethnic,Hispanic or Latino,58,41,99
435739,Late syphilis,ethnic,Hispanic or Latino,32,67,99
4090550,Evening colic,ethnic,Hispanic or Latino,62,37,99
4016359,Streptococcus carrier,racial,White,97,2,99
444291,Cochlear hearing loss,racial,White,30,69,99
193528,Third degree uterine prolapse,ethnic,Hispanic or Latino,99,0,99
76791,Acquired deformity of hip,ethnic,Hispanic or Latino,62,37,99
4171430,Screening for malignant neoplasm of rectum,racial,Asian,62,37,99
133853,Osteomyelitis of ankle AND/OR foot,racial,White,9,90,99
75617,Polyarticular osteoarthritis,racial,Filipino,16,83,99
440431,Pneumonia due to Mycoplasma pneumoniae,racial,White,35,64,99
136198,Cervical spondylosis with myelopathy,ethnic,Not Hispanic or Latino,32,67,99
436222,Altered mental status,ethnic,Not Hispanic or Latino,74,25,99
4154309,Severe recurrent major depression with psychotic features,racial,Black or African American ,44,55,99
435510,Hypocalcemia,racial,Unknown,71,28,99
379832,Mixed conductive and sensorineural deafness,racial,White,76,23,99
434502,Closed fracture of phalanx of toe,ethnic,Not Hispanic or Latino,78,21,99
259848,Chronic rhinitis,racial,Black or African American ,60,39,99
192450,Not passing urine,ethnic,Not Hispanic or Latino,23,76,99
78097,Metastatic tumour of bone,ethnic,Hispanic or Latino,83,16,99
434902,Autistic disorder of childhood onset,racial,Black or African American ,18,81,99
436067,Schizophrenia simplex,racial,Asian,16,83,99
200391,Peripheral autonomic neuropathy disease EC,ethnic,Not Hispanic or Latino,5,94,99
200763,Chronic hepatitis,racial,Asian,28,71,99
375552,Pterygium,ethnic,Not Hispanic or Latino,48,51,99
197484,Diarrhea of presumed infectious origin,racial,White,51,48,99
438698,"Malignant lymphoma of lymph nodes of head, face AND/OR neck",ethnic,Hispanic or Latino,99,0,99
135618,Prurigo,racial,White,53,46,99
435839,Lymphatic oedema,racial,Unknown,94,5,99
133794,Chronic gingivitis,ethnic,Not Hispanic or Latino,62,37,99
137053,Seborrheic dermatitis,racial,Asian,44,55,99
433657,Fall from furniture,ethnic,Hispanic or Latino,60,39,99
4013526,ESR raised,ethnic,Hispanic or Latino,85,14,99
252365,MGN - Membranous glomerulonephritis,racial,White,78,21,99
433992,"Bipolar affective disorder, currently manic, moderate",racial,White,12,87,99
381444,Black eye,racial,White,46,53,99
4005933,Urethral meatus underneath penis,racial,White,0,99,99
4062491,Anemia screening,ethnic,Hispanic or Latino,62,37,99
373472,Pigmentary retinal dystrophy,racial,Unknown,97,0,97
192676,Cervical intraepithelial neoplasia grade 1,ethnic,Not Hispanic or Latino,94,2,96
377001,Unruptured cerebral aneurysm,racial,Unknown,97,0,97
257628,Systemic lupus erythematosus,racial,Asian,78,18,96
434657,Weakness of face muscles,racial,White,55,41,96
134452,Miners' elbow,racial,White,37,60,97
140673,Hypothyroid,racial,American Indian,97,0,97
192279,Diabetic nephropathy,racial,Native Hawaiian or Other Pacific Islander ,53,44,97
316822,Finding of heart murmur,racial,Black or African American ,55,41,96
4084229,Primary gout,racial,Other Race,14,83,97
79116,Disorder of tendon of shoulder region,racial,White,44,53,97
255919,Finding of head and neck region,racial,Unknown,39,58,97
74114,Cellulitis and abscess of foot excluding toe,ethnic,Not Hispanic or Latino,32,64,96
436078,Malnutrition of moderate degree (Gomez: 60% to less than 75% of standard weight),racial,Unknown,76,21,97
140362,Hypoparathyroidism,racial,Unknown,76,21,97
438698,"Malignant lymphoma of lymph nodes of head, face AND/OR neck",racial,White,97,0,97
193522,Acute prostatitis,racial,Unknown,0,97,97
443409,On examination - left lower abdominal mass,racial,White,85,12,97
137944,Bullous dermatosis,racial,White,21,76,97
440519,Premature - weight 1000g-2499g or gestation of 28-37weeks,racial,White,60,37,97
141941,Cervical spondylosis without myelopathy,ethnic,Not Hispanic or Latino,85,12,97
437677,Abnormal findings on diagnostic imaging of lung,ethnic,Not Hispanic or Latino,41,55,96
193552,Furuncle of skin AND/OR subcutaneous tissue,ethnic,Not Hispanic or Latino,48,48,96
30437,Gastroesophageal reflux disease with esophagitis,racial,Other Race,51,46,97
434169,Abnormal findings on diagnostic imaging of breast,racial,Other Race,97,0,97
31317,Can't get food down,racial,Black or African American ,14,83,97
440081,Barbiturate dependence,ethnic,Hispanic or Latino,28,69,97
135526,Myelopathy,ethnic,Hispanic or Latino,37,60,97
443933,Nicotiana tabacum poisoning,ethnic,Hispanic or Latino,64,32,96
436391,Primary cerebellar degeneration,ethnic,Hispanic or Latino,58,39,97
78605,Superficial bruising of elbow,racial,White,53,44,97
319049,Acute respiratory failure,ethnic,Hispanic or Latino,37,60,97
377886,Chronic purulent otitis media,racial,Unknown,9,87,96
440083,Acute stress disorder,ethnic,Not Hispanic or Latino,83,14,97
439120,Aseptic necrosis of head AND/OR neck of femur,ethnic,Not Hispanic or Latino,37,60,97
433752,Impulse control disorder,racial,Asian,0,97,97
444129,Wrist injury,ethnic,Not Hispanic or Latino,55,41,96
440279,Accident,racial,White,51,46,97
75860,Costiveness,racial,American Indian or Alaska Native ,62,35,97
133141,Tinea pedis,racial,Black or African American ,30,67,97
198363,Candidiasis of vagina,racial,Black or African American ,97,0,97
4100365,Schizophrenic disorders,ethnic,Hispanic or Latino,87,9,96
317248,Disorder of hematopoietic structure,ethnic,Not Hispanic or Latino,41,55,96
74892,Articular gout,ethnic,Hispanic or Latino,18,78,96
432590,Delusional disorder,racial,White,51,46,97
380378,Epilepsy,racial,Other Race,97,0,97
378161,Disorder of ear,racial,White,60,37,97
443415,Gestation greater than 24 weeks,ethnic,Hispanic or Latino,58,39,97
436298,Adverse reaction to food,racial,Black or African American ,37,60,97
4230642,Acquired deformity of chest,racial,White,94,2,96
438005,Closed fracture shaft of fibula,ethnic,Hispanic or Latino,81,16,97
141038,Diastolic dysfunction,racial,White,64,32,96
77635,Disease of hand,racial,Asian,78,18,96
141831,Branchial arch syndrome,ethnic,Hispanic or Latino,30,67,97
77074,Joint pain,racial,Black or African American ,55,41,96
137944,Bullous dermatosis,ethnic,Hispanic or Latino,18,78,96
197684,Dysuria,racial,Filipino,71,25,96
259153,Throat soreness,racial,Asian,67,30,97
433751,Prolonged depressive adjustment reaction,ethnic,Not Hispanic or Latino,92,5,97
4005933,Urethral meatus underneath penis,ethnic,Hispanic or Latino,0,97,97
4008089,Dysentery,ethnic,Hispanic or Latino,55,41,96
260427,Common cold,racial,Asian,51,46,97
440921,Traumatic injury,racial,White,46,51,97
444243,Neurotic disorder,ethnic,Hispanic or Latino,53,44,97
377885,Disorder of eye movements,ethnic,Not Hispanic or Latino,48,48,96
437165,Motor vehicle traffic accident,racial,Unknown,55,41,96
4179963,Family history of malignant neoplasm of breast,ethnic,Not Hispanic or Latino,94,2,96
77029,Epididymo-orchitis without abscess,ethnic,Hispanic or Latino,0,97,97
379019,Inflammation of conjunctiva,racial,Black or African American ,51,46,97
4179963,Family history of malignant neoplasm of breast,racial,Unknown,97,0,97
437688,Abnormal findings on antenatal screening of mother,racial,White,97,0,97
313236,Cough variant asthma,racial,Asian,46,51,97
133294,Prepatellar bursitis,racial,White,23,74,97
4167406,Eye disorder screening,racial,Unknown,44,53,97
4150307,Dental restoration observation,racial,Asian,62,35,97
77421,Open wound of hand except fingers without complication,ethnic,Not Hispanic or Latino,25,71,96
79072,Inflammatory disorder of breast,ethnic,Not Hispanic or Latino,81,16,97
432517,Posttraumatic wound infection,racial,White,35,62,97
432597,Schizoaffective schizophrenia,racial,Black or African American ,85,9,94
374948,Acute nonsuppurative otitis media,racial,Unknown,46,48,94
73341,Closed fracture of head of radius,racial,White,39,55,94
435950,Closed Colles' fracture,racial,White,81,14,95
76565,Shoulder bruise,ethnic,Hispanic or Latino,51,44,95
440385,Obstructive hydrocephalus,ethnic,Not Hispanic or Latino,37,58,95
74135,Disorder of synovium,ethnic,Hispanic or Latino,46,48,94
441126,Monosomy and deletion from autosome,racial,White,44,51,95
73089,Contusion of buttock,ethnic,Hispanic or Latino,71,23,94
139179,Open wound of lip without complication,ethnic,Hispanic or Latino,23,71,94
194491,Tenderness of epigastrium,ethnic,Hispanic or Latino,78,16,94
440438,Anodontia,racial,Unknown,71,23,94
440329,Herpes zoster without complication,racial,Other Race,30,64,94
436176,Spontaneous abortion without complication,racial,White,94,0,94
432554,Human immunodeficiency virus II infection,ethnic,Hispanic or Latino,35,60,95
442794,Poisoning by wasp sting,racial,White,53,41,94
435219,Schizophrenia in remission,racial,White,60,35,95
437655,Cryptorchism,racial,Unknown,0,94,94
136368,Non-toxic multinodular goiter,ethnic,Not Hispanic or Latino,87,7,94
4196960,Varicocele,racial,White,2,92,94
372409,Sciatica neuralgia,racial,Black or African American ,60,35,95
254761,Cough,racial,American Indian or Alaska Native ,83,12,95
198263,Right upper quadrant pain,racial,Other Race,37,58,95
4090651,Dialysis observation,racial,Asian,90,5,95
441202,Generalized anaphylaxis,racial,White,62,32,94
320744,Complete atrioventricular block,ethnic,Hispanic or Latino,53,41,94
4046500,Acute peptic ulcer with hemorrhage,ethnic,Hispanic or Latino,94,0,94
199754,Primary malignant neoplasm of pancreas,ethnic,Hispanic or Latino,51,44,95
438134,Excessive sleep,racial,White,67,28,95
79873,Urolith,racial,White,64,30,94
436972,Glaucoma associated with systemic syndromes,racial,Other Race,41,53,94
81151,Sprain of ankle joint,racial,Other Race,55,39,94
197236,Uterine fibroid,racial,Asian,94,0,94
318459,Respiratory insufficiency,ethnic,Hispanic or Latino,32,62,94
25297,Acute pharyngitis,racial,American Indian or Alaska Native ,69,25,94
4105187,Speech or language developmental disorder NOS,ethnic,Hispanic or Latino,37,58,95
197036,Vesicoureteral reflux,racial,White,35,60,95
320136,Disease of respiratory system,racial,White,51,44,95
200527,Splenomegaly,racial,White,55,39,94
40483107,Inflamed seborrheic keratosis,ethnic,Hispanic or Latino,76,18,94
436375,Sodium and water depletion,racial,Unknown,94,0,94
256448,Chronic asthmatic bronchitis,racial,Native Hawaiian or Other Pacific Islander ,67,28,95
258453,Acute upper respiratory infection of multiple sites,racial,White,55,39,94
4141481,"Hand, foot and mouth disease",racial,Unknown,32,62,94
253788,Nasal polyp,racial,Unknown,51,44,95
81454,Injury of finger,ethnic,Not Hispanic or Latino,35,60,95
372423,Reduction deformities of brain,racial,White,78,16,94
441276,Nondependent alcohol abuse in remission,racial,Unknown,9,85,94
30163,Cellulitis and abscess of neck,racial,White,35,60,95
380055,Primary malignant neoplasm of brain,ethnic,Hispanic or Latino,67,28,95
197304,Ulcer of lower limb,ethnic,Not Hispanic or Latino,71,23,94
198809,Acute cholecystitis,ethnic,Hispanic or Latino,55,39,94
253954,PTB - Pulmonary tuberculosis,racial,White,60,35,95
312358,CGN - Chronic glomerulonephritis,racial,White,35,60,95
24970,Chronic laryngitis,ethnic,Hispanic or Latino,44,51,95
443111,Tenosynovitis of foot,ethnic,Hispanic or Latino,74,21,95
135338,Pemphigus,ethnic,Hispanic or Latino,81,14,95
260125,Acute bronchiolitis,racial,Black or African American ,25,69,94
195856,Cholangitis,racial,White,92,2,94
199078,Vaginal wall prolapse,racial,Unknown,94,0,94
81175,Contusion of chest,racial,Unknown,44,51,95
376382,Tension-type headache,racial,Asian,90,5,95
138604,"Contusion of face, scalp and neck, excluding eye(s)",ethnic,Not Hispanic or Latino,58,37,95
437394,Closed fracture of lower end of forearm,ethnic,Not Hispanic or Latino,60,35,95
30679,Benign tumour major salivary gland,ethnic,Hispanic or Latino,85,7,92
436253,Sprain of foot,racial,Unknown,53,39,92
438170,Acute myocardial infarction of inferior wall,ethnic,Hispanic or Latino,12,81,93
436583,[X]Falls,racial,Other Race,51,41,92
4170137,Non-suppurative otitis media,racial,Unknown,62,30,92
4062637,TB - Tuberculosis screening,racial,Native Hawaiian or Other Pacific Islander ,53,39,92
313459,Sleep apnea,racial,American Indian or Alaska Native ,76,16,92
74464,Idiopathic scoliosis AND/OR kyphoscoliosis,racial,Other Race,51,41,92
201907,Oedema of male genital organs,ethnic,Hispanic or Latino,0,92,92
79804,Myotonic dystrophy,racial,White,67,25,92
74396,TMJ - Temporomandibular joint disorder,ethnic,Not Hispanic or Latino,78,14,92
256622,Pulmonary disease due to Mycobacteria,ethnic,Hispanic or Latino,44,48,92
439082,Menopausal syndrome,racial,Other Race,92,0,92
133436,Thyrotoxic crisis,racial,Asian,92,0,92
257007,Allergic rhinitis,racial,Native Hawaiian or Other Pacific Islander ,21,71,92
4261613,Educational problem,ethnic,Not Hispanic or Latino,35,58,93
432447,Atypical glandular cells on cervical Papanicolaou smear,racial,Unknown,92,0,92
378414,Separation of retinal layers,racial,White,30,62,92
378752,Corneal opacity,ethnic,Hispanic or Latino,55,37,92
4305080,Abnormal breathing,ethnic,Hispanic or Latino,48,44,92
27321,Persistent vomiting,ethnic,Hispanic or Latino,71,21,92
79069,Disease of rectum,racial,White,35,58,93
192353,Disorder of gallbladder,ethnic,Hispanic or Latino,81,12,93
439154,Abnormal findings on diagnostic imaging of skull and head,racial,White,39,53,92
435928,Abnormal decrease in weight,racial,Other Race,25,67,92
443675,Traumatic amputation of toe(s) without mention of complication,ethnic,Hispanic or Latino,39,53,92
381036,Multiple AND bilateral precerebral artery stenosis,ethnic,Hispanic or Latino,69,23,92
438244,Congenital hydrocephalus,racial,White,48,44,92
317585,Aortic aneurysm,racial,Unknown,9,83,92
255348,Polymyalgia rheumatica,racial,White,60,32,92
258482,Abscess of Bartholin's gland,racial,White,92,0,92
440373,Subchronic schizophrenia,ethnic,Hispanic or Latino,14,78,92
4008683,Anxiety neurosis,racial,Unknown,76,16,92
136495,Lichenification and lichen simplex chronicus,ethnic,Hispanic or Latino,62,30,92
4012491,Difficulty chewing,racial,White,76,16,92
79069,Disease of rectum,ethnic,Hispanic or Latino,35,58,93
261326,Viral pneumonia,racial,White,35,58,93
377252,Neurofibromatosis type 1,racial,White,37,55,92
76725,Fissure in ano,ethnic,Not Hispanic or Latino,46,46,92
196360,Primary malignant neoplasm of bladder,racial,White,14,78,92
74469,Light-for-dates without mention of fetal malnutrition,ethnic,Not Hispanic or Latino,2,90,92
72469,Closed dislocation of shoulder region,racial,White,37,55,92
434896,Benign neoplasm of skin of upper limb and shoulder,ethnic,Hispanic or Latino,67,25,92
72715,Exostosis,racial,White,60,32,92
197381,Epigastric pain,racial,Asian,64,28,92
442597,Meteorism,racial,White,83,9,92
375822,Neonatal obstruction of nasolacrimal duct,racial,White,48,44,92
313236,Cough variant asthma,racial,Black or African American ,35,58,93
372888,Sciatic nerve lesion,ethnic,Hispanic or Latino,83,9,92
72618,Disorder of muscle,racial,White,64,28,92
259153,Throat soreness,racial,Black or African American ,46,46,92
438409,Attention deficit hyperactivity disorder,racial,Other Race,12,81,93
376111,Unqualified visual loss of one eye,ethnic,Hispanic or Latino,58,35,93
30133,Acute laryngitis,ethnic,Not Hispanic or Latino,71,21,92
374914,Quadriplegia,racial,White,5,87,92
440689,Agranulocytosis,ethnic,Hispanic or Latino,67,25,92
135888,Decubitus ulcer,ethnic,Hispanic or Latino,41,51,92
4179332,Parent-child problem,ethnic,Hispanic or Latino,46,46,92
440321,Helicobacter-associated disease,racial,Asian,62,30,92
198700,Liver secondary cancer,ethnic,Hispanic or Latino,25,67,92
435802,Blepharospasm,ethnic,Hispanic or Latino,53,39,92
4161978,Patient on oxygen,ethnic,Not Hispanic or Latino,53,39,92
80816,Intervertebral disc degeneration,racial,Other Race,41,51,92
433450,Paranoid schizophrenia,ethnic,Not Hispanic or Latino,87,5,92
256622,Pulmonary disease due to Mycobacteria,racial,White,44,48,92
377802,Late effects of poliomyelitis,racial,White,60,32,92
4340380,Hepatitis C carrier,racial,Unknown,25,67,92
4060985,BMI 30+ - obesity,racial,Filipino,81,12,93
80495,Palindromic rheumatism of the pelvic region and thigh,racial,Unknown,78,12,90
193528,Third degree uterine prolapse,racial,White,90,0,90
201820,Diabetes mellitus,ethnic,Not Hispanic or Latino,28,62,90
443587,Diastolic heart failure,racial,Asian,41,48,89
4256640,Body mass index 40+ - severely obese,ethnic,Not Hispanic or Latino,67,23,90
140027,Herpetic gingivostomatitis,racial,Unknown,69,21,90
442270,Disease of duodenum,racial,Unknown,46,44,90
4055758,Temporomandibular joint disorder NOS,racial,White,67,23,90
318736,Migraine,racial,Black or African American ,69,21,90
4175226,Screening for malignant neoplasm of colon,racial,Native Hawaiian or Other Pacific Islander ,44,46,90
442067,Atopic dermatitis and related conditions,racial,Filipino,28,62,90
378419,AD - Alzheimer's disease,racial,Native Hawaiian or Other Pacific Islander ,81,9,90
438409,Attention deficit hyperactivity disorder,racial,Asian,30,60,90
432311,Angle-closure glaucoma - borderline,ethnic,Hispanic or Latino,69,21,90
4101660,Amputated below knee,racial,Unknown,48,41,89
437246,Vitamin B deficiency,racial,Unknown,32,58,90
381316,CVA - Cerebrovascular accident,ethnic,Not Hispanic or Latino,58,32,90
440382,LD - Learning difficulties,racial,Unknown,21,69,90
443617,Conduct disorder,ethnic,Not Hispanic or Latino,23,67,90
373786,Abnormal vision,racial,White,30,60,90
76161,Impotence of organic origin,racial,Asian,0,90,90
313217,Atrial fibrillation,racial,American Indian or Alaska Native ,67,23,90
4102739,Screening for cardiovascular system disease,ethnic,Hispanic or Latino,16,74,90
4319325,Acquired deformity of trunk,racial,Unknown,78,12,90
4103894,Hordeolum and other deep inflammation of eyelid NOS,ethnic,Hispanic or Latino,71,18,89
198715,Premature menopause,racial,Unknown,90,0,90
4193570,Abnormal results of hearing screening test,ethnic,Hispanic or Latino,32,58,90
200219,Abdominal pain,racial,American Indian or Alaska Native ,64,25,89
316127,Vitreous opacities,racial,White,51,39,90
259848,Chronic rhinitis,racial,Other Race,46,44,90
432588,Megaloblastic anemia due to vitamin B>12< deficiency,racial,Unknown,71,18,89
133414,Candidiasis of skin and nails,racial,Unknown,81,9,90
4168213,Chest pain on breathing,racial,Asian,18,71,89
439254,"Bipolar affective disorder, current episode depression",racial,White,90,0,90
443430,HPV - Human papillomavirus test positive,ethnic,Not Hispanic or Latino,78,12,90
4167075,Fusion of knee,ethnic,Hispanic or Latino,44,46,90
443622,Aneurysm of thoracic aorta,ethnic,Hispanic or Latino,48,41,89
4062495,Glaucoma screening,racial,Asian,58,32,90
436077,Developmental delay,racial,Unknown,35,55,90
435802,Blepharospasm,racial,White,58,32,90
4110815,"Sensorineural hearing loss, bilateral",ethnic,Not Hispanic or Latino,64,25,89
440465,Postpartum state,racial,Unknown,90,0,90
443876,Obsessive compulsive personality disorder,ethnic,Hispanic or Latino,85,5,90
201620,Calculus of kidney,racial,Asian,39,51,90
434742,Congenital abnormality of skull and face bones,ethnic,Not Hispanic or Latino,37,53,90
312723,Congenital heart disease,racial,Unknown,46,44,90
4230642,Acquired deformity of chest,racial,Unknown,87,2,89
81106,Acquired genu varum,racial,White,30,60,90
432867,Hyperlipidemia,racial,American Indian,39,51,90
440694,"Nondependent mixed drug abuse, episodic",ethnic,Hispanic or Latino,46,44,90
198194,Female genital organ symptoms,racial,Black or African American ,90,0,90
74130,Thoracic spondylosis without myelopathy,ethnic,Hispanic or Latino,55,35,90
73843,Synovial cyst of popliteal space,racial,White,44,46,90
77373,Congenital deformity of hip joint,racial,White,62,28,90
4138253,Malabsorption syndrome,ethnic,Hispanic or Latino,81,9,90
201620,Calculus of kidney,racial,Other Race,55,35,90
197318,Cholesterolosis of gallbladder,racial,White,55,35,90
4090550,Evening colic,racial,White,55,35,90
198101,Lipoma of skin and subcutaneous tissue (excluding face),ethnic,Not Hispanic or Latino,48,41,89
4167075,Fusion of knee,racial,White,51,39,90
132344,Gingival and periodontal disease,racial,Unknown,30,60,90
30133,Acute laryngitis,racial,Unknown,76,14,90
135333,Pressure sore,racial,Unknown,53,37,90
440069,Drug dependence,racial,Unknown,23,67,90
435875,"Complications of pregnancy, childbirth and the puerperium",ethnic,Hispanic or Latino,87,2,89
138148,Plantar nerve lesion,racial,White,71,18,89
317585,Aortic aneurysm,racial,White,23,67,90
193525,Abdominal pregnancy,ethnic,Hispanic or Latino,90,0,90
441829,Hyperosmolality and or hypernatremia,ethnic,Hispanic or Latino,67,23,90
4055208,Chronic hepatitis unspecified,ethnic,Hispanic or Latino,55,32,87
437489,Herpes zoster with complication,ethnic,Hispanic or Latino,74,14,88
439141,Abnormal increase in weight,racial,Asian,9,78,87
80189,Displacement of lumbar intervertebral disc without myelopathy,racial,Black or African American ,62,25,87
200450,Disease of urethra,racial,White,55,32,87
193787,Varicose veins of lower extremity with ulcer AND inflammation,racial,White,41,46,87
194158,Perinatal gastrointestinal hemorrhage,ethnic,Hispanic or Latino,30,58,88
440535,Abnormal radiographic examination,ethnic,Hispanic or Latino,48,39,87
435219,Schizophrenia in remission,ethnic,Hispanic or Latino,71,16,87
434610,Hyperkalemia,racial,Other Race,64,23,87
4005823,Tobacco user,racial,Asian,0,87,87
137063,Corns and callus,racial,Other Race,64,23,87
199075,Neurogenic bladder,ethnic,Not Hispanic or Latino,14,74,88
4062637,TB - Tuberculosis screening,racial,Filipino,46,41,87
200687,Renal disorder associated with type I diabetes mellitus,racial,Other Race,62,25,87
192273,Benign tumour of adrenal gland,ethnic,Hispanic or Latino,48,39,87
437525,Overweight,racial,Asian Indian,67,21,88
194611,CIN 3 - Cervical intraepithelial neoplasia grade 3,racial,Unknown,87,0,87
195867,Noninflammatory vaginal disorders,racial,Unknown,87,0,87
432453,General clinical state finding,racial,Unknown,71,16,87
78529,Kyphoscoliosis and scoliosis,racial,White,67,21,88
442116,Allergy to eggs,racial,White,21,67,88
376124,Pinguecula,racial,White,46,41,87
80767,Breast irregular nodularity,racial,Other Race,83,5,88
139750,Primary malignant neoplasm of skin,ethnic,Hispanic or Latino,58,30,88
441417,Lack of coordination,racial,White,37,51,88
440388,[X]Developmental co - ordination disorder,racial,White,14,74,88
193874,Bed wetting,racial,Unknown,39,48,87
316998,Left bundle branch block,racial,White,78,9,87
377560,Internal hordeolum,racial,Unknown,62,25,87
72990,Localised osteoarthrosis uncertain if primary OR secondary,racial,White,74,14,88
201337,Disorder of bladder and bladder neck,ethnic,Hispanic or Latino,55,32,87
314369,Malignant hypertensive heart disease without congestive heart failure,racial,White,44,44,88
317248,Disorder of hematopoietic structure,racial,Unknown,48,39,87
197610,Ovarian cyst,racial,Black or African American ,87,0,87
4318408,Subdural haematoma,ethnic,Hispanic or Latino,16,71,87
442425,Lumbar post-laminectomy syndrome,racial,Unknown,2,85,87
197378,Overflow incontinence of urine,racial,White,58,30,88
74132,Degeneration of lumbosacral intervertebral disc,racial,Other Race,46,41,87
439253,"Bipolar affective disorder, currently depressed, mild",ethnic,Not Hispanic or Latino,60,28,88
432941,Disease of tongue,racial,White,58,30,88
137213,Fungal dermatosis,racial,Unknown,53,35,88
194913,Idiopathic peripheral autonomic neuropathy,racial,Other Race,0,87,87
40491340,Closed fracture of tibia,racial,White,51,37,88
441259,Non-thrombocytopenic purpura,ethnic,Hispanic or Latino,46,41,87
372613,Flaccid hemiplegia,racial,White,14,74,88
439695,Hypertensive heart and renal disease with renal failure,racial,White,64,23,87
4101602,Henoch-Schonlein purpura,racial,White,25,62,87
440686,Residual schizophrenia in remission,racial,Unknown,0,87,87
139902,Allergic urticaria,ethnic,Not Hispanic or Latino,39,48,87
261880,Atelectasis,ethnic,Hispanic or Latino,62,25,87
140486,Ulcer of calf,ethnic,Hispanic or Latino,44,44,88
4103638,Amputated - transfemoral,racial,White,62,25,87
313878,Respiratory symptoms,racial,American Indian or Alaska Native ,69,18,87
437233,Plasmacytic myeloma,ethnic,Not Hispanic or Latino,87,0,87
437677,Abnormal findings on diagnostic imaging of lung,racial,Unknown,5,83,88
436681,Insomnia disorder related to known organic factor,ethnic,Hispanic or Latino,39,48,87
4086918,Viral screening,racial,American Indian or Alaska Native ,69,18,87
443415,Gestation greater than 24 weeks,racial,White,74,14,88
79127,Congenital spondylolisthesis,racial,White,55,32,87
437251,Benign neoplasm of pituitary gland and craniopharyngeal duct,racial,Black or African American ,0,87,87
255334,Collagen disease,ethnic,Hispanic or Latino,67,21,88
435889,Decubitus ulcer of ankle,ethnic,Hispanic or Latino,37,51,88
320746,Cardiomyopathy associated with another disorder,ethnic,Not Hispanic or Latino,0,87,87
201078,Senile atrophic vaginitis,ethnic,Not Hispanic or Latino,78,9,87
23220,Chronic tonsillitis,racial,White,48,39,87
4148407,Family history: Cardiovascular disease,ethnic,Hispanic or Latino,37,51,88
379010,Macular retinal puckering,racial,Unknown,78,9,87
195906,Disorder of lumbar spine,ethnic,Not Hispanic or Latino,14,74,88
4250023,Severe major depression with psychotic features,racial,Black or African American ,37,51,88
435810,After-cataract,racial,White,48,39,87
4263370,R.I.N.D. syndrome,racial,Asian,18,67,85
437986,FTT - Failure to thrive,racial,Black or African American ,18,67,85
136934,Primary hyperparathyroidism,racial,White,46,39,85
378849,Microtia,ethnic,Hispanic or Latino,37,48,85
433885,Closed supracondylar fracture of humerus,ethnic,Hispanic or Latino,41,44,85
78474,Hypertrophy of breast,racial,Unknown,18,67,85
440751,Peritonsillar abscess,racial,White,39,46,85
192359,RF - Renal failure,ethnic,Not Hispanic or Latino,37,48,85
201606,Crohn's disease,ethnic,Not Hispanic or Latino,35,51,86
138996,Carcinoma in situ of skin,ethnic,Hispanic or Latino,58,28,86
432867,Hyperlipidemia,racial,Asian Indian,32,53,85
4064905,Venereal disease screening,racial,Asian,46,39,85
80946,Tinea manus,ethnic,Hispanic or Latino,37,48,85
137626,Seborrhoeic eczema of scalp,ethnic,Not Hispanic or Latino,18,67,85
75052,Enthesopathy of wrist AND/OR carpus,racial,White,67,18,85
443237,"Manic disorder, single episode",ethnic,Not Hispanic or Latino,69,16,85
201927,Cellulitis and abscess of leg,racial,Other Race,48,37,85
376208,Soft tissue disorder,racial,White,30,55,85
80141,Functional diarrhea,ethnic,Hispanic or Latino,55,30,85
435508,Adrenal cortical hypofunction,ethnic,Not Hispanic or Latino,25,60,85
381842,Petit mal status,ethnic,Not Hispanic or Latino,53,32,85
380839,TS - Tuberous sclerosis,racial,Unknown,78,7,85
436839,Closed fracture of metacarpal bone,racial,Unknown,21,64,85
377885,Disorder of eye movements,racial,Unknown,53,32,85
381306,Deaf mutism,racial,White,53,32,85
434376,Acute myocardial infarction of anterior wall,racial,Asian,67,18,85
374882,Benign connective tissue neoplasm,ethnic,Hispanic or Latino,58,28,86
437828,Disorder of calcium metabolism,racial,Unknown,60,25,85
315947,Thoracic back sprain,ethnic,Not Hispanic or Latino,48,37,85
194286,"Malignant neoplasm of corpus uteri, excluding isthmus",racial,White,85,0,85
440788,Hyperemesis gravidarum with metabolic disturbance - not delivered,ethnic,Hispanic or Latino,85,0,85
134765,General body deterioration,racial,White,39,46,85
4093344,Prostate observation,racial,Black or African American ,0,85,85
197925,Haemorrhage of rectum and anus,racial,Other Race,32,53,85
436147,Glossitis,ethnic,Hispanic or Latino,58,28,86
4064381,Nephropathy screening,racial,Unknown,60,25,85
201343,Acute alcoholic liver disease,ethnic,Hispanic or Latino,16,69,85
132553,Herpangina,racial,Unknown,37,48,85
440424,Aphasia,racial,Other Race,2,83,85
437995,Closed ill-defined fractures of upper limb,racial,Unknown,83,2,85
376382,Tension-type headache,racial,Other Race,62,23,85
79873,Urolith,racial,Unknown,37,48,85
377001,Unruptured cerebral aneurysm,ethnic,Not Hispanic or Latino,64,21,85
440700,Communicating hydrocephalus,ethnic,Hispanic or Latino,9,76,85
376707,Acute conjunctivitis,racial,Asian,44,41,85
75354,Osteochondropathy,racial,Other Race,76,9,85
378424,Astigmatism,racial,White,53,32,85
256449,Bronchiectasis,racial,White,83,2,85
443344,Barrett esophagus,ethnic,Not Hispanic or Latino,51,35,86
435216,Disorder associated with type I diabetes mellitus,ethnic,Not Hispanic or Latino,28,58,86
40491340,Closed fracture of tibia,racial,Unknown,71,14,85
443228,"Abrasion or friction burn of foot and toe, without mention of infection",racial,White,39,46,85
75036,Primary localized osteoarthrosis of hand,racial,White,69,16,85
199754,Primary malignant neoplasm of pancreas,racial,Unknown,46,39,85
4028253,Neoplasm of digestive system,racial,White,62,23,85
4201387,Tracheostomy in situ,racial,Black or African American ,78,7,85
434119,Hidradenitis,ethnic,Not Hispanic or Latino,67,18,85
77395,Current tear of semilunar cartilage,racial,Unknown,46,39,85
4166776,Dupuytren contracture,racial,White,23,62,85
141104,Intervertebral disc disorder of lumbar region with myelopathy,racial,Other Race,28,58,86
4326601,Anorectal abscess,ethnic,Not Hispanic or Latino,44,41,85
375823,Optic nerve hypoplasia,ethnic,Hispanic or Latino,32,53,85
441547,Oppositional defiant disorder,ethnic,Hispanic or Latino,7,78,85
4155526,Acute otitis media with effusion,racial,White,23,62,85
374950,Oedema of eyelid,racial,White,55,30,85
437474,Postoperative infection,racial,White,76,9,85
141090,PG - Pyogenic granuloma,racial,White,37,48,85
74125,Inflammatory polyarthropathy,ethnic,Hispanic or Latino,64,21,85
437966,Calcium deposits in tendon,ethnic,Hispanic or Latino,55,30,85
436265,Open wound of multiple sites of one lower limb AND thigh without complication,ethnic,Hispanic or Latino,62,23,85
77029,Epididymo-orchitis without abscess,racial,White,0,83,83
438962,Herpes simplex with complication,racial,White,25,58,83
444115,Disorder of bursa,ethnic,Hispanic or Latino,46,37,83
440216,Abnormal glucose tolerance test,racial,Other Race,58,25,83
31967,Nausea,racial,Other Race,62,21,83
194611,CIN 3 - Cervical intraepithelial neoplasia grade 3,ethnic,Not Hispanic or Latino,83,0,83
78474,Hypertrophy of breast,ethnic,Not Hispanic or Latino,28,55,83
133141,Tinea pedis,racial,Asian,35,48,83
134074,Oral soft tissue cellulitis,racial,White,53,30,83
376647,Primary malignant neoplasm of soft tissues,ethnic,Hispanic or Latino,14,69,83
436118,After-cataract with vision obscured,racial,White,51,32,83
4263325,Actinic cheilitis,ethnic,Hispanic or Latino,46,37,83
141508,Dermatophytosis of scalp or beard,racial,Unknown,23,60,83
436245,Atypical glandular cells on vaginal Papanicolaou smear,racial,Unknown,83,0,83
198289,Nonvenomous insect bite of hip without infection,ethnic,Hispanic or Latino,60,23,83
198263,Right upper quadrant pain,racial,Asian,55,28,83
381859,Infective OE,racial,Asian,44,39,83
4307254,Closed fracture,racial,Unknown,48,35,83
440530,Oropharyngeal dysphagia,racial,White,53,30,83
75010,Fibroadenosis of breast,ethnic,Hispanic or Latino,83,0,83
198550,"Atresia and stenosis of large intestine, rectum and anal canal",racial,White,21,62,83
252658,Intrinsic asthma without status asthmaticus,ethnic,Not Hispanic or Latino,53,30,83
138176,Acute gingivitis,ethnic,Not Hispanic or Latino,58,25,83
437536,Somatoform autonomic dysfunction - gastrointestinal tract,ethnic,Hispanic or Latino,30,53,83
440685,"Nondependent alcohol abuse, episodic",ethnic,Not Hispanic or Latino,21,62,83
433885,Closed supracondylar fracture of humerus,racial,White,32,51,83
78529,Kyphoscoliosis and scoliosis,racial,Unknown,12,71,83
140020,Viral exanthem,racial,Unknown,32,51,83
379832,Mixed conductive and sensorineural deafness,racial,Unknown,64,18,82
433527,Endometriosis,racial,White,83,0,83
79884,Galactorrhea not associated with childbirth,ethnic,Not Hispanic or Latino,83,0,83
319034,Hypertensive heart disease without congestive heart failure,ethnic,Not Hispanic or Latino,74,9,83
72457,Closed fracture of sacrum AND/OR coccyx without spinal cord injury,ethnic,Hispanic or Latino,67,16,83
193249,Acute erosive gastritis,ethnic,Hispanic or Latino,51,32,83
195562,Hemorrhoids,racial,Black or African American ,44,39,83
4030270,Proliferative polycythemia,racial,Unknown,0,83,83
192731,Digestive symptom,ethnic,Not Hispanic or Latino,62,21,83
254591,Secondary malignant tumour of lung,racial,White,83,0,83
196436,Internal haemorrhoid,racial,White,28,55,83
73075,Contusion of upper limb,ethnic,Hispanic or Latino,62,21,83
372247,Candidal otomycosis,ethnic,Hispanic or Latino,74,9,83
135745,Exanthema subitum,ethnic,Hispanic or Latino,41,41,82
141831,Branchial arch syndrome,racial,White,25,58,83
196359,Primary malignant neoplasm of uterine cervix,racial,Other Race,83,0,83
439155,Carcinoembryonic antigen present,racial,Unknown,46,37,83
440465,Postpartum state,ethnic,Not Hispanic or Latino,76,7,83
439406,Allergy to animal,racial,Unknown,44,39,83
442139,Primary bronchial cancer,ethnic,Not Hispanic or Latino,9,74,83
444375,"Contact dermatitis due to plants, except food",ethnic,Hispanic or Latino,48,35,83
134569,Erythema infectiosum,ethnic,Hispanic or Latino,28,55,83
28060,Strept throat,racial,Black or African American ,32,51,83
375824,Abnormal auditory perception,ethnic,Hispanic or Latino,44,39,83
443577,Asymmetric sensorineural hearing loss,racial,Unknown,46,37,83
197607,Polymenorrhagia,racial,Black or African American ,83,0,83
439080,Dyspareunia,racial,Unknown,83,0,83
75897,Polyarthropathy,ethnic,Hispanic or Latino,67,16,83
257628,Systemic lupus erythematosus,racial,Other Race,30,53,83
4228802,Mild recurrent major depression,racial,Asian,58,25,83
321462,Cardiac complications of care,racial,White,25,58,83
438836,Poliomyelitis osteopathy of the lower leg,racial,Unknown,7,76,83
4171430,Screening for malignant neoplasm of rectum,racial,Other Race,21,62,83
141104,Intervertebral disc disorder of lumbar region with myelopathy,racial,Black or African American ,21,62,83
436940,Insulin resistance syndrome,ethnic,Not Hispanic or Latino,64,18,82
4290927,Impairment level: low vision of both eyes,racial,Unknown,48,35,83
73553,Arthropathy,racial,Filipino,83,0,83
78832,Intervertebral disc disorder with myelopathy,racial,White,55,28,83
438722,Non megaloblastic anemia associated with nutritional deficiency,ethnic,Hispanic or Latino,71,12,83
312934,Atherosclerosis of aorta,racial,Asian,46,37,83
444112,Integumentary system finding,ethnic,Not Hispanic or Latino,51,32,83
73571,Pathological fracture,racial,Unknown,64,18,82
201069,"Peptic ulcer without hemorrhage, without perforation AND without obstruction",racial,Filipino,81,0,81
373474,Seeing double,racial,White,23,58,81
374025,Retinal haemorrhages,racial,White,55,25,80
197044,Female infertility associated with anovulation,racial,White,81,0,81
81377,Climacteric arthritis of the lower leg,ethnic,Hispanic or Latino,62,18,80
80512,Acquired kyphosis,ethnic,Hispanic or Latino,71,9,80
378735,Migraine without aura,ethnic,Not Hispanic or Latino,78,2,80
257628,Systemic lupus erythematosus,racial,Black or African American ,81,0,81
194871,Trichomonal vulvovaginitis,ethnic,Hispanic or Latino,81,0,81
380055,Primary malignant neoplasm of brain,racial,White,62,18,80
201603,Disease of teeth AND/OR supporting structures,racial,Other Race,21,60,81
315078,Palpitations,racial,Black or African American ,51,30,81
201530,"Diabetes mellitus, adult onset, with hyperosmolar coma",racial,White,58,23,81
381581,Chalazion,ethnic,Not Hispanic or Latino,41,39,80
378756,Conjunctival hemorrhage,ethnic,Not Hispanic or Latino,41,39,80
193782,End stage renal disease,racial,Black or African American ,18,62,80
439004,Restzustand,racial,White,0,81,81
4181604,Subcutaneous contraceptive implant,ethnic,Hispanic or Latino,81,0,81
195259,Entrapment of lateral cutaneous nerve of thigh,racial,White,51,30,81
197988,General abdominal pain-symptom,racial,Other Race,69,12,81
377291,"Peripheral pterygium, progressive",ethnic,Hispanic or Latino,41,39,80
434896,Benign neoplasm of skin of upper limb and shoulder,racial,White,48,32,80
40481820,Flaccid hemiplegia of nondominant side,ethnic,Hispanic or Latino,48,32,80
4239721,Seafood allergy,ethnic,Hispanic or Latino,55,25,80
4112525,Acute bronchiolitis NOS,racial,Unknown,30,51,81
77403,Closed fracture of vertebral column without spinal cord injury,ethnic,Not Hispanic or Latino,53,28,81
376707,Acute conjunctivitis,racial,Other Race,60,21,81
24970,Chronic laryngitis,racial,White,41,39,80
437394,Closed fracture of lower end of forearm,racial,Unknown,51,30,81
193519,Impaired renal function disorder,racial,White,46,35,81
439155,Carcinoembryonic antigen present,ethnic,Hispanic or Latino,62,18,80
135852,Teething syndrome,ethnic,Not Hispanic or Latino,21,60,81
439846,LVF - Left ventricular failure,ethnic,Not Hispanic or Latino,9,71,80
198550,"Atresia and stenosis of large intestine, rectum and anal canal",ethnic,Hispanic or Latino,21,60,81
80242,Current tear of medial cartilage AND/OR meniscus of knee,ethnic,Not Hispanic or Latino,55,25,80
194382,External haemorrhoid,racial,Unknown,71,9,80
375281,Acute suppurative otitis media - tympanic membrane intact,racial,Asian,35,46,81
74080,Orthostatic proteinuria,ethnic,Hispanic or Latino,25,55,80
253321,Stridor,ethnic,Hispanic or Latino,28,53,81
24966,OV - Oesophageal varices,racial,Unknown,55,25,80
4109253,Pterygium NOS,ethnic,Hispanic or Latino,30,51,81
378165,Nystagmus,racial,White,51,30,81
318186,Achalasia of esophagus,ethnic,Hispanic or Latino,76,5,81
4110047,Chronic bronchitis NOS,racial,Unknown,30,51,81
254061,Pleural effusion,racial,Unknown,32,48,80
134144,Cleft palate with cleft lip,ethnic,Not Hispanic or Latino,37,44,81
436666,Psychosexual disorder,ethnic,Hispanic or Latino,14,67,81
78473,Solitary cyst of breast,ethnic,Not Hispanic or Latino,78,2,80
442793,Diabetic complication,racial,Black or African American ,58,23,81
316432,Right bundle branch block AND left anterior fascicular block,ethnic,Hispanic or Latino,28,53,81
138717,Thyrotoxicosis with diffuse goitre,ethnic,Hispanic or Latino,71,9,80
199754,Primary malignant neoplasm of pancreas,ethnic,Not Hispanic or Latino,67,14,81
321042,Cardiac arrest,ethnic,Hispanic or Latino,30,51,81
437241,Qualitative platelet defect,racial,White,25,55,80
201603,Disease of teeth AND/OR supporting structures,racial,Asian,48,32,80
381292,Chronic allergic conjunctivitis,racial,Black or African American ,28,53,81
4115173,Atrial premature complex,ethnic,Hispanic or Latino,44,37,81
433599,Abnormal biochemistry finding,racial,Other Race,7,74,81
433227,Abnormal sensation,ethnic,Hispanic or Latino,53,28,81
320073,Neutrophil count below reference range,ethnic,Not Hispanic or Latino,53,28,81
315273,MS - Mitral stenosis,ethnic,Hispanic or Latino,76,5,81
438407,BN - Bulimia nervosa,ethnic,Hispanic or Latino,69,12,81
435656,Neonatal jaundice,ethnic,Not Hispanic or Latino,25,55,80
81390,Idiopathic osteoporosis,ethnic,Not Hispanic or Latino,81,0,81
252365,MGN - Membranous glomerulonephritis,ethnic,Not Hispanic or Latino,14,67,81
321314,Abdominal aortic aneurysm without rupture,racial,Asian,28,53,81
381549,Migraine with aura,racial,Unknown,71,9,80
4018734,Sprain of costal cartilage,ethnic,Not Hispanic or Latino,46,35,81
432612,Mild mental handicap,racial,Unknown,35,46,81
4086928,IUCD status,racial,Unknown,81,0,81
436070,Vitamin D deficiency,racial,Other Race,62,18,80
31821,Endocrinopathy,ethnic,Hispanic or Latino,48,32,80
76611,Injury of shoulder region,ethnic,Not Hispanic or Latino,39,41,80
444093,Patient status finding,racial,Unknown,67,14,81
317009,Hyperreactive airway disease,racial,American Indian,64,16,80
433440,Dysthymia,racial,Black or African American ,81,0,81
320073,Neutrophil count below reference range,racial,Unknown,58,23,81
195856,Cholangitis,ethnic,Not Hispanic or Latino,81,0,81
197378,Overflow incontinence of urine,racial,Unknown,74,7,81
4196960,Varicocele,racial,Unknown,2,78,80
440748,Interstitial emphysema of lung,racial,Black or African American ,9,71,80
374914,Quadriplegia,ethnic,Hispanic or Latino,2,78,80
436033,Syphilis,racial,Unknown,37,44,81
78232,Shoulder joint pain,racial,American Indian or Alaska Native ,48,30,78
321107,AR - Congenital aortic regurgitation,ethnic,Hispanic or Latino,25,53,78
4064925,Hypertension screening,racial,Unknown,60,18,78
4018734,Sprain of costal cartilage,racial,Unknown,55,23,78
313761,Central retinal vein occlusion,ethnic,Hispanic or Latino,44,35,79
432661,Stomatitis,ethnic,Not Hispanic or Latino,46,32,78
312358,CGN - Chronic glomerulonephritis,racial,Unknown,55,23,78
380096,Proliferative diabetic retinopathy,racial,Other Race,37,41,78
196158,Disease of penis,racial,Unknown,0,78,78
4204904,Education about sexually transmitted disease prevention,racial,Unknown,71,7,78
200051,Primary malignant neoplasm of ovary,racial,White,78,0,78
77965,Nodular tendinous disease of finger,racial,Other Race,44,35,79
196168,Irregular menstrual bleeding,racial,Black or African American ,78,0,78
436391,Primary cerebellar degeneration,racial,White,51,28,79
72465,Closed fracture of one or more phalanges of hand,ethnic,Not Hispanic or Latino,44,35,79
442790,Growth and development,ethnic,Hispanic or Latino,48,30,78
4133029,Primigravida,racial,Black or African American ,78,0,78
4028716,Idiopathic thrombocythemia,racial,Asian,28,51,79
444297,Vertiginous syndrome,ethnic,Hispanic or Latino,60,18,78
137977,Icteric,racial,Unknown,9,69,78
197206,Balantidiasis,racial,White,0,78,78
441974,Closed fracture of forearm,racial,Unknown,37,41,78
134898,Non-toxic single thyroid nodule,racial,Asian,69,9,78
194993,Intestinal malabsorption,ethnic,Hispanic or Latino,46,32,78
40480668,Chronic inflammatory demyelinating polyneuritis,racial,Unknown,78,0,78
318397,Chronic idiopathic thrombocytopenic purpura,racial,White,16,62,78
4146248,Rheumatoid arthritis and other inflammatory polyarthropathies,racial,Unknown,76,2,78
432582,Neoplastic disease of uncertain behavior,racial,White,39,39,78
379801,Trigeminal neuralgia,ethnic,Not Hispanic or Latino,64,14,78
192680,Portal hypertension,racial,Unknown,62,16,78
140489,Acquired acanthosis nigricans,ethnic,Not Hispanic or Latino,44,35,79
444239,Postprocedural state finding,racial,Black or African American ,44,35,79
4104710,Parkinson's disease NOS,ethnic,Hispanic or Latino,69,9,78
4133029,Primigravida,racial,Other Race,78,0,78
135852,Teething syndrome,racial,Unknown,18,60,78
381839,Habit disorder,ethnic,Hispanic or Latino,25,53,78
438244,Congenital hydrocephalus,racial,Other Race,62,16,78
434374,Anisocoria,ethnic,Hispanic or Latino,46,32,78
4108975,Borderline glaucoma NOS,ethnic,Hispanic or Latino,76,2,78
4005823,Tobacco user,racial,Black or African American ,28,51,79
198683,Viral hepatitis B without hepatic coma,ethnic,Hispanic or Latino,71,7,78
433527,Endometriosis,ethnic,Hispanic or Latino,78,0,78
437058,Sunburn,ethnic,Hispanic or Latino,30,48,78
440382,LD - Learning difficulties,ethnic,Not Hispanic or Latino,30,48,78
438879,Closed bimalleolar fracture,racial,Unknown,71,7,78
377527,Presenile dementia with depression,racial,Black or African American ,78,0,78
40481820,Flaccid hemiplegia of nondominant side,racial,Unknown,14,64,78
40480668,Chronic inflammatory demyelinating polyneuritis,ethnic,Not Hispanic or Latino,78,0,78
441276,Nondependent alcohol abuse in remission,ethnic,Not Hispanic or Latino,28,51,79
4201390,Colostomy present,ethnic,Not Hispanic or Latino,76,2,78
30361,Hypoglycemic disorder,ethnic,Hispanic or Latino,67,12,79
80509,Bone cyst,ethnic,Hispanic or Latino,37,41,78
134461,Tietze disease,racial,Other Race,62,16,78
435648,Testicular retraction,ethnic,Hispanic or Latino,0,78,78
81942,Enthesopathy of ankle AND/OR tarsus,racial,White,39,39,78
193255,"Noninflammatory disorders of the ovary, fallopian tube and broad ligament",ethnic,Hispanic or Latino,78,0,78
200762,Autoimmune hepatitis,ethnic,Hispanic or Latino,37,41,78
437671,Abnormal feces,racial,White,58,21,79
135287,Non-neoplastic naevus,ethnic,Not Hispanic or Latino,41,37,78
24660,Acute tonsillitis,racial,Black or African American ,35,44,79
432729,Crying infant,racial,White,30,48,78
134116,Dermatitis due to drug AND/OR medicine taken internally,racial,White,32,46,78
260427,Common cold,racial,Black or African American ,37,41,78
437954,Lateral meniscus derangement,ethnic,Hispanic or Latino,35,44,79
137497,Dermatophytosis of the body,racial,Black or African American ,44,35,79
4090651,Dialysis observation,racial,Other Race,12,67,79
252663,Pneumonitis due to inhalation of food or vomitus,ethnic,Hispanic or Latino,51,28,79
199866,Acute gastritis,racial,Asian,30,48,78
137379,Musculoskeletal symptom,racial,Asian,46,32,78
319041,Orthostatic hypotension,ethnic,Not Hispanic or Latino,14,64,78
433701,Mycosis,racial,White,58,21,79
27674,N&V - Nausea and vomiting,racial,Black or African American ,21,58,79
4110787,Other otitis externa,ethnic,Hispanic or Latino,58,21,79
437092,Physiological development failure,racial,Other Race,67,12,79
75623,Old disruption of anterior cruciate ligament,ethnic,Not Hispanic or Latino,41,37,78
193251,Umbilical hernia without obstruction AND without gangrene,racial,Other Race,64,14,78
4252735,Mourning,racial,Black or African American ,71,7,78
194491,Tenderness of epigastrium,racial,White,60,18,78
434854,FP - Food poisoning,racial,White,41,37,78
253797,Post-inflammatory pulmonary fibrosis,ethnic,Not Hispanic or Latino,74,5,79
192353,Disorder of gallbladder,racial,White,69,9,78
78234,Arthralgia of the hand,racial,Other Race,64,14,78
4210151,HIV counseling,racial,White,60,18,78
438407,BN - Bulimia nervosa,racial,White,58,21,79
442615,Carotid artery stenosis,racial,Asian,55,23,78
197675,Bowel incontinence,racial,White,60,18,78
4024567,Respiratory observation,ethnic,Hispanic or Latino,30,48,78
432878,Drug abuse using speed,racial,White,39,39,78
373999,Diabetic oculopathy associated with type I diabetes mellitus,ethnic,Not Hispanic or Latino,28,51,79
440927,High risk drug monitoring status,racial,White,53,25,78
4150307,Dental restoration observation,racial,Unknown,64,14,78
73045,Hand sprain,ethnic,Not Hispanic or Latino,37,41,78
201927,Cellulitis and abscess of leg,racial,Asian,51,28,79
192376,Rhesus isoimmunization with antenatal problem,ethnic,Hispanic or Latino,76,0,76
198928,Mechanical complication due to intrauterine contraceptive device,ethnic,Hispanic or Latino,76,0,76
4029488,Hepatic encephalopathy,racial,White,18,58,76
4092896,Stool contents abnormal,racial,Asian,48,28,76
440457,Threatened abortion,racial,White,76,0,76
443753,Abrasion AND/OR friction burn of wrist without infection,racial,White,25,51,76
194077,Chronic ulcerative enterocolitis,racial,White,9,67,76
77673,Sign or symptom of the urinary system,racial,White,35,41,76
258540,Marfan syndrome,ethnic,Hispanic or Latino,35,41,76
374027,Lesion of ulnar nerve,racial,White,37,39,76
4012570,High risk sexual behavior,ethnic,Not Hispanic or Latino,51,25,76
373766,Retinopathy of prematurity,ethnic,Not Hispanic or Latino,35,41,76
254980,Intrinsic asthma with asthma attack,ethnic,Hispanic or Latino,30,46,76
432347,Chronic disease of tonsils AND/OR adenoids,ethnic,Hispanic or Latino,53,23,76
193552,Furuncle of skin AND/OR subcutaneous tissue,racial,Unknown,25,51,76
318800,GERD - Gastro-esophageal reflux disease,racial,Filipino,37,39,76
440373,Subchronic schizophrenia,racial,Unknown,0,76,76
441553,Myoclonus,ethnic,Hispanic or Latino,60,16,76
442425,Lumbar post-laminectomy syndrome,racial,White,32,44,76
4053599,Open wound of forearm,ethnic,Hispanic or Latino,37,39,76
436235,Taste sense altered,racial,White,62,14,76
199754,Primary malignant neoplasm of pancreas,racial,White,64,12,76
439695,Hypertensive heart and renal disease with renal failure,racial,Unknown,7,69,76
256722,Bronchopneumonia,racial,White,39,37,76
4302252,High risk pregnancy care,racial,Black or African American ,76,0,76
432586,Mental disorder,racial,White,41,35,76
78230,Rheumatoid arthritis with organ / system involvement,ethnic,Hispanic or Latino,53,23,76
4148407,Family history: Cardiovascular disease,racial,White,32,44,76
437530,Disorders of lipoid metabolism,ethnic,Hispanic or Latino,67,9,76
140362,Hypoparathyroidism,racial,White,25,51,76
443597,Chronic kidney disease stage 3,racial,American Indian or Alaska Native ,76,0,76
439770,Ketoacidosis in type I diabetes mellitus,ethnic,Hispanic or Latino,51,25,76
380513,Congenital cataract,racial,White,55,21,76
193809,Melena due to gastrointestinal hemorrhage,racial,Other Race,35,41,76
320752,Influenza with non-respiratory manifestation,racial,Unknown,58,18,76
192854,Interstitial uterine fibroid,ethnic,Not Hispanic or Latino,76,0,76
435875,"Complications of pregnancy, childbirth and the puerperium",racial,White,76,0,76
439697,Hypertensive renal disease with renal failure,racial,Asian,76,0,76
193984,Adrenal hypofunction,ethnic,Hispanic or Latino,67,9,76
137809,Primary malignant neoplasm of female breast,racial,Filipino,76,0,76
437839,Pica,ethnic,Hispanic or Latino,44,32,76
136495,Lichenification and lichen simplex chronicus,racial,White,53,23,76
78236,Muscle wasting disorder,racial,Black or African American ,5,71,76
377877,Convergent squint,racial,Unknown,41,35,76
320074,Lymphocytosis,racial,White,69,7,76
437041,Mother not delivered,racial,Other Race,76,0,76
441835,Chronic schizoaffective schizophrenia,ethnic,Not Hispanic or Latino,35,41,76
314754,Wheezing,racial,Black or African American ,30,46,76
4144274,Housing lack,racial,White,16,60,76
4160859,Methicillin resistant staphylococcus aureus carrier,ethnic,Hispanic or Latino,53,23,76
78505,"Localised, primary osteoarthritis of the ankle and/or foot",racial,Unknown,74,2,76
378839,Spina bifida with hydrocephalus,ethnic,Hispanic or Latino,62,14,76
140020,Viral exanthem,ethnic,Not Hispanic or Latino,41,35,76
372765,Open wound of head without complication,ethnic,Hispanic or Latino,25,51,76
72576,Benign tumour of breast,racial,White,76,0,76
378849,Microtia,racial,White,37,39,76
436252,Closed fracture of shaft of tibia,ethnic,Hispanic or Latino,62,14,76
257004,Acute exacerbation of chronic obstructive airways disease,racial,Asian,18,58,76
192278,Type II diabetes mellitus - poor control,racial,Asian Indian,41,35,76
375239,Cerebral degeneration,racial,White,41,35,76
432545,Bacterial disease,ethnic,Not Hispanic or Latino,67,9,76
136185,Abnormal granulation tissue,racial,White,44,32,76
4103642,Amputated toe,ethnic,Not Hispanic or Latino,18,58,76
75406,Crush injury of finger,ethnic,Hispanic or Latino,39,37,76
4064918,Diabetes mellitus screening,racial,Native Hawaiian or Other Pacific Islander ,41,35,76
439254,"Bipolar affective disorder, current episode depression",ethnic,Not Hispanic or Latino,64,12,76
134765,General body deterioration,ethnic,Not Hispanic or Latino,12,64,76
315296,Preinfarction syndrome,racial,White,37,39,76
197023,Bilateral inguinal hernia,racial,White,2,74,76
432441,Finding of length of gestation,racial,White,51,25,76
4311159,Midline cystocele,ethnic,Not Hispanic or Latino,76,0,76
4022073,Dependance on wheel chair,racial,Unknown,46,30,76
200485,Decubitus ulcer of buttock,ethnic,Not Hispanic or Latino,51,25,76
134668,Chronic maxillary sinusitis,racial,White,41,35,76
4154623,Fit denture,ethnic,Hispanic or Latino,62,14,76
432441,Finding of length of gestation,ethnic,Not Hispanic or Latino,23,53,76
140641,Verruca vulgaris,racial,Other Race,37,39,76
73562,Solitary sacroiliitis,racial,White,71,5,76
442985,Male,ethnic,Not Hispanic or Latino,25,51,76
26378,Hyperpituitarism,racial,Unknown,74,2,76
132835,Pediculosis capitis,ethnic,Not Hispanic or Latino,74,2,76
432795,Traumatic AND/OR non-traumatic injury,ethnic,Not Hispanic or Latino,35,41,76
201337,Disorder of bladder and bladder neck,racial,White,48,28,76
433946,Fall on same level due to impact against another person,racial,Unknown,37,39,76
132446,Congenital anomaly of skin,ethnic,Not Hispanic or Latino,18,58,76
4047937,Neonatal urinary tract infection,ethnic,Hispanic or Latino,51,25,76
194077,Chronic ulcerative enterocolitis,ethnic,Hispanic or Latino,9,67,76
256531,Head and neck swelling,racial,Other Race,58,18,76
199744,Carcinoma liver and/or biliary system,racial,White,28,48,76
75346,Disorder of meniscus of knee,racial,White,37,39,76
200171,Carbuncle of skin AND/OR subcutaneous tissue,ethnic,Hispanic or Latino,51,25,76
437449,Victim of child abuse,ethnic,Hispanic or Latino,46,30,76
437489,Herpes zoster with complication,racial,Unknown,71,5,76
135777,Neoplasm of uncertain behaviour of skin,ethnic,Not Hispanic or Latino,37,39,76
138102,Benign tumour of skin,racial,Other Race,60,16,76
434701,"Anemia in mother complicating pregnancy, childbirth AND/OR puerperium",ethnic,Hispanic or Latino,76,0,76
4252735,Mourning,racial,Asian,69,7,76
4240902,Allergy to peanuts,ethnic,Not Hispanic or Latino,18,58,76
376120,"Keratoconjunctivitis sicca, not specified as Sjogren's",racial,White,67,9,76
444093,Patient status finding,ethnic,Not Hispanic or Latino,32,44,76
75004,Frank hematuria,ethnic,Not Hispanic or Latino,28,48,76
438028,Poisoning by drug AND/OR medicinal substance,ethnic,Hispanic or Latino,23,51,74
74194,Back sprain,racial,Unknown,62,12,74
312934,Atherosclerosis of aorta,racial,Other Race,32,41,73
435790,Spurious polycythaemia,ethnic,Not Hispanic or Latino,16,58,74
320536,Abnormal EKG finding,racial,Other Race,32,41,73
435515,Hypo-osmolality and or hyponatremia,racial,Native Hawaiian or Other Pacific Islander ,69,5,74
78162,Peripheral vertigo,racial,Unknown,60,14,74
443537,Deep venous thrombosis of lower extremity,racial,Filipino,0,74,74
4092879,Absent kidney,racial,Unknown,74,0,74
313792,PT - Paroxysmal tachycardia,ethnic,Hispanic or Latino,58,16,74
438170,Acute myocardial infarction of inferior wall,racial,White,5,69,74
436706,Acute myocardial infarction of lateral wall,racial,White,74,0,74
4174977,Diabetic retinopathy,ethnic,Not Hispanic or Latino,44,30,74
443431,Disorder of menstruation,racial,Other Race,74,0,74
372897,Homonymous bilateral visual field defects,ethnic,Hispanic or Latino,30,44,74
444437,Congenital abnormality of cervix,ethnic,Hispanic or Latino,74,0,74
437038,Blood in urine,racial,Black or African American ,37,37,74
432795,Traumatic AND/OR non-traumatic injury,racial,Unknown,46,28,74
444098,"Gestation period, 40 weeks",ethnic,Hispanic or Latino,32,41,73
4147497,Nervous system and sense organ diseases,ethnic,Not Hispanic or Latino,30,44,74
433071,Contusion of multiple sites,ethnic,Hispanic or Latino,39,35,74
381290,Ocular hypertension,racial,Unknown,62,12,74
4235140,Operation for bone injury of phalanges of hand,ethnic,Hispanic or Latino,39,35,74
437688,Abnormal findings on antenatal screening of mother,racial,Unknown,74,0,74
435244,Developmental disorder,ethnic,Hispanic or Latino,32,41,73
4005743,Female sterility,ethnic,Hispanic or Latino,74,0,74
78230,Rheumatoid arthritis with organ / system involvement,racial,Unknown,51,23,74
199866,Acute gastritis,racial,Other Race,44,30,74
79917,Acquired deformity of toe,ethnic,Hispanic or Latino,48,25,73
197913,Disorder of function of stomach,racial,Black or African American ,39,35,74
437390,Hypoxaemia,ethnic,Not Hispanic or Latino,37,37,74
196821,Observation of urethral discharge,ethnic,Hispanic or Latino,0,74,74
200527,Splenomegaly,racial,Unknown,30,44,74
373724,Neoplasm of brain,racial,Unknown,37,37,74
140486,Ulcer of calf,racial,White,35,39,74
133414,Candidiasis of skin and nails,ethnic,Not Hispanic or Latino,60,14,74
77963,Achilles tendinitis,racial,Unknown,62,12,74
80874,Open wound of multiple sites of one upper limb without complication,ethnic,Hispanic or Latino,37,37,74
4102739,Screening for cardiovascular system disease,racial,White,12,62,74
437464,"Injury undetermined whether accidentally or purposely inflicted, fall from residential premises",ethnic,Hispanic or Latino,55,18,73
4111875,Varicose veins of the leg NOS,ethnic,Hispanic or Latino,55,18,73
132344,Gingival and periodontal disease,racial,White,39,35,74
379801,Trigeminal neuralgia,racial,Other Race,51,23,74
81403,Osteopetrosis,ethnic,Hispanic or Latino,62,12,74
196165,Cervical intraepithelial neoplasia grade 2,ethnic,Not Hispanic or Latino,74,0,74
433168,Iron deficiency anaemia secondary to inadequate dietary iron intake,ethnic,Hispanic or Latino,67,7,74
438699,Primary malignant neoplasm of rectosigmoid junction,ethnic,Hispanic or Latino,2,71,73
440329,Herpes zoster without complication,racial,Asian,37,37,74
435023,Mild hyperemesis-not delivered,ethnic,Not Hispanic or Latino,74,0,74
433533,Incomplete spontaneous abortion with no mention of complication,racial,White,74,0,74
80495,Palindromic rheumatism of the pelvic region and thigh,ethnic,Not Hispanic or Latino,74,0,74
4208970,History of physical abuse,ethnic,Hispanic or Latino,64,9,73
433990,Subchronic catatonic schizophrenia,racial,White,0,74,74
376961,Disturbance of consciousness,ethnic,Not Hispanic or Latino,51,23,74
255841,Chronic bronchitis,racial,Black or African American ,64,9,73
435207,"Nodular lymphoma of lymph nodes of head, face and neck",ethnic,Hispanic or Latino,71,2,73
441974,Closed fracture of forearm,ethnic,Not Hispanic or Latino,53,21,74
132740,Positive skin test reaction,racial,Black or African American ,28,46,74
78516,Arthralgia of the upper arm,racial,Black or African American ,53,21,74
443876,Obsessive compulsive personality disorder,ethnic,Not Hispanic or Latino,74,0,74
435666,Closed fracture of upper end of tibia,ethnic,Hispanic or Latino,28,46,74
319835,Congestive cardiac failure,racial,Filipino,0,74,74
197223,Enterobiasis,racial,White,46,28,74
4055337,Gallbladder calculus without mention of cholecystitis,ethnic,Hispanic or Latino,35,39,74
137379,Musculoskeletal symptom,racial,Black or African American ,41,32,73
439700,Inhibited sexual desire,racial,Black or African American ,0,74,74
257012,Chronic rhinosinusitis,racial,Native Hawaiian or Other Pacific Islander ,74,0,74
438066,Chlamydial infection,racial,Black or African American ,39,35,74
320136,Disease of respiratory system,racial,Unknown,30,44,74
198995,Type 1 diabetes mellitus - poor control,racial,Native Hawaiian or Other Pacific Islander ,39,35,74
133444,Thyroiditis,racial,White,69,5,74
321596,Peripheral venous insufficiency,racial,Asian,12,62,74
436658,Vitamin deficiency,ethnic,Not Hispanic or Latino,62,12,74
200169,Pruritus ani,racial,Unknown,46,28,74
4288676,Acute and chronic cholecystitis,ethnic,Hispanic or Latino,69,5,74
201627,Abnormal vaginal bleeding,ethnic,Not Hispanic or Latino,74,0,74
4086928,IUCD status,ethnic,Not Hispanic or Latino,74,0,74
79768,Neoplasm of urinary system,ethnic,Not Hispanic or Latino,7,67,74
197230,Malignant neoplasm of uterus,racial,Unknown,74,0,74
436706,Acute myocardial infarction of lateral wall,ethnic,Hispanic or Latino,74,0,74
73866,Congenital anomaly of breast,ethnic,Hispanic or Latino,67,7,74
194995,Disorder of ureter,racial,White,67,7,74
4171434,Immunization refused,racial,Unknown,46,28,74
76548,Closed dislocation of hip,ethnic,Hispanic or Latino,48,25,73
441874,Cerebral thrombosis,racial,White,48,25,73
435093,Closed fracture of femur,racial,Unknown,39,35,74
377252,Neurofibromatosis type 1,ethnic,Hispanic or Latino,37,37,74
4091532,Bowel observation,racial,Unknown,48,25,73
195363,Congenital anomaly of kidney,ethnic,Hispanic or Latino,35,39,74
438536,Congenital anomaly of jaw,ethnic,Not Hispanic or Latino,32,41,73
201916,Ureteric stone,racial,White,46,28,74
138841,Disorder of sacrum,racial,White,44,30,74
381842,Petit mal status,racial,White,64,9,73
255573,Chronic obstructive lung disease,racial,Native Hawaiian or Other Pacific Islander ,16,58,74
319835,Congestive cardiac failure,racial,Native Hawaiian or Other Pacific Islander ,7,67,74
432582,Neoplastic disease of uncertain behavior,ethnic,Hispanic or Latino,46,28,74
378427,Tear film insufficiency,racial,Other Race,64,9,73
78149,Congenital hereditary muscular dystrophy,racial,White,30,44,74
315947,Thoracic back sprain,racial,Unknown,53,18,71
318712,Peripheral circulatory disorder associated with type I diabetes mellitus,racial,Asian,0,71,71
441039,Phlebitis of lower limb vein,ethnic,Hispanic or Latino,67,5,72
436070,Vitamin D deficiency,racial,Asian,41,30,71
442985,Male,racial,Asian,21,51,72
79864,Hematuria syndrome,racial,Unknown,25,46,71
312349,Venous varices,racial,Asian,23,48,71
378421,Alcoholic peripheral neuropathy,ethnic,Hispanic or Latino,0,71,71
379805,Myopia,racial,Black or African American ,32,39,71
31610,Disorder of oesophagus,ethnic,Hispanic or Latino,37,35,72
4293175,"Mental state, behaviour and/or psychosocial function finding",racial,Black or African American ,14,58,72
378144,Disease of basal ganglia,ethnic,Hispanic or Latino,16,55,71
436839,Closed fracture of metacarpal bone,ethnic,Not Hispanic or Latino,23,48,71
141933,Alopecia areata,racial,Unknown,41,30,71
77129,Closed fracture of pelvis,ethnic,Hispanic or Latino,67,5,72
193688,Clostridium difficile infection,ethnic,Not Hispanic or Latino,69,2,71
4234604,Disruption of cesarean wound in the puerperium,ethnic,Hispanic or Latino,71,0,71
198846,Enthesopathy of hip region,ethnic,Not Hispanic or Latino,67,5,72
436265,Open wound of multiple sites of one lower limb AND thigh without complication,racial,White,51,21,72
197230,Malignant neoplasm of uterus,ethnic,Hispanic or Latino,71,0,71
261889,Simple chronic bronchitis,ethnic,Not Hispanic or Latino,23,48,71
316437,Cerebral atherosclerosis,racial,White,53,18,71
440228,Closed fracture of lower end of humerus,racial,White,48,23,71
436246,Low libido,racial,Unknown,21,51,72
4298697,Multiple open wounds without complication,racial,Other Race,35,37,72
381312,Neural hearing loss,racial,Unknown,60,12,72
378742,Blind hypotensive eye,ethnic,Hispanic or Latino,18,53,71
376115,Cystoid macular retinal degeneration,ethnic,Hispanic or Latino,60,12,72
201907,Oedema of male genital organs,racial,White,0,71,71
444445,Benign neoplasm of skin of leg,ethnic,Hispanic or Latino,51,21,72
441788,Human papilloma virus infection,racial,White,58,14,72
4179214,Family history of malignant neoplasm of gastrointestinal tract,ethnic,Not Hispanic or Latino,51,21,72
441202,Generalized anaphylaxis,ethnic,Hispanic or Latino,35,37,72
24660,Acute tonsillitis,racial,Other Race,41,30,71
315831,Chronic pulmonary heart disease,racial,Other Race,44,28,72
433735,Alcohol dependence with acute alcoholic intoxication,ethnic,Hispanic or Latino,2,69,71
30968,Diabetes insipidus,racial,White,51,21,72
198197,Male infertility,ethnic,Hispanic or Latino,0,71,71
312950,IgE-mediated allergic asthma,racial,Asian,46,25,71
198062,"Infectious colitis, enteritis and gastroenteritis",racial,Unknown,55,16,71
437041,Mother not delivered,racial,Asian,71,0,71
438731,Fat pad,ethnic,Hispanic or Latino,58,14,72
4147497,Nervous system and sense organ diseases,racial,Unknown,37,35,72
318800,GERD - Gastro-esophageal reflux disease,racial,Native Hawaiian or Other Pacific Islander ,60,12,72
436940,Insulin resistance syndrome,racial,Unknown,55,16,71
436445,Abrasion of teeth,racial,Unknown,37,35,72
74080,Orthostatic proteinuria,racial,White,16,55,71
438567,Adult failure to thrive syndrome,racial,Unknown,55,16,71
444129,Wrist injury,racial,Unknown,55,16,71
257581,Exacerbation of asthma,racial,Filipino,21,51,72
441207,Drug reaction,ethnic,Not Hispanic or Latino,46,25,71
443869,Nonvenomous insect bite of wrist without infection,ethnic,Hispanic or Latino,37,35,72
314666,Healed coronary,racial,Asian,5,67,72
440525,Prematurity of fetus,racial,Black or African American ,30,41,71
136368,Non-toxic multinodular goiter,racial,Asian,71,0,71
437902,Teeth development and eruption disorders,ethnic,Not Hispanic or Latino,25,46,71
434056,Late effects of cerebrovascular disease,racial,Filipino,28,44,72
442775,Degeneration of thoracic intervertebral disc,ethnic,Hispanic or Latino,35,37,72
376337,Disease of nervous system,ethnic,Hispanic or Latino,37,35,72
139179,Open wound of lip without complication,racial,White,18,53,71
313209,Left bundle branch hemiblock,racial,White,39,32,71
73045,Hand sprain,racial,Unknown,55,16,71
320074,Lymphocytosis,ethnic,Hispanic or Latino,69,2,71
373487,AION - Acute ischaemic optic neuropathy,ethnic,Hispanic or Latino,18,53,71
380094,Carpal tunnel syndrome,racial,Black or African American ,69,2,71
80568,Traumatic amputation of finger without mention of complication,racial,White,14,58,72
440329,Herpes zoster without complication,racial,Black or African American ,5,67,72
4263370,R.I.N.D. syndrome,racial,Other Race,21,51,72
439251,"Bipolar affective disorder, currently depressed, in full remission",racial,White,60,12,72
380702,Cerebral cysts,racial,White,30,41,71
192667,Atrophic gastritis,racial,Asian,18,53,71
40484513,Hemiplegia of nondominant side as late effect of cerebrovascular disease,racial,Filipino,2,69,71
197917,Disorder of biliary tract,racial,White,46,25,71
254761,Cough,racial,Native Hawaiian or Other Pacific Islander ,41,30,71
439847,Intracranial hemorrhage,ethnic,Hispanic or Latino,46,25,71
372914,Optic atrophy,racial,White,23,48,71
318443,Arteriosclerotic vascular disease,ethnic,Hispanic or Latino,51,21,72
4202322,Amputated big toe,racial,White,16,55,71
434675,Complication of gastrostomy,racial,White,21,51,72
381114,Microcephalus,ethnic,Hispanic or Latino,55,16,71
435516,Lipoprotein deficiency disorder,ethnic,Not Hispanic or Latino,35,37,72
380733,Otalgia,racial,Other Race,48,23,71
437264,Tobacco dependence syndrome,racial,Native Hawaiian or Other Pacific Islander ,28,44,72
4210151,HIV counseling,ethnic,Hispanic or Latino,55,16,71
134569,Erythema infectiosum,racial,White,21,51,72
79106,Arthralgia of the pelvic region and thigh,racial,Native Hawaiian or Other Pacific Islander ,2,69,71
444243,Neurotic disorder,racial,White,32,39,71
320536,Abnormal EKG finding,racial,Black or African American ,30,41,71
200831,Congenital anomaly of penis,ethnic,Hispanic or Latino,0,71,71
194684,Crohn's disease of large bowel,racial,White,64,7,71
194696,Menorrhalgia,racial,Other Race,71,0,71
4165091,Lack of exercise,ethnic,Not Hispanic or Latino,25,46,71
194081,Acute cystitis,racial,Other Race,67,2,69
377560,Internal hordeolum,ethnic,Not Hispanic or Latino,46,23,69
4160859,Methicillin resistant staphylococcus aureus carrier,racial,White,46,23,69
196168,Irregular menstrual bleeding,racial,Asian,69,0,69
435368,Congenital pigeon chest,ethnic,Hispanic or Latino,0,69,69
81378,Chondromalacia of patella,ethnic,Not Hispanic or Latino,48,21,69
440525,Prematurity of fetus,racial,Other Race,37,32,69
137548,Cervical root lesion,racial,Asian,7,62,69
376065,Neurologic disorder associated with type II diabetes mellitus,racial,Native Hawaiian or Other Pacific Islander ,12,58,70
4273391,Suicidal thoughts,ethnic,Hispanic or Latino,53,16,69
374375,Impacted cerumen,racial,Filipino,21,48,69
437058,Sunburn,racial,White,23,46,69
317309,Peripheral arterial occlusive disease,racial,Other Race,51,18,69
443571,Cervicovaginal cytology: High grade squamous intraepithelial lesion or carcinoma,ethnic,Not Hispanic or Latino,55,14,69
436253,Sprain of foot,ethnic,Not Hispanic or Latino,35,35,70
73090,Superficial bruising of foot,racial,Unknown,64,5,69
201322,Internal hemorrhoids without complication,ethnic,Not Hispanic or Latino,51,18,69
192376,Rhesus isoimmunization with antenatal problem,racial,White,69,0,69
435569,Disorder of jaw,ethnic,Hispanic or Latino,28,41,69
440377,Paralysis,racial,White,21,48,69
319034,Hypertensive heart disease without congestive heart failure,racial,White,41,28,69
72737,Microcalcifications of the breast,ethnic,Not Hispanic or Latino,64,5,69
432904,Blood in anterior chamber,ethnic,Hispanic or Latino,60,9,69
78200,Benign mammary dysplasia,racial,White,69,0,69
443563,Arteriosclerosis in coronary artery bypass graft,racial,Unknown,53,16,69
140641,Verruca vulgaris,racial,Black or African American ,12,58,70
198185,Chronic renal failure syndrome,racial,Unknown,18,51,69
135526,Myelopathy,racial,White,30,39,69
77963,Achilles tendinitis,ethnic,Not Hispanic or Latino,62,7,69
434622,Deficiency anemias,racial,Unknown,18,51,69
441085,Elderly primip,ethnic,Not Hispanic or Latino,69,0,69
74464,Idiopathic scoliosis AND/OR kyphoscoliosis,racial,Black or African American ,25,44,69
73301,Synovitis/tenosynovitis - wrist,racial,Unknown,64,5,69
200662,Lymphosarcoma,ethnic,Hispanic or Latino,39,30,69
439926,Malaise and fatigue,racial,American Indian or Alaska Native ,53,16,69
373185,Drug-induced dyskinesia,ethnic,Not Hispanic or Latino,14,55,69
442067,Atopic dermatitis and related conditions,racial,Native Hawaiian or Other Pacific Islander ,2,67,69
433315,Feeding difficulties in newborn,ethnic,Not Hispanic or Latino,30,39,69
316429,Ectopics,racial,Unknown,48,21,69
315361,Orthopnea,ethnic,Hispanic or Latino,41,28,69
321080,"Hypertension complicating pregnancy, childbirth and the puerperium",ethnic,Hispanic or Latino,69,0,69
199913,Acquired deformity of ankle AND/OR foot,ethnic,Not Hispanic or Latino,41,28,69
193688,Clostridium difficile infection,racial,Unknown,46,23,69
4062488,Thyroid disorder screening,ethnic,Not Hispanic or Latino,62,7,69
133853,Osteomyelitis of ankle AND/OR foot,ethnic,Not Hispanic or Latino,0,69,69
80813,Lumbosacral spondylosis without myelopathy,racial,Other Race,16,53,69
80813,Lumbosacral spondylosis without myelopathy,racial,American Indian or Alaska Native ,0,69,69
257778,Pertussis,racial,White,41,28,69
138239,Observation of limb structure,ethnic,Not Hispanic or Latino,32,37,69
312622,BVO - Branch retinal occlusion,ethnic,Hispanic or Latino,55,14,69
372247,Candidal otomycosis,racial,White,60,9,69
441334,Glossodynia,ethnic,Hispanic or Latino,55,14,69
4051564,FH: Metabolic disorder,ethnic,Hispanic or Latino,48,21,69
437127,Closed dislocation of acromioclavicular joint,ethnic,Hispanic or Latino,28,41,69
312935,Venous hypertension,ethnic,Hispanic or Latino,16,53,69
433753,Alcohol abuse,racial,Other Race,2,67,69
81902,Urinary tract infectious disease,racial,Filipino,69,0,69
4077577,Moderate recurrent major depression,racial,Asian,69,0,69
137548,Cervical root lesion,racial,Other Race,55,14,69
77421,Open wound of hand except fingers without complication,racial,Unknown,39,30,69
435798,"Nondependent opioid abuse, episodic",ethnic,Hispanic or Latino,12,58,70
133468,Disease of extremity,ethnic,Hispanic or Latino,16,53,69
4111392,Angina pectoris NOS,racial,Unknown,32,37,69
192731,Digestive symptom,racial,Unknown,28,41,69
434164,Glycosuria,racial,Unknown,53,16,69
197684,Dysuria,racial,Native Hawaiian or Other Pacific Islander ,53,16,69
201070,Cholelithiasis AND cholecystitis without obstruction,racial,White,67,2,69
79768,Neoplasm of urinary system,ethnic,Hispanic or Latino,35,35,70
439004,Restzustand,ethnic,Hispanic or Latino,0,69,69
432898,Severe mental handicap,ethnic,Not Hispanic or Latino,0,69,69
260139,Acute bronchitis,racial,Filipino,35,35,70
440535,Abnormal radiographic examination,racial,White,30,39,69
4276723,Finding of child weight centiles,racial,Black or African American ,35,35,70
381504,Post-herpetic trigeminal neuralgia,ethnic,Hispanic or Latino,60,9,69
434097,Twin pregnancy with antenatal problem,ethnic,Not Hispanic or Latino,67,2,69
435940,"Closed fracture of humerus, shaft",ethnic,Hispanic or Latino,67,2,69
436658,Vitamin deficiency,racial,White,62,7,69
31821,Endocrinopathy,racial,White,37,32,69
27321,Persistent vomiting,racial,White,51,18,69
441968,Acetonuria,ethnic,Hispanic or Latino,32,37,69
198978,Acute gonorrhea of lower genitourinary tract,ethnic,Not Hispanic or Latino,55,14,69
197230,Malignant neoplasm of uterus,racial,White,69,0,69
440693,Continuous opioid dependence,racial,Other Race,2,67,69
254761,Cough,racial,Filipino,46,23,69
439871,Haemospermia,racial,White,0,69,69
197925,Haemorrhage of rectum and anus,racial,Asian,39,30,69
77647,Mallet finger,ethnic,Hispanic or Latino,28,41,69
4194160,Thyroid function tests abnormal,racial,Asian,51,18,69
316084,Lymphadenitis,racial,Unknown,32,37,69
443452,Bleeding of unknown origin,ethnic,Hispanic or Latino,41,28,69
23798,Acute laryngopharyngitis,racial,White,51,18,69
436583,[X]Falls,racial,Black or African American ,37,32,69
373999,Diabetic oculopathy associated with type I diabetes mellitus,racial,Other Race,58,12,70
442790,Growth and development,racial,White,46,23,69
196821,Observation of urethral discharge,racial,White,0,67,67
441547,Oppositional defiant disorder,racial,White,7,60,67
312437,Dyspnea,racial,Black or African American ,60,7,67
201914,Premenopausal menorrhagia,racial,Other Race,67,0,67
374027,Lesion of ulnar nerve,racial,Unknown,0,67,67
200843,Observation of frequency of urination,racial,Other Race,30,37,67
432250,Infective disorder,ethnic,Hispanic or Latino,44,23,67
436787,Panniculitis affecting neck,racial,White,67,0,67
4310682,Multiple open wounds with complication,ethnic,Hispanic or Latino,37,30,67
75756,Malignant neoplasm of posterior wall of urinary bladder,racial,Unknown,0,67,67
442262,Blister of toe without infection,racial,Unknown,30,37,67
374040,Ill-defined disorder of eye,ethnic,Not Hispanic or Latino,28,39,67
432597,Schizoaffective schizophrenia,racial,American Indian or Alaska Native ,67,0,67
258785,Pneumococcal pneumonia,ethnic,Hispanic or Latino,32,35,67
443537,Deep venous thrombosis of lower extremity,racial,Black or African American ,28,39,67
4103894,Hordeolum and other deep inflammation of eyelid NOS,racial,White,46,21,67
194699,Liver disorder in pregnancy,ethnic,Hispanic or Latino,67,0,67
193809,Melena due to gastrointestinal hemorrhage,racial,Black or African American ,41,25,66
4147837,Generalized metabolic disorder,ethnic,Hispanic or Latino,28,39,67
195851,"Gastric ulcer without hemorrhage, without perforation AND without obstruction",ethnic,Not Hispanic or Latino,46,21,67
139188,Open wound of scalp without complication,racial,Unknown,23,44,67
74635,Lumbosacral root lesion,ethnic,Not Hispanic or Latino,41,25,66
201265,Splenic disorder,ethnic,Hispanic or Latino,28,39,67
79898,Cellulitis and abscess of finger,ethnic,Not Hispanic or Latino,35,32,67
314659,Arteritis,ethnic,Hispanic or Latino,53,14,67
4111875,Varicose veins of the leg NOS,racial,White,46,21,67
137497,Dermatophytosis of the body,racial,Other Race,41,25,66
434170,Atypical squamous cells of undetermined significance on cervical Papanicolaou smear,racial,Asian,67,0,67
432301,Opioid dependence in remission,racial,Unknown,32,35,67
376647,Primary malignant neoplasm of soft tissues,racial,Unknown,0,67,67
378253,HA - Headache,racial,American Indian or Alaska Native ,58,9,67
4298854,HIV seropositivity,racial,Asian,0,67,67
4116452,Generalized osteoarthritis NOS,racial,Asian,51,16,67
4112816,Other respiratory system diseases,ethnic,Not Hispanic or Latino,48,18,66
321107,AR - Congenital aortic regurgitation,racial,White,12,55,67
381308,Abscess of eyelid,racial,Unknown,39,28,67
436787,Panniculitis affecting neck,ethnic,Hispanic or Latino,67,0,67
24818,Neck injury,racial,Unknown,37,30,67
26711,Chronic pharyngitis,ethnic,Not Hispanic or Latino,48,18,66
194871,Trichomonal vulvovaginitis,racial,White,67,0,67
193525,Abdominal pregnancy,racial,White,67,0,67
261324,Pneumonia due to Streptococcus,ethnic,Hispanic or Latino,48,18,66
441190,Injury of unknown intent due to fall from height,ethnic,Hispanic or Latino,55,12,67
135745,Exanthema subitum,racial,White,28,39,67
200775,Endometrial hyperplasia,ethnic,Hispanic or Latino,67,0,67
444115,Disorder of bursa,racial,White,32,35,67
199856,Varicose veins of lower extremity with inflammation,ethnic,Not Hispanic or Latino,41,25,66
441391,"Acquired forearm deformity, excluding fingers",ethnic,Hispanic or Latino,21,46,67
195401,Superficial bruising of hip,ethnic,Hispanic or Latino,39,28,67
4331899,Child in family care,racial,White,18,48,66
4110046,Obstructive chronic bronchitis NOS,racial,Unknown,2,64,66
443675,Traumatic amputation of toe(s) without mention of complication,racial,White,28,39,67
439037,Aneurysm of artery of neck,ethnic,Hispanic or Latino,64,2,66
317009,Hyperreactive airway disease,racial,Asian Indian,28,39,67
436373,DSD - Developmental speech disorder,racial,Black or African American ,28,39,67
78832,Intervertebral disc disorder with myelopathy,ethnic,Hispanic or Latino,44,23,67
75128,Injury of chest wall,ethnic,Hispanic or Latino,37,30,67
317895,Hypertension due to renovascular disease,ethnic,Hispanic or Latino,60,7,67
443556,Primary focal hyperhidrosis,ethnic,Hispanic or Latino,53,14,67
4105330,Chronic undifferentiated schizophrenia,ethnic,Not Hispanic or Latino,35,32,67
432461,"Closed fracture clavicle, shaft",ethnic,Hispanic or Latino,32,35,67
199978,Contusion of lower limb,racial,White,39,28,67
137792,Kaposi's varicelliform eruption,ethnic,Hispanic or Latino,37,30,67
438867,Generalized body aches,racial,Other Race,44,23,67
321319,Cardiomyopathy,racial,Black or African American ,23,44,67
381859,Infective OE,racial,Black or African American ,48,18,66
80805,Primary localized osteoarthrosis of forearm,ethnic,Hispanic or Latino,39,28,67
378523,Residual foreign body in soft tissue,ethnic,Hispanic or Latino,28,39,67
437540,CRAO - Central retinal artery occlusion,ethnic,Hispanic or Latino,12,55,67
4066260,Galactorrhea in pregnancy and the puerperium,ethnic,Hispanic or Latino,67,0,67
28779,Oesophageal varices with bleeding,ethnic,Not Hispanic or Latino,67,0,67
136057,Benign neoplasm of skin of trunk,ethnic,Not Hispanic or Latino,44,23,67
434005,Morbid obesity,racial,American Indian,60,7,67
376981,Amblyopia,ethnic,Hispanic or Latino,25,41,66
317309,Peripheral arterial occlusive disease,racial,Asian,16,51,67
433751,Prolonged depressive adjustment reaction,racial,Asian,67,0,67
192239,Post-herpetic polyneuropathy,ethnic,Not Hispanic or Latino,67,0,67
260134,Croup,racial,Unknown,23,44,67
75756,Malignant neoplasm of posterior wall of urinary bladder,ethnic,Hispanic or Latino,0,67,67
4024361,Paralysis of glottis,ethnic,Hispanic or Latino,32,35,67
374366,Sensorineural hearing loss,racial,Other Race,16,51,67
200845,Urinary precipitancy,racial,Asian,41,25,66
380513,Congenital cataract,ethnic,Hispanic or Latino,55,12,67
4104864,Migraine NOS,ethnic,Not Hispanic or Latino,62,5,67
140273,"Contusion, forearm area",racial,White,44,23,67
80189,Displacement of lumbar intervertebral disc without myelopathy,racial,Other Race,62,5,67
374036,Chronic conjunctivitis,racial,Unknown,53,14,67
196347,Intestinal parasitism,ethnic,Hispanic or Latino,37,30,67
4139915,Acute pyelitis,ethnic,Hispanic or Latino,62,5,67
73673,Disorder of prosthetic joint,ethnic,Hispanic or Latino,55,12,67
78149,Congenital hereditary muscular dystrophy,ethnic,Not Hispanic or Latino,30,37,67
440508,Congenital disease,racial,Asian,5,62,67
140168,Psoriasis,ethnic,Hispanic or Latino,16,51,67
4164707,Canceled operative procedure,racial,Unknown,37,30,67
375538,"Degeneration of macula due to cyst, hole or pseudohole",ethnic,Hispanic or Latino,46,21,67
80946,Tinea manus,racial,White,46,21,67
200452,Disease of female genital organ,racial,White,67,0,67
197684,Dysuria,racial,American Indian,53,14,67
132736,Bacteremia,ethnic,Hispanic or Latino,16,51,67
316994,Malignant hypertensive heart disease with congestive cardiac failure,racial,Unknown,28,39,67
4096198,Vitamin B-complex deficiency,ethnic,Hispanic or Latino,37,30,67
434462,VSD - Ventricular septal defect,ethnic,Not Hispanic or Latino,23,44,67
4100365,Schizophrenic disorders,racial,Unknown,67,0,67
434494,Closed fracture of the proximal humerus,racial,Unknown,32,35,67
314059,Right bundle branch block,ethnic,Not Hispanic or Latino,35,32,67
192963,Disease of pancreas,racial,White,39,28,67
441963,Prader-Willi syndrome,ethnic,Hispanic or Latino,0,67,67
441422,Closed fracture of humerus,racial,Unknown,62,5,67
376707,Acute conjunctivitis,racial,Black or African American ,23,44,67
77139,Open wound of finger without complication,ethnic,Not Hispanic or Latino,28,39,67
141056,Acute ethmoidal sinusitis,ethnic,Hispanic or Latino,32,35,67
321042,Cardiac arrest,racial,White,16,51,67
4179332,Parent-child problem,racial,White,28,37,65
79061,Colonic constipation,ethnic,Hispanic or Latino,46,18,64
436073,Psychotic disorder,racial,Asian,5,60,65
433227,Abnormal sensation,racial,White,44,21,65
136198,Cervical spondylosis with myelopathy,racial,Asian,14,51,65
4334644,Decubitus ulcer of lower back,ethnic,Hispanic or Latino,62,2,64
195245,Reflex sympathetic dystrophy,ethnic,Not Hispanic or Latino,25,39,64
440276,"Infection AND/OR inflammatory reaction due to internal prosthetic device, implant AND/OR graft",racial,White,51,14,65
437241,Qualitative platelet defect,ethnic,Hispanic or Latino,32,32,64
374905,Non-organic sleep disorder,racial,White,39,25,64
28403,Acromegaly and gigantism,ethnic,Hispanic or Latino,2,62,64
196738,Male genital organ disease,racial,Asian,0,64,64
79898,Cellulitis and abscess of finger,racial,Unknown,32,32,64
374923,Bell palsy,racial,Black or African American ,51,14,65
443422,Scleroderma,ethnic,Not Hispanic or Latino,55,9,64
197717,Open wound of anterior abdominal wall without complication,ethnic,Hispanic or Latino,28,37,65
441408,Vomiting,racial,Asian,32,32,64
4133029,Primigravida,racial,Asian,64,0,64
75053,Fracture of bone,ethnic,Hispanic or Latino,44,21,65
80809,Rheumatoid arthritis,racial,Filipino,64,0,64
196061,Benign tumour of stomach,ethnic,Hispanic or Latino,55,9,64
80502,Osteoporosis,racial,American Indian or Alaska Native ,64,0,64
77670,Chest pain,racial,American Indian or Alaska Native ,58,7,65
321462,Cardiac complications of care,ethnic,Not Hispanic or Latino,21,44,65
315922,Patent ductus arteriosus,racial,White,23,41,64
375824,Abnormal auditory perception,racial,White,37,28,65
136575,Nonvenomous insect bite with infection,racial,Unknown,32,32,64
377001,Unruptured cerebral aneurysm,racial,Asian,64,0,64
376709,Discharge of eye,racial,White,25,39,64
81377,Climacteric arthritis of the lower leg,racial,Unknown,46,18,64
134460,Plantar fascial fibromatosis,racial,Asian,23,41,64
76565,Shoulder bruise,racial,White,30,35,65
198928,Mechanical complication due to intrauterine contraceptive device,racial,White,62,2,64
28060,Strept throat,racial,Other Race,32,32,64
4059637,Work environment deleterious,ethnic,Hispanic or Latino,35,30,65
435782,Chronic schizophrenic,racial,Black or African American ,41,23,64
4103416,Drug dependence NOS,ethnic,Hispanic or Latino,16,48,64
134735,Chronic osteomyelitis,racial,White,25,39,64
437851,Open angle with borderline intraocular pressure,ethnic,Hispanic or Latino,53,12,65
317002,Hypopiesis,racial,Asian,5,60,65
440927,High risk drug monitoring status,ethnic,Not Hispanic or Latino,62,2,64
133436,Thyrotoxic crisis,racial,Other Race,64,0,64
436972,Glaucoma associated with systemic syndromes,racial,Black or African American ,23,41,64
192278,Type II diabetes mellitus - poor control,racial,American Indian,35,30,65
201612,ALD - Alcoholic liver disease,racial,White,35,30,65
4201388,Gastrostomy present,racial,Other Race,53,12,65
192671,GI - Gastrointestinal haemorrhage,racial,Asian,41,23,64
375823,Optic nerve hypoplasia,racial,White,32,32,64
200843,Observation of frequency of urination,racial,Asian,39,25,64
40490888,Herniation of rectum into vagina,racial,White,64,0,64
77647,Mallet finger,racial,White,28,37,65
4144274,Housing lack,ethnic,Hispanic or Latino,16,48,64
74052,Labyrinthitis,ethnic,Hispanic or Latino,41,23,64
75860,Costiveness,racial,Native Hawaiian or Other Pacific Islander ,28,37,65
26935,Disorder of endocrine testis,racial,Unknown,0,64,64
194133,Low back pain,racial,Native Hawaiian or Other Pacific Islander ,9,55,64
444202,Abscess,racial,American Indian or Alaska Native ,53,12,65
4292726,Contact - infectious disease,racial,Unknown,37,28,65
441284,Open-angle glaucoma,racial,Other Race,53,12,65
432695,Post-term pregnancy,ethnic,Hispanic or Latino,64,0,64
196341,Dermatophytosis of the perianal area,racial,Other Race,9,55,64
201313,Hypertensive renal disease,racial,White,41,23,64
440377,Paralysis,ethnic,Hispanic or Latino,23,41,64
78517,Arthralgia of multiple joints,racial,Black or African American ,44,21,65
376125,Disorder of eyelid,racial,White,28,37,65
141305,Unilateral sensorineural hearing loss with unrestricted hearing on the contralateral side,racial,White,28,37,65
4100912,Screening for rheumatoid conditions,ethnic,Hispanic or Latino,64,0,64
434894,Acute post-hemorrhagic anemia,ethnic,Hispanic or Latino,30,35,65
4084229,Primary gout,racial,Asian,7,58,65
316139,HF - Heart failure,racial,Other Race,58,7,65
442306,Adjustment disorder with depressed mood,ethnic,Not Hispanic or Latino,25,39,64
373488,Pupil-sparing third nerve palsy,ethnic,Hispanic or Latino,37,28,65
201079,Acute parametritis and pelvic cellulitis,ethnic,Hispanic or Latino,64,0,64
433881,Additional general conditions of patient,racial,White,46,18,64
437082,Marie-Strumpell spondylitis,ethnic,Hispanic or Latino,2,62,64
443237,"Manic disorder, single episode",racial,White,48,16,64
439150,Hypersomnia with sleep apnea,ethnic,Hispanic or Latino,28,37,65
4064918,Diabetes mellitus screening,racial,American Indian or Alaska Native ,44,21,65
312338,Benign hypertensive heart disease with congestive heart failure,racial,Asian,0,64,64
432899,Normal pressure hydrocephalus,racial,White,2,62,64
256440,Disorder of paranasal sinuses,racial,Asian,46,18,64
321389,Thoracic disc disorder,racial,White,9,55,64
255573,Chronic obstructive lung disease,racial,Filipino,14,51,65
321389,Thoracic disc disorder,ethnic,Hispanic or Latino,9,55,64
80552,Closed fracture of the scaphoid,racial,White,21,44,65
435798,"Nondependent opioid abuse, episodic",ethnic,Not Hispanic or Latino,28,37,65
134671,Dental abscess without a sinus,racial,Unknown,21,44,65
198683,Viral hepatitis B without hepatic coma,racial,White,51,14,65
432876,Bipolar I disorder,racial,Black or African American ,39,25,64
133848,Non-traumatic slipped upper femoral epiphysis,ethnic,Hispanic or Latino,2,62,64
132553,Herpangina,ethnic,Not Hispanic or Latino,23,41,64
201045,Thrombosed external haemorrhoids,racial,White,32,32,64
437247,Anaemia of chronic disease,racial,Black or African American ,12,53,65
438962,Herpes simplex with complication,ethnic,Hispanic or Latino,39,25,64
435956,Closed fracture of base of neck of femur,ethnic,Hispanic or Latino,28,37,65
136516,Congenital pes planus,racial,Unknown,25,39,64
4092896,Stool contents abnormal,racial,Other Race,35,30,65
200779,Intrauterine polyp,ethnic,Hispanic or Latino,64,0,64
135338,Pemphigus,racial,White,64,0,64
256716,Asthma with status asthmaticus,ethnic,Not Hispanic or Latino,25,39,64
75354,Osteochondropathy,racial,Native Hawaiian or Other Pacific Islander ,48,16,64
30234,Cervical sprain,racial,Other Race,44,21,65
136580,Dehiscence of surgical wound,ethnic,Hispanic or Latino,16,48,64
439221,"Adverse effect, due to correct medicinal substance properly administered",ethnic,Not Hispanic or Latino,46,18,64
441422,Closed fracture of humerus,ethnic,Not Hispanic or Latino,48,16,64
138502,Vitiligo,ethnic,Not Hispanic or Latino,48,14,62
4103638,Amputated - transfemoral,racial,Unknown,2,60,62
372897,Homonymous bilateral visual field defects,racial,Unknown,21,41,62
440088,Academic underachievement disorder,racial,White,25,37,62
133848,Non-traumatic slipped upper femoral epiphysis,racial,White,2,60,62
4299574,Factitious skin disease,racial,Unknown,44,18,62
195259,Entrapment of lateral cutaneous nerve of thigh,racial,Unknown,51,12,63
4062495,Glaucoma screening,racial,Other Race,58,5,63
381860,Vascular abnormality of conjunctiva,ethnic,Hispanic or Latino,62,0,62
376657,Lipoma of face,ethnic,Hispanic or Latino,37,25,62
140168,Psoriasis,racial,White,9,53,62
436278,Superficial bruising of thigh,racial,White,30,32,62
80004,Hand injury,ethnic,Not Hispanic or Latino,28,35,63
313023,Neonatal chronic respiratory disease,racial,Black or African American ,12,51,63
432611,Explosive personality disorder,ethnic,Hispanic or Latino,5,58,63
441192,Accidentally struck by or against objects or persons,ethnic,Hispanic or Latino,21,41,62
139841,Chronic frontal sinusitis,ethnic,Not Hispanic or Latino,46,16,62
436539,Closed fracture of patella,racial,White,44,18,62
132583,Postablative hypothyroidism,ethnic,Hispanic or Latino,60,2,62
315296,Preinfarction syndrome,racial,Unknown,44,18,62
378735,Migraine without aura,racial,Asian,62,0,62
4286333,Carcinoma in situ,ethnic,Hispanic or Latino,41,21,62
77066,Derangement of medial meniscus,ethnic,Not Hispanic or Latino,23,39,62
4146239,Pruritus of genital organs,racial,Unknown,60,2,62
256909,Primary pulmonary coccidioidomycosis,ethnic,Not Hispanic or Latino,25,37,62
438722,Non megaloblastic anemia associated with nutritional deficiency,racial,White,48,14,62
379010,Macular retinal puckering,racial,White,39,23,62
436147,Glossitis,racial,White,39,23,62
73021,Bilateral congenital dislocation of hip,ethnic,Hispanic or Latino,62,0,62
4051564,FH: Metabolic disorder,racial,White,44,18,62
444200,Neoplasm of nervous system,ethnic,Hispanic or Latino,55,7,62
441818,Haemangioma,ethnic,Not Hispanic or Latino,28,35,63
376063,Benign neoplasm of cerebral meninges,racial,Unknown,37,25,62
140803,Idiopathic angio-oedema-urticaria,ethnic,Hispanic or Latino,30,32,62
4086918,Viral screening,racial,Native Hawaiian or Other Pacific Islander ,35,28,63
81671,Unilateral congenital dislocation of hip,ethnic,Hispanic or Latino,41,21,62
140821,Spasm,racial,American Indian or Alaska Native ,39,23,62
374924,Generalized convulsive epilepsy,racial,Asian,21,41,62
141249,Benign tumour of thyroid gland,ethnic,Hispanic or Latino,51,12,63
134398,Periodontal disease,ethnic,Hispanic or Latino,32,30,62
193251,Umbilical hernia without obstruction AND without gangrene,racial,Black or African American ,30,32,62
201254,Insulin dependent diabetes mellitus,racial,Asian,14,48,62
197795,Acute hepatitis B,racial,White,39,23,62
377910,Deviated nasal septum,ethnic,Not Hispanic or Latino,25,37,62
439937,C-reactive protein abnormal,racial,Unknown,35,28,63
200174,Disease of skin AND/OR subcutaneous tissue,racial,Black or African American ,41,21,62
196157,Induratio penis plastica,ethnic,Hispanic or Latino,0,62,62
24075,Esophageal stricture and stenosis,ethnic,Hispanic or Latino,44,18,62
432899,Normal pressure hydrocephalus,ethnic,Hispanic or Latino,0,62,62
437954,Lateral meniscus derangement,racial,White,32,30,62
4141622,Asthma NOS,racial,Unknown,44,18,62
134765,General body deterioration,racial,Black or African American ,12,51,63
379822,Cyst of eyelid,ethnic,Hispanic or Latino,53,9,62
78831,Disease of ankle,racial,Unknown,48,14,62
443869,Nonvenomous insect bite of wrist without infection,racial,White,28,35,63
372328,Otitis media,racial,American Indian or Alaska Native ,30,32,62
135333,Pressure sore,racial,White,30,32,62
78097,Metastatic tumour of bone,racial,Unknown,46,16,62
132703,Lichen planus,ethnic,Hispanic or Latino,51,12,63
4193570,Abnormal results of hearing screening test,racial,White,23,39,62
314968,Varices,racial,White,48,14,62
319835,Congestive cardiac failure,racial,American Indian or Alaska Native ,21,41,62
201340,Gastritis,ethnic,Not Hispanic or Latino,35,28,63
440985,Phobia,racial,White,48,14,62
4161977,Patient with cardiac pacemaker,racial,Other Race,12,51,63
4149382,Endocrine/metabolic screening,racial,Unknown,51,12,63
4296204,First degree burn,ethnic,Hispanic or Latino,53,9,62
314379,First degree atrioventricular block,ethnic,Not Hispanic or Latino,30,32,62
78162,Peripheral vertigo,racial,White,32,30,62
372610,Post-concussion syndrome,ethnic,Hispanic or Latino,25,37,62
4310768,Fall on steps,racial,White,53,9,62
4176874,Infantile melanodontia,racial,White,14,48,62
29735,Candidiasis of mouth,racial,Asian,39,23,62
444375,"Contact dermatitis due to plants, except food",racial,White,37,25,62
136497,Scar conditions and fibrosis of skin,racial,White,41,21,62
432312,Anatomical narrow angle glaucoma,ethnic,Hispanic or Latino,18,44,62
443564,Malignant neoplasm of bone,racial,White,32,30,62
434097,Twin pregnancy with antenatal problem,racial,Unknown,62,0,62
312664,Influenza with respiratory manifestation other than pneumonia,racial,Other Race,28,35,63
194700,"Diabetes mellitus in mother complicating pregnancy, childbirth AND/OR puerperium",racial,Unknown,62,0,62
30753,Esophagitis,ethnic,Not Hispanic or Latino,48,14,62
439014,Panuveitis,ethnic,Hispanic or Latino,58,5,63
197610,Ovarian cyst,racial,Asian,62,0,62
192364,Nephrotic syndrome associated with another disorder,ethnic,Hispanic or Latino,30,32,62
375549,Double pterygium,racial,Unknown,37,25,62
4144274,Housing lack,ethnic,Not Hispanic or Latino,16,46,62
375249,Traction detachment of retina,ethnic,Hispanic or Latino,32,30,62
438332,Disease of possible viral origin,racial,Filipino,30,32,62
4110815,"Sensorineural hearing loss, bilateral",racial,Asian,41,21,62
193807,Anorectal fistula,ethnic,Not Hispanic or Latino,18,44,62
316211,Acquired spondylolisthesis,racial,Unknown,41,21,62
77960,Joint observation,ethnic,Hispanic or Latino,44,18,62
376525,Audiogram abnormal,racial,White,32,30,62
381864,Subjective tinnitus,ethnic,Hispanic or Latino,44,18,62
441830,Disorder of fluid AND/OR electrolyte,racial,Unknown,39,23,62
317576,Coronary arteriosclerosis,racial,Filipino,0,62,62
436373,DSD - Developmental speech disorder,racial,Asian,9,53,62
141056,Acute ethmoidal sinusitis,racial,White,37,25,62
81151,Sprain of ankle joint,racial,Black or African American ,44,18,62
443933,Nicotiana tabacum poisoning,ethnic,Not Hispanic or Latino,46,16,62
197237,Benign tumour of prostate,ethnic,Hispanic or Latino,0,62,62
4048727,Neoplasm screening,ethnic,Not Hispanic or Latino,23,39,62
314665,Atrial flutter,racial,Asian,25,37,62
443111,Tenosynovitis of foot,racial,White,48,14,62
78097,Metastatic tumour of bone,ethnic,Not Hispanic or Latino,62,0,62
436962,Sleeplessness,racial,Filipino,37,25,62
4008566,Atypical schizophrenia,racial,White,28,35,63
440155,Postartificial menopausal syndrome,ethnic,Hispanic or Latino,62,0,62
434073,Loss of teeth - acquired,ethnic,Not Hispanic or Latino,58,5,63
435798,"Nondependent opioid abuse, episodic",racial,White,5,58,63
440424,Aphasia,racial,Asian,0,62,62
437041,Mother not delivered,racial,Black or African American ,62,0,62
80815,Mucous cyst of skin,racial,Unknown,39,23,62
4024567,Respiratory observation,racial,White,30,32,62
437165,Motor vehicle traffic accident,ethnic,Not Hispanic or Latino,25,37,62
193255,"Noninflammatory disorders of the ovary, fallopian tube and broad ligament",racial,White,62,0,62
4101068,Observation of ear discharge,ethnic,Hispanic or Latino,25,35,60
436088,Nondependent opioid abuse in remission,ethnic,Hispanic or Latino,18,41,59
315085,Enlargement of lymph nodes,racial,Asian,46,14,60
141758,Spinal cord injury without spinal bone injury,racial,White,0,60,60
78804,Schimmelbusch's disease,racial,Unknown,60,0,60
192683,Uterovaginal prolapse,racial,White,60,0,60
28060,Strept throat,racial,Asian,37,23,60
74892,Articular gout,ethnic,Not Hispanic or Latino,48,12,60
260427,Common cold,racial,Other Race,28,32,60
198520,Lumbar spondylosis with myelopathy,racial,Unknown,0,60,60
200171,Carbuncle of skin AND/OR subcutaneous tissue,racial,White,37,23,60
4263370,R.I.N.D. syndrome,racial,Black or African American ,53,7,60
73089,Contusion of buttock,racial,White,46,14,60
139900,Urticaria,racial,Other Race,30,30,60
378839,Spina bifida with hydrocephalus,racial,White,16,44,60
439391,Physical abuse of adult,ethnic,Hispanic or Latino,58,2,60
73866,Congenital anomaly of breast,racial,White,53,7,60
316535,Closed fracture of dorsal vertebra without spinal cord injury,racial,White,41,18,59
378160,Otorrhea,ethnic,Hispanic or Latino,18,41,59
4176874,Infantile melanodontia,racial,Unknown,30,30,60
199839,External haemorrhoids without complication,racial,Asian,30,30,60
196813,Simple renal cyst,racial,White,44,16,60
77630,Disease of shoulder,racial,Other Race,41,18,59
442792,Pes anserinus bursitis,racial,White,53,7,60
132835,Pediculosis capitis,racial,Unknown,55,5,60
319049,Acute respiratory failure,racial,White,21,39,60
79936,Polyuria,ethnic,Not Hispanic or Latino,12,48,60
4093311,Latent early syphilis NOS,racial,White,0,60,60
434467,Ostium secundum type atrial septal defect,racial,Black or African American ,60,0,60
78472,Microscopic haematuria,racial,Asian,35,25,60
436140,Vulval varices,ethnic,Hispanic or Latino,60,0,60
256439,Allergic rhinitis due to pollen,racial,Black or African American ,16,44,60
378416,Retinal disorder,racial,Unknown,51,9,60
194684,Crohn's disease of large bowel,ethnic,Not Hispanic or Latino,55,5,60
78257,Osteogenesis imperfecta,racial,White,16,44,60
4093311,Latent early syphilis NOS,ethnic,Hispanic or Latino,0,60,60
376973,Cataract secondary to ocular disease,ethnic,Hispanic or Latino,44,16,60
196347,Intestinal parasitism,racial,White,35,25,60
26378,Hyperpituitarism,ethnic,Not Hispanic or Latino,41,18,59
134718,Hirsutism,ethnic,Not Hispanic or Latino,60,0,60
4168226,Micturition frequency and polyuria,ethnic,Hispanic or Latino,48,12,60
316432,Right bundle branch block AND left anterior fascicular block,racial,Unknown,18,41,59
134438,CD - Contact dermatitis,racial,Filipino,37,23,60
194997,Prostatitis,ethnic,Not Hispanic or Latino,0,60,60
197911,Hernia of anterior abdominal wall without obstruction AND without gangrene,racial,Black or African American ,0,60,60
437382,Urine observation,racial,Black or African American ,41,18,59
193518,Intestinal obstruction,racial,White,35,25,60
81390,Idiopathic osteoporosis,racial,Native Hawaiian or Other Pacific Islander ,60,0,60
4310682,Multiple open wounds with complication,racial,White,25,35,60
76482,MA - Missed abortion,ethnic,Not Hispanic or Latino,55,5,60
440508,Congenital disease,racial,Unknown,5,55,60
74458,Enthesopathy of knee region,ethnic,Not Hispanic or Latino,48,12,60
78835,Palindromic rheumatism of the lower leg,racial,Other Race,51,9,60
80497,Disorder of cervical spine,ethnic,Not Hispanic or Latino,37,23,60
80767,Breast irregular nodularity,racial,Black or African American ,55,5,60
4016675,"Sprain, ankle joint, medial",ethnic,Hispanic or Latino,32,28,60
134304,Benign tumour of parathyroid gland,ethnic,Hispanic or Latino,53,7,60
432881,Pancytopenia,ethnic,Not Hispanic or Latino,7,53,60
200164,Urine-induced contact dermatitis,racial,Other Race,25,35,60
437104,"Abnormal smear, noted, recall delete",racial,White,60,0,60
437891,PPHT - Primary pulmonary hypertension,racial,White,60,0,60
261325,Pulmonary emphysema,racial,Asian,5,55,60
253482,Cortical blindness,ethnic,Hispanic or Latino,16,44,60
318775,Venous embolism,racial,Other Race,48,12,60
75010,Fibroadenosis of breast,racial,White,60,0,60
441201,"[X]Fall from, out of or through building or structure",ethnic,Hispanic or Latino,32,28,60
442425,Lumbar post-laminectomy syndrome,ethnic,Not Hispanic or Latino,32,28,60
4060318,Chest pain NOS,ethnic,Hispanic or Latino,30,30,60
75091,Closed fracture of carpal bone,ethnic,Not Hispanic or Latino,28,32,60
25572,Disease of salivary gland,ethnic,Hispanic or Latino,16,44,60
73291,Palindromic rheumatism of the ankle and/or foot,racial,Other Race,18,41,59
198964,Chronic type C viral hepatitis,racial,American Indian,60,0,60
433032,Pyrexia postprocedure,ethnic,Hispanic or Latino,55,5,60
437942,Caesarean delivery - delivered,racial,White,60,0,60
4173811,Congenital quadriplegia,ethnic,Not Hispanic or Latino,21,39,60
436067,Schizophrenia simplex,racial,Black or African American ,18,41,59
441836,Depressed bipolar I disorder,racial,Unknown,55,5,60
78237,Bicipital tenosynovitis,ethnic,Not Hispanic or Latino,46,14,60
137548,Cervical root lesion,racial,Unknown,37,23,60
4058247,Anaemia during pregnancy/childbirth/puerperium NOS,ethnic,Hispanic or Latino,60,0,60
444243,Neurotic disorder,ethnic,Not Hispanic or Latino,23,37,60
441333,Geographic tongue,ethnic,Hispanic or Latino,23,37,60
136775,Contact dermatitis due to solar radiation,racial,White,41,18,59
196813,Simple renal cyst,ethnic,Hispanic or Latino,44,16,60
312437,Dyspnea,racial,Asian,51,9,60
138479,Thyroid dysfunction during pregnancy - baby not yet delivered,ethnic,Not Hispanic or Latino,58,2,60
4161977,Patient with cardiac pacemaker,racial,Native Hawaiian or Other Pacific Islander ,46,14,60
201618,Disease of intestine,ethnic,Hispanic or Latino,39,21,60
4108079,Perceptive hearing loss NOS,ethnic,Hispanic or Latino,35,25,60
4044391,Diabetic neuropathy,racial,White,60,0,60
432933,Aneurysm of artery of lower extremity,racial,White,2,58,60
377853,Chronic tension-type headache,racial,White,48,12,60
433736,Obesity,racial,Asian Indian,39,21,60
435914,Metatarsus varus,ethnic,Hispanic or Latino,23,37,60
72245,Chlamydial infection of lower genitourinary tract,ethnic,Hispanic or Latino,55,5,60
257583,Allergic bronchopulmonary aspergillosis,ethnic,Hispanic or Latino,60,0,60
376105,Krampfe salaam attacks,racial,White,39,21,60
197981,Abdominal tenderness,racial,White,44,16,60
4188027,Food allergy,racial,Unknown,39,21,60
4158567,Post percutaneous transluminal coronary angioplasty,racial,Black or African American ,39,21,60
72418,Scoliosis deformity of spine,racial,Unknown,16,44,60
436176,Spontaneous abortion without complication,ethnic,Not Hispanic or Latino,60,0,60
4053599,Open wound of forearm,racial,White,32,28,60
194018,"Functional enuresis, NOS",racial,Unknown,44,16,60
78786,Pleurisy,racial,White,39,21,60
439770,Ketoacidosis in type I diabetes mellitus,racial,White,30,30,60
372887,Disease of brain,racial,White,14,46,60
200768,Inflammatory disease of vagina and/or vulva,ethnic,Hispanic or Latino,60,0,60
434750,Feeding difficulties and mismanagement,racial,Other Race,28,32,60
376120,"Keratoconjunctivitis sicca, not specified as Sjogren's",racial,Unknown,58,2,60
442067,Atopic dermatitis and related conditions,racial,American Indian or Alaska Native ,46,14,60
255919,Finding of head and neck region,ethnic,Not Hispanic or Latino,32,28,60
200528,Ascites,ethnic,Not Hispanic or Latino,35,25,60
4053045,Dog bite,ethnic,Not Hispanic or Latino,37,23,60
443909,"Decreased level, laboratory test",racial,White,28,32,60
440129,Hypertrophy of nasal turbinates,ethnic,Not Hispanic or Latino,32,28,60
81723,Contusion of hand,ethnic,Not Hispanic or Latino,32,28,60
437843,Childhood conduct disorder,ethnic,Hispanic or Latino,16,44,60
434219,Anaphylactic shock due to adverse food reaction,racial,White,9,51,60
255348,Polymyalgia rheumatica,racial,Unknown,60,0,60
194093,Postcoital bleeding,racial,Unknown,60,0,60
435656,Neonatal jaundice,racial,Unknown,14,46,60
376111,Unqualified visual loss of one eye,racial,White,41,16,57
201603,Disease of teeth AND/OR supporting structures,racial,Black or African American ,32,25,57
193519,Impaired renal function disorder,ethnic,Hispanic or Latino,35,23,58
81984,Sprain of shoulder and upper arm,racial,Other Race,51,7,58
374347,Blepharoconjunctivitis,ethnic,Hispanic or Latino,30,28,58
377286,VFD - Visual field defect,racial,White,23,35,58
440392,Retinal vascular occlusion,ethnic,Hispanic or Latino,41,16,57
139899,Pemphigoid,ethnic,Hispanic or Latino,25,32,57
440689,Agranulocytosis,racial,White,51,7,58
438329,Late effect of motor vehicle accident,ethnic,Hispanic or Latino,55,2,57
201111,Congenital renal dysplasia,ethnic,Hispanic or Latino,48,9,57
73026,Abnormal respiratory sounds,ethnic,Hispanic or Latino,37,21,58
376063,Benign neoplasm of cerebral meninges,racial,White,37,21,58
198100,Carcinoid tumor of small intestine,ethnic,Hispanic or Latino,55,2,57
141216,MC - Molluscum contagiosum,racial,Black or African American ,12,46,58
439700,Inhibited sexual desire,racial,Asian,0,58,58
132703,Lichen planus,racial,White,48,9,57
135033,Hair and hair follicle diseases,racial,Black or African American ,23,35,58
141758,Spinal cord injury without spinal bone injury,ethnic,Not Hispanic or Latino,0,58,58
4108533,Unspecified otalgia,racial,Unknown,46,12,58
312648,Benign essential hypertension,racial,Alaska Native,0,58,58
4310768,Fall on steps,racial,Unknown,37,21,58
312349,Venous varices,racial,Other Race,48,9,57
132412,Failed back syndrome,ethnic,Hispanic or Latino,7,51,58
381028,Acute suppurative otitis media - tympanic membrane ruptured,racial,Unknown,25,32,57
192592,Pseudoprimary aldosteronism,racial,White,0,58,58
440694,"Nondependent mixed drug abuse, episodic",ethnic,Not Hispanic or Latino,18,39,57
441190,Injury of unknown intent due to fall from height,racial,Unknown,46,12,58
318459,Respiratory insufficiency,racial,White,5,53,58
438005,Closed fracture shaft of fibula,racial,White,35,23,58
138379,"Chronic lymphoid leukemia, disease",racial,White,30,28,58
439155,Carcinoembryonic antigen present,ethnic,Not Hispanic or Latino,23,35,58
78518,Observation of shoulder joint,ethnic,Hispanic or Latino,51,7,58
442308,Abrasion AND/OR friction burn of thigh without infection,racial,Unknown,28,30,58
255891,Lupus erythematosus,racial,Black or African American ,58,0,58
318556,Nosebleed,racial,Asian,21,37,58
4064377,Depression screening,racial,Asian Indian,25,32,57
132489,Partial thickness burn of finger,ethnic,Hispanic or Latino,37,21,58
321318,Angina,racial,Filipino,0,58,58
436446,Cracked tooth syndrome,racial,White,25,32,57
253321,Stridor,racial,White,25,32,57
436816,Vaginal vault smear abnormal,ethnic,Hispanic or Latino,58,0,58
432571,Malignant lymphoma,ethnic,Not Hispanic or Latino,2,55,57
77068,Secondary localised osteoarthrosis of lower leg,ethnic,Hispanic or Latino,37,21,58
441968,Acetonuria,racial,White,28,30,58
316535,Closed fracture of dorsal vertebra without spinal cord injury,racial,Unknown,53,5,58
433990,Subchronic catatonic schizophrenia,ethnic,Hispanic or Latino,0,58,58
313219,Phlebitis and thrombophlebitis,racial,White,37,21,58
199192,Abrasion AND/OR friction burn of trunk without infection,ethnic,Hispanic or Latino,25,32,57
440012,Fall from chair or bed,racial,White,37,21,58
312336,Arterial aneurysm,ethnic,Hispanic or Latino,41,16,57
442588,OSA - Obstructive sleep apnoea,racial,Asian,37,21,58
4002644,Rotator cuff shoulder syndrome and allied disorders,racial,Unknown,32,25,57
141693,Elevated blood-pressure reading without diagnosis of hypertension,racial,American Indian or Alaska Native ,46,12,58
79897,Obstetric non-purulent mastitis - delivered with postnatal complication,racial,White,58,0,58
4104853,Epileptic seizures - clonic,racial,Unknown,51,7,58
440386,Transsexualism,ethnic,Hispanic or Latino,0,58,58
192592,Pseudoprimary aldosteronism,ethnic,Hispanic or Latino,0,58,58
4112525,Acute bronchiolitis NOS,ethnic,Not Hispanic or Latino,18,39,57
439183,Concussion,racial,Unknown,21,37,58
372912,Visual discomfort,ethnic,Hispanic or Latino,37,21,58
135858,Disorder of lip,ethnic,Not Hispanic or Latino,35,23,58
438557,Abnormal glucose level,racial,Filipino,32,25,57
200768,Inflammatory disease of vagina and/or vulva,racial,White,58,0,58
377575,Tinnitus,racial,Other Race,37,21,58
381575,Disorder of external ear,ethnic,Hispanic or Latino,44,14,58
433811,Hydronephrosis,racial,Asian,23,35,58
320835,TOF - Tetralogy of Fallot,ethnic,Not Hispanic or Latino,12,46,58
315276,Vitreous hemorrhage,racial,Unknown,51,7,58
436096,Chronic pain,racial,American Indian or Alaska Native ,2,55,57
81931,Psoriasis with arthropathy,ethnic,Not Hispanic or Latino,18,39,57
4066260,Galactorrhea in pregnancy and the puerperium,racial,White,58,0,58
135699,Burn any degree involving 10-19 percent of body surface,racial,White,25,32,57
137658,Congenital pigmentary anomaly of skin,ethnic,Hispanic or Latino,21,37,58
437246,Vitamin B deficiency,ethnic,Not Hispanic or Latino,39,18,57
4150157,Other anemias,ethnic,Hispanic or Latino,39,18,57
436077,Developmental delay,racial,Other Race,46,12,58
435236,Acute exacerbation of chronic schizoaffective schizophrenia,ethnic,Not Hispanic or Latino,53,5,58
441207,Drug reaction,racial,Unknown,53,5,58
75103,Sprain of jaw,ethnic,Hispanic or Latino,32,25,57
434165,Abnormal cervical smear,racial,Asian,58,0,58
4028641,Pregnancy and drug dependence,ethnic,Not Hispanic or Latino,58,0,58
77638,Displacement of intervertebral disc without myelopathy,ethnic,Not Hispanic or Latino,53,5,58
377910,Deviated nasal septum,racial,Unknown,5,53,58
74135,Disorder of synovium,racial,White,21,37,58
432933,Aneurysm of artery of lower extremity,ethnic,Not Hispanic or Latino,0,58,58
441678,"Gestation period, 33 weeks",racial,White,23,35,58
23325,Heartburn,racial,Other Race,37,21,58
432725,Congenital anomaly of integument,ethnic,Hispanic or Latino,23,35,58
254058,Acute bronchiolitis due to respiratory syncytial virus,ethnic,Not Hispanic or Latino,9,48,57
443723,Finding of cellular component of blood,racial,White,35,23,58
434821,SIRS - System inflammatory response syndrome,racial,Unknown,39,18,57
315558,Atherosclerosis of arteries of the extremities,ethnic,Not Hispanic or Latino,32,25,57
443360,Eye mass,ethnic,Hispanic or Latino,32,25,57
200764,Bile duct calculus without mention of cholecystitis and no obstruction,ethnic,Hispanic or Latino,18,39,57
442139,Primary bronchial cancer,racial,Unknown,7,51,58
432898,Severe mental handicap,ethnic,Hispanic or Latino,5,53,58
321887,Disorder of artery,racial,Other Race,58,0,58
376686,Polyneuropathy associated with another disorder,ethnic,Not Hispanic or Latino,28,30,58
436075,Adjustment disorder with anxious mood,ethnic,Not Hispanic or Latino,23,35,58
4100529,Misuse of drugs NOS,ethnic,Hispanic or Latino,44,14,58
313792,PT - Paroxysmal tachycardia,racial,Unknown,37,21,58
443570,Cervicovaginal cytology: Low grade squamous intraepithelial lesion,racial,Asian,58,0,58
192675,Biliary cirrhosis,racial,Unknown,41,16,57
374013,Secondary Parkinson's disease,ethnic,Not Hispanic or Latino,0,58,58
440990,Chorea,ethnic,Hispanic or Latino,12,46,58
444371,Abrasion AND/OR friction burn of finger without infection,ethnic,Hispanic or Latino,28,30,58
437579,Paroxysmal ventricular tachycardia,racial,Other Race,58,0,58
378741,Brachial plexus lesion,ethnic,Hispanic or Latino,39,18,57
135930,Musculoskeletal system observation,ethnic,Hispanic or Latino,44,14,58
4299574,Factitious skin disease,racial,White,53,5,58
76506,Effusion of joint of lower leg,racial,Unknown,30,28,58
135030,Discoloration of skin,ethnic,Not Hispanic or Latino,41,16,57
435372,Underweight,racial,Black or African American ,5,53,58
440940,Methicillin resistant Staphylococcus aureus infection,racial,White,39,18,57
436972,Glaucoma associated with systemic syndromes,racial,Asian,14,44,58
432526,Needs influenza immunisation,racial,American Indian,30,28,58
139036,Systolic dysfunction,ethnic,Hispanic or Latino,16,41,57
4024000,Urinary system finding,ethnic,Hispanic or Latino,23,35,58
252365,MGN - Membranous glomerulonephritis,racial,Black or African American ,2,55,57
439654,Partial epilepsy with impairment of consciousness,ethnic,Not Hispanic or Latino,51,7,58
434752,Positive serological AND/OR viral culture findings for human immunodeficiency virus,racial,Unknown,0,58,58
433911,Contusion of eye AND ocular adnexa,ethnic,Hispanic or Latino,14,44,58
193256,Alcoholic fatty liver,racial,Unknown,5,53,58
437530,Disorders of lipoid metabolism,racial,White,44,14,58
198100,Carcinoid tumor of small intestine,racial,White,55,2,57
4025009,Inguinal hernia NOS,racial,White,2,55,57
435515,Hypo-osmolality and or hyponatremia,racial,Asian,21,37,58
25297,Acute pharyngitis,racial,Filipino,32,25,57
28714,Syndrome of diencephalo-hypophyseal origin,ethnic,Hispanic or Latino,55,2,57
28385,Disorder of posterior pituitary,ethnic,Not Hispanic or Latino,58,0,58
380096,Proliferative diabetic retinopathy,racial,Asian,9,48,57
321689,Apneic,ethnic,Not Hispanic or Latino,21,37,58
444429,Herpes simplex infection,ethnic,Hispanic or Latino,37,21,58
376946,Senile delirium,ethnic,Hispanic or Latino,46,12,58
374375,Impacted cerumen,racial,Native Hawaiian or Other Pacific Islander ,41,16,57
80186,Recurrent dislocation of shoulder region,ethnic,Hispanic or Latino,14,44,58
439224,Drug allergy,ethnic,Not Hispanic or Latino,25,32,57
74892,Articular gout,racial,White,0,58,58
441980,Closed fracture of foot,ethnic,Not Hispanic or Latino,44,14,58
4025009,Inguinal hernia NOS,ethnic,Hispanic or Latino,2,55,57
433030,False-positive serological test for syphilis,ethnic,Hispanic or Latino,46,12,58
4263325,Actinic cheilitis,racial,Unknown,39,18,57
4130036,Brain damage due to hypoxia,racial,White,14,44,58
441604,Acute appendicitis without peritonitis,ethnic,Hispanic or Latino,30,25,55
444098,"Gestation period, 40 weeks",racial,White,21,35,56
443570,Cervicovaginal cytology: Low grade squamous intraepithelial lesion,racial,Black or African American ,55,0,55
138113,Cyst of thyroid,ethnic,Not Hispanic or Latino,55,0,55
80187,Medial epicondylitis,racial,Unknown,44,12,56
435796,Dehydration,racial,Asian,9,46,55
436263,Broken tooth without complication,racial,White,37,18,55
195083,Left lower quadrant pain,racial,Asian,48,7,55
378161,Disorder of ear,racial,Unknown,48,7,55
4001998,Pulmonary apoplexy,racial,White,7,48,55
4288676,Acute and chronic cholecystitis,racial,White,41,14,55
436673,Chronic residual schizophrenia,ethnic,Hispanic or Latino,39,16,55
376422,Mucopurulent conjunctivitis,ethnic,Not Hispanic or Latino,28,28,56
253954,PTB - Pulmonary tuberculosis,racial,Unknown,48,7,55
197484,Diarrhea of presumed infectious origin,racial,Unknown,48,7,55
140273,"Contusion, forearm area",racial,Unknown,30,25,55
200174,Disease of skin AND/OR subcutaneous tissue,racial,American Indian or Alaska Native ,55,0,55
77352,Pyogenic arthritis of the lower leg,ethnic,Hispanic or Latino,37,18,55
379782,Gilles de la Tourette's syndrome,ethnic,Hispanic or Latino,32,23,55
439795,Minimal cognitive impairment,racial,Other Race,21,35,56
197911,Hernia of anterior abdominal wall without obstruction AND without gangrene,racial,Other Race,28,28,56
440921,Traumatic injury,racial,Unknown,39,16,55
132932,Chronic ethmoidal sinusitis,ethnic,Hispanic or Latino,48,7,55
80509,Bone cyst,racial,White,23,32,55
381857,Impairment level: one eye: total impairment: other eye: not specified,ethnic,Not Hispanic or Latino,39,16,55
196443,Gastric ulcer without hemorrhage AND without perforation but with obstruction,ethnic,Hispanic or Latino,48,7,55
377298,Chronic otitis externa,ethnic,Hispanic or Latino,41,14,55
141411,Scalp injury,ethnic,Hispanic or Latino,23,32,55
29056,Sialoadenitis,racial,Unknown,30,25,55
138113,Cyst of thyroid,racial,Unknown,53,2,55
196359,Primary malignant neoplasm of uterine cervix,ethnic,Not Hispanic or Latino,55,0,55
433316,Giddiness,racial,American Indian or Alaska Native ,51,5,56
435236,Acute exacerbation of chronic schizoaffective schizophrenia,racial,Black or African American ,51,5,56
432612,Mild mental handicap,ethnic,Not Hispanic or Latino,12,44,56
77072,Joint effusion of ankle AND/OR foot,racial,White,35,21,56
4273391,Suicidal thoughts,ethnic,Not Hispanic or Latino,30,25,55
432453,General clinical state finding,ethnic,Not Hispanic or Latino,37,18,55
81251,Neoplasm of breast,racial,Asian,55,0,55
374036,Chronic conjunctivitis,racial,White,16,39,55
436954,Drug abuse,racial,Unknown,35,21,56
437104,"Abnormal smear, noted, recall delete",ethnic,Hispanic or Latino,55,0,55
441481,Adult victim of abuse,ethnic,Hispanic or Latino,39,16,55
75512,Carcinoma in situ of colon,ethnic,Hispanic or Latino,39,16,55
439080,Dyspareunia,ethnic,Not Hispanic or Latino,55,0,55
435220,Severe recurrent major depression without psychotic features,racial,Black or African American ,55,0,55
26662,Testicular hypofunction,racial,Other Race,0,55,55
375246,Mononeuritis of upper limb,racial,White,12,44,56
434094,Spontaneous abortion with complication,ethnic,Hispanic or Latino,55,0,55
4194160,Thyroid function tests abnormal,racial,Other Race,0,55,55
197921,Renal osteodystrophy,ethnic,Hispanic or Latino,51,5,56
374044,Droopy eyelid,ethnic,Not Hispanic or Latino,16,39,55
261687,Hemoptysis,racial,Unknown,46,9,55
73090,Superficial bruising of foot,ethnic,Not Hispanic or Latino,51,5,56
441655,Disorder of sweat gland,ethnic,Hispanic or Latino,41,14,55
74472,Congenital deformity of foot,racial,White,14,41,55
200831,Congenital anomaly of penis,racial,White,0,55,55
374954,Optic neuritis,ethnic,Hispanic or Latino,25,30,55
435666,Closed fracture of upper end of tibia,racial,White,23,32,55
442558,"Gestation period, 32 weeks",racial,White,41,14,55
4059157,Family circumstance NOS,ethnic,Not Hispanic or Latino,37,18,55
439304,Retinal round hole without detachment,ethnic,Hispanic or Latino,41,14,55
4293175,"Mental state, behaviour and/or psychosocial function finding",racial,Other Race,9,46,55
4109880,Varicose veins of the leg with ulcer,ethnic,Not Hispanic or Latino,37,18,55
260123,Acute inflammation of sinus,racial,Filipino,25,30,55
73338,Sprain of lateral collateral ligament of knee,ethnic,Hispanic or Latino,28,28,56
442558,"Gestation period, 32 weeks",ethnic,Hispanic or Latino,41,14,55
81251,Neoplasm of breast,ethnic,Not Hispanic or Latino,55,0,55
198715,Premature menopause,racial,White,55,0,55
195007,Female stress incontinence,racial,Other Race,55,0,55
76685,MG - Myasthenia gravis,ethnic,Hispanic or Latino,39,16,55
4060318,Chest pain NOS,racial,White,30,25,55
80141,Functional diarrhea,racial,White,28,28,56
374882,Benign connective tissue neoplasm,racial,White,41,14,55
433909,Foreign body on external eye,ethnic,Hispanic or Latino,5,51,56
4115370,Arthralgia NOS,ethnic,Hispanic or Latino,51,5,56
432878,Drug abuse using speed,ethnic,Not Hispanic or Latino,35,21,56
4110787,Other otitis externa,racial,White,37,18,55
373499,Disorder of eye region,ethnic,Not Hispanic or Latino,41,14,55
198197,Male infertility,racial,White,0,55,55
4245252,Raised prostate specific antigen,racial,Black or African American ,0,55,55
435088,Senility,ethnic,Hispanic or Latino,32,23,55
40484028,Dental caries extending into dentine,racial,White,35,21,56
261687,Hemoptysis,ethnic,Not Hispanic or Latino,30,25,55
439120,Aseptic necrosis of head AND/OR neck of femur,racial,Black or African American ,12,44,56
139750,Primary malignant neoplasm of skin,racial,Unknown,41,14,55
435394,Intracranial hemorrhage following injury,racial,Unknown,0,55,55
141499,Septicemia,ethnic,Hispanic or Latino,32,23,55
440012,Fall from chair or bed,racial,Unknown,39,16,55
443211,Benign prostatic hypertrophy with outflow obstruction,ethnic,Hispanic or Latino,0,55,55
137351,Epidermoid cyst of skin,racial,Asian,32,23,55
4141481,"Hand, foot and mouth disease",ethnic,Not Hispanic or Latino,16,39,55
435244,Developmental disorder,racial,White,21,35,56
138825,Actinic keratosis,racial,Asian,14,41,55
440389,MR - Mental retardation,racial,Black or African American ,16,39,55
197795,Acute hepatitis B,racial,Unknown,16,39,55
4024013,Sensory nervous system finding,racial,White,37,18,55
439706,Psychosis with origin in childhood,ethnic,Not Hispanic or Latino,5,51,56
40481920,Periumbilical pain,ethnic,Not Hispanic or Latino,25,30,55
381839,Habit disorder,racial,White,30,25,55
199876,Prolapse of female genital organs,racial,Unknown,55,0,55
435394,Intracranial hemorrhage following injury,ethnic,Hispanic or Latino,0,55,55
31317,Can't get food down,racial,Other Race,23,32,55
379805,Myopia,racial,Other Race,41,14,55
432695,Post-term pregnancy,racial,White,53,2,55
4345578,Rhabdomyolysis,ethnic,Hispanic or Latino,28,28,56
443431,Disorder of menstruation,racial,Black or African American ,55,0,55
193787,Varicose veins of lower extremity with ulcer AND inflammation,racial,Unknown,9,46,55
135858,Disorder of lip,racial,Unknown,28,28,56
4008566,Atypical schizophrenia,ethnic,Hispanic or Latino,28,28,56
77354,Primary localised osteoarthrosis of lower leg,racial,Black or African American ,39,16,55
261782,Herpetic ulceration of vulva,racial,White,55,0,55
201914,Premenopausal menorrhagia,racial,Black or African American ,55,0,55
79106,Arthralgia of the pelvic region and thigh,racial,American Indian or Alaska Native ,51,5,56
135215,Hashimoto thyroiditis,racial,White,55,0,55
30515,Oesophagostenosis,ethnic,Hispanic or Latino,23,32,55
432310,Meningitis due to cryptococcus,ethnic,Hispanic or Latino,0,55,55
372888,Sciatic nerve lesion,racial,White,48,7,55
4100529,Misuse of drugs NOS,racial,Unknown,23,32,55
4110046,Obstructive chronic bronchitis NOS,ethnic,Not Hispanic or Latino,0,55,55
78831,Disease of ankle,ethnic,Not Hispanic or Latino,37,18,55
373185,Drug-induced dyskinesia,racial,Asian,0,55,55
376415,Hypermetropia,racial,White,23,32,55
4025514,Unspecified peptic ulcer,racial,White,14,41,55
27674,N&V - Nausea and vomiting,racial,Other Race,37,18,55
197318,Cholesterolosis of gallbladder,racial,Unknown,32,23,55
193874,Bed wetting,racial,Black or African American ,18,37,55
441918,"Emotional AND/OR mental disease in mother complicating pregnancy, childbirth AND/OR puerperium",ethnic,Not Hispanic or Latino,55,0,55
198809,Acute cholecystitis,racial,White,35,21,56
437092,Physiological development failure,racial,Asian,12,44,56
77642,Arthralgia of the forearm,racial,Black or African American ,41,14,55
380038,Viral conjunctivitis,racial,Unknown,30,25,55
4171556,Ankle ulcer,ethnic,Not Hispanic or Latino,2,53,55
438699,Primary malignant neoplasm of rectosigmoid junction,racial,Asian,0,55,55
436298,Adverse reaction to food,racial,Unknown,9,46,55
316994,Malignant hypertensive heart disease with congestive cardiac failure,racial,White,35,21,56
440081,Barbiturate dependence,racial,White,12,44,56
4008089,Dysentery,racial,White,25,30,55
74582,Primary malignant neoplasm of rectum,racial,Asian,2,53,55
435836,Disorder of nasopharynx,ethnic,Hispanic or Latino,18,35,53
74468,Congenital anomaly of rib,ethnic,Hispanic or Latino,25,28,53
197236,Uterine fibroid,racial,American Indian or Alaska Native ,53,0,53
4147639,Cellulitis and abscess of toe NOS,racial,White,21,32,53
194574,Chronic type B viral hepatitis,racial,Black or African American ,0,53,53
374655,Mastoiditis,ethnic,Hispanic or Latino,39,14,53
381036,Multiple AND bilateral precerebral artery stenosis,racial,White,48,5,53
439246,"Mixed bipolar affective disorder, severe, with psychosis",ethnic,Hispanic or Latino,53,0,53
381278,Cluster headache,racial,White,35,18,53
432301,Opioid dependence in remission,ethnic,Hispanic or Latino,9,44,53
436730,"Appendicitis, unqualified",racial,Unknown,16,37,53
435534,"Nondependent alcohol abuse, continuous",racial,Black or African American ,0,53,53
193666,Hip injury,ethnic,Not Hispanic or Latino,30,23,53
376713,Cerebral hemorrhage,racial,Unknown,30,23,53
4152813,Family disruption,ethnic,Not Hispanic or Latino,18,35,53
373185,Drug-induced dyskinesia,ethnic,Hispanic or Latino,37,16,53
320420,Vitreous degeneration,racial,White,46,7,53
437832,Malnutrition of mild degree (Gomez: 75% to less than 90% of standard weight),racial,White,46,7,53
375525,Athetoid cerebral palsy,ethnic,Hispanic or Latino,44,9,53
376229,Abnormal involuntary movement,racial,Asian,18,35,53
193256,Alcoholic fatty liver,racial,White,5,48,53
432311,Angle-closure glaucoma - borderline,racial,Unknown,41,12,53
373769,Nuclear cataract,ethnic,Hispanic or Latino,18,35,53
444445,Benign neoplasm of skin of leg,racial,White,41,12,53
376208,Soft tissue disorder,racial,Black or African American ,0,53,53
379769,Benign brain tumour,racial,Unknown,51,2,53
435912,Endocardial cushion defect,ethnic,Hispanic or Latino,37,16,53
193666,Hip injury,racial,Unknown,46,7,53
40483107,Inflamed seborrheic keratosis,racial,Unknown,41,12,53
373487,AION - Acute ischaemic optic neuropathy,racial,Unknown,0,53,53
4331899,Child in family care,ethnic,Hispanic or Latino,16,37,53
141232,MM - Malignant melanoma of skin,ethnic,Not Hispanic or Latino,37,16,53
434613,Generalized anxiety disorder,racial,Black or African American ,12,41,53
74451,Palindromic rheumatism of the forearm,ethnic,Not Hispanic or Latino,21,32,53
433071,Contusion of multiple sites,racial,White,37,16,53
378414,Separation of retinal layers,ethnic,Not Hispanic or Latino,39,14,53
4154623,Fit denture,racial,Unknown,44,9,53
433985,Hypercarotinemia,ethnic,Not Hispanic or Latino,7,46,53
138996,Carcinoma in situ of skin,racial,White,14,39,53
314658,Cardiomegaly,racial,Native Hawaiian or Other Pacific Islander ,51,2,53
4299535,Pregnancy confirmed,racial,Black or African American ,53,0,53
140648,Onychomycosis due to dermatophyte,racial,American Indian or Alaska Native ,32,21,53
200779,Intrauterine polyp,racial,White,53,0,53
379769,Benign brain tumour,racial,White,41,12,53
443570,Cervicovaginal cytology: Low grade squamous intraepithelial lesion,racial,Other Race,53,0,53
78517,Arthralgia of multiple joints,racial,American Indian or Alaska Native ,46,7,53
201627,Abnormal vaginal bleeding,racial,Other Race,53,0,53
381308,Abscess of eyelid,ethnic,Not Hispanic or Latino,23,30,53
4222138,Allergic contact dermatitis of eyelid,ethnic,Hispanic or Latino,46,7,53
133278,Disorder of hair,ethnic,Hispanic or Latino,53,0,53
73923,"Contusion, upper arm",racial,White,32,21,53
376713,Cerebral hemorrhage,racial,White,21,32,53
77646,Disorder of bone and articular cartilage,ethnic,Hispanic or Latino,23,30,53
192357,Paralytic ileus,ethnic,Hispanic or Latino,28,25,53
196463,Alcoholic cirrhosis,racial,Other Race,9,44,53
434782,Closed fracture of tibia AND fibula,ethnic,Hispanic or Latino,41,12,53
313236,Cough variant asthma,racial,Other Race,32,21,53
4086918,Viral screening,racial,Filipino,39,14,53
381677,SBO - Spina bifida occulta,racial,White,7,46,53
434459,Ganglion of tendon sheath,ethnic,Hispanic or Latino,44,9,53
75406,Crush injury of finger,racial,White,25,28,53
4249474,Generalized seborrheic dermatitis of infants,ethnic,Hispanic or Latino,28,25,53
195363,Congenital anomaly of kidney,racial,White,14,39,53
31317,Can't get food down,racial,Asian,14,39,53
197032,Hyperplasia of prostate,racial,Native Hawaiian or Other Pacific Islander ,0,53,53
138996,Carcinoma in situ of skin,racial,Unknown,51,2,53
74723,Arthropathy associated with a neurological disorder,racial,White,23,30,53
78890,Sprain of elbow and forearm,racial,White,37,16,53
197332,Incomplete uterovaginal prolapse,racial,Unknown,53,0,53
436033,Syphilis,ethnic,Not Hispanic or Latino,5,48,53
440846,"Blood coagulation disorder, categorized by value of screening test",racial,White,25,28,53
376124,Pinguecula,racial,Unknown,30,23,53
437409,Intracranial injury,racial,White,5,48,53
80806,Climacteric arthritis of multiple sites,ethnic,Hispanic or Latino,39,14,53
433455,Teeth grinding whilst asleep,ethnic,Hispanic or Latino,41,12,53
444455,Benign tumour of soft tissue of head,ethnic,Hispanic or Latino,46,7,53
141090,PG - Pyogenic granuloma,racial,Unknown,9,44,53
4080568,Problem behaviour,ethnic,Not Hispanic or Latino,16,37,53
432306,Gender identity disorder of adolescence,ethnic,Hispanic or Latino,21,32,53
79897,Obstetric non-purulent mastitis - delivered with postnatal complication,ethnic,Hispanic or Latino,53,0,53
197018,Chronic gastric ulcer with hemorrhage but without obstruction,ethnic,Hispanic or Latino,39,14,53
434490,Shivering,racial,White,39,14,53
132393,Pressure ulcer stage 1,racial,Other Race,0,53,53
381562,"Impairment level: better eye: moderate impairment: lesser eye: blind, not further specified",ethnic,Hispanic or Latino,44,9,53
314962,Raynaud disease,racial,White,48,5,53
201343,Acute alcoholic liver disease,racial,Unknown,5,48,53
138479,Thyroid dysfunction during pregnancy - baby not yet delivered,racial,Unknown,53,0,53
133002,Acute osteomyelitis,ethnic,Hispanic or Latino,5,48,53
435950,Closed Colles' fracture,racial,Unknown,48,5,53
372328,Otitis media,racial,Native Hawaiian or Other Pacific Islander ,21,32,53
439081,Premenstrual tension syndrome,ethnic,Not Hispanic or Latino,48,5,53
4171115,Low birth weight infant,ethnic,Hispanic or Latino,28,25,53
4218764,Gastroschisis,ethnic,Hispanic or Latino,21,32,53
134743,Congenital ichthyosis of skin,ethnic,Hispanic or Latino,21,32,53
132393,Pressure ulcer stage 1,racial,Unknown,51,2,53
4047937,Neonatal urinary tract infection,racial,White,28,25,53
444437,Congenital abnormality of cervix,racial,White,53,0,53
195498,Benign tumour of kidney,racial,Unknown,2,51,53
139888,Threatened premature labor - not delivered,racial,Unknown,53,0,53
259849,Pneumonia with infectious diseases EC,racial,White,30,23,53
435796,Dehydration,racial,Other Race,30,23,53
434219,Anaphylactic shock due to adverse food reaction,ethnic,Hispanic or Latino,5,48,53
376104,Posttraumatic headache,racial,White,28,25,53
196734,Disease of prostate,racial,Unknown,0,53,53
4103471,Observation of body mass index,racial,Alaska Native,16,37,53
443257,Swellings and lumps,racial,Other Race,12,41,53
4086918,Viral screening,racial,American Indian,28,25,53
4194232,Absence seizure,racial,White,37,16,53
4181604,Subcutaneous contraceptive implant,racial,White,53,0,53
317893,Paroxysmal supraventricular tachycardia,racial,Unknown,41,9,50
435220,Severe recurrent major depression without psychotic features,racial,Other Race,44,7,51
437993,Closed fracture of cervical spine,ethnic,Hispanic or Latino,0,51,51
372328,Otitis media,racial,Filipino,16,35,51
442013,Burn,ethnic,Not Hispanic or Latino,16,35,51
4305589,"Neoplasm, benign",racial,Unknown,28,23,51
435242,Cerebellar ataxia,ethnic,Hispanic or Latino,44,7,51
198678,Intestinal infectious disease,racial,Other Race,25,25,50
317309,Peripheral arterial occlusive disease,racial,Black or African American ,48,2,50
197924,Bile duct calculus with acute cholecystitis and obstruction,ethnic,Hispanic or Latino,30,21,51
4147837,Generalized metabolic disorder,racial,White,28,23,51
4048191,Enlargement of tonsil or adenoid,racial,Unknown,28,23,51
80205,Perinatal condition,ethnic,Hispanic or Latino,44,7,51
381549,Migraine with aura,ethnic,Not Hispanic or Latino,44,7,51
4114314,Screening for osteoporosis,racial,American Indian or Alaska Native ,48,2,50
4280828,"Carrier, infectious agent",racial,Unknown,39,12,51
432878,Drug abuse using speed,ethnic,Hispanic or Latino,14,37,51
436446,Cracked tooth syndrome,racial,Unknown,28,23,51
435368,Congenital pigeon chest,racial,White,0,51,51
381278,Cluster headache,ethnic,Hispanic or Latino,25,25,50
132412,Failed back syndrome,racial,Unknown,0,51,51
74892,Articular gout,racial,Unknown,18,32,50
254061,Pleural effusion,ethnic,Not Hispanic or Latino,12,39,51
441868,Optic disc oedema,ethnic,Hispanic or Latino,48,2,50
437784,Pfeiffer's disease,racial,White,32,18,50
75617,Polyarticular osteoarthritis,racial,American Indian or Alaska Native ,41,9,50
442139,Primary bronchial cancer,racial,Black or African American ,0,51,51
432725,Congenital anomaly of integument,racial,White,25,25,50
141305,Unilateral sensorineural hearing loss with unrestricted hearing on the contralateral side,racial,Unknown,51,0,51
4273391,Suicidal thoughts,racial,White,30,21,51
436070,Vitamin D deficiency,racial,Black or African American ,51,0,51
316135,AVB - Atrioventricular block,ethnic,Hispanic or Latino,0,51,51
198803,Nodular hyperplasia of prostate gland,racial,American Indian or Alaska Native ,0,51,51
375826,Central hearing loss,racial,Unknown,37,14,51
136934,Primary hyperparathyroidism,ethnic,Not Hispanic or Latino,32,18,50
74130,Thoracic spondylosis without myelopathy,racial,White,35,16,51
192691,Diabetes mellitus during pregnancy - baby not yet delivered,ethnic,Hispanic or Latino,51,0,51
4186238,Louse infestation,ethnic,Not Hispanic or Latino,41,9,50
201075,Noninflammatory disorder of cervix,ethnic,Hispanic or Latino,51,0,51
375545,Lens opacity,racial,Native Hawaiian or Other Pacific Islander ,9,41,50
138239,Observation of limb structure,racial,Asian,28,23,51
441701,Sprain of hip joint,ethnic,Not Hispanic or Latino,30,21,51
312664,Influenza with respiratory manifestation other than pneumonia,racial,Asian,16,35,51
196625,Viral hepatitis A without hepatic coma,racial,White,35,16,51
381017,Ametropic amblyopia,ethnic,Not Hispanic or Latino,37,14,51
135122,Multiple spinal cord injuries without spinal bone injury,ethnic,Hispanic or Latino,0,51,51
440785,Vomiting of pregnancy,ethnic,Hispanic or Latino,51,0,51
81186,Contusion of wrist,ethnic,Not Hispanic or Latino,44,7,51
76887,Disorders of urogenital prostheses or implants,racial,White,48,2,50
439237,Assault,ethnic,Hispanic or Latino,39,12,51
4147961,Screening for malignant neoplasm of breast,racial,Filipino,51,0,51
434281,Aspergillosis,ethnic,Hispanic or Latino,39,12,51
374919,Disseminated sclerosis,racial,Black or African American ,51,0,51
372886,Refractory migraine with aura,racial,Unknown,51,0,51
372435,Periventricular leukomalacia,ethnic,Hispanic or Latino,44,7,51
373769,Nuclear cataract,racial,Unknown,18,32,50
315286,Chronic ischemic heart disease,racial,White,14,37,51
437264,Tobacco dependence syndrome,racial,American Indian,28,23,51
381035,Vertigo of central origin,ethnic,Hispanic or Latino,32,18,50
26638,Primary malignant neoplasm of oesophagus,ethnic,Hispanic or Latino,7,44,51
4108975,Borderline glaucoma NOS,racial,Unknown,51,0,51
4109253,Pterygium NOS,racial,Unknown,21,30,51
437176,Late effect of accidental fall,racial,Unknown,39,12,51
256531,Head and neck swelling,racial,Asian,30,21,51
192273,Benign tumour of adrenal gland,racial,White,39,12,51
435782,Chronic schizophrenic,racial,Asian,39,12,51
438350,Pneumocystosis,ethnic,Hispanic or Latino,0,51,51
77734,Contusion of lower leg,racial,Unknown,46,5,51
4024013,Sensory nervous system finding,racial,Unknown,30,21,51
441077,Stenosis of cervix,ethnic,Hispanic or Latino,51,0,51
439183,Concussion,ethnic,Not Hispanic or Latino,14,37,51
4104157,Genital observation,ethnic,Hispanic or Latino,23,28,51
198464,Incisional hernia,racial,Unknown,25,25,50
442764,Anal pain,ethnic,Not Hispanic or Latino,21,30,51
78219,Cellulitis and abscess of hand excluding digits,ethnic,Not Hispanic or Latino,16,35,51
194158,Perinatal gastrointestinal hemorrhage,racial,Unknown,21,30,51
439082,Menopausal syndrome,racial,Asian,51,0,51
198850,Congenital hypoplasia of penis,ethnic,Hispanic or Latino,0,51,51
442584,Carbuncle of buttock,ethnic,Not Hispanic or Latino,39,12,51
136184,Pruritic disorder,racial,Other Race,44,7,51
134668,Chronic maxillary sinusitis,racial,Unknown,35,16,51
440689,Agranulocytosis,racial,Unknown,30,21,51
4139915,Acute pyelitis,racial,White,46,5,51
78524,Acquired deformity of finger,ethnic,Hispanic or Latino,35,16,51
434942,Postseptal orbital cellulitis,ethnic,Hispanic or Latino,37,14,51
136788,Spinal stenosis of lumbar region,racial,Black or African American ,23,28,51
4064925,Hypertension screening,racial,White,32,18,50
78193,Epididymo-orchitis,ethnic,Not Hispanic or Latino,0,51,51
439037,Aneurysm of artery of neck,racial,White,51,0,51
4235140,Operation for bone injury of phalanges of hand,racial,White,21,30,51
443571,Cervicovaginal cytology: High grade squamous intraepithelial lesion or carcinoma,racial,Unknown,51,0,51
80552,Closed fracture of the scaphoid,ethnic,Hispanic or Latino,16,35,51
372765,Open wound of head without complication,racial,White,14,37,51
441482,Administrative reason for encounter,racial,Black or African American ,23,28,51
4103416,Drug dependence NOS,racial,White,18,32,50
441829,Hyperosmolality and or hypernatremia,racial,White,41,9,50
376712,Purulent otitis media,ethnic,Hispanic or Latino,23,28,51
441261,Episodic acute alcoholic intoxication in alcoholism,ethnic,Hispanic or Latino,9,41,50
135350,Acute osteomyelitis of the ankle and/or foot,ethnic,Hispanic or Latino,9,41,50
4185471,Disorder of pigmentation,ethnic,Not Hispanic or Latino,30,21,51
75044,"Stiff joint NEC, of the hand",ethnic,Hispanic or Latino,39,12,51
137792,Kaposi's varicelliform eruption,racial,White,16,35,51
319825,Rheumatic heart disease,ethnic,Hispanic or Latino,25,25,50
443431,Disorder of menstruation,racial,American Indian or Alaska Native ,51,0,51
138117,Benign tumour of spinal cord,ethnic,Hispanic or Latino,44,7,51
440374,Obsessive compulsive disorder,racial,Unknown,51,0,51
40480431,Speech and language developmental delay due to hearing loss,ethnic,Not Hispanic or Latino,0,51,51
433095,Fall on or from steps,racial,White,37,14,51
4101199,Hearing problem,racial,Other Race,44,7,51
437082,Marie-Strumpell spondylitis,ethnic,Not Hispanic or Latino,12,39,51
75897,Polyarthropathy,ethnic,Not Hispanic or Latino,9,41,50
192239,Post-herpetic polyneuropathy,racial,Unknown,44,7,51
440990,Chorea,racial,White,12,39,51
192606,Paraplegia,racial,Asian,0,51,51
442282,Urinary casts,ethnic,Not Hispanic or Latino,41,9,50
434459,Ganglion of tendon sheath,racial,White,44,7,51
260139,Acute bronchitis,racial,Native Hawaiian or Other Pacific Islander ,25,25,50
4103723,Other refraction and accommodation disorders,racial,Unknown,32,18,50
261325,Pulmonary emphysema,racial,Native Hawaiian or Other Pacific Islander ,48,2,50
435171,Allergic state,racial,Other Race,35,16,51
28779,Oesophageal varices with bleeding,racial,White,25,25,50
74513,Open wound of foot without mention of complication,racial,Unknown,30,21,51
438477,Atrophy of testis,ethnic,Hispanic or Latino,0,51,51
434889,"Hysterical neurosis, conversion type",ethnic,Hispanic or Latino,48,2,50
4302252,High risk pregnancy care,racial,Asian,51,0,51
193249,Acute erosive gastritis,racial,White,35,16,51
137658,Congenital pigmentary anomaly of skin,racial,White,21,30,51
373638,Superficial injury of cornea,racial,Unknown,35,16,51
133228,Dental caries,racial,Native Hawaiian or Other Pacific Islander ,39,12,51
140214,Eruption of skin,racial,American Indian or Alaska Native ,46,5,51
195294,Thrombosed hemorrhoids,ethnic,Hispanic or Latino,35,16,51
196217,Congenital malformation of diaphragm,ethnic,Hispanic or Latino,35,16,51
438788,Hypertrophy of adenoids,ethnic,Hispanic or Latino,5,46,51
135122,Multiple spinal cord injuries without spinal bone injury,racial,White,0,51,51
4085922,Infection screening,racial,White,32,18,50
198289,Nonvenomous insect bite of hip without infection,racial,White,39,12,51
436386,Severe depressed bipolar I disorder with psychotic features,ethnic,Not Hispanic or Latino,21,30,51
438447,Acute myocardial infarction of inferolateral wall,ethnic,Hispanic or Latino,14,37,51
192372,Placenta praevia without haemorrhage - not delivered,racial,White,51,0,51
376117,Cataract in degenerative disorder,ethnic,Not Hispanic or Latino,46,5,51
4108982,Cataract associated with other syndromes,racial,White,51,0,51
437536,Somatoform autonomic dysfunction - gastrointestinal tract,racial,White,0,51,51
314665,Atrial flutter,racial,Other Race,9,41,50
4051114,FH: Diabetes mellitus,racial,Other Race,21,30,51
137213,Fungal dermatosis,ethnic,Not Hispanic or Latino,23,28,51
4105187,Speech or language developmental disorder NOS,racial,White,28,23,51
440940,Methicillin resistant Staphylococcus aureus infection,racial,Unknown,32,18,50
381292,Chronic allergic conjunctivitis,racial,Native Hawaiian or Other Pacific Islander ,30,21,51
198558,Nycturia,racial,Other Race,2,48,50
437221,Chlamydia trachomatis infection,ethnic,Hispanic or Latino,48,2,50
436373,DSD - Developmental speech disorder,racial,Other Race,14,37,51
381301,Chronic serous otitis media,ethnic,Not Hispanic or Latino,16,35,51
441202,Generalized anaphylaxis,ethnic,Not Hispanic or Latino,39,12,51
377274,Nonsenile cataract,ethnic,Hispanic or Latino,44,7,51
4213085,Family history of prostate cancer,ethnic,Hispanic or Latino,0,51,51
75512,Carcinoma in situ of colon,ethnic,Not Hispanic or Latino,51,0,51
439125,T21 - Trisomy 21,racial,Asian,37,14,51
439125,T21 - Trisomy 21,racial,Black or African American ,51,0,51
380038,Viral conjunctivitis,ethnic,Not Hispanic or Latino,30,21,51
439002,Eating disorder,racial,Unknown,35,16,51
78273,Closed fracture multiple ribs,racial,Unknown,44,7,51
81426,Closed fracture of clavicle,racial,Unknown,30,21,51
433168,Iron deficiency anaemia secondary to inadequate dietary iron intake,racial,White,39,12,51
4305303,Sleep deprivation,ethnic,Hispanic or Latino,37,14,51
135892,Erythematous condition,racial,Unknown,48,2,50
135699,Burn any degree involving 10-19 percent of body surface,ethnic,Hispanic or Latino,25,25,50
4105880,Contact of sexually transmissible disorder,racial,Black or African American ,28,21,49
4093146,Herpes simplex with other specified complication,racial,White,7,41,48
381252,Benign neoplasm of eye,ethnic,Hispanic or Latino,37,12,49
201136,Infection of navel cord,ethnic,Hispanic or Latino,23,25,48
372887,Disease of brain,racial,Unknown,5,44,49
4287237,Vascular hamartoma of skin,ethnic,Hispanic or Latino,18,30,48
195083,Left lower quadrant pain,racial,Other Race,48,0,48
377274,Nonsenile cataract,racial,White,41,7,48
137977,Icteric,ethnic,Not Hispanic or Latino,21,28,49
74855,Genital herpes simplex,racial,Black or African American ,32,16,48
434926,Iridocyclitis,racial,White,39,9,48
198846,Enthesopathy of hip region,racial,Unknown,23,25,48
79127,Congenital spondylolisthesis,racial,Unknown,48,0,48
444413,Pyrexial convulsion,ethnic,Not Hispanic or Latino,30,18,48
4249474,Generalized seborrheic dermatitis of infants,racial,White,16,32,48
437891,PPHT - Primary pulmonary hypertension,ethnic,Not Hispanic or Latino,48,0,48
4150157,Other anemias,racial,White,37,12,49
133299,Swelling of limb,racial,Other Race,25,23,48
74606,Benign bone tumor,ethnic,Hispanic or Latino,46,2,48
378421,Alcoholic peripheral neuropathy,racial,Unknown,0,48,48
195314,Nephrotic syndrome,racial,Other Race,21,28,49
377575,Tinnitus,racial,Asian,28,21,49
436230,Blood chemistry abnormal,racial,Black or African American ,30,18,48
442005,Full thickness burn of back of hand,racial,Unknown,48,0,48
437833,Hypokalaemia,racial,Black or African American ,32,16,48
443585,Abrasion AND/OR friction burn of multiple sites,racial,Black or African American ,37,12,49
74468,Congenital anomaly of rib,racial,White,23,25,48
437222,Respiratory syncytial virus infection,ethnic,Hispanic or Latino,12,37,49
197304,Ulcer of lower limb,racial,Filipino,48,0,48
4093146,Herpes simplex with other specified complication,ethnic,Hispanic or Latino,7,41,48
196991,Chronic renal disease,racial,Filipino,0,48,48
73562,Solitary sacroiliitis,ethnic,Not Hispanic or Latino,48,0,48
434319,Premature orgasm - male,ethnic,Hispanic or Latino,0,48,48
4025514,Unspecified peptic ulcer,ethnic,Not Hispanic or Latino,2,46,48
81395,Metatarsus primus varus,ethnic,Hispanic or Latino,0,48,48
201045,Thrombosed external haemorrhoids,racial,Unknown,35,14,49
435216,Disorder associated with type I diabetes mellitus,racial,Other Race,35,14,49
374357,Acquired stenosis of nasolacrimal duct,racial,Unknown,16,32,48
192286,Intestinal disaccharidase deficiency,ethnic,Not Hispanic or Latino,16,32,48
4055337,Gallbladder calculus without mention of cholecystitis,racial,White,23,25,48
444101,Hypertensive heart failure,racial,Other Race,41,7,48
379806,Migraine variants,ethnic,Hispanic or Latino,30,18,48
135340,Pressure ulcer stage 3,racial,White,7,41,48
441482,Administrative reason for encounter,racial,Asian,25,23,48
437093,Congenital ptosis of upper eyelid,ethnic,Hispanic or Latino,37,12,49
4206460,Problem,racial,Black or African American ,21,28,49
26935,Disorder of endocrine testis,ethnic,Not Hispanic or Latino,0,48,48
443260,Umbilical lump,ethnic,Hispanic or Latino,37,12,49
439706,Psychosis with origin in childhood,racial,Unknown,2,46,48
4055208,Chronic hepatitis unspecified,racial,White,12,37,49
4281232,Type B viral hepatitis,ethnic,Hispanic or Latino,23,25,48
4111392,Angina pectoris NOS,racial,White,37,12,49
133424,Primary malignant neoplasm of thyroid gland,ethnic,Not Hispanic or Latino,41,7,48
434309,Sexual precocity,ethnic,Not Hispanic or Latino,25,23,48
432284,Single major depressive episode,racial,Native Hawaiian or Other Pacific Islander ,2,46,48
375415,Injury of head region,racial,Other Race,25,23,48
196735,Acute pyelonephritis without medullary necrosis,racial,Unknown,41,7,48
433760,Dysreflexia,racial,White,32,16,48
74816,Contusion of toe,racial,Unknown,30,18,48
200836,Congenital anomaly of gastrointestinal tract,ethnic,Hispanic or Latino,35,14,49
435956,Closed fracture of base of neck of femur,racial,White,12,37,49
139099,Ingrowing nail,racial,Asian,44,5,49
373786,Abnormal vision,racial,Unknown,14,35,49
436140,Vulval varices,racial,White,46,2,48
4149382,Endocrine/metabolic screening,racial,White,39,9,48
435648,Testicular retraction,racial,White,0,48,48
318556,Nosebleed,racial,Black or African American ,9,39,48
77968,Hallux valgus AND bunion,racial,Black or African American ,23,25,48
438332,Disease of possible viral origin,racial,Native Hawaiian or Other Pacific Islander ,14,35,49
201530,"Diabetes mellitus, adult onset, with hyperosmolar coma",racial,Unknown,44,5,49
440690,Social phobia,racial,White,28,21,49
78200,Benign mammary dysplasia,racial,Unknown,48,0,48
373489,Congenital nystagmus,ethnic,Hispanic or Latino,35,14,49
138821,Seborrhea,ethnic,Not Hispanic or Latino,28,21,49
4176890,Male sterility,ethnic,Hispanic or Latino,0,48,48
134976,Complex dental caries,ethnic,Hispanic or Latino,32,16,48
434972,Developmental abnormality of tooth size and form,racial,White,32,16,48
40481819,Early satiety,ethnic,Hispanic or Latino,35,14,49
313219,Phlebitis and thrombophlebitis,racial,Unknown,35,14,49
437498,Primary malignant neoplasm of tongue,ethnic,Hispanic or Latino,0,48,48
80156,Asymptomatic bacteriuria in pregnancy,racial,Unknown,48,0,48
434467,Ostium secundum type atrial septal defect,racial,Unknown,39,9,48
318186,Achalasia of esophagus,racial,Unknown,48,0,48
437896,Disorder of language,ethnic,Hispanic or Latino,16,32,48
314754,Wheezing,racial,American Indian or Alaska Native ,35,14,49
4108905,Congenital malformation of the urinary system,racial,White,18,30,48
73571,Pathological fracture,racial,Other Race,0,48,48
4031190,Swallowed foreign body,ethnic,Hispanic or Latino,30,18,48
73026,Abnormal respiratory sounds,racial,White,32,16,48
194990,Inflammatory disorder of liver,racial,Other Race,39,9,48
4147639,Cellulitis and abscess of toe NOS,ethnic,Hispanic or Latino,25,23,48
200765,Chronic cholecystitis,ethnic,Hispanic or Latino,39,9,48
321319,Cardiomyopathy,racial,Other Race,48,0,48
437784,Pfeiffer's disease,ethnic,Hispanic or Latino,35,14,49
137820,Postoperative hypothyroidism,racial,Unknown,32,16,48
195603,Vulval and/or perineal noninflammatory disorders,racial,Unknown,48,0,48
193308,Congenital anomaly of spleen,ethnic,Hispanic or Latino,23,25,48
436962,Sleeplessness,racial,American Indian or Alaska Native ,39,9,48
30163,Cellulitis and abscess of neck,ethnic,Not Hispanic or Latino,28,21,49
4002644,Rotator cuff shoulder syndrome and allied disorders,racial,White,18,30,48
80189,Displacement of lumbar intervertebral disc without myelopathy,racial,Asian,21,28,49
74719,Foot ulcer,racial,Asian,41,7,48
259865,Cyst of Bartholin's gland duct,ethnic,Not Hispanic or Latino,44,5,49
438531,Chondromalacia,ethnic,Hispanic or Latino,39,9,48
314971,Chronic respiratory failure,racial,Other Race,44,5,49
77673,Sign or symptom of the urinary system,racial,Unknown,30,18,48
433315,Feeding difficulties in newborn,racial,Black or African American ,23,25,48
196152,Peritonitis,ethnic,Hispanic or Latino,16,32,48
4194895,Screening for disorder,racial,Black or African American ,18,30,48
436027,Coxsackie virus disease,ethnic,Hispanic or Latino,25,23,48
437498,Primary malignant neoplasm of tongue,racial,Unknown,0,48,48
4055208,Chronic hepatitis unspecified,racial,Unknown,44,5,49
195007,Female stress incontinence,racial,Asian,48,0,48
432590,Delusional disorder,racial,Unknown,30,18,48
4062491,Anemia screening,racial,White,30,18,48
133278,Disorder of hair,racial,White,46,2,48
141508,Dermatophytosis of scalp or beard,ethnic,Not Hispanic or Latino,16,32,48
134743,Congenital ichthyosis of skin,racial,White,7,41,48
441408,Vomiting,racial,Black or African American ,16,32,48
377535,Sleep walking disorder,ethnic,Hispanic or Latino,23,25,48
257004,Acute exacerbation of chronic obstructive airways disease,racial,Native Hawaiian or Other Pacific Islander ,35,14,49
134331,Cauda equina syndrome without neurogenic bladder,racial,White,46,2,48
442005,Full thickness burn of back of hand,ethnic,Hispanic or Latino,48,0,48
443597,Chronic kidney disease stage 3,racial,Filipino,16,32,48
435521,Psychophysiologic disorder,ethnic,Hispanic or Latino,23,25,48
76545,Closed traumatic dislocation of patella,ethnic,Hispanic or Latino,32,16,48
441553,Myoclonus,racial,White,48,0,48
259123,Congenital subaortic stenosis,ethnic,Hispanic or Latino,44,5,49
439696,Hypertensive heart and renal disease with (congestive) heart failure,racial,Unknown,5,44,49
73560,Calcaneal spur,racial,Other Race,37,12,49
443790,Multi-infarct dementia with delusions,racial,White,46,2,48
441542,Anxiety,racial,American Indian,46,2,48
40481820,Flaccid hemiplegia of nondominant side,ethnic,Not Hispanic or Latino,0,48,48
4319325,Acquired deformity of trunk,ethnic,Not Hispanic or Latino,32,16,48
79091,Unstable lie,ethnic,Hispanic or Latino,48,0,48
134671,Dental abscess without a sinus,racial,Other Race,18,30,48
261880,Atelectasis,racial,White,25,23,48
194133,Low back pain,racial,Filipino,25,23,48
439706,Psychosis with origin in childhood,racial,Other Race,35,14,49
28779,Oesophageal varices with bleeding,racial,Unknown,18,30,48
27587,Disturbance of salivary secretion,racial,Unknown,30,18,48
440674,Gout,racial,Native Hawaiian or Other Pacific Islander ,9,39,48
132702,Erythema multiforme,ethnic,Hispanic or Latino,18,30,48
377254,"Multi-infarct dementia, uncomplicated",racial,Other Race,9,39,48
437943,Pulp abscess of finger,ethnic,Hispanic or Latino,21,28,49
200169,Pruritus ani,ethnic,Not Hispanic or Latino,12,37,49
4001998,Pulmonary apoplexy,ethnic,Not Hispanic or Latino,0,48,48
320136,Disease of respiratory system,ethnic,Not Hispanic or Latino,25,23,48
442753,Furuncle of trunk,ethnic,Not Hispanic or Latino,14,35,49
200970,CIS - Carcinoma in situ of prostate,ethnic,Not Hispanic or Latino,0,48,48
73576,Acquired chest and rib deformity,ethnic,Hispanic or Latino,14,35,49
437966,Calcium deposits in tendon,racial,White,35,14,49
440922,Diabetic on insulin,racial,Unknown,41,7,48
443801,Exercise-induced asthma,racial,Other Race,23,25,48
436336,Herpes zoster with nervous system complication,racial,Unknown,21,28,49
440922,Diabetic on insulin,ethnic,Not Hispanic or Latino,23,25,48
374375,Impacted cerumen,racial,American Indian or Alaska Native ,41,7,48
4088777,Vagina observation,ethnic,Not Hispanic or Latino,48,0,48
4186238,Louse infestation,racial,Unknown,37,12,49
192691,Diabetes mellitus during pregnancy - baby not yet delivered,racial,White,46,0,46
4175028,Irritant gastritis,racial,Unknown,39,7,46
199878,Light and infrequent menstruation,racial,Unknown,46,0,46
135762,Acute myeloid leukaemia in remission,ethnic,Hispanic or Latino,32,14,46
378135,Facial nerve disorder,racial,White,28,18,46
4109698,Acute conjunctivitis NOS,ethnic,Hispanic or Latino,23,23,46
437082,Marie-Strumpell spondylitis,racial,White,5,41,46
134057,Disease of cardiovascular system,racial,Black or African American ,37,9,46
441264,Primary thrombocytopenia,racial,Asian,0,46,46
4052931,Abandoned child,ethnic,Hispanic or Latino,32,14,46
29735,Candidiasis of mouth,racial,Black or African American ,23,23,46
375552,Pterygium,racial,Other Race,28,18,46
197033,Endometriosis of pelvic peritoneum,ethnic,Hispanic or Latino,46,0,46
140960,Secondary malignant neoplasm of breast,ethnic,Not Hispanic or Latino,46,0,46
441701,Sprain of hip joint,racial,Unknown,28,18,46
4085922,Infection screening,ethnic,Hispanic or Latino,25,21,46
432741,Abnormal immunology finding,racial,Other Race,23,23,46
40481820,Flaccid hemiplegia of nondominant side,racial,White,30,16,46
437243,Chronic paranoid schizophrenia with acute exacerbation,racial,White,0,46,46
436245,Atypical glandular cells on vaginal Papanicolaou smear,ethnic,Not Hispanic or Latino,46,0,46
138858,Pale complexion,ethnic,Hispanic or Latino,28,18,46
439928,Gangrenous disorder,racial,White,9,37,46
436231,Abnormal findings diagnostic imaging of liver and biliary tract,ethnic,Hispanic or Latino,32,14,46
195300,Alcoholic gastritis,ethnic,Hispanic or Latino,18,28,46
435723,Wound seroma,ethnic,Hispanic or Latino,41,5,46
373489,Congenital nystagmus,racial,White,32,14,46
78835,Palindromic rheumatism of the lower leg,racial,American Indian or Alaska Native ,21,25,46
75911,Acquired hallux valgus,ethnic,Not Hispanic or Latino,35,12,47
436336,Herpes zoster with nervous system complication,ethnic,Not Hispanic or Latino,32,14,46
194411,Unilateral simple inguinal hernia,racial,Black or African American ,0,46,46
28974,Candidiasis of oesophagus,ethnic,Hispanic or Latino,28,18,46
435553,Watery eye,racial,Unknown,39,7,46
443883,Acute disease,ethnic,Hispanic or Latino,9,37,46
79804,Myotonic dystrophy,ethnic,Not Hispanic or Latino,30,16,46
436673,Chronic residual schizophrenia,racial,White,39,7,46
378741,Brachial plexus lesion,racial,White,37,9,46
436059,Multiple myeloma in remission,racial,White,46,0,46
432910,Disorder of lacrimal system,ethnic,Hispanic or Latino,37,9,46
4108817,"Tricuspid valve disorders, non-rheumatic",racial,Unknown,46,0,46
28083,Primary malignant neoplasm of pharynx,ethnic,Hispanic or Latino,2,44,46
443545,Nonvenomous insect bite,racial,Black or African American ,23,23,46
4013526,ESR raised,racial,White,35,12,47
443616,Refractory migraine without aura,ethnic,Hispanic or Latino,16,30,46
4087756,Late latent syphilis,racial,Unknown,2,44,46
377298,Chronic otitis externa,racial,White,28,18,46
74458,Enthesopathy of knee region,racial,Black or African American ,46,0,46
321315,Trifascicular block,ethnic,Hispanic or Latino,46,0,46
255848,Pneumonia,racial,American Indian or Alaska Native ,46,0,46
4016675,"Sprain, ankle joint, medial",racial,White,28,18,46
4092879,Absent kidney,ethnic,Not Hispanic or Latino,2,44,46
24977,Mucocele of salivary gland,ethnic,Hispanic or Latino,30,16,46
436671,Carcinoma in situ of anal canal,ethnic,Hispanic or Latino,23,23,46
440788,Hyperemesis gravidarum with metabolic disturbance - not delivered,racial,White,46,0,46
140949,Scabies,racial,Other Race,21,25,46
433752,Impulse control disorder,ethnic,Hispanic or Latino,44,2,46
4064383,Rheumatoid arthritis screening,ethnic,Hispanic or Latino,32,14,46
375256,Anterior subcapsular polar senile cataract,ethnic,Hispanic or Latino,35,12,47
433450,Paranoid schizophrenia,racial,Unknown,46,0,46
138117,Benign tumour of spinal cord,racial,White,39,7,46
4170576,Pressure ulcer,ethnic,Not Hispanic or Latino,30,16,46
4109544,"Total, mature senile cataract",ethnic,Hispanic or Latino,46,0,46
194286,"Malignant neoplasm of corpus uteri, excluding isthmus",ethnic,Not Hispanic or Latino,46,0,46
81671,Unilateral congenital dislocation of hip,racial,White,25,21,46
195079,Functional urinary incontinence,racial,White,41,5,46
79768,Neoplasm of urinary system,racial,Asian,7,39,46
436386,Severe depressed bipolar I disorder with psychotic features,racial,White,21,25,46
4103580,Unspecified senile cataract,ethnic,Hispanic or Latino,28,18,46
440525,Prematurity of fetus,racial,Asian,16,30,46
133436,Thyrotoxic crisis,racial,Black or African American ,32,14,46
444071,Furuncle of forearm,ethnic,Hispanic or Latino,21,25,46
321315,Trifascicular block,racial,Unknown,46,0,46
140960,Secondary malignant neoplasm of breast,racial,White,46,0,46
192239,Post-herpetic polyneuropathy,racial,Black or African American ,5,41,46
314971,Chronic respiratory failure,ethnic,Not Hispanic or Latino,37,9,46
435224,Leukopenia,racial,Black or African American ,9,37,46
4101660,Amputated below knee,racial,Other Race,0,46,46
375527,Headache disorder,ethnic,Hispanic or Latino,28,18,46
433015,Congenital anomaly of aortic arch,racial,White,25,21,46
255348,Polymyalgia rheumatica,ethnic,Not Hispanic or Latino,46,0,46
374954,Optic neuritis,racial,White,32,14,46
74189,Sprain of cruciate ligament of knee,ethnic,Not Hispanic or Latino,30,16,46
193322,Right lower quadrant pain,racial,Asian,28,18,46
25572,Disease of salivary gland,racial,White,16,30,46
40485064,Latent syphilis,racial,Black or African American ,5,41,46
196733,Urethral syndrome,ethnic,Hispanic or Latino,32,14,46
438005,Closed fracture shaft of fibula,racial,Unknown,46,0,46
4152167,Acute stress reaction NOS,racial,White,41,5,46
193262,Inflammatory disorder of penis,ethnic,Hispanic or Latino,0,46,46
374025,Retinal haemorrhages,ethnic,Not Hispanic or Latino,18,28,46
132685,Severe pre-eclampsia - not delivered,ethnic,Hispanic or Latino,46,0,46
377282,Conjunctivitis with mucocutaneous disorder,ethnic,Hispanic or Latino,37,9,46
252365,MGN - Membranous glomerulonephritis,racial,Other Race,46,0,46
441269,Autoimmune hemolytic anemia,ethnic,Hispanic or Latino,46,0,46
193984,Adrenal hypofunction,racial,Unknown,46,0,46
439155,Carcinoembryonic antigen present,racial,White,39,7,46
441547,Oppositional defiant disorder,ethnic,Not Hispanic or Latino,7,39,46
197925,Haemorrhage of rectum and anus,racial,American Indian or Alaska Native ,41,5,46
135033,Hair and hair follicle diseases,racial,Other Race,23,23,46
440386,Transsexualism,ethnic,Not Hispanic or Latino,14,32,46
26052,Primary malignant neoplasm of larynx,ethnic,Hispanic or Latino,5,41,46
138455,Stomatitis,ethnic,Hispanic or Latino,25,21,46
4064381,Nephropathy screening,ethnic,Not Hispanic or Latino,28,18,46
201347,Pelvic pain syndrome,ethnic,Hispanic or Latino,46,0,46
435535,Aggressive type unsocialized behavior disorder,ethnic,Hispanic or Latino,9,37,46
137951,Acquired keratoderma,ethnic,Not Hispanic or Latino,32,14,46
28714,Syndrome of diencephalo-hypophyseal origin,racial,White,44,2,46
444055,Thrombophlebitis of superficial veins of lower extremity,ethnic,Hispanic or Latino,39,7,46
197239,Haemangioma of intra-abdominal structure,ethnic,Hispanic or Latino,25,21,46
261782,Herpetic ulceration of vulva,ethnic,Hispanic or Latino,46,0,46
439082,Menopausal syndrome,racial,Black or African American ,46,0,46
434675,Complication of gastrostomy,racial,Unknown,30,16,46
22281,Sickle cell disease,ethnic,Not Hispanic or Latino,12,35,47
379782,Gilles de la Tourette's syndrome,racial,White,32,14,46
78835,Palindromic rheumatism of the lower leg,racial,Black or African American ,39,7,46
136834,Closed intertrochanteric fracture,ethnic,Hispanic or Latino,37,9,46
30284,Motion sickness,ethnic,Hispanic or Latino,30,16,46
443729,Peripheral circulatory disorder associated with type II diabetes mellitus,racial,American Indian or Alaska Native ,41,5,46
132446,Congenital anomaly of skin,racial,Unknown,23,23,46
379006,Cerebral degeneration in childhood,racial,White,46,0,46
197320,ARF - Acute renal failure,racial,Black or African American ,18,28,46
28083,Primary malignant neoplasm of pharynx,racial,White,0,46,46
377550,Compression of brain,ethnic,Hispanic or Latino,37,9,46
436386,Severe depressed bipolar I disorder with psychotic features,ethnic,Hispanic or Latino,18,28,46
199192,Abrasion AND/OR friction burn of trunk without infection,racial,White,23,23,46
80800,Polymyositis,racial,White,44,2,46
4103640,Amputated foot,racial,White,0,46,46
442774,Intermittent claudication,racial,Black or African American ,2,44,46
135618,Prurigo,ethnic,Not Hispanic or Latino,16,30,46
72469,Closed dislocation of shoulder region,racial,Unknown,23,23,46
440697,Nonaggressive unsocial conduct disorder,ethnic,Hispanic or Latino,18,28,46
443414,Chronic post-traumatic stress disorder,racial,Black or African American ,7,39,46
440379,Episodic opioid dependence,ethnic,Hispanic or Latino,18,28,46
441969,Radiology result abnormal,ethnic,Not Hispanic or Latino,39,7,46
381677,SBO - Spina bifida occulta,ethnic,Hispanic or Latino,7,39,46
372610,Post-concussion syndrome,racial,White,23,23,46
4152167,Acute stress reaction NOS,ethnic,Hispanic or Latino,41,5,46
313223,Wegener granulomatosis,racial,White,5,41,46
81395,Metatarsus primus varus,racial,Unknown,0,46,46
442597,Meteorism,racial,Unknown,44,2,46
372721,Congenital anomaly of cerebrovascular system,ethnic,Hispanic or Latino,18,28,46
72501,Superficial foreign body of foot without major open wound AND without infection,ethnic,Hispanic or Latino,25,21,46
4305080,Abnormal breathing,racial,White,25,21,46
436059,Multiple myeloma in remission,ethnic,Hispanic or Latino,46,0,46
4164792,Hemophilus influenzae laryngitis,ethnic,Hispanic or Latino,37,9,46
444100,Mood disorder,racial,Black or African American ,12,35,47
442775,Degeneration of thoracic intervertebral disc,racial,White,25,21,46
134603,CML - Chronic myeloid leukaemia,racial,White,44,2,46
4340380,Hepatitis C carrier,racial,Asian,5,41,46
75382,Closed fractures of tarsal AND metatarsal bones,ethnic,Hispanic or Latino,35,12,47
378416,Retinal disorder,racial,White,35,12,47
134118,Atrophic condition of skin,racial,Other Race,18,28,46
137063,Corns and callus,racial,Asian,12,35,47
194526,Injury of trunk,ethnic,Hispanic or Latino,25,21,46
195562,Hemorrhoids,racial,American Indian or Alaska Native ,46,0,46
444429,Herpes simplex infection,racial,White,37,9,46
4129342,Nephrectomy of remaining or solitary kidney,ethnic,Hispanic or Latino,37,9,46
440979,Acquired hemolytic anemia,ethnic,Hispanic or Latino,16,30,46
379805,Myopia,racial,Asian,28,18,46
439937,C-reactive protein abnormal,ethnic,Not Hispanic or Latino,37,9,46
22281,Sickle cell disease,racial,Black or African American ,9,37,46
4164222,Tendon contracture,ethnic,Hispanic or Latino,30,16,46
377861,Disorder of refraction AND/OR accommodation,racial,Native Hawaiian or Other Pacific Islander ,25,21,46
78219,Cellulitis and abscess of hand excluding digits,racial,Unknown,32,14,46
437116,Closed fracture of distal end of radius,racial,White,37,9,46
374034,Visual disturbance,racial,Black or African American ,32,14,46
28127,"Multiple endocrine neoplasia, type 1",ethnic,Hispanic or Latino,32,14,46
317893,Paroxysmal supraventricular tachycardia,racial,Black or African American ,46,0,46
440704,Chronic pain syndrome,racial,Other Race,30,16,46
72374,Unstable lie with antenatal problem,ethnic,Hispanic or Latino,46,0,46
441678,"Gestation period, 33 weeks",ethnic,Hispanic or Latino,14,32,46
198363,Candidiasis of vagina,racial,Asian,46,0,46
138102,Benign tumour of skin,racial,Asian,30,16,46
314131,Degeneration of cervical intervertebral disc,racial,American Indian or Alaska Native ,32,14,46
444455,Benign tumour of soft tissue of head,racial,Unknown,46,0,46
195498,Benign tumour of kidney,ethnic,Not Hispanic or Latino,9,37,46
376229,Abnormal involuntary movement,racial,Other Race,35,12,47
438750,Old total retinal detachment,ethnic,Hispanic or Latino,23,23,46
4110499,Allergic rhinitis NOS,ethnic,Not Hispanic or Latino,25,21,46
441039,Phlebitis of lower limb vein,racial,Unknown,46,0,46
72986,Disease of lower leg,ethnic,Not Hispanic or Latino,0,46,46
197033,Endometriosis of pelvic peritoneum,racial,White,46,0,46
137497,Dermatophytosis of the body,racial,Asian,21,25,46
4239721,Seafood allergy,racial,White,28,18,46
4012491,Difficulty chewing,ethnic,Not Hispanic or Latino,18,25,43
378742,Blind hypotensive eye,racial,Other Race,0,44,44
439128,Extreme immaturity,ethnic,Hispanic or Latino,18,25,43
81237,Primary malignant neoplasm of upper limb bones and scapula,racial,Unknown,44,0,44
377853,Chronic tension-type headache,racial,Unknown,44,0,44
4044391,Diabetic neuropathy,racial,Unknown,18,25,43
433457,Agoraphobia without mention of panic attacks,ethnic,Hispanic or Latino,18,25,43
74728,Synovitis and tenosynovitis,ethnic,Not Hispanic or Latino,21,23,44
313791,Bundle branch block,ethnic,Hispanic or Latino,35,9,44
24818,Neck injury,ethnic,Not Hispanic or Latino,18,25,43
435798,"Nondependent opioid abuse, episodic",racial,Unknown,7,37,44
74138,Pathological fracture of vertebra,racial,White,30,14,44
81237,Primary malignant neoplasm of upper limb bones and scapula,ethnic,Hispanic or Latino,44,0,44
201998,Unilateral traumatic amputation of leg at OR above knee without complication,racial,Unknown,21,23,44
72404,Joint stiffness,ethnic,Hispanic or Latino,23,21,44
78508,Arthralgia of the ankle and/or foot,racial,Black or African American ,37,7,44
433450,Paranoid schizophrenia,racial,White,21,23,44
196473,Hypertrophy of uterus,ethnic,Not Hispanic or Latino,44,0,44
379806,Migraine variants,racial,White,25,18,43
81336,Rectal prolapse,ethnic,Hispanic or Latino,44,0,44
74188,Closed fracture of rib,ethnic,Not Hispanic or Latino,9,35,44
197676,Hepatomegaly,ethnic,Not Hispanic or Latino,18,25,43
434926,Iridocyclitis,ethnic,Not Hispanic or Latino,39,5,44
444202,Abscess,racial,Filipino,30,14,44
439694,Hypertensive heart and renal disease with both (congestive) heart failure and renal failure,ethnic,Not Hispanic or Latino,0,44,44
444071,Furuncle of forearm,racial,White,12,32,44
195321,Postmenopausal bleeding,racial,Asian,44,0,44
139900,Urticaria,racial,Asian,21,23,44
378544,Subdural and cerebral hemorrhage due to birth trauma,ethnic,Hispanic or Latino,35,9,44
72986,Disease of lower leg,racial,Unknown,12,32,44
30234,Cervical sprain,racial,Asian,28,16,44
141371,PR - Pityriasis rosea,ethnic,Not Hispanic or Latino,25,18,43
80815,Mucous cyst of skin,ethnic,Not Hispanic or Latino,35,9,44
443728,Mass of chest wall,racial,Other Race,37,7,44
254068,Upper respiratory disease,ethnic,Not Hispanic or Latino,23,21,44
436670,MD - Metabolic disorders,ethnic,Not Hispanic or Latino,39,5,44
435925,Very premature - less than 1000g or less than 28 weeks,ethnic,Hispanic or Latino,41,2,43
195339,Decubitus ulcer of hip,ethnic,Hispanic or Latino,21,23,44
4346969,Joint mice in knee,ethnic,Hispanic or Latino,18,25,43
441805,Primary malignant neoplasm of endocervix,ethnic,Hispanic or Latino,44,0,44
444247,Venous thrombosis,racial,Unknown,2,41,43
201626,Mid-cycle pain,ethnic,Hispanic or Latino,44,0,44
440529,Abnormal findings on diagnostic imaging of urinary organs,ethnic,Not Hispanic or Latino,41,2,43
141095,Acne,racial,Native Hawaiian or Other Pacific Islander ,23,21,44
197981,Abdominal tenderness,racial,Unknown,30,14,44
441589,Endocarditis,ethnic,Hispanic or Latino,44,0,44
442609,Friction blister without infection,racial,White,23,21,44
439224,Drug allergy,racial,Unknown,28,16,44
312728,Congenital tricuspid atresia and stenosis,ethnic,Hispanic or Latino,44,0,44
378523,Residual foreign body in soft tissue,racial,White,16,28,44
444433,Open wound of toe with complication,ethnic,Hispanic or Latino,39,5,44
4204966,Regurgitant esophagitis,ethnic,Hispanic or Latino,18,25,43
78529,Kyphoscoliosis and scoliosis,ethnic,Not Hispanic or Latino,37,7,44
318222,Acute adenitis,ethnic,Not Hispanic or Latino,37,7,44
440653,Infection by toxoplasma gondii,ethnic,Hispanic or Latino,0,44,44
77129,Closed fracture of pelvis,racial,Unknown,41,2,43
317893,Paroxysmal supraventricular tachycardia,racial,Asian,44,0,44
312935,Venous hypertension,racial,Unknown,9,35,44
374940,Blepharophimosis syndrome,ethnic,Hispanic or Latino,2,41,43
312934,Atherosclerosis of aorta,racial,Native Hawaiian or Other Pacific Islander ,44,0,44
134976,Complex dental caries,racial,White,21,23,44
197320,ARF - Acute renal failure,racial,Asian,14,30,44
201079,Acute parametritis and pelvic cellulitis,racial,White,41,2,43
134442,Thibierge-Weissenbach syndrome,racial,White,30,14,44
194382,External haemorrhoid,ethnic,Not Hispanic or Latino,32,12,44
81454,Injury of finger,racial,Unknown,30,14,44
435797,Selective immunoglobulin dysfunction,racial,White,44,0,44
440386,Transsexualism,racial,White,14,30,44
259123,Congenital subaortic stenosis,racial,Unknown,44,0,44
317585,Aortic aneurysm,ethnic,Not Hispanic or Latino,0,44,44
443723,Finding of cellular component of blood,ethnic,Not Hispanic or Latino,23,21,44
443728,Mass of chest wall,racial,Asian,0,44,44
312337,Arterial embolic and thrombotic occlusion,racial,White,35,9,44
135360,Fainting,racial,Other Race,35,9,44
136934,Primary hyperparathyroidism,racial,Unknown,44,0,44
137682,Skin sensation disturbance,racial,Black or African American ,23,21,44
134438,CD - Contact dermatitis,racial,American Indian or Alaska Native ,35,9,44
193493,Benign hypertensive renal disease,ethnic,Hispanic or Latino,39,5,44
192276,Chronic gouty nephropathy,ethnic,Hispanic or Latino,12,32,44
434628,Separation anxiety,ethnic,Hispanic or Latino,23,21,44
78097,Metastatic tumour of bone,racial,White,44,0,44
4113027,Dietary intake observations,racial,Other Race,25,18,43
196369,Adrenogenital disorder,ethnic,Hispanic or Latino,23,21,44
4287544,Manic bipolar I disorder,racial,Black or African American ,2,41,43
437264,Tobacco dependence syndrome,racial,Filipino,5,39,44
438168,Aneurysm of heart,ethnic,Hispanic or Latino,32,12,44
75614,Acrodermatitis continua,racial,Other Race,21,23,44
4006788,Percutaneous transluminal coronary balloon angioplasty,ethnic,Hispanic or Latino,21,23,44
4141492,Other ill-defined heart disease,racial,Unknown,35,9,44
137065,Nonstageable pressure ulcer,ethnic,Hispanic or Latino,41,2,43
197006,Residual hemorrhoidal skin tags,ethnic,Hispanic or Latino,28,16,44
140173,Telogen effluvium,ethnic,Hispanic or Latino,44,0,44
73923,"Contusion, upper arm",racial,Unknown,37,7,44
432738,Iceland disease,racial,Black or African American ,37,7,44
376415,Hypermetropia,ethnic,Not Hispanic or Latino,14,30,44
134074,Oral soft tissue cellulitis,ethnic,Not Hispanic or Latino,12,32,44
443012,Diabetes mellitus during pregnancy - baby delivered,ethnic,Hispanic or Latino,44,0,44
79768,Neoplasm of urinary system,racial,Unknown,16,28,44
434207,"Insect bite, nonvenomous, of hand, without mention of infection",ethnic,Hispanic or Latino,23,21,44
436100,Narcolepsy,racial,White,0,44,44
140648,Onychomycosis due to dermatophyte,racial,Native Hawaiian or Other Pacific Islander ,30,14,44
375819,TM - Tympanic membrane disorder,ethnic,Hispanic or Latino,18,25,43
4059637,Work environment deleterious,racial,White,28,16,44
132393,Pressure ulcer stage 1,racial,White,28,16,44
437243,Chronic paranoid schizophrenia with acute exacerbation,ethnic,Hispanic or Latino,0,44,44
77968,Hallux valgus AND bunion,racial,Other Race,30,14,44
4143915,Cholestasis,ethnic,Hispanic or Latino,37,7,44
432461,"Closed fracture clavicle, shaft",racial,White,32,12,44
434701,"Anemia in mother complicating pregnancy, childbirth AND/OR puerperium",racial,White,44,0,44
440360,Pure hyperglyceridemia,racial,Native Hawaiian or Other Pacific Islander ,35,9,44
436298,Adverse reaction to food,racial,Other Race,18,25,43
4298697,Multiple open wounds without complication,racial,Asian,16,28,44
440279,Accident,racial,Unknown,25,18,43
435785,Meningitis,racial,White,28,16,44
317510,Leukaemia,ethnic,Hispanic or Latino,12,32,44
433657,Fall from furniture,racial,White,28,16,44
199767,Neoplasm of uncertain behaviour of liver and/or biliary passages,racial,Unknown,9,35,44
78472,Microscopic haematuria,racial,Other Race,25,18,43
4161978,Patient on oxygen,racial,Other Race,35,9,44
201899,Unilateral recurrent inguinal hernia,ethnic,Not Hispanic or Latino,7,37,44
372599,Severe mixed bipolar I disorder without psychotic features,ethnic,Hispanic or Latino,12,32,44
444247,Venous thrombosis,ethnic,Not Hispanic or Latino,18,25,43
314659,Arteritis,racial,Unknown,39,5,44
375549,Double pterygium,racial,White,16,28,44
439014,Panuveitis,racial,White,44,0,44
444132,Knee injury,racial,Other Race,12,32,44
73840,Primary localised osteoarthrosis of shoulder region,ethnic,Not Hispanic or Latino,25,18,43
78560,Congenital deformity and malformation of feet and toes,ethnic,Hispanic or Latino,16,28,44
321661,Spinal stenosis of thoracic region,ethnic,Hispanic or Latino,44,0,44
192956,Cholecystitis,racial,Unknown,32,12,44
434172,Insomnia with sleep apnoea,racial,Unknown,0,44,44
432310,Meningitis due to cryptococcus,racial,White,0,44,44
30361,Hypoglycemic disorder,racial,White,35,9,44
433000,Patellar tendonitis,ethnic,Not Hispanic or Latino,21,23,44
435889,Decubitus ulcer of ankle,racial,Unknown,16,28,44
320744,Complete atrioventricular block,racial,White,14,30,44
440921,Traumatic injury,ethnic,Not Hispanic or Latino,12,32,44
432590,Delusional disorder,ethnic,Not Hispanic or Latino,16,28,44
4048727,Neoplasm screening,racial,Unknown,23,21,44
76791,Acquired deformity of hip,ethnic,Not Hispanic or Latino,5,39,44
443774,"Disease condition determination, uncontrolled",racial,Unknown,35,9,44
80813,Lumbosacral spondylosis without myelopathy,racial,Asian,35,9,44
441793,Infection due to Class Cestoda and/or Class Trematoda and/or Phylum Nemata,ethnic,Hispanic or Latino,23,21,44
373200,Chronic fungal otitis externa,ethnic,Hispanic or Latino,30,14,44
435553,Watery eye,racial,White,25,18,43
76835,Closed dislocation of elbow,ethnic,Hispanic or Latino,18,25,43
443431,Disorder of menstruation,racial,Asian,44,0,44
314059,Right bundle branch block,racial,Asian,18,25,43
433527,Endometriosis,ethnic,Not Hispanic or Latino,44,0,44
138278,Sprains and strains of joints and adjacent muscles,racial,Black or African American ,18,25,43
442011,Mechanical complication due to cardiac pacemaker electrode,ethnic,Hispanic or Latino,39,5,44
4005743,Female sterility,racial,White,44,0,44
73819,Painful breasts,racial,Asian,41,2,43
193308,Congenital anomaly of spleen,racial,White,21,23,44
439727,HIV - Human immunodeficiency virus infection,racial,Other Race,32,12,44
197381,Epigastric pain,racial,American Indian or Alaska Native ,41,2,43
436944,Chronic paranoid schizophrenia,ethnic,Not Hispanic or Latino,0,44,44
439141,Abnormal increase in weight,racial,Black or African American ,23,21,44
443257,Swellings and lumps,racial,Black or African American ,37,7,44
4152813,Family disruption,racial,Unknown,9,35,44
318521,Displacement of thoracic intervertebral disc without myelopathy,ethnic,Hispanic or Latino,41,2,43
439391,Physical abuse of adult,racial,White,44,0,44
197924,Bile duct calculus with acute cholecystitis and obstruction,racial,Unknown,25,18,43
4167406,Eye disorder screening,ethnic,Not Hispanic or Latino,32,12,44
380103,Retinal detachment with retinal defect,racial,White,12,32,44
137053,Seborrheic dermatitis,racial,Black or African American ,18,25,43
4185302,Chronic myocardial ischemia,ethnic,Not Hispanic or Latino,7,37,44
432801,"Injury undetermined whether accidentally or purposely inflicted, fall from natural site",racial,Unknown,37,7,44
194475,Singultus,racial,Unknown,0,44,44
197913,Disorder of function of stomach,racial,American Indian or Alaska Native ,30,14,44
76836,Sprain of knee and leg,racial,Black or African American ,18,25,43
200848,Dribbling of urine,ethnic,Hispanic or Latino,5,39,44
435093,Closed fracture of femur,ethnic,Not Hispanic or Latino,7,37,44
74513,Open wound of foot without mention of complication,ethnic,Not Hispanic or Latino,28,16,44
434329,Spinocerebellar disease,ethnic,Hispanic or Latino,41,2,43
74322,Benign neoplasm of scrotum,ethnic,Hispanic or Latino,0,44,44
194079,Post-surgical malabsorption,ethnic,Not Hispanic or Latino,25,18,43
140190,Disorder of back,racial,White,30,14,44
4210151,HIV counseling,ethnic,Not Hispanic or Latino,21,23,44
432582,Neoplastic disease of uncertain behavior,ethnic,Not Hispanic or Latino,9,35,44
434872,Infection by Trichomonas,ethnic,Hispanic or Latino,39,5,44
73338,Sprain of lateral collateral ligament of knee,racial,White,21,23,44
4100912,Screening for rheumatoid conditions,racial,White,44,0,44
4062484,Cervical neoplasia screening,racial,Filipino,44,0,44
435789,Megaloblastic anemia,ethnic,Hispanic or Latino,25,18,43
255334,Collagen disease,racial,Unknown,44,0,44
256440,Disorder of paranasal sinuses,racial,Black or African American ,25,18,43
436381,Gender identity disorder of childhood,ethnic,Hispanic or Latino,9,35,44
433753,Alcohol abuse,racial,Black or African American ,2,41,43
197237,Benign tumour of prostate,ethnic,Not Hispanic or Latino,0,44,44
434622,Deficiency anemias,ethnic,Not Hispanic or Latino,37,7,44
75689,Contusion of breast,ethnic,Hispanic or Latino,44,0,44
317302,Coronary sinus rhythm disorder,racial,Black or African American ,32,12,44
140259,Open wound of face without complication,ethnic,Not Hispanic or Latino,14,30,44
375826,Central hearing loss,ethnic,Not Hispanic or Latino,28,16,44
133835,Dermatitis,racial,Black or African American ,21,23,44
434549,Fall from toilet seat,ethnic,Hispanic or Latino,35,9,44
381570,Mechanical ptosis,ethnic,Hispanic or Latino,12,30,42
434007,Congenital factor VIII deficiency,ethnic,Hispanic or Latino,2,39,41
443723,Finding of cellular component of blood,ethnic,Hispanic or Latino,37,5,42
137989,Abnormal results of cardiovascular function studies,ethnic,Hispanic or Latino,14,28,42
443417,Villonodular synovitis of lower limb,ethnic,Hispanic or Latino,39,2,41
133729,Hyperparathyroidism,racial,Asian,39,2,41
77642,Arthralgia of the forearm,racial,Other Race,18,23,41
4331899,Child in family care,ethnic,Not Hispanic or Latino,16,25,41
193186,Cauda equina syndrome with neurogenic bladder,racial,Unknown,41,0,41
253954,PTB - Pulmonary tuberculosis,ethnic,Not Hispanic or Latino,30,12,42
436670,MD - Metabolic disorders,racial,Unknown,12,30,42
4247802,Muscular dystrophy,ethnic,Not Hispanic or Latino,7,35,42
437557,Eczematous dermatitis of eyelid,ethnic,Hispanic or Latino,41,0,41
441604,Acute appendicitis without peritonitis,racial,White,18,23,41
75576,Colon spasm,racial,Asian,35,7,42
4105187,Speech or language developmental disorder NOS,racial,Unknown,5,37,42
201756,Lumbar cord injury without spinal bone injury,racial,Black or African American ,0,41,41
4171430,Screening for malignant neoplasm of rectum,racial,Black or African American ,12,30,42
440927,High risk drug monitoring status,racial,Black or African American ,41,0,41
434119,Hidradenitis,racial,Unknown,35,7,42
200219,Abdominal pain,racial,Filipino,30,12,42
74892,Articular gout,racial,Native Hawaiian or Other Pacific Islander ,41,0,41
197332,Incomplete uterovaginal prolapse,racial,White,41,0,41
139900,Urticaria,racial,Native Hawaiian or Other Pacific Islander ,41,0,41
75576,Colon spasm,racial,Black or African American ,28,14,42
437843,Childhood conduct disorder,racial,White,7,35,42
375281,Acute suppurative otitis media - tympanic membrane intact,racial,American Indian or Alaska Native ,35,7,42
198199,Pyelonephritis,racial,Other Race,25,16,41
435797,Selective immunoglobulin dysfunction,ethnic,Not Hispanic or Latino,41,0,41
443909,"Decreased level, laboratory test",ethnic,Hispanic or Latino,23,18,41
198853,Congenital anomaly of ovary,ethnic,Not Hispanic or Latino,41,0,41
433735,Alcohol dependence with acute alcoholic intoxication,racial,White,2,39,41
373185,Drug-induced dyskinesia,racial,Unknown,25,16,41
75044,"Stiff joint NEC, of the hand",racial,White,28,14,42
77395,Current tear of semilunar cartilage,ethnic,Not Hispanic or Latino,18,23,41
132466,Lumbar sprain,racial,Other Race,23,18,41
23220,Chronic tonsillitis,racial,Unknown,28,14,42
141933,Alopecia areata,ethnic,Not Hispanic or Latino,23,18,41
440360,Pure hyperglyceridemia,racial,Filipino,16,25,41
321080,"Hypertension complicating pregnancy, childbirth and the puerperium",racial,White,37,5,42
440905,Toxic effect of venom,ethnic,Not Hispanic or Latino,32,9,41
439005,Chronic alcoholism in remission,racial,Unknown,2,39,41
435515,Hypo-osmolality and or hyponatremia,racial,Black or African American ,2,39,41
77987,Respiratory observations of chest,ethnic,Not Hispanic or Latino,32,9,41
79903,Effusion of joint,ethnic,Hispanic or Latino,23,18,41
4064375,Iron deficiency screening,racial,Native Hawaiian or Other Pacific Islander ,18,23,41
73819,Painful breasts,racial,Other Race,41,0,41
75941,Closed fracture of one rib,ethnic,Hispanic or Latino,28,14,42
4062488,Thyroid disorder screening,racial,Unknown,37,5,42
316135,AVB - Atrioventricular block,racial,White,0,41,41
30679,Benign tumour major salivary gland,racial,Unknown,35,7,42
135778,Toxic multinodular goitre,ethnic,Hispanic or Latino,41,0,41
75095,Closed fracture of ankle,racial,Black or African American ,30,12,42
380111,Acute atopic conjunctivitis,ethnic,Not Hispanic or Latino,21,21,42
79917,Acquired deformity of toe,racial,White,32,9,41
437831,"Recurrent manic episodes, in full remission",ethnic,Hispanic or Latino,14,28,42
376657,Lipoma of face,racial,White,16,25,41
313223,Wegener granulomatosis,ethnic,Hispanic or Latino,2,39,41
196163,Cervicitis and endocervicitis,racial,Unknown,41,0,41
25844,Ulcer of esophagus,ethnic,Hispanic or Latino,16,25,41
374919,Disseminated sclerosis,racial,Asian Indian,0,41,41
381839,Habit disorder,ethnic,Not Hispanic or Latino,12,30,42
136917,Primary malignant neoplasm of skin of face,ethnic,Hispanic or Latino,39,2,41
433257,Mesangiocapillary glomerulonephritis,ethnic,Hispanic or Latino,18,23,41
441838,Personality disorder,racial,White,9,32,41
439961,Superficial injury without infection,ethnic,Hispanic or Latino,32,9,41
318397,Chronic idiopathic thrombocytopenic purpura,racial,Unknown,28,14,42
377888,CHL - Conductive hearing loss,racial,Native Hawaiian or Other Pacific Islander ,0,41,41
440321,Helicobacter-associated disease,racial,Black or African American ,30,12,42
74322,Benign neoplasm of scrotum,racial,White,0,41,41
81379,Lateral epicondylitis,racial,Asian,30,12,42
380733,Otalgia,racial,Black or African American ,28,14,42
432791,Urticaria-angio-oedema,racial,Unknown,30,12,42
141253,Disease of thyroid gland,racial,Other Race,23,18,41
199764,Benign ovarian tumour,ethnic,Hispanic or Latino,41,0,41
381572,Abducens nerve palsy,racial,White,7,35,42
196456,Cholecystolithiasis,racial,Black or African American ,25,16,41
436666,Psychosexual disorder,racial,White,14,28,42
436675,Anorexia nervosa,ethnic,Hispanic or Latino,39,2,41
372425,Congenital abnormality of ear,ethnic,Hispanic or Latino,28,14,42
318222,Acute adenitis,racial,Unknown,23,18,41
378253,HA - Headache,racial,Filipino,25,16,41
195873,Leukorrhagia,racial,Other Race,41,0,41
254068,Upper respiratory disease,racial,Unknown,30,12,42
4168217,Generalized hyperhidrosis,ethnic,Not Hispanic or Latino,18,23,41
438879,Closed bimalleolar fracture,racial,White,23,18,41
4101602,Henoch-Schonlein purpura,racial,Unknown,39,2,41
4272867,General well-being finding,racial,Other Race,16,25,41
196456,Cholecystolithiasis,racial,American Indian or Alaska Native ,37,5,42
444243,Neurotic disorder,racial,Unknown,21,21,42
432312,Anatomical narrow angle glaucoma,racial,White,0,41,41
316211,Acquired spondylolisthesis,racial,Other Race,2,39,41
440032,CMV - Cytomegalovirus infection,ethnic,Hispanic or Latino,0,41,41
434500,Closed fracture of neck of femur,ethnic,Not Hispanic or Latino,35,7,42
316998,Left bundle branch block,ethnic,Not Hispanic or Latino,32,9,41
194984,Hepatopathy,racial,Asian,32,9,41
78200,Benign mammary dysplasia,ethnic,Not Hispanic or Latino,41,0,41
441497,Brucellosis,ethnic,Hispanic or Latino,39,2,41
201756,Lumbar cord injury without spinal bone injury,ethnic,Hispanic or Latino,0,41,41
433125,Infection due to Staphylocccus aureus,ethnic,Not Hispanic or Latino,16,25,41
198853,Congenital anomaly of ovary,racial,Asian,41,0,41
256451,Bronchitis,racial,American Indian or Alaska Native ,28,14,42
432941,Disease of tongue,racial,Unknown,28,14,42
132489,Partial thickness burn of finger,racial,Unknown,35,7,42
444090,Disease of foot,ethnic,Not Hispanic or Latino,37,5,42
435875,"Complications of pregnancy, childbirth and the puerperium",ethnic,Not Hispanic or Latino,39,2,41
4098311,Borderline psychosis of childhood,ethnic,Hispanic or Latino,5,37,42
441946,Calcific tendinitis of shoulder,racial,Unknown,37,5,42
73843,Synovial cyst of popliteal space,ethnic,Not Hispanic or Latino,16,25,41
319041,Orthostatic hypotension,racial,Asian,0,41,41
442862,"Abrasion or friction burn of hand, without mention of infection",ethnic,Hispanic or Latino,16,25,41
312664,Influenza with respiratory manifestation other than pneumonia,racial,Black or African American ,16,25,41
201072,Benign prostatic hypertrophy without outflow obstruction,racial,Unknown,0,41,41
201956,Congenital anomaly of lower limb,ethnic,Hispanic or Latino,32,9,41
74698,Breech presentation,ethnic,Hispanic or Latino,37,5,42
72457,Closed fracture of sacrum AND/OR coccyx without spinal cord injury,racial,White,39,2,41
133727,Thyrotoxicosis without goiter OR other cause,racial,Other Race,32,9,41
442008,Injury at T7-T12 level with spinal cord injury AND without bone injury,ethnic,Hispanic or Latino,0,41,41
4340379,Hepatitis B carrier,racial,Black or African American ,23,18,41
198062,"Infectious colitis, enteritis and gastroenteritis",ethnic,Not Hispanic or Latino,23,18,41
4112831,Extrinsic asthma NOS,ethnic,Not Hispanic or Latino,35,7,42
381306,Deaf mutism,racial,Asian,21,21,42
438878,Abnormal results of liver function studies,racial,Asian,18,23,41
200662,Lymphosarcoma,racial,White,30,12,42
78257,Osteogenesis imperfecta,ethnic,Not Hispanic or Latino,5,37,42
438788,Hypertrophy of adenoids,racial,White,2,39,41
254980,Intrinsic asthma with asthma attack,racial,White,21,21,42
434316,von Willebrand disorder,ethnic,Hispanic or Latino,5,37,42
438447,Acute myocardial infarction of inferolateral wall,racial,White,2,39,41
193326,Urge incontinence of urine,racial,American Indian or Alaska Native ,41,0,41
4104710,Parkinson's disease NOS,racial,White,35,7,42
74194,Back sprain,ethnic,Not Hispanic or Latino,23,18,41
192440,Ureterocele,racial,White,41,0,41
4146248,Rheumatoid arthritis and other inflammatory polyarthropathies,racial,White,28,14,42
316127,Vitreous opacities,ethnic,Not Hispanic or Latino,23,18,41
80805,Primary localized osteoarthrosis of forearm,racial,White,14,28,42
25518,AS - Sickle cell trait,racial,White,16,25,41
4088930,Confirmation of pregnancy,racial,Asian,41,0,41
434894,Acute post-hemorrhagic anemia,racial,White,21,21,42
140654,Deep seated dermatophytosis,ethnic,Hispanic or Latino,14,28,42
141094,Lichen,ethnic,Hispanic or Latino,28,14,42
196217,Congenital malformation of diaphragm,racial,White,21,21,42
321887,Disorder of artery,ethnic,Not Hispanic or Latino,32,9,41
433909,Foreign body on external eye,racial,White,5,37,42
4211231,Panic disorder without agoraphobia,racial,Other Race,37,5,42
435443,[X]Fall involving wheelchair,ethnic,Hispanic or Latino,35,7,42
438480,"Abnormal glucose tolerance in mother complicating pregnancy, childbirth AND/OR puerperium",racial,Asian,41,0,41
441542,Anxiety,racial,Native Hawaiian or Other Pacific Islander ,39,2,41
433751,Prolonged depressive adjustment reaction,racial,Unknown,23,18,41
74816,Contusion of toe,ethnic,Not Hispanic or Latino,18,23,41
441428,Closed fracture of lateral malleolus,ethnic,Not Hispanic or Latino,28,14,42
192440,Ureterocele,ethnic,Hispanic or Latino,41,0,41
435242,Cerebellar ataxia,racial,Unknown,41,0,41
4008573,Advanced open-angle glaucoma,ethnic,Hispanic or Latino,28,14,42
432904,Blood in anterior chamber,racial,Unknown,35,7,42
4240902,Allergy to peanuts,racial,Unknown,9,32,41
4130036,Brain damage due to hypoxia,ethnic,Hispanic or Latino,14,28,42
439162,"Closed fracture ankle, medial malleolus",racial,White,39,2,41
78097,Metastatic tumour of bone,racial,Asian,41,0,41
194696,Menorrhalgia,racial,Black or African American ,41,0,41
381290,Ocular hypertension,racial,White,32,9,41
194081,Acute cystitis,racial,Asian,35,7,42
440612,Toxic effect of tobacco and nicotine,ethnic,Hispanic or Latino,21,21,42
193186,Cauda equina syndrome with neurogenic bladder,ethnic,Hispanic or Latino,41,0,41
312935,Venous hypertension,ethnic,Not Hispanic or Latino,16,25,41
438827,Foreign body granuloma of subcutaneous tissue,ethnic,Hispanic or Latino,28,14,42
260139,Acute bronchitis,racial,American Indian,21,21,42
195977,Contusion of trunk,racial,Unknown,30,12,42
81426,Closed fracture of clavicle,ethnic,Not Hispanic or Latino,21,21,42
77067,Bucket handle tear of lateral meniscus,ethnic,Not Hispanic or Latino,41,0,41
257907,Disorder of lung,racial,Black or African American ,2,39,41
72737,Microcalcifications of the breast,racial,Asian,41,0,41
199886,Simple endometrial hyperplasia,ethnic,Hispanic or Latino,41,0,41
28385,Disorder of posterior pituitary,racial,Unknown,37,5,42
441269,Autoimmune hemolytic anemia,racial,White,41,0,41
434916,"Amfetamine or psychostimulant dependence, continuous",ethnic,Hispanic or Latino,12,30,42
4195572,"Mild major depression, single episode",racial,Other Race,35,7,42
135360,Fainting,racial,Black or African American ,25,16,41
437113,Asthenia,racial,Unknown,25,16,41
201078,Senile atrophic vaginitis,racial,Other Race,41,0,41
441497,Brucellosis,racial,White,39,2,41
261782,Herpetic ulceration of vulva,ethnic,Not Hispanic or Latino,41,0,41
313761,Central retinal vein occlusion,racial,Unknown,23,18,41
4108982,Cataract associated with other syndromes,racial,Unknown,21,21,42
374914,Quadriplegia,ethnic,Not Hispanic or Latino,2,39,41
192687,Vulvovaginitis associated with another disease,racial,Unknown,41,0,41
315830,Variant angina,ethnic,Hispanic or Latino,37,5,42
141955,Pectus excavatum,ethnic,Hispanic or Latino,9,32,41
77067,Bucket handle tear of lateral meniscus,racial,Unknown,41,0,41
193518,Intestinal obstruction,racial,Unknown,18,23,41
256448,Chronic asthmatic bronchitis,racial,Asian,32,9,41
138519,Spondylosis without myelopathy,racial,Asian,14,28,42
4101068,Observation of ear discharge,racial,White,23,16,39
4272867,General well-being finding,racial,Asian,23,16,39
195079,Functional urinary incontinence,ethnic,Not Hispanic or Latino,30,9,39
200762,Autoimmune hepatitis,racial,White,28,12,40
77365,Disuse osteoporosis,ethnic,Hispanic or Latino,28,12,40
4204966,Regurgitant esophagitis,racial,White,12,28,40
138113,Cyst of thyroid,racial,Asian,39,0,39
440207,Hypoplastic left heart syndrome,ethnic,Hispanic or Latino,25,14,39
376224,Spina bifida without hydrocephalus,racial,Unknown,12,28,40
4096665,Diabetes mellitus with no mention of complication,racial,Unknown,18,21,39
437221,Chlamydia trachomatis infection,racial,White,37,2,39
77072,Joint effusion of ankle AND/OR foot,racial,Unknown,23,16,39
133424,Primary malignant neoplasm of thyroid gland,racial,Asian,35,5,40
440855,Closed fracture of base of metacarpal bone other than first metacarpal,ethnic,Hispanic or Latino,23,16,39
435081,Abnormal findings on diagnostic imaging of heart and coronary circulation,ethnic,Hispanic or Latino,18,21,39
141094,Lichen,racial,White,23,16,39
438244,Congenital hydrocephalus,ethnic,Not Hispanic or Latino,14,25,39
373212,Esophoria,ethnic,Hispanic or Latino,25,14,39
443943,Herpes zoster,racial,Unknown,30,9,39
441201,"[X]Fall from, out of or through building or structure",racial,Unknown,16,23,39
434942,Postseptal orbital cellulitis,racial,White,18,21,39
200771,Peptic ulcer without hemorrhage AND without perforation but with obstruction,ethnic,Hispanic or Latino,23,16,39
375827,Acute non-suppurative otitis media - serous,racial,Other Race,18,21,39
72715,Exostosis,ethnic,Not Hispanic or Latino,30,9,39
439254,"Bipolar affective disorder, current episode depression",ethnic,Hispanic or Latino,37,2,39
72986,Disease of lower leg,racial,American Indian or Alaska Native ,0,39,39
140480,Impetigo,racial,Other Race,18,21,39
136264,Open wound of floor of mouth without complication,ethnic,Hispanic or Latino,23,16,39
4046893,Lifestyle,ethnic,Not Hispanic or Latino,12,28,40
435508,Adrenal cortical hypofunction,racial,Black or African American ,0,39,39
256531,Head and neck swelling,racial,Black or African American ,28,12,40
4326601,Anorectal abscess,racial,Unknown,14,25,39
75580,Chronic ulcerative proctitis,racial,White,37,2,39
136788,Spinal stenosis of lumbar region,racial,American Indian or Alaska Native ,39,0,39
439697,Hypertensive renal disease with renal failure,racial,Black or African American ,14,25,39
444285,Acquired equinovarus deformity,racial,White,25,14,39
74728,Synovitis and tenosynovitis,racial,Unknown,30,9,39
378752,Corneal opacity,racial,White,32,7,39
78273,Closed fracture multiple ribs,racial,White,18,21,39
4258683,Faeces - impacted,ethnic,Hispanic or Latino,21,18,39
443415,Gestation greater than 24 weeks,ethnic,Not Hispanic or Latino,32,7,39
435511,Hypercalcemia,racial,Other Race,16,23,39
75614,Acrodermatitis continua,racial,Filipino,2,37,39
134898,Non-toxic single thyroid nodule,racial,Other Race,23,16,39
436477,Abnormal products of conception,ethnic,Hispanic or Latino,39,0,39
4005933,Urethral meatus underneath penis,ethnic,Not Hispanic or Latino,0,39,39
376399,Incipient cataract,ethnic,Hispanic or Latino,30,9,39
435120,Blister of toe with infection,ethnic,Hispanic or Latino,25,14,39
141941,Cervical spondylosis without myelopathy,racial,Asian,39,0,39
4066376,Pilonidal sinus with abscess,racial,Unknown,9,30,39
132932,Chronic ethmoidal sinusitis,racial,White,25,14,39
432868,Hemoglobinopathy,ethnic,Hispanic or Latino,18,21,39
441264,Primary thrombocytopenia,racial,Black or African American ,0,39,39
195847,Gastroparesis syndrome,ethnic,Not Hispanic or Latino,21,18,39
201418,"Flatulence, eructation and gas pain",racial,Other Race,35,5,40
4213085,Family history of prostate cancer,racial,White,0,39,39
30679,Benign tumour major salivary gland,racial,White,39,0,39
72245,Chlamydial infection of lower genitourinary tract,racial,White,35,5,40
135032,Dermatitis due to substances taken internally,ethnic,Hispanic or Latino,30,9,39
435569,Disorder of jaw,racial,White,2,37,39
133510,Rapidly progressive periodontitis,ethnic,Hispanic or Latino,25,14,39
312728,Congenital tricuspid atresia and stenosis,racial,Unknown,39,0,39
72457,Closed fracture of sacrum AND/OR coccyx without spinal cord injury,racial,Unknown,37,2,39
80182,Dermatomyositis,ethnic,Hispanic or Latino,25,14,39
76191,Disease of upper arm,racial,Unknown,39,0,39
436231,Abnormal findings diagnostic imaging of liver and biliary tract,racial,White,25,14,39
73300,Radial styloid tenosynovitis,ethnic,Not Hispanic or Latino,32,7,39
440953,Cysticercosis,racial,White,18,21,39
317893,Paroxysmal supraventricular tachycardia,racial,Native Hawaiian or Other Pacific Islander ,39,0,39
197672,Urinary incontinence,racial,American Indian or Alaska Native ,39,0,39
435751,Primary malignant neoplasm of fundus of stomach,racial,White,0,39,39
73089,Contusion of buttock,racial,Unknown,32,7,39
4138253,Malabsorption syndrome,ethnic,Not Hispanic or Latino,37,2,39
375815,Bullous keratopathy,ethnic,Hispanic or Latino,28,12,40
438350,Pneumocystosis,racial,White,0,39,39
4115370,Arthralgia NOS,racial,White,35,5,40
313792,PT - Paroxysmal tachycardia,racial,White,37,2,39
261889,Simple chronic bronchitis,racial,Black or African American ,7,32,39
4298854,HIV seropositivity,racial,Other Race,0,39,39
434316,von Willebrand disorder,racial,White,2,37,39
40389902,"Neoplasm of uncertain behavior of pleura, thymus and mediastinum",ethnic,Not Hispanic or Latino,0,39,39
432447,Atypical glandular cells on cervical Papanicolaou smear,ethnic,Not Hispanic or Latino,39,0,39
434821,SIRS - System inflammatory response syndrome,ethnic,Not Hispanic or Latino,18,21,39
437251,Benign neoplasm of pituitary gland and craniopharyngeal duct,racial,Asian,39,0,39
77592,Articular crepitus of temporomandibular joint,ethnic,Hispanic or Latino,16,23,39
77373,Congenital deformity of hip joint,ethnic,Not Hispanic or Latino,35,5,40
433647,Poisoning by central nervous system muscle tone depressant,ethnic,Hispanic or Latino,39,0,39
133436,Thyrotoxic crisis,racial,American Indian or Alaska Native ,39,0,39
376112,Diabetic polyneuropathy,racial,Filipino,5,35,40
4126282,Chlamydial urethritis,ethnic,Hispanic or Latino,23,16,39
436263,Broken tooth without complication,racial,Unknown,18,21,39
4092896,Stool contents abnormal,racial,Black or African American ,28,12,40
196328,Enteric paratyphosis,ethnic,Hispanic or Latino,9,30,39
197494,Viral hepatitis C,racial,Other Race,5,35,40
4098311,Borderline psychosis of childhood,racial,White,2,37,39
375504,Psychoactive substance-induced organic mental disorder,racial,White,14,25,39
433750,"Single major depressive episode, in full remission",ethnic,Not Hispanic or Latino,21,18,39
375550,Senile corneal changes,ethnic,Hispanic or Latino,16,23,39
444382,Thoracic radiculitis,racial,Other Race,28,12,40
4108817,"Tricuspid valve disorders, non-rheumatic",racial,White,12,28,40
254591,Secondary malignant tumour of lung,racial,Asian,12,28,40
435904,Derangement of anterior horn of medial meniscus,ethnic,Hispanic or Latino,18,21,39
434169,Abnormal findings on diagnostic imaging of breast,racial,American Indian or Alaska Native ,39,0,39
78835,Palindromic rheumatism of the lower leg,racial,Asian,23,16,39
436166,Mild hyperemesis gravidarum,ethnic,Not Hispanic or Latino,39,0,39
313236,Cough variant asthma,racial,Native Hawaiian or Other Pacific Islander ,32,7,39
40389902,"Neoplasm of uncertain behavior of pleura, thymus and mediastinum",racial,Asian,0,39,39
437449,Victim of child abuse,racial,White,23,16,39
441126,Monosomy and deletion from autosome,ethnic,Not Hispanic or Latino,30,9,39
433946,Fall on same level due to impact against another person,ethnic,Not Hispanic or Latino,30,9,39
4064375,Iron deficiency screening,racial,Filipino,18,21,39
198470,Unilateral inguinal hernia with obstruction but no gangrene,ethnic,Hispanic or Latino,2,37,39
437241,Qualitative platelet defect,ethnic,Not Hispanic or Latino,12,28,40
442308,Abrasion AND/OR friction burn of thigh without infection,ethnic,Not Hispanic or Latino,18,21,39
433647,Poisoning by central nervous system muscle tone depressant,racial,Unknown,39,0,39
440035,European cryptococcosis,ethnic,Hispanic or Latino,39,0,39
138826,Acne varioliformis,ethnic,Hispanic or Latino,9,30,39
75365,Oliguria and anuria,ethnic,Hispanic or Latino,18,21,39
259055,Extrinsic asthma with asthma attack,racial,Other Race,16,23,39
81611,Diverticular disease of colon,racial,Black or African American ,30,9,39
441830,Disorder of fluid AND/OR electrolyte,ethnic,Not Hispanic or Latino,30,9,39
434494,Closed fracture of the proximal humerus,ethnic,Not Hispanic or Latino,16,23,39
434172,Insomnia with sleep apnoea,racial,White,0,39,39
4016352,Tuberculosis contact,ethnic,Not Hispanic or Latino,25,14,39
443790,Multi-infarct dementia with delusions,ethnic,Not Hispanic or Latino,39,0,39
4096198,Vitamin B-complex deficiency,racial,White,37,2,39
372599,Severe mixed bipolar I disorder without psychotic features,racial,White,7,32,39
4188027,Food allergy,ethnic,Not Hispanic or Latino,14,25,39
433125,Infection due to Staphylocccus aureus,racial,Unknown,28,12,40
80225,Sprain of ligament of lumbosacral joint,ethnic,Not Hispanic or Latino,30,9,39
73231,Arthralgia of temporomandibular joint,racial,Unknown,32,7,39
437222,Respiratory syncytial virus infection,racial,White,9,30,39
381036,Multiple AND bilateral precerebral artery stenosis,ethnic,Not Hispanic or Latino,32,7,39
377535,Sleep walking disorder,racial,White,23,16,39
438557,Abnormal glucose level,racial,Native Hawaiian or Other Pacific Islander ,25,14,39
432454,Excessive thirst,ethnic,Not Hispanic or Latino,12,28,40
192963,Disease of pancreas,ethnic,Not Hispanic or Latino,28,12,40
440674,Gout,racial,American Indian or Alaska Native ,7,32,39
198216,Retroverted incarcerated gravid uterus - delivered,ethnic,Hispanic or Latino,39,0,39
258482,Abscess of Bartholin's gland,racial,Unknown,39,0,39
4168226,Micturition frequency and polyuria,racial,White,35,5,40
133835,Dermatitis,racial,Other Race,16,23,39
4079876,Familial combined hyperlipidemia,racial,American Indian,14,25,39
432895,Cortical senile cataract,ethnic,Not Hispanic or Latino,7,32,39
433134,Histoplasmosis,ethnic,Hispanic or Latino,0,39,39
434742,Congenital abnormality of skull and face bones,racial,Asian,18,21,39
133551,Vesicular eczema of hands and/or feet,racial,Unknown,28,12,40
437464,"Injury undetermined whether accidentally or purposely inflicted, fall from residential premises",racial,Unknown,23,16,39
200775,Endometrial hyperplasia,racial,White,39,0,39
4105330,Chronic undifferentiated schizophrenia,racial,Asian,32,7,39
435752,Primary malignant neoplasm of duodenum,ethnic,Hispanic or Latino,0,39,39
137820,Postoperative hypothyroidism,ethnic,Not Hispanic or Latino,23,16,39
437082,Marie-Strumpell spondylitis,racial,Black or African American ,0,39,39
72995,Joint contracture of hand,racial,White,14,25,39
381312,Neural hearing loss,racial,White,23,16,39
137053,Seborrheic dermatitis,racial,Other Race,21,18,39
435510,Hypocalcemia,ethnic,Not Hispanic or Latino,18,21,39
194992,Coeliac disease,racial,White,16,23,39
437409,Intracranial injury,ethnic,Not Hispanic or Latino,14,25,39
197988,General abdominal pain-symptom,racial,Asian,32,7,39
134398,Periodontal disease,racial,White,12,28,40
135772,Goiter,racial,Asian,39,0,39
73341,Closed fracture of head of radius,racial,Unknown,32,7,39
135892,Erythematous condition,ethnic,Not Hispanic or Latino,23,16,39
438527,"Juvenile osteochondrosis of lower extremity, excluding foot",racial,Unknown,14,25,39
320744,Complete atrioventricular block,racial,Unknown,35,5,40
375557,Cerebral embolism,racial,White,30,9,39
443783,Chronic disease,racial,American Indian or Alaska Native ,2,37,39
194286,"Malignant neoplasm of corpus uteri, excluding isthmus",racial,Other Race,39,0,39
316501,Disorder of blood vessels affecting skin,ethnic,Hispanic or Latino,16,23,39
195245,Reflex sympathetic dystrophy,racial,White,0,39,39
434329,Spinocerebellar disease,racial,White,39,0,39
198246,Congenital hiatus hernia,ethnic,Hispanic or Latino,25,14,39
199958,Open wound of hip AND thigh without complication,ethnic,Hispanic or Latino,16,23,39
443350,Lower urinary tract symptoms,racial,American Indian or Alaska Native ,0,39,39
4024000,Urinary system finding,racial,White,21,18,39
75576,Colon spasm,racial,Other Race,35,5,40
438120,Opioid dependence,racial,Other Race,25,14,39
435751,Primary malignant neoplasm of fundus of stomach,ethnic,Hispanic or Latino,0,39,39
432730,Dysphonia,ethnic,Not Hispanic or Latino,28,12,40
192963,Disease of pancreas,racial,Unknown,28,12,40
4245252,Raised prostate specific antigen,racial,American Indian or Alaska Native ,0,39,39
374022,Hemiplegia,racial,American Indian or Alaska Native ,0,39,39
318521,Displacement of thoracic intervertebral disc without myelopathy,racial,Unknown,37,2,39
4171115,Low birth weight infant,racial,White,28,12,40
4305080,Abnormal breathing,racial,Unknown,32,7,39
196443,Gastric ulcer without hemorrhage AND without perforation but with obstruction,racial,White,32,7,39
435651,Atypical squamous cells on cervical Papanicolaou smear cannot exclude high grade squamous intraepithelial lesion,racial,Unknown,39,0,39
134453,Inflammation of bursa,ethnic,Not Hispanic or Latino,16,23,39
31821,Endocrinopathy,ethnic,Not Hispanic or Latino,25,14,39
139036,Systolic dysfunction,racial,Unknown,14,25,39
4276723,Finding of child weight centiles,racial,Other Race,14,25,39
80070,Uric acid urolithiasis,ethnic,Hispanic or Latino,16,23,39
441333,Geographic tongue,racial,White,14,23,37
197006,Residual hemorrhoidal skin tags,racial,White,21,16,37
199064,Chronic vascular insufficiency of intestine,ethnic,Hispanic or Latino,9,28,37
80552,Closed fracture of the scaphoid,ethnic,Not Hispanic or Latino,18,18,36
377280,Corneal disorder,ethnic,Hispanic or Latino,28,9,37
4064918,Diabetes mellitus screening,racial,Filipino,30,7,37
374338,Nondiabetic proliferative retinopathy,ethnic,Hispanic or Latino,12,25,37
436919,Primary malignant neoplasm of unspecified site,racial,Asian,14,23,37
438733,Profound mental handicap,ethnic,Not Hispanic or Latino,18,18,36
201626,Mid-cycle pain,racial,White,32,5,37
28179,Polyp of vocal cord or larynx,ethnic,Hispanic or Latino,32,5,37
195599,Post-hysterectomy vaginal vault prolapse,ethnic,Hispanic or Latino,37,0,37
433015,Congenital anomaly of aortic arch,ethnic,Hispanic or Latino,25,12,37
434170,Atypical squamous cells of undetermined significance on cervical Papanicolaou smear,racial,Other Race,37,0,37
435640,"Gestation period, 25 weeks",racial,White,9,28,37
81936,Monoarthritis,ethnic,Hispanic or Latino,21,16,37
374009,Organic mental disorder,racial,White,21,16,37
135778,Toxic multinodular goitre,racial,Unknown,37,0,37
197381,Epigastric pain,racial,Black or African American ,32,5,37
380818,Acquired deformity of head,ethnic,Hispanic or Latino,18,18,36
140259,Open wound of face without complication,racial,Unknown,12,25,37
258540,Marfan syndrome,racial,White,12,25,37
24609,Hypoglycaemia,racial,Black or African American ,21,16,37
199870,Renal vascular disorder,racial,White,12,25,37
4097560,Burkitt lymphoma of intra-abdominal lymph nodes,racial,Black or African American ,0,37,37
381548,Monoplegia,racial,White,21,16,37
314968,Varices,racial,Unknown,35,2,37
197239,Haemangioma of intra-abdominal structure,racial,White,25,12,37
74855,Genital herpes simplex,racial,Other Race,30,7,37
437839,Pica,racial,White,21,16,37
134460,Plantar fascial fibromatosis,racial,Black or African American ,14,23,37
434007,Congenital factor VIII deficiency,racial,White,2,35,37
433403,Viral meningitis,ethnic,Hispanic or Latino,30,7,37
260841,Perinatal subarachnoid hemorrhage,ethnic,Hispanic or Latino,28,9,37
81186,Contusion of wrist,racial,Unknown,18,18,36
74511,Open wound of knee and/or leg and/or ankle with complication,ethnic,Hispanic or Latino,37,0,37
75099,Coccyx sprain,ethnic,Hispanic or Latino,28,9,37
438170,Acute myocardial infarction of inferior wall,ethnic,Not Hispanic or Latino,0,37,37
137951,Acquired keratoderma,racial,Unknown,32,5,37
440389,MR - Mental retardation,racial,Other Race,32,5,37
372907,Macular scar,ethnic,Hispanic or Latino,16,21,37
438962,Herpes simplex with complication,ethnic,Not Hispanic or Latino,0,37,37
440814,Torticollis,racial,Unknown,23,14,37
441428,Closed fracture of lateral malleolus,racial,Unknown,37,0,37
4161977,Patient with cardiac pacemaker,racial,American Indian or Alaska Native ,37,0,37
440690,Social phobia,ethnic,Hispanic or Latino,25,12,37
443577,Asymmetric sensorineural hearing loss,racial,White,25,12,37
437992,Abnormal results of kidney function studies,racial,Unknown,9,28,37
442597,Meteorism,ethnic,Not Hispanic or Latino,28,9,37
80504,Acquired genu valgum,racial,Unknown,35,2,37
440438,Anodontia,ethnic,Not Hispanic or Latino,23,14,37
4110655,Pupil-involving third nerve palsy,ethnic,Hispanic or Latino,7,30,37
437851,Open angle with borderline intraocular pressure,racial,Unknown,35,2,37
440788,Hyperemesis gravidarum with metabolic disturbance - not delivered,racial,Unknown,37,0,37
436929,Malignant histiocytosis of extranodal AND/OR solid organ site,ethnic,Hispanic or Latino,5,32,37
374358,Dermatochalasis,ethnic,Not Hispanic or Latino,0,37,37
77987,Respiratory observations of chest,racial,Unknown,21,16,37
312723,Congenital heart disease,racial,Black or African American ,21,16,37
193306,Situs inversus,ethnic,Hispanic or Latino,14,23,37
433260,Mother delivered,racial,White,37,0,37
74739,Osteopathy from poliomyelitis,ethnic,Hispanic or Latino,9,28,37
438531,Chondromalacia,racial,White,32,5,37
137351,Epidermoid cyst of skin,racial,Other Race,30,7,37
441830,Disorder of fluid AND/OR electrolyte,racial,White,25,12,37
436816,Vaginal vault smear abnormal,racial,White,37,0,37
441918,"Emotional AND/OR mental disease in mother complicating pregnancy, childbirth AND/OR puerperium",racial,Unknown,37,0,37
4287544,Manic bipolar I disorder,racial,Other Race,14,23,37
195771,Secondary diabetes mellitus,racial,Black or African American ,0,37,37
194995,Disorder of ureter,racial,Unknown,9,28,37
441678,"Gestation period, 33 weeks",ethnic,Not Hispanic or Latino,18,18,36
443801,Exercise-induced asthma,racial,Black or African American ,30,7,37
135615,Pityriasis,ethnic,Not Hispanic or Latino,18,18,36
317376,Tachypnoeic,ethnic,Hispanic or Latino,9,28,37
443801,Exercise-induced asthma,racial,Asian,14,23,37
312337,Arterial embolic and thrombotic occlusion,ethnic,Hispanic or Latino,23,14,37
4303805,Allergic reaction to bite and/or sting,racial,White,23,14,37
381114,Microcephalus,racial,White,25,12,37
73571,Pathological fracture,racial,White,35,2,37
4138253,Malabsorption syndrome,racial,Asian,37,0,37
443111,Tenosynovitis of foot,ethnic,Not Hispanic or Latino,21,16,37
444283,Superficial foreign body of hand without major open wound AND without infection,ethnic,Hispanic or Latino,25,12,37
378140,Inflammatory and toxic neuropathy,ethnic,Hispanic or Latino,37,0,37
320682,Finding of white blood cell number,racial,White,28,9,37
254591,Secondary malignant tumour of lung,ethnic,Not Hispanic or Latino,37,0,37
434587,Primary malignant neoplasm of dorsal surface of tongue,ethnic,Hispanic or Latino,0,37,37
4097560,Burkitt lymphoma of intra-abdominal lymph nodes,ethnic,Not Hispanic or Latino,0,37,37
80573,Contusion of ankle,racial,Unknown,25,12,37
440155,Postartificial menopausal syndrome,racial,White,35,2,37
136950,5q minus syndrome,racial,Unknown,0,37,37
136950,5q minus syndrome,ethnic,Hispanic or Latino,0,37,37
433457,Agoraphobia without mention of panic attacks,racial,White,37,0,37
4149353,"Attention deficit hyperactivity disorder, predominantly inattentive type",racial,Other Race,28,9,37
318549,Cardiac septal defects,ethnic,Hispanic or Latino,37,0,37
4282316,Recurrent major depression,ethnic,Hispanic or Latino,14,23,37
439708,Disorders of initiating and maintaining sleep,racial,American Indian or Alaska Native ,12,25,37
436803,FRAXA - Fragile X syndrome,ethnic,Hispanic or Latino,7,30,37
436230,Blood chemistry abnormal,racial,American Indian or Alaska Native ,14,23,37
379006,Cerebral degeneration in childhood,ethnic,Hispanic or Latino,32,5,37
73576,Acquired chest and rib deformity,racial,White,7,30,37
4175226,Screening for malignant neoplasm of colon,racial,American Indian,14,23,37
136982,Trichiasis without entropion,ethnic,Hispanic or Latino,21,16,37
79240,Dislocation of joint prosthesis,ethnic,Hispanic or Latino,23,14,37
376103,Retinopathy,ethnic,Not Hispanic or Latino,25,12,37
433760,Dysreflexia,ethnic,Hispanic or Latino,32,5,37
196165,Cervical intraepithelial neoplasia grade 2,racial,Unknown,37,0,37
40480002,Aphasia as late effect of cerebrovascular disease,ethnic,Not Hispanic or Latino,37,0,37
78804,Schimmelbusch's disease,ethnic,Not Hispanic or Latino,37,0,37
372906,Both eyes total visual impairment,racial,Black or African American ,35,2,37
133569,Fasciitis,racial,Unknown,23,14,37
435651,Atypical squamous cells on cervical Papanicolaou smear cannot exclude high grade squamous intraepithelial lesion,ethnic,Not Hispanic or Latino,30,7,37
198850,Congenital hypoplasia of penis,racial,White,0,37,37
201612,ALD - Alcoholic liver disease,racial,Unknown,0,37,37
436953,Continuous chronic alcoholism,ethnic,Not Hispanic or Latino,5,32,37
434094,Spontaneous abortion with complication,racial,White,37,0,37
434587,Primary malignant neoplasm of dorsal surface of tongue,racial,White,0,37,37
433030,False-positive serological test for syphilis,racial,White,25,12,37
4092511,Malignant neoplasm of central part of female breast,ethnic,Hispanic or Latino,37,0,37
75580,Chronic ulcerative proctitis,ethnic,Hispanic or Latino,28,9,37
437127,Closed dislocation of acromioclavicular joint,racial,White,21,16,37
436803,FRAXA - Fragile X syndrome,racial,White,7,30,37
135340,Pressure ulcer stage 3,racial,Unknown,18,18,36
4105880,Contact of sexually transmissible disorder,racial,Other Race,23,14,37
77679,Spine or spinal cord injury due to birth trauma,racial,Unknown,0,37,37
436929,Malignant histiocytosis of extranodal AND/OR solid organ site,racial,White,5,32,37
442793,Diabetic complication,racial,Native Hawaiian or Other Pacific Islander ,28,9,37
134517,Open wound of mouth without complication,ethnic,Hispanic or Latino,21,16,37
443442,Finding of vaginal vault smear result,racial,Unknown,37,0,37
440202,Multiple congenital malformations,ethnic,Not Hispanic or Latino,9,28,37
439150,Hypersomnia with sleep apnea,racial,White,5,32,37
29056,Sialoadenitis,ethnic,Not Hispanic or Latino,18,18,36
439666,Contracture of multiple joints,ethnic,Hispanic or Latino,28,9,37
434008,White blood cell disorder,ethnic,Not Hispanic or Latino,30,7,37
192367,Dysplasia of cervix,ethnic,Not Hispanic or Latino,37,0,37
195873,Leukorrhagia,racial,Black or African American ,37,0,37
141825,Non-toxic goiter,ethnic,Hispanic or Latino,37,0,37
435517,Acidosis,ethnic,Not Hispanic or Latino,9,28,37
432526,Needs influenza immunisation,racial,Asian Indian,12,25,37
4160859,Methicillin resistant staphylococcus aureus carrier,ethnic,Not Hispanic or Latino,28,9,37
375256,Anterior subcapsular polar senile cataract,racial,White,32,5,37
433316,Giddiness,racial,Filipino,23,14,37
256717,Bronchospasm,racial,Other Race,28,9,37
437540,CRAO - Central retinal artery occlusion,racial,Unknown,0,37,37
432513,Animal bite wound,racial,White,30,7,37
433495,"Conductive hearing loss, bilateral",ethnic,Hispanic or Latino,23,14,37
381297,Xanthoma of eyelid,ethnic,Hispanic or Latino,37,0,37
135762,Acute myeloid leukaemia in remission,racial,Unknown,28,9,37
439162,"Closed fracture ankle, medial malleolus",ethnic,Hispanic or Latino,32,5,37
140176,Erythema nodosum,ethnic,Hispanic or Latino,23,14,37
436100,Narcolepsy,ethnic,Hispanic or Latino,2,35,37
376112,Diabetic polyneuropathy,racial,American Indian or Alaska Native ,18,18,36
437753,Seen by surgical fitting - service,racial,White,37,0,37
195498,Benign tumour of kidney,ethnic,Hispanic or Latino,18,18,36
438882,Closed fracture of neck of metacarpal bone,racial,White,2,35,37
4064383,Rheumatoid arthritis screening,racial,White,25,12,37
135930,Musculoskeletal system observation,racial,White,28,9,37
439406,Allergy to animal,ethnic,Not Hispanic or Latino,23,14,37
133468,Disease of extremity,racial,White,9,28,37
443238,Diabetic - poor control,racial,American Indian or Alaska Native ,0,37,37
435656,Neonatal jaundice,racial,Other Race,28,9,37
4069184,Infundibular pulmonic stenosis,ethnic,Hispanic or Latino,18,18,36
78838,Acquired deformity of knee,ethnic,Hispanic or Latino,18,18,36
374372,Otogenic otalgia,ethnic,Hispanic or Latino,30,7,37
74729,Ganglion and synovial cyst,racial,Black or African American ,25,12,37
438688,Sarcoidosis,ethnic,Hispanic or Latino,32,5,37
441460,Late effect of sprain AND/OR strain without tendon injury,ethnic,Hispanic or Latino,21,16,37
432250,Infective disorder,racial,White,21,16,37
195259,Entrapment of lateral cutaneous nerve of thigh,ethnic,Not Hispanic or Latino,14,23,37
4141622,Asthma NOS,ethnic,Not Hispanic or Latino,25,12,37
443452,Bleeding of unknown origin,racial,Unknown,18,18,36
376116,Central loss of vision,ethnic,Hispanic or Latino,2,35,37
444406,Acute subendocardial infarction,ethnic,Hispanic or Latino,21,16,37
378548,Polyotia,ethnic,Hispanic or Latino,21,16,37
140526,Congenital anomaly of endocrine gland,ethnic,Hispanic or Latino,23,14,37
195501,Polycystic ovaries,racial,Asian,37,0,37
374358,Dermatochalasis,racial,Native Hawaiian or Other Pacific Islander ,0,37,37
261324,Pneumonia due to Streptococcus,racial,Unknown,23,14,37
438368,Primary malignant neoplasm of thymus,ethnic,Not Hispanic or Latino,0,37,37
440529,Abnormal findings on diagnostic imaging of urinary organs,racial,Unknown,35,2,37
441969,Radiology result abnormal,racial,Unknown,32,5,37
4090255,Colloid bodies in retina,ethnic,Hispanic or Latino,35,2,37
436677,"Brief situational non-psychotic disorder, NOS",racial,Unknown,35,2,37
192438,Abdominal mass,racial,Other Race,37,0,37
193493,Benign hypertensive renal disease,racial,White,32,5,37
77679,Spine or spinal cord injury due to birth trauma,ethnic,Hispanic or Latino,0,37,37
440032,CMV - Cytomegalovirus infection,racial,White,0,37,37
138225,Disease of sebaceous glands,ethnic,Not Hispanic or Latino,32,5,37
442790,Growth and development,ethnic,Not Hispanic or Latino,21,16,37
4104710,Parkinson's disease NOS,racial,Unknown,35,2,37
140966,Benign neoplasm of skin of face,ethnic,Not Hispanic or Latino,32,5,37
373202,Corneal ulcer,ethnic,Hispanic or Latino,35,2,37
375260,Polyneuropathy in collagen vascular disease,ethnic,Hispanic or Latino,16,21,37
196569,Contusion of abdominal wall,ethnic,Hispanic or Latino,16,21,37
432730,Dysphonia,racial,Unknown,21,16,37
435080,Biliuria,ethnic,Hispanic or Latino,14,23,37
316999,Cardiac arrhythmia,racial,Native Hawaiian or Other Pacific Islander ,2,35,37
438688,Sarcoidosis,racial,White,32,5,37
377290,Legal blindness USA,ethnic,Not Hispanic or Latino,25,12,37
436333,Orf virus disease,ethnic,Hispanic or Latino,23,14,37
78909,"Contusion, shoulder and upper arm, multiple sites",ethnic,Hispanic or Latino,21,16,37
432452,Anemia of prematurity,ethnic,Hispanic or Latino,21,16,37
432347,Chronic disease of tonsils AND/OR adenoids,racial,White,23,14,37
437127,Closed dislocation of acromioclavicular joint,racial,Unknown,0,37,37
4013916,Closed fracture of clavicle NOS,ethnic,Hispanic or Latino,21,16,37
316429,Ectopics,ethnic,Not Hispanic or Latino,23,14,37
4060985,BMI 30+ - obesity,racial,Asian Indian,21,16,37
4290927,Impairment level: low vision of both eyes,ethnic,Not Hispanic or Latino,16,21,37
441788,Human papilloma virus infection,ethnic,Not Hispanic or Latino,37,0,37
381504,Post-herpetic trigeminal neuralgia,racial,Unknown,35,2,37
195306,Gastroduodenitis,racial,American Indian or Alaska Native ,32,5,37
436466,Balanoposthitis,racial,Other Race,0,37,37
442588,OSA - Obstructive sleep apnoea,racial,Native Hawaiian or Other Pacific Islander ,2,35,37
196160,Fistula of intestine,ethnic,Not Hispanic or Latino,37,0,37
4108905,Congenital malformation of the urinary system,ethnic,Hispanic or Latino,14,23,37
436700,Eye displaced forwards,ethnic,Hispanic or Latino,25,12,37
80767,Breast irregular nodularity,racial,American Indian or Alaska Native ,37,0,37
75053,Fracture of bone,racial,White,23,14,37
4263325,Actinic cheilitis,racial,White,18,18,36
432597,Schizoaffective schizophrenia,racial,Other Race,12,25,37
4239721,Seafood allergy,ethnic,Not Hispanic or Latino,21,16,37
134438,CD - Contact dermatitis,racial,Native Hawaiian or Other Pacific Islander ,5,32,37
376961,Disturbance of consciousness,racial,Other Race,9,28,37
4209151,Repair of musculotendinous cuff of shoulder,ethnic,Hispanic or Latino,25,12,37
195851,"Gastric ulcer without hemorrhage, without perforation AND without obstruction",racial,Asian,23,14,37
24660,Acute tonsillitis,racial,Asian,18,18,36
443597,Chronic kidney disease stage 3,racial,Native Hawaiian or Other Pacific Islander ,12,25,37
25518,AS - Sickle cell trait,ethnic,Hispanic or Latino,18,18,36
443677,Open wound of knee and/or leg and/or ankle,ethnic,Not Hispanic or Latino,16,21,37
197601,Spermatocele,ethnic,Hispanic or Latino,0,37,37
4167406,Eye disorder screening,racial,Other Race,16,21,37
438477,Atrophy of testis,racial,White,0,37,37
77650,Aseptic necrosis of bone,ethnic,Hispanic or Latino,21,16,37
195906,Disorder of lumbar spine,racial,Unknown,2,35,37
433316,Giddiness,racial,Native Hawaiian or Other Pacific Islander ,28,9,37
74469,Light-for-dates without mention of fetal malnutrition,ethnic,Hispanic or Latino,30,7,37
443409,On examination - left lower abdominal mass,racial,Other Race,37,0,37
437528,"Bipolar affective disorder, currently depressed, moderate",racial,Black or African American ,0,37,37
435082,Closed fracture nasal bone,racial,Unknown,9,28,37
381842,Petit mal status,racial,Unknown,0,37,37
374923,Bell palsy,racial,Other Race,21,16,37
199767,Neoplasm of uncertain behaviour of liver and/or biliary passages,ethnic,Not Hispanic or Latino,2,35,37
4115173,Atrial premature complex,racial,Unknown,18,18,36
440081,Barbiturate dependence,racial,Unknown,9,28,37
438368,Primary malignant neoplasm of thymus,racial,Asian,0,37,37
79897,Obstetric non-purulent mastitis - delivered with postnatal complication,ethnic,Not Hispanic or Latino,37,0,37
133728,Congenital hypothyroidism,ethnic,Hispanic or Latino,37,0,37
315296,Preinfarction syndrome,ethnic,Not Hispanic or Latino,18,18,36
435081,Abnormal findings on diagnostic imaging of heart and coronary circulation,racial,White,18,18,36
200764,Bile duct calculus without mention of cholecystitis and no obstruction,racial,White,16,18,34
81250,Carcinoma in situ of breast,ethnic,Not Hispanic or Latino,35,0,35
257905,Mucopurulent chronic bronchitis,racial,Unknown,21,14,35
4180784,Cancer of parotid gland,ethnic,Not Hispanic or Latino,35,0,35
441260,Drug withdrawal syndrome,ethnic,Hispanic or Latino,23,12,35
434462,VSD - Ventricular septal defect,racial,Unknown,16,18,34
134144,Cleft palate with cleft lip,racial,Other Race,0,35,35
435088,Senility,racial,White,18,16,34
81144,Sprain of medial collateral ligament of knee,ethnic,Not Hispanic or Latino,21,14,35
443909,"Decreased level, laboratory test",ethnic,Not Hispanic or Latino,21,14,35
196925,Secondary malignant neoplasm of retroperitoneum and peritoneum,racial,Unknown,35,0,35
436235,Taste sense altered,ethnic,Not Hispanic or Latino,30,5,35
379822,Cyst of eyelid,racial,Unknown,28,7,35
201618,Disease of intestine,ethnic,Not Hispanic or Latino,30,5,35
141056,Acute ethmoidal sinusitis,ethnic,Not Hispanic or Latino,25,9,34
377889,Hearing loss,racial,Native Hawaiian or Other Pacific Islander ,9,25,34
4150307,Dental restoration observation,racial,Other Race,21,14,35
440005,Complication of medical care,racial,White,28,7,35
40490423,Incontinence without sensory awareness,racial,Asian,9,25,34
433942,Accident whilst engaged in household activity,ethnic,Not Hispanic or Latino,23,12,35
253797,Post-inflammatory pulmonary fibrosis,racial,Other Race,14,21,35
433735,Alcohol dependence with acute alcoholic intoxication,racial,Unknown,0,35,35
77630,Disease of shoulder,racial,Asian,21,14,35
196925,Secondary malignant neoplasm of retroperitoneum and peritoneum,ethnic,Hispanic or Latino,35,0,35
135303,Cyst of oral soft tissue,ethnic,Hispanic or Latino,23,12,35
435739,Late syphilis,racial,Unknown,7,28,35
443400,Peritoneal cancer,racial,White,18,16,34
195294,Thrombosed hemorrhoids,racial,White,28,7,35
436088,Nondependent opioid abuse in remission,racial,White,21,14,35
4082311,B-CLL - B-cell chronic lymphocytic leukemia,racial,Unknown,0,35,35
376104,Posttraumatic headache,racial,Unknown,32,2,34
436398,Glaucoma associated with ocular disorder,ethnic,Hispanic or Latino,14,21,35
195590,Urethral stricture,racial,Unknown,5,30,35
379806,Migraine variants,racial,Unknown,30,5,35
73649,Contusion of finger,ethnic,Not Hispanic or Latino,25,9,34
77072,Joint effusion of ankle AND/OR foot,ethnic,Not Hispanic or Latino,16,18,34
4092879,Absent kidney,racial,Asian,0,35,35
381301,Chronic serous otitis media,racial,Unknown,12,23,35
377861,Disorder of refraction AND/OR accommodation,racial,American Indian or Alaska Native ,18,16,34
440693,Continuous opioid dependence,racial,American Indian,35,0,35
378839,Spina bifida with hydrocephalus,ethnic,Not Hispanic or Latino,0,35,35
72778,Open wound of toe(s) without mention of complication,racial,Unknown,21,14,35
201418,"Flatulence, eructation and gas pain",racial,Asian,28,7,35
77352,Pyogenic arthritis of the lower leg,racial,White,30,5,35
440693,Continuous opioid dependence,racial,Black or African American ,14,21,35
77646,Disorder of bone and articular cartilage,racial,White,16,18,34
314666,Healed coronary,racial,American Indian or Alaska Native ,18,16,34
195588,Cystitis,racial,Asian,32,2,34
381592,Chronic mucoid otitis media,ethnic,Not Hispanic or Latino,28,7,35
78234,Arthralgia of the hand,racial,Asian,28,7,35
433911,Contusion of eye AND ocular adnexa,racial,White,5,30,35
141932,Senile hyperkeratosis,racial,Asian,5,30,35
4114746,Climacteric arthritis NOS,ethnic,Hispanic or Latino,30,5,35
77365,Disuse osteoporosis,racial,White,23,12,35
40389897,"Neoplasm of uncertain behaviour of trachea, bronchus and lung",ethnic,Hispanic or Latino,14,21,35
193520,Urinary bladder stone,ethnic,Hispanic or Latino,7,28,35
435517,Acidosis,ethnic,Hispanic or Latino,7,28,35
31610,Disorder of oesophagus,racial,White,21,14,35
200450,Disease of urethra,racial,Unknown,25,9,34
436477,Abnormal products of conception,racial,White,35,0,35
138826,Acne varioliformis,racial,White,7,28,35
381952,Injury to brachial plexus as birth trauma,ethnic,Not Hispanic or Latino,0,35,35
378414,Separation of retinal layers,racial,Other Race,21,14,35
79873,Urolith,ethnic,Not Hispanic or Latino,14,21,35
375292,Perforation of tympanic membrane,racial,Asian,28,7,35
317305,Stricture of artery,ethnic,Hispanic or Latino,12,23,35
432923,SAH - Subarachnoid haemorrhage,racial,White,35,0,35
434592,B-cell lymphoma,ethnic,Hispanic or Latino,35,0,35
193020,Incomplete emptying of bladder,ethnic,Hispanic or Latino,18,16,34
312922,Coronary bypass graft observation,racial,Other Race,32,2,34
81611,Diverticular disease of colon,racial,Native Hawaiian or Other Pacific Islander ,0,35,35
4318408,Subdural haematoma,racial,Unknown,2,32,34
314381,Kawasaki syndrome,ethnic,Hispanic or Latino,18,16,34
442310,Acute heart failure,ethnic,Hispanic or Latino,16,18,34
132391,Furuncle of face,ethnic,Hispanic or Latino,12,23,35
141825,Non-toxic goiter,racial,White,35,0,35
432868,Hemoglobinopathy,racial,White,18,16,34
375528,Spastic hemiplegia,racial,White,2,32,34
138994,MDS - Myelodysplastic syndrome,racial,Other Race,35,0,35
440076,SS - Short stature,racial,Unknown,14,21,35
194018,"Functional enuresis, NOS",ethnic,Not Hispanic or Latino,25,9,34
4082311,B-CLL - B-cell chronic lymphocytic leukemia,ethnic,Hispanic or Latino,0,35,35
435626,Tibial collateral ligament bursitis,ethnic,Hispanic or Latino,5,30,35
376106,Disorder of the central nervous system,ethnic,Hispanic or Latino,28,7,35
377877,Convergent squint,ethnic,Not Hispanic or Latino,14,21,35
193322,Right lower quadrant pain,racial,Other Race,23,12,35
72748,Strain of rotator cuff of shoulder,racial,Black or African American ,0,35,35
432910,Disorder of lacrimal system,racial,White,35,0,35
29735,Candidiasis of mouth,racial,Other Race,21,14,35
436166,Mild hyperemesis gravidarum,racial,White,35,0,35
317510,Leukaemia,racial,White,12,23,35
4012570,High risk sexual behavior,racial,Black or African American ,30,5,35
441788,Human papilloma virus infection,racial,Unknown,35,0,35
256571,FB - Nasal foreign body,ethnic,Hispanic or Latino,16,18,34
435411,Injury at C5-C7 level with spinal cord injury AND without bone injury,racial,White,0,35,35
372423,Reduction deformities of brain,ethnic,Not Hispanic or Latino,32,2,34
197494,Viral hepatitis C,racial,Black or African American ,7,28,35
139899,Pemphigoid,racial,White,2,32,34
77670,Chest pain,racial,Filipino,9,25,34
372435,Periventricular leukomalacia,racial,Other Race,35,0,35
436919,Primary malignant neoplasm of unspecified site,racial,Unknown,28,7,35
372646,"Peripheral pterygium, stationary",ethnic,Hispanic or Latino,32,2,34
200164,Urine-induced contact dermatitis,racial,Black or African American ,21,14,35
78093,Primary malignant neoplasm of pleura,ethnic,Hispanic or Latino,0,35,35
432306,Gender identity disorder of adolescence,racial,White,14,21,35
77592,Articular crepitus of temporomandibular joint,racial,White,14,21,35
256909,Primary pulmonary coccidioidomycosis,racial,Black or African American ,0,35,35
374905,Non-organic sleep disorder,ethnic,Not Hispanic or Latino,18,16,34
373478,Presbyopia,racial,Other Race,30,5,35
4014230,Ankle sprain NOS,racial,Unknown,12,23,35
72712,Synovial cyst,ethnic,Hispanic or Latino,30,5,35
193262,Inflammatory disorder of penis,racial,White,0,35,35
76545,Closed traumatic dislocation of patella,racial,White,21,14,35
432876,Bipolar I disorder,racial,Other Race,30,5,35
442256,Disorder of bursae of shoulder region,racial,Asian,18,16,34
372629,Nonexudative age-related macular degeneration,ethnic,Not Hispanic or Latino,2,32,34
441818,Haemangioma,racial,Unknown,35,0,35
193519,Impaired renal function disorder,ethnic,Not Hispanic or Latino,18,16,34
377559,Vernal conjunctivitis,racial,White,18,16,34
373189,Encephalomyelitis,ethnic,Hispanic or Latino,18,16,34
317376,Tachypnoeic,racial,White,7,28,35
141651,Stevens-Johnson syndrome,ethnic,Hispanic or Latino,0,35,35
321042,Cardiac arrest,ethnic,Not Hispanic or Latino,30,5,35
28974,Candidiasis of oesophagus,racial,White,18,16,34
436314,Accidental puncture AND/OR laceration during a procedure,ethnic,Hispanic or Latino,18,16,34
77340,Genitourinary tract infection in pregnancy,racial,Unknown,35,0,35
437064,Chondrocalcinosis,ethnic,Hispanic or Latino,23,12,35
139888,Threatened premature labor - not delivered,ethnic,Not Hispanic or Latino,35,0,35
438028,Poisoning by drug AND/OR medicinal substance,racial,Unknown,14,21,35
40480943,Lateral cystocele,ethnic,Hispanic or Latino,30,5,35
441259,Non-thrombocytopenic purpura,racial,Unknown,16,18,34
24977,Mucocele of salivary gland,racial,White,23,12,35
443897,Disruption of perineal wound in the puerperium,racial,White,35,0,35
374649,Strabismic amblyopia,ethnic,Hispanic or Latino,25,9,34
200848,Dribbling of urine,racial,White,5,30,35
40490423,Incontinence without sensory awareness,ethnic,Not Hispanic or Latino,9,25,34
138845,Rheumatism,ethnic,Hispanic or Latino,35,0,35
434164,Glycosuria,ethnic,Not Hispanic or Latino,23,12,35
373852,Neuralgia,racial,Asian,14,21,35
136185,Abnormal granulation tissue,ethnic,Not Hispanic or Latino,14,21,35
78505,"Localised, primary osteoarthritis of the ankle and/or foot",racial,White,25,9,34
439013,Insomnia disorder related to another mental disorder,racial,Unknown,21,14,35
80189,Displacement of lumbar intervertebral disc without myelopathy,racial,American Indian or Alaska Native ,35,0,35
4180784,Cancer of parotid gland,racial,Asian,35,0,35
141371,PR - Pityriasis rosea,racial,Unknown,25,9,34
439975,Injury at C1-C4 level with spinal cord injury AND without bone injury,racial,White,21,14,35
134461,Tietze disease,racial,Asian,25,9,34
74698,Breech presentation,racial,White,25,9,34
78093,Primary malignant neoplasm of pleura,racial,White,0,35,35
79864,Hematuria syndrome,ethnic,Not Hispanic or Latino,7,28,35
4071485,Foetus or neonate affected by caesarean section,ethnic,Hispanic or Latino,35,0,35
141816,Acute lymphoid leukaemia in remission,ethnic,Hispanic or Latino,9,25,34
78619,"Contusion, knee",racial,Black or African American ,25,9,34
4088930,Confirmation of pregnancy,racial,Other Race,35,0,35
441391,"Acquired forearm deformity, excluding fingers",racial,White,12,23,35
433456,Acute pain,racial,Black or African American ,28,7,35
432968,Anemia during pregnancy - baby delivered,ethnic,Hispanic or Latino,35,0,35
195401,Superficial bruising of hip,racial,White,21,14,35
378544,Subdural and cerebral hemorrhage due to birth trauma,racial,White,35,0,35
141693,Elevated blood-pressure reading without diagnosis of hypertension,racial,Native Hawaiian or Other Pacific Islander ,16,18,34
4299574,Factitious skin disease,ethnic,Not Hispanic or Latino,28,7,35
72737,Microcalcifications of the breast,racial,Unknown,35,0,35
434281,Aspergillosis,racial,Unknown,35,0,35
4014296,Twins - both live born,racial,White,28,7,35
4176890,Male sterility,racial,White,0,35,35
376131,Tympanic membrane conductive hearing loss,ethnic,Hispanic or Latino,5,30,35
4100529,Misuse of drugs NOS,ethnic,Not Hispanic or Latino,2,32,34
200780,Disease of uterus,ethnic,Hispanic or Latino,35,0,35
315922,Patent ductus arteriosus,ethnic,Not Hispanic or Latino,32,2,34
199856,Varicose veins of lower extremity with inflammation,racial,Other Race,35,0,35
196152,Peritonitis,racial,White,7,28,35
197605,Inflammatory disorder of male genital organ,ethnic,Hispanic or Latino,0,35,35
193326,Urge incontinence of urine,racial,Other Race,18,16,34
439382,Disorder of hypothalamus,ethnic,Hispanic or Latino,35,0,35
78517,Arthralgia of multiple joints,racial,Asian,18,16,34
436954,Drug abuse,racial,Asian,0,35,35
444285,Acquired equinovarus deformity,ethnic,Hispanic or Latino,21,14,35
321080,"Hypertension complicating pregnancy, childbirth and the puerperium",ethnic,Not Hispanic or Latino,30,5,35
373474,Seeing double,racial,Unknown,14,21,35
440005,Complication of medical care,ethnic,Hispanic or Latino,28,7,35
195590,Urethral stricture,ethnic,Not Hispanic or Latino,25,9,34
435940,"Closed fracture of humerus, shaft",racial,Unknown,32,2,34
437947,Complication of obstetrical surgical wound,ethnic,Hispanic or Latino,35,0,35
254387,Upper respiratory tract hypersensitivity reaction,racial,Black or African American ,21,14,35
4087756,Late latent syphilis,ethnic,Not Hispanic or Latino,12,23,35
73075,Contusion of upper limb,racial,White,28,7,35
314963,Giant cell arteritis,racial,White,9,25,34
435950,Closed Colles' fracture,ethnic,Not Hispanic or Latino,23,12,35
440088,Academic underachievement disorder,ethnic,Not Hispanic or Latino,12,23,35
136580,Dehiscence of surgical wound,racial,White,18,16,34
253815,Ulceration of vulva,racial,Unknown,35,0,35
196454,Colostomy and enterostomy malfunction,ethnic,Hispanic or Latino,21,14,35
436246,Low libido,ethnic,Not Hispanic or Latino,14,21,35
432301,Opioid dependence in remission,ethnic,Not Hispanic or Latino,23,12,35
192353,Disorder of gallbladder,ethnic,Not Hispanic or Latino,7,28,35
436238,Elevated levels of transaminase and lactic acid dehydrogenase,racial,Filipino,30,5,35
192684,"Renal hypertension complicating pregnancy, childbirth and the puerperium - not delivered",racial,White,5,30,35
78619,"Contusion, knee",racial,Other Race,12,23,35
436235,Taste sense altered,racial,Unknown,35,0,35
442615,Carotid artery stenosis,racial,American Indian or Alaska Native ,12,23,35
4115173,Atrial premature complex,racial,White,18,16,34
140266,Superficial bruising of back,ethnic,Not Hispanic or Latino,25,9,34
4050572,Implantation of automatic cardiac defibrillator,racial,Other Race,35,0,35
376965,Hypertensive retinopathy,racial,White,16,18,34
435226,"Bipolar affective disorder, current episode mixed",racial,White,23,12,35
4295261,Postmenopausal state,racial,Asian,35,0,35
73241,Anal and rectal polyp,ethnic,Not Hispanic or Latino,25,9,34
4086928,IUCD status,racial,Other Race,35,0,35
80512,Acquired kyphosis,racial,White,35,0,35
380102,Corneal edema,ethnic,Hispanic or Latino,16,18,34
73241,Anal and rectal polyp,racial,Unknown,21,14,35
436962,Sleeplessness,racial,American Indian,25,9,34
135772,Goiter,racial,Black or African American ,23,12,35
435543,Primary angle-closure glaucoma,ethnic,Hispanic or Latino,30,5,35
74723,Arthropathy associated with a neurological disorder,ethnic,Not Hispanic or Latino,12,23,35
436254,Closed fractures of multiple bones of lower limb,ethnic,Hispanic or Latino,28,7,35
433540,Polyhydramnios with antenatal problem,ethnic,Hispanic or Latino,35,0,35
197023,Bilateral inguinal hernia,ethnic,Not Hispanic or Latino,0,35,35
379020,Entropion,ethnic,Hispanic or Latino,16,18,34
132583,Postablative hypothyroidism,racial,White,35,0,35
441192,Accidentally struck by or against objects or persons,racial,Unknown,9,25,34
314131,Degeneration of cervical intervertebral disc,racial,Asian,0,35,35
443563,Arteriosclerosis in coronary artery bypass graft,racial,Black or African American ,35,0,35
376691,Delimited old retinal detachment,ethnic,Hispanic or Latino,9,25,34
4303805,Allergic reaction to bite and/or sting,ethnic,Hispanic or Latino,21,14,35
79061,Colonic constipation,racial,White,18,16,34
376105,Krampfe salaam attacks,racial,Other Race,35,0,35
201899,Unilateral recurrent inguinal hernia,racial,Other Race,0,35,35
139750,Primary malignant neoplasm of skin,racial,White,18,16,34
375538,"Degeneration of macula due to cyst, hole or pseudohole",racial,White,14,21,35
135157,Observation of cardiovascular device,ethnic,Hispanic or Latino,32,2,34
438112,Neoplastic disease,ethnic,Hispanic or Latino,23,12,35
75512,Carcinoma in situ of colon,racial,White,30,5,35
442023,Poisoning of undetermined intent,ethnic,Hispanic or Latino,23,12,35
314665,Atrial flutter,racial,American Indian or Alaska Native ,35,0,35
40481374,Allergic rhinitis due to food,ethnic,Hispanic or Latino,5,30,35
194395,Bleeding diverticulosis,ethnic,Hispanic or Latino,16,18,34
440035,European cryptococcosis,racial,White,35,0,35
380510,Congenital abnormality of eyelid,racial,White,21,14,35
375479,Kaposi's sarcoma of soft tissues,ethnic,Hispanic or Latino,0,35,35
74125,Inflammatory polyarthropathy,racial,White,28,7,35
4179214,Family history of malignant neoplasm of gastrointestinal tract,racial,Unknown,21,14,35
194092,Uterine prolapse without vaginal wall prolapse,ethnic,Not Hispanic or Latino,35,0,35
141411,Scalp injury,racial,White,16,18,34
436812,Tongue tie,ethnic,Not Hispanic or Latino,5,30,35
381575,Disorder of external ear,racial,Unknown,32,2,34
197717,Open wound of anterior abdominal wall without complication,racial,Unknown,14,21,35
381952,Injury to brachial plexus as birth trauma,racial,Unknown,0,35,35
4114746,Climacteric arthritis NOS,racial,Unknown,30,5,35
193522,Acute prostatitis,ethnic,Not Hispanic or Latino,0,32,32
136025,Gp B streptococcal septicemia,ethnic,Hispanic or Latino,28,5,33
442604,Hypertensive heart disease,racial,Other Race,23,9,32
432308,Mononeuritis of lower limb,racial,Unknown,25,7,32
194802,Foreign body in vulva and vagina,ethnic,Hispanic or Latino,32,0,32
372629,Nonexudative age-related macular degeneration,racial,Asian,0,32,32
441189,Pertussis vaccine adverse reaction,ethnic,Hispanic or Latino,28,5,33
200783,Previous cesarean section,ethnic,Not Hispanic or Latino,32,0,32
443012,Diabetes mellitus during pregnancy - baby delivered,racial,Unknown,32,0,32
373204,Conjunctival xerosis,ethnic,Hispanic or Latino,7,25,32
435839,Lymphatic oedema,ethnic,Not Hispanic or Latino,18,14,32
374948,Acute nonsuppurative otitis media,ethnic,Not Hispanic or Latino,12,21,33
79091,Unstable lie,racial,White,32,0,32
141693,Elevated blood-pressure reading without diagnosis of hypertension,racial,Filipino,12,21,33
193242,Perforation of intestine,ethnic,Hispanic or Latino,18,14,32
440538,Closed fracture of lower end of radius AND ulna,ethnic,Hispanic or Latino,7,25,32
4091768,Burkitt lymphoma of intrathoracic lymph nodes,ethnic,Hispanic or Latino,32,0,32
77965,Nodular tendinous disease of finger,racial,Black or African American ,14,18,32
443211,Benign prostatic hypertrophy with outflow obstruction,racial,White,0,32,32
4107528,Lermoyez syndrome,ethnic,Hispanic or Latino,32,0,32
437400,Closed fracture of shaft of ulna,ethnic,Hispanic or Latino,7,25,32
4164222,Tendon contracture,racial,White,23,9,32
198191,Acquired hypertrophic pyloric stenosis,ethnic,Hispanic or Latino,25,7,32
4138253,Malabsorption syndrome,racial,White,23,9,32
196160,Fistula of intestine,racial,White,32,0,32
442792,Pes anserinus bursitis,racial,Unknown,5,28,33
432851,Secondary malignant neoplastic disease,ethnic,Hispanic or Latino,32,0,32
75210,Carcinoma in situ of rectum,racial,Asian,0,32,32
379032,Acute mastoiditis with complications,racial,White,0,32,32
72990,Localised osteoarthrosis uncertain if primary OR secondary,racial,Unknown,30,2,32
439248,"Mixed bipolar affective disorder, moderate",ethnic,Hispanic or Latino,25,7,32
436209,Fracture of fibula,ethnic,Not Hispanic or Latino,21,12,33
437046,Complete abortion,ethnic,Not Hispanic or Latino,32,0,32
435141,Haemorrhage AND/OR haematoma complicating procedure,ethnic,Hispanic or Latino,16,16,32
436682,Moderate mental handicap,ethnic,Not Hispanic or Latino,9,23,32
196019,"Tuberculosis of intestines, peritoneum and mesenteric glands",ethnic,Hispanic or Latino,32,0,32
377282,Conjunctivitis with mucocutaneous disorder,racial,Unknown,25,7,32
377294,Exotropia,racial,Unknown,2,30,32
24609,Hypoglycaemia,racial,Asian,21,12,33
28127,"Multiple endocrine neoplasia, type 1",racial,Unknown,32,0,32
441793,Infection due to Class Cestoda and/or Class Trematoda and/or Phylum Nemata,racial,White,7,25,32
4158567,Post percutaneous transluminal coronary angioplasty,racial,Other Race,18,14,32
438979,Primary malignant neoplasm of hepatic flexure of colon,ethnic,Hispanic or Latino,32,0,32
192242,Acute hepatitis C,racial,Black or African American ,0,32,32
435723,Wound seroma,racial,White,25,7,32
73075,Contusion of upper limb,racial,Unknown,21,12,33
438168,Aneurysm of heart,racial,White,30,2,32
4058247,Anaemia during pregnancy/childbirth/puerperium NOS,racial,White,32,0,32
443228,"Abrasion or friction burn of foot and toe, without mention of infection",racial,Unknown,21,12,33
436001,Emotional abuse of adult,ethnic,Hispanic or Latino,32,0,32
376094,Arteriosclerotic dementia with delirium,ethnic,Hispanic or Latino,18,14,32
4116861,Neuromyopathy,ethnic,Hispanic or Latino,16,16,32
76548,Closed dislocation of hip,racial,White,14,18,32
4066820,Ingestion dermatitis due to food,ethnic,Not Hispanic or Latino,18,14,32
200962,Primary malignant neoplasm of prostate,racial,Black or African American ,0,32,32
443897,Disruption of perineal wound in the puerperium,ethnic,Hispanic or Latino,32,0,32
443883,Acute disease,racial,White,14,18,32
4104853,Epileptic seizures - clonic,ethnic,Not Hispanic or Latino,32,0,32
252663,Pneumonitis due to inhalation of food or vomitus,racial,White,9,23,32
4103642,Amputated toe,racial,Other Race,32,0,32
440846,"Blood coagulation disorder, categorized by value of screening test",ethnic,Not Hispanic or Latino,5,28,33
136516,Congenital pes planus,ethnic,Not Hispanic or Latino,21,12,33
376969,Orofacial dyskinesia,ethnic,Hispanic or Latino,25,7,32
375252,Disorder of eye,racial,Asian,23,9,32
197230,Malignant neoplasm of uterus,ethnic,Not Hispanic or Latino,32,0,32
443178,"Insect bite, nonvenomous, of face",ethnic,Hispanic or Latino,12,21,33
26459,Acute oesophagitis,ethnic,Hispanic or Latino,14,18,32
441827,Disorder of amino acid and organic acid metabolism,ethnic,Not Hispanic or Latino,0,32,32
443767,Diabetic oculopathy,racial,American Indian or Alaska Native ,32,0,32
196738,Male genital organ disease,racial,Other Race,0,32,32
74130,Thoracic spondylosis without myelopathy,racial,Unknown,18,14,32
437969,Acquired pes planus,racial,Black or African American ,7,25,32
80951,Candidiasis of urogenital site,racial,Other Race,14,18,32
440940,Methicillin resistant Staphylococcus aureus infection,ethnic,Not Hispanic or Latino,21,12,33
137345,Pressure ulcer stage 4,ethnic,Hispanic or Latino,14,18,32
433577,Hammer toe,ethnic,Not Hispanic or Latino,23,9,32
200444,Post-cholecystectomy syndrome,ethnic,Hispanic or Latino,18,14,32
442862,"Abrasion or friction burn of hand, without mention of infection",racial,White,18,14,32
437530,Disorders of lipoid metabolism,racial,Unknown,30,2,32
320752,Influenza with non-respiratory manifestation,ethnic,Not Hispanic or Latino,14,18,32
438134,Excessive sleep,racial,Other Race,7,25,32
4278672,Fracture of forearm,ethnic,Hispanic or Latino,16,16,32
198201,Chronic salpingo-oophoritis,ethnic,Hispanic or Latino,32,0,32
4069184,Infundibular pulmonic stenosis,racial,White,14,18,32
77650,Aseptic necrosis of bone,racial,White,32,0,32
321661,Spinal stenosis of thoracic region,racial,Unknown,32,0,32
196438,Acquired arteriovenous fistula of liver,ethnic,Hispanic or Latino,12,21,33
137856,Atypical facial pain,ethnic,Hispanic or Latino,14,18,32
4112831,Extrinsic asthma NOS,racial,Unknown,23,9,32
436681,Insomnia disorder related to known organic factor,racial,White,18,14,32
381572,Abducens nerve palsy,ethnic,Hispanic or Latino,7,25,32
79911,Effusion of joint of upper arm,ethnic,Hispanic or Latino,16,16,32
314965,Embolism and thrombosis of an arm or leg artery,ethnic,Hispanic or Latino,32,0,32
4056329,Vaginitis and vulvovaginitis NOS,ethnic,Not Hispanic or Latino,30,2,32
381316,CVA - Cerebrovascular accident,racial,Black or African American ,30,2,32
4175226,Screening for malignant neoplasm of colon,racial,Asian Indian,23,9,32
78605,Superficial bruising of elbow,racial,Unknown,23,9,32
4329847,MI - Myocardial infarction,racial,White,5,28,33
198260,Perinatal adrenal haemorrhage,racial,White,0,32,32
4171075,Bite of animal,ethnic,Hispanic or Latino,16,16,32
201344,Vesico-intestinal fistula,ethnic,Hispanic or Latino,25,7,32
141932,Senile hyperkeratosis,racial,Other Race,25,7,32
140842,Changes in skin texture,racial,Asian,7,25,32
440927,High risk drug monitoring status,racial,Unknown,30,2,32
434902,Autistic disorder of childhood onset,racial,Filipino,0,32,32
375801,Demyelinating disease of central nervous system,ethnic,Hispanic or Latino,32,0,32
141232,MM - Malignant melanoma of skin,racial,Unknown,28,5,33
436920,Reticulosarcoma,ethnic,Hispanic or Latino,32,0,32
195926,Slowing of urinary stream,ethnic,Hispanic or Latino,7,25,32
440386,Transsexualism,racial,Black or African American ,0,32,32
192364,Nephrotic syndrome associated with another disorder,racial,Unknown,23,9,32
4179925,Basic learning problem,ethnic,Not Hispanic or Latino,5,28,33
4079876,Familial combined hyperlipidemia,racial,Asian Indian,18,14,32
378140,Inflammatory and toxic neuropathy,racial,White,32,0,32
314379,First degree atrioventricular block,racial,Unknown,0,32,32
198260,Perinatal adrenal haemorrhage,ethnic,Not Hispanic or Latino,0,32,32
4175807,Rheumatic disease of tricuspid valve,racial,White,14,18,32
135033,Hair and hair follicle diseases,racial,Asian,16,16,32
373488,Pupil-sparing third nerve palsy,racial,White,16,16,32
76153,Low compliance bladder,racial,Black or African American ,18,14,32
437899,Acute and subacute bacterial endocarditis,ethnic,Hispanic or Latino,23,9,32
376400,Combined form of senile cataract,racial,Other Race,12,21,33
4052837,Open wound of breast,ethnic,Not Hispanic or Latino,32,0,32
79740,Overlapping malignant neoplasm of colon,ethnic,Hispanic or Latino,32,0,32
4292726,Contact - infectious disease,racial,Other Race,16,16,32
435411,Injury at C5-C7 level with spinal cord injury AND without bone injury,ethnic,Not Hispanic or Latino,0,32,32
440372,Acquired thrombocytopenia,ethnic,Hispanic or Latino,0,32,32
80141,Functional diarrhea,ethnic,Not Hispanic or Latino,28,5,33
81878,Benign paroxysmal positional vertigo,racial,Other Race,25,7,32
434926,Iridocyclitis,ethnic,Hispanic or Latino,18,14,32
438406,"Major depressive disorder, single episode, severe with psychotic features",racial,White,21,12,33
375291,Bullous myringitis,ethnic,Hispanic or Latino,16,16,32
441481,Adult victim of abuse,racial,White,18,14,32
194152,Renal agenesis and dysgenesis,racial,Unknown,32,0,32
4038835,HD - Hodgkin's disease,ethnic,Not Hispanic or Latino,32,0,32
4103416,Drug dependence NOS,racial,Unknown,16,16,32
439702,Residual infantile autism,ethnic,Hispanic or Latino,0,32,32
315273,MS - Mitral stenosis,racial,White,30,2,32
439166,Closed fracture of radius,racial,Unknown,23,9,32
433600,"Problem, abnormal test",ethnic,Hispanic or Latino,32,0,32
320425,Heart block,ethnic,Hispanic or Latino,2,30,32
4194232,Absence seizure,ethnic,Not Hispanic or Latino,32,0,32
316428,Hypertrophic obstructive cardiomyopathy,racial,Unknown,16,16,32
4064375,Iron deficiency screening,racial,American Indian or Alaska Native ,23,9,32
132736,Bacteremia,racial,White,5,28,33
74052,Labyrinthitis,racial,White,21,12,33
133284,Impetigo herpetiformis,ethnic,Hispanic or Latino,14,18,32
436667,Stammer,ethnic,Hispanic or Latino,5,28,33
440547,Closed fracture of shaft of metacarpal bone,ethnic,Hispanic or Latino,21,12,33
79173,Closed dislocation of jaw,ethnic,Hispanic or Latino,30,2,32
195834,Atherosclerosis of renal artery,racial,White,16,16,32
436110,Glaucoma associated with ocular inflammation,racial,White,0,32,32
434029,Chronic iridocyclitis,ethnic,Hispanic or Latino,5,28,33
441259,Non-thrombocytopenic purpura,racial,White,23,9,32
439005,Chronic alcoholism in remission,ethnic,Not Hispanic or Latino,16,16,32
138455,Stomatitis,racial,White,21,12,33
78560,Congenital deformity and malformation of feet and toes,racial,White,9,23,32
442623,Abrasion AND/OR friction burn of scalp without infection,ethnic,Not Hispanic or Latino,16,16,32
436155,Redundant prepuce and phimosis,racial,Black or African American ,0,32,32
201956,Congenital anomaly of lower limb,racial,Unknown,23,9,32
432571,Malignant lymphoma,racial,Other Race,5,28,33
23325,Heartburn,racial,Black or African American ,12,21,33
77076,Diastasis of muscle,ethnic,Hispanic or Latino,2,30,32
444108,Finding related to sleep,ethnic,Hispanic or Latino,32,0,32
443933,Nicotiana tabacum poisoning,racial,Native Hawaiian or Other Pacific Islander ,32,0,32
199062,"Acute gastric ulcer without hemorrhage, without perforation AND without obstruction",racial,White,0,32,32
198216,Retroverted incarcerated gravid uterus - delivered,racial,White,32,0,32
133280,Alopecia,racial,Asian,2,30,32
380734,External ear conductive hearing loss,racial,Unknown,32,0,32
443360,Eye mass,racial,White,18,14,32
256716,Asthma with status asthmaticus,racial,Unknown,14,18,32
439928,Gangrenous disorder,racial,Unknown,5,28,33
443556,Primary focal hyperhidrosis,racial,White,21,12,33
200836,Congenital anomaly of gastrointestinal tract,racial,Unknown,23,9,32
376981,Amblyopia,racial,Unknown,18,14,32
75389,Current tear of lateral cartilage AND/OR meniscus of knee,ethnic,Not Hispanic or Latino,30,2,32
373101,Injury of ulnar nerve,racial,White,7,25,32
434628,Separation anxiety,racial,White,12,21,33
138278,Sprains and strains of joints and adjacent muscles,racial,Other Race,21,12,33
140949,Scabies,racial,Asian,16,16,32
314658,Cardiomegaly,racial,Other Race,30,2,32
381028,Acute suppurative otitis media - tympanic membrane ruptured,ethnic,Not Hispanic or Latino,14,18,32
80951,Candidiasis of urogenital site,racial,Black or African American ,25,7,32
4052931,Abandoned child,racial,White,21,12,33
138379,"Chronic lymphoid leukemia, disease",ethnic,Hispanic or Latino,25,7,32
197601,Spermatocele,racial,White,0,32,32
201111,Congenital renal dysplasia,racial,White,23,9,32
137829,Erythroid aplasia,racial,White,2,30,32
197237,Benign tumour of prostate,racial,White,0,32,32
4001998,Pulmonary apoplexy,ethnic,Hispanic or Latino,32,0,32
443378,Anabolic steroids adverse reaction,ethnic,Hispanic or Latino,0,32,32
313224,Anomalous atrioventricular excitation,ethnic,Hispanic or Latino,0,32,32
141253,Disease of thyroid gland,racial,Asian,18,14,32
132685,Severe pre-eclampsia - not delivered,racial,White,32,0,32
200687,Renal disorder associated with type I diabetes mellitus,racial,Asian,0,32,32
441827,Disorder of amino acid and organic acid metabolism,racial,Asian,0,32,32
433163,Deficiency of macronutrients,ethnic,Not Hispanic or Latino,28,5,33
442565,Gestational edema without hypertension,ethnic,Not Hispanic or Latino,32,0,32
75689,Contusion of breast,racial,White,32,0,32
318448,"Incomplete atrioventricular block, second degree",ethnic,Hispanic or Latino,7,25,32
75010,Fibroadenosis of breast,ethnic,Not Hispanic or Latino,32,0,32
444287,Carbuncle of neck,ethnic,Hispanic or Latino,5,28,33
4202322,Amputated big toe,racial,Unknown,2,30,32
197028,Calculus of lower urinary tract,ethnic,Hispanic or Latino,5,28,33
438701,UKP - Disseminated malignancy of unknown primary,ethnic,Hispanic or Latino,7,25,32
199913,Acquired deformity of ankle AND/OR foot,racial,Unknown,12,21,33
201688,Urinary hesitancy,racial,Unknown,9,23,32
200769,"Chronic gastric ulcer without hemorrhage, without perforation AND without obstruction",ethnic,Hispanic or Latino,32,0,32
76506,Effusion of joint of lower leg,ethnic,Not Hispanic or Latino,18,14,32
140803,Idiopathic angio-oedema-urticaria,racial,White,25,7,32
194083,Vaginitis and vulvovaginitis,racial,American Indian or Alaska Native ,32,0,32
140966,Benign neoplasm of skin of face,racial,Unknown,21,12,33
312723,Congenital heart disease,racial,Other Race,21,12,33
438390,Benign tumour of vulva,racial,White,32,0,32
432590,Delusional disorder,racial,Asian,12,21,33
141651,Stevens-Johnson syndrome,racial,White,0,32,32
441189,Pertussis vaccine adverse reaction,racial,White,25,7,32
138682,Herpes zoster auricularis,ethnic,Hispanic or Latino,30,2,32
76240,Closed fracture of pubis,ethnic,Hispanic or Latino,21,12,33
196359,Primary malignant neoplasm of uterine cervix,racial,Unknown,32,0,32
318445,Post cardiac operation functional disturbance,ethnic,Not Hispanic or Latino,32,0,32
377091,Fits - convulsions,racial,Filipino,32,0,32
438750,Old total retinal detachment,racial,White,16,16,32
374655,Mastoiditis,racial,White,23,9,32
437966,Calcium deposits in tendon,ethnic,Not Hispanic or Latino,30,2,32
440647,Sexually transmitted infectious disease,racial,Unknown,21,12,33
139902,Allergic urticaria,racial,Asian,18,14,32
433659,Delayed healing of surgical wound,ethnic,Hispanic or Latino,18,14,32
4146239,Pruritus of genital organs,ethnic,Not Hispanic or Latino,30,2,32
434374,Anisocoria,racial,Unknown,14,18,32
75623,Old disruption of anterior cruciate ligament,racial,Unknown,16,16,32
374341,Huntington's chorea,ethnic,Not Hispanic or Latino,2,30,32
4052837,Open wound of breast,racial,Other Race,32,0,32
132706,Nail disease,racial,Black or African American ,25,7,32
438390,Benign tumour of vulva,ethnic,Hispanic or Latino,32,0,32
379822,Cyst of eyelid,racial,White,23,9,32
438905,Sequelae of injury of spinal cord,racial,White,0,32,32
79061,Colonic constipation,racial,Unknown,30,2,32
438209,Pregnancy care of habitual aborter,ethnic,Hispanic or Latino,32,0,32
75382,Closed fractures of tarsal AND metatarsal bones,racial,White,21,12,33
4158567,Post percutaneous transluminal coronary angioplasty,racial,American Indian or Alaska Native ,2,30,32
434029,Chronic iridocyclitis,racial,White,5,28,33
133284,Impetigo herpetiformis,racial,White,16,16,32
198802,Occlusion of ureter,racial,White,23,9,32
138824,Contact dermatitis due to metal,ethnic,Hispanic or Latino,25,7,32
434904,Persistent hypersomnia,ethnic,Hispanic or Latino,7,25,32
375552,Pterygium,racial,Asian,14,18,32
441829,Hyperosmolality and or hypernatremia,racial,Unknown,25,7,32
4008573,Advanced open-angle glaucoma,racial,White,18,14,32
374645,Phantom limb syndrome,ethnic,Hispanic or Latino,16,16,32
134517,Open wound of mouth without complication,racial,White,18,14,32
4066376,Pilonidal sinus with abscess,ethnic,Not Hispanic or Latino,0,32,32
4062636,Bacterial disease screening,racial,Other Race,32,0,32
433811,Hydronephrosis,racial,Other Race,14,18,32
438882,Closed fracture of neck of metacarpal bone,ethnic,Hispanic or Latino,7,25,32
319845,Pulmonary valve disease,racial,White,16,16,32
140803,Idiopathic angio-oedema-urticaria,racial,Unknown,12,21,33
72708,Traumatic arthropathy of the shoulder region,ethnic,Hispanic or Latino,30,2,32
135157,Observation of cardiovascular device,racial,White,32,0,32
436110,Glaucoma associated with ocular inflammation,ethnic,Hispanic or Latino,0,32,32
441655,Disorder of sweat gland,racial,White,16,16,32
196157,Induratio penis plastica,racial,Unknown,0,32,32
372629,Nonexudative age-related macular degeneration,racial,White,28,5,33
436421,"Mixed conductive and sensorineural hearing loss, bilateral",ethnic,Hispanic or Latino,12,21,33
375428,Second cranial nerve injury,ethnic,Hispanic or Latino,0,32,32
433071,Contusion of multiple sites,ethnic,Not Hispanic or Latino,32,0,32
435521,Psychophysiologic disorder,racial,White,16,16,32
435904,Derangement of anterior horn of medial meniscus,racial,White,12,21,33
436546,Strain of subscapularis muscle,ethnic,Hispanic or Latino,25,7,32
196438,Acquired arteriovenous fistula of liver,racial,White,12,21,33
198400,Haemangioma of skin and subcutaneous tissue,ethnic,Not Hispanic or Latino,18,14,32
141104,Intervertebral disc disorder of lumbar region with myelopathy,racial,Asian,14,18,32
40479575,Dysphasia as late effect of cerebrovascular disease,racial,White,28,5,33
314368,Mitral stenosis with insufficiency,ethnic,Hispanic or Latino,32,0,32
373101,Injury of ulnar nerve,ethnic,Hispanic or Latino,12,21,33
375529,Infantile cerebral palsy,racial,Asian,25,7,32
133569,Fasciitis,ethnic,Not Hispanic or Latino,14,18,32
4176874,Infantile melanodontia,ethnic,Not Hispanic or Latino,2,30,32
441868,Optic disc oedema,racial,White,32,0,32
437655,Cryptorchism,racial,Black or African American ,0,32,32
440905,Toxic effect of venom,racial,Unknown,21,12,33
438959,Amoebiasis,ethnic,Hispanic or Latino,21,12,33
381864,Subjective tinnitus,racial,White,23,9,32
440855,Closed fracture of base of metacarpal bone other than first metacarpal,racial,White,23,9,32
434465,Nonallopathic lesion of rib cage,ethnic,Hispanic or Latino,21,12,33
443545,Nonvenomous insect bite,racial,Asian,14,18,32
443115,Closed fracture finger proximal phalanx,ethnic,Not Hispanic or Latino,9,23,32
440814,Torticollis,ethnic,Not Hispanic or Latino,23,9,32
437663,Fever,racial,American Indian or Alaska Native ,16,16,32
135333,Pressure sore,ethnic,Not Hispanic or Latino,18,14,32
75210,Carcinoma in situ of rectum,ethnic,Hispanic or Latino,0,32,32
436278,Superficial bruising of thigh,racial,Unknown,23,9,32
197028,Calculus of lower urinary tract,racial,Unknown,5,28,33
72986,Disease of lower leg,racial,White,28,5,33
81112,Arthralgia of the lower leg,racial,American Indian,16,16,32
380102,Corneal edema,racial,Unknown,14,18,32
444031,Chronic heart failure,ethnic,Hispanic or Latino,7,25,32
4272867,General well-being finding,racial,Black or African American ,12,21,33
197609,"Cervical, vaginal and vulval inflammatory diseases",ethnic,Hispanic or Latino,32,0,32
141323,Acute maxillary sinusitis,racial,Black or African American ,18,14,32
376224,Spina bifida without hydrocephalus,ethnic,Not Hispanic or Latino,0,32,32
312622,BVO - Branch retinal occlusion,racial,White,25,7,32
434887,Disorders of bilirubin excretion,racial,Unknown,0,32,32
76191,Disease of upper arm,ethnic,Not Hispanic or Latino,16,16,32
439025,Dacryocystitis,ethnic,Hispanic or Latino,18,14,32
377873,Lid lag,ethnic,Hispanic or Latino,16,16,32
196019,"Tuberculosis of intestines, peritoneum and mesenteric glands",racial,Unknown,32,0,32
201347,Pelvic pain syndrome,racial,White,32,0,32
74606,Benign bone tumor,racial,White,18,14,32
432441,Finding of length of gestation,racial,Black or African American ,9,23,32
4038835,HD - Hodgkin's disease,racial,Other Race,32,0,32
201606,Crohn's disease,racial,Unknown,12,21,33
434633,Disorder of autonomic nervous system,racial,White,18,14,32
439961,Superficial injury without infection,racial,White,23,9,32
141663,Osteomyelitis,ethnic,Not Hispanic or Latino,18,14,32
4334644,Decubitus ulcer of lower back,racial,Unknown,32,0,32
4145627,Biliary calculus,racial,Unknown,23,9,32
193814,Chronic parametritis and pelvic cellulitis,ethnic,Hispanic or Latino,32,0,32
444371,Abrasion AND/OR friction burn of finger without infection,racial,White,12,21,33
80495,Palindromic rheumatism of the pelvic region and thigh,racial,Other Race,32,0,32
444433,Open wound of toe with complication,racial,Unknown,32,0,32
440647,Sexually transmitted infectious disease,ethnic,Not Hispanic or Latino,16,16,32
30770,Chronic peptic ulcer with hemorrhage but without obstruction,ethnic,Hispanic or Latino,32,0,32
139895,"Thyroid dysfunction during pregnancy, childbirth and the puerperium",ethnic,Hispanic or Latino,30,2,32
376337,Disease of nervous system,racial,White,21,12,33
442167,Neoplasm of uncertain behaviour of craniopharyngeal duct,ethnic,Hispanic or Latino,18,14,32
432301,Opioid dependence in remission,racial,White,12,21,33
433556,Derangement of posterior horn of lateral meniscus,ethnic,Hispanic or Latino,25,7,32
78011,Sprain of metacarpophalangeal joint,ethnic,Hispanic or Latino,14,18,32
432588,Megaloblastic anemia due to vitamin B>12< deficiency,ethnic,Not Hispanic or Latino,25,7,32
375415,Injury of head region,racial,Black or African American ,7,25,32
435810,After-cataract,racial,Unknown,18,14,32
4090651,Dialysis observation,racial,Black or African American ,25,7,32
312998,Pain in thoracic spine,racial,Other Race,32,0,32
381444,Black eye,racial,Unknown,18,14,32
4285139,Social maladjustment,ethnic,Hispanic or Latino,2,28,30
4152047,Lipid screening,racial,Other Race,12,18,30
441532,Monoclonal paraproteinaemia,racial,White,9,21,30
433000,Patellar tendonitis,racial,Unknown,2,28,30
4014296,Twins - both live born,ethnic,Hispanic or Latino,23,7,30
199859,Bilateral recurrent inguinal hernia,ethnic,Not Hispanic or Latino,0,30,30
201131,Pelvic mass,racial,Other Race,30,0,30
441460,Late effect of sprain AND/OR strain without tendon injury,racial,White,16,14,30
321689,Apneic,racial,Unknown,23,7,30
313791,Bundle branch block,racial,Unknown,28,2,30
317003,Compression of vein,ethnic,Not Hispanic or Latino,0,30,30
376709,Discharge of eye,ethnic,Not Hispanic or Latino,14,16,30
443257,Swellings and lumps,racial,Asian,23,7,30
313224,Anomalous atrioventricular excitation,racial,White,0,30,30
136760,Transient hypertension of pregnancy - not delivered,ethnic,Not Hispanic or Latino,28,2,30
195316,Atypical endometrial hyperplasia,ethnic,Hispanic or Latino,30,0,30
28060,Strept throat,racial,Filipino,21,9,30
436233,Delayed milestone,racial,Unknown,5,25,30
4281232,Type B viral hepatitis,racial,White,18,12,30
141955,Pectus excavatum,racial,White,7,23,30
4115379,"Localised, primary osteoarthritis of the pelvic region and thigh",racial,Black or African American ,30,0,30
320429,Rheumatic aortic stenosis with regurgitation,racial,Unknown,25,5,30
377550,Compression of brain,racial,White,30,0,30
436100,Narcolepsy,racial,Unknown,30,0,30
196044,Primary malignant neoplasm of stomach,racial,Unknown,30,0,30
193239,Diverticulitis of small intestine,ethnic,Hispanic or Latino,28,2,30
317003,Compression of vein,racial,Asian,0,30,30
436238,Elevated levels of transaminase and lactic acid dehydrogenase,racial,American Indian or Alaska Native ,30,0,30
432739,Red blood cell disorder,racial,Unknown,21,9,30
199958,Open wound of hip AND thigh without complication,racial,White,12,18,30
252663,Pneumonitis due to inhalation of food or vomitus,ethnic,Not Hispanic or Latino,0,30,30
197018,Chronic gastric ulcer with hemorrhage but without obstruction,racial,White,30,0,30
192671,GI - Gastrointestinal haemorrhage,racial,Other Race,28,2,30
80805,Primary localized osteoarthrosis of forearm,ethnic,Not Hispanic or Latino,23,7,30
432308,Mononeuritis of lower limb,ethnic,Not Hispanic or Latino,14,16,30
441261,Episodic acute alcoholic intoxication in alcoholism,racial,White,9,21,30
26459,Acute oesophagitis,racial,White,14,16,30
4119298,Late onset asthma,ethnic,Hispanic or Latino,16,14,30
194083,Vaginitis and vulvovaginitis,racial,Native Hawaiian or Other Pacific Islander ,30,0,30
4108975,Borderline glaucoma NOS,racial,White,28,2,30
4108533,Unspecified otalgia,ethnic,Not Hispanic or Latino,23,7,30
439981,Wound dehiscence,ethnic,Hispanic or Latino,23,7,30
137627,Prickly heat,racial,Unknown,9,21,30
433455,Teeth grinding whilst asleep,racial,Other Race,28,2,30
432626,Glaucoma associated with vascular disorder,ethnic,Hispanic or Latino,21,9,30
80004,Hand injury,racial,Unknown,12,18,30
257907,Disorder of lung,racial,Other Race,14,16,30
4108664,Hypertensive heart disease NOS,ethnic,Hispanic or Latino,30,0,30
27674,N&V - Nausea and vomiting,racial,American Indian or Alaska Native ,30,0,30
441542,Anxiety,racial,Filipino,23,7,30
433659,Delayed healing of surgical wound,racial,White,21,9,30
374562,Acute poliomyelitis with paralysis except bulbar,ethnic,Hispanic or Latino,30,0,30
138539,Shprintzen-Goldberg syndrome,ethnic,Hispanic or Latino,7,23,30
4141492,Other ill-defined heart disease,ethnic,Not Hispanic or Latino,30,0,30
378160,Otorrhea,racial,White,9,21,30
374357,Acquired stenosis of nasolacrimal duct,racial,Other Race,7,23,30
318773,Dilated cardiomyopathy secondary to alcohol,ethnic,Hispanic or Latino,0,30,30
136495,Lichenification and lichen simplex chronicus,ethnic,Not Hispanic or Latino,23,7,30
76836,Sprain of knee and leg,racial,Other Race,12,18,30
192673,Vascular insufficiency of intestine,ethnic,Hispanic or Latino,28,2,30
4088920,Womb absent,racial,Other Race,30,0,30
136788,Spinal stenosis of lumbar region,racial,Other Race,16,14,30
438827,Foreign body granuloma of subcutaneous tissue,racial,White,14,16,30
4304916,Gastrointestinal tract finding,racial,White,21,9,30
435789,Megaloblastic anemia,racial,White,18,12,30
136237,Cardiovascular system problem,racial,Unknown,14,16,30
201322,Internal hemorrhoids without complication,racial,Other Race,23,7,30
434170,Atypical squamous cells of undetermined significance on cervical Papanicolaou smear,racial,Black or African American ,30,0,30
30515,Oesophagostenosis,racial,White,14,16,30
434872,Infection by Trichomonas,racial,White,28,2,30
312337,Arterial embolic and thrombotic occlusion,ethnic,Not Hispanic or Latino,30,0,30
315078,Palpitations,racial,American Indian or Alaska Native ,30,0,30
261325,Pulmonary emphysema,racial,Other Race,14,16,30
373200,Chronic fungal otitis externa,racial,White,23,7,30
439080,Dyspareunia,racial,Other Race,30,0,30
257315,Bacterial pneumonia,racial,Asian,16,14,30
378160,Otorrhea,racial,Unknown,16,14,30
432554,Human immunodeficiency virus II infection,ethnic,Not Hispanic or Latino,14,16,30
4101199,Hearing problem,racial,Black or African American ,14,16,30
438557,Abnormal glucose level,racial,American Indian,7,23,30
201518,Primary malignant neoplasm of lower limb,ethnic,Hispanic or Latino,0,30,30
432352,Idiopathic fibrosing alveolitis,racial,Unknown,2,28,30
441692,Finding of serum tumour marker level,ethnic,Hispanic or Latino,28,2,30
440389,MR - Mental retardation,racial,Asian,2,28,30
80156,Asymptomatic bacteriuria in pregnancy,ethnic,Not Hispanic or Latino,28,2,30
196473,Hypertrophy of uterus,racial,Unknown,30,0,30
256571,FB - Nasal foreign body,racial,White,16,14,30
314054,Aortic valve disease,racial,Other Race,2,28,30
196523,Diarrhea,racial,American Indian or Alaska Native ,14,16,30
201518,Primary malignant neoplasm of lower limb,racial,Unknown,0,30,30
432791,Urticaria-angio-oedema,ethnic,Not Hispanic or Latino,18,12,30
73291,Palindromic rheumatism of the ankle and/or foot,racial,Black or African American ,28,2,30
441334,Glossodynia,racial,White,23,7,30
198401,Neoplasm of uncertain behavior of bladder,racial,White,14,16,30
201927,Cellulitis and abscess of leg,racial,American Indian or Alaska Native ,16,14,30
432352,Idiopathic fibrosing alveolitis,ethnic,Hispanic or Latino,2,28,30
4096271,Methadone analog adverse reaction,ethnic,Hispanic or Latino,0,30,30
138539,Shprintzen-Goldberg syndrome,racial,White,7,23,30
432739,Red blood cell disorder,ethnic,Not Hispanic or Latino,14,16,30
375825,Referred otalgia,racial,White,18,12,30
201965,Shock,ethnic,Hispanic or Latino,25,5,30
437093,Congenital ptosis of upper eyelid,racial,White,28,2,30
40481374,Allergic rhinitis due to food,racial,White,12,18,30
76725,Fissure in ano,racial,Unknown,25,5,30
4170137,Non-suppurative otitis media,racial,Other Race,14,16,30
443580,Systolic heart failure,racial,Unknown,16,14,30
78838,Acquired deformity of knee,racial,White,16,14,30
441737,Bruising,racial,Black or African American ,21,9,30
199866,Acute gastritis,racial,Filipino,21,9,30
375475,Meningoencephalitis due to acquired toxoplasmosis,ethnic,Hispanic or Latino,2,28,30
74104,Fetal condition affecting obstetrical care of mother,ethnic,Hispanic or Latino,30,0,30
381297,Xanthoma of eyelid,racial,Unknown,30,0,30
24970,Chronic laryngitis,ethnic,Not Hispanic or Latino,25,5,30
4148407,Family history: Cardiovascular disease,ethnic,Not Hispanic or Latino,12,18,30
261327,Empyema of pleura without fistula,racial,White,18,12,30
72404,Joint stiffness,racial,White,21,9,30
381252,Benign neoplasm of eye,racial,White,21,9,30
195321,Postmenopausal bleeding,racial,American Indian or Alaska Native ,30,0,30
75065,Acquired deformity of spine,ethnic,Hispanic or Latino,21,9,30
259849,Pneumonia with infectious diseases EC,racial,Unknown,23,7,30
80571,Open wound of foot with complication,ethnic,Hispanic or Latino,21,9,30
320429,Rheumatic aortic stenosis with regurgitation,ethnic,Hispanic or Latino,25,5,30
436075,Adjustment disorder with anxious mood,racial,Unknown,16,14,30
138463,Oral aphthae,racial,Asian,16,14,30
137065,Nonstageable pressure ulcer,racial,Unknown,30,0,30
135888,Decubitus ulcer,racial,White,9,21,30
433033,Abnormal cervical Papanicolaou smear,racial,Unknown,30,0,30
376691,Delimited old retinal detachment,racial,Unknown,5,25,30
372324,Eustachian tube disorder,racial,Other Race,23,7,30
314664,Long Q-T syndrome,ethnic,Hispanic or Latino,28,2,30
315085,Enlargement of lymph nodes,racial,Other Race,18,12,30
193326,Urge incontinence of urine,racial,Asian,21,9,30
438905,Sequelae of injury of spinal cord,ethnic,Not Hispanic or Latino,0,30,30
443447,Iatrogenic hypotension,ethnic,Hispanic or Latino,18,12,30
192353,Disorder of gallbladder,racial,Unknown,14,16,30
441321,Chronic nasopharyngitis,ethnic,Hispanic or Latino,18,12,30
380731,OE - Otitis externa,ethnic,Not Hispanic or Latino,7,23,30
198400,Haemangioma of skin and subcutaneous tissue,racial,Unknown,28,2,30
135893,Decubitus ulcer of heel,ethnic,Not Hispanic or Latino,21,9,30
78579,Closed fracture of first cervical vertebra,ethnic,Hispanic or Latino,30,0,30
27017,Defective dental restoration,ethnic,Hispanic or Latino,7,23,30
261326,Viral pneumonia,ethnic,Not Hispanic or Latino,7,23,30
74125,Inflammatory polyarthropathy,racial,Unknown,16,14,30
135061,Congenital anomaly of musculoskeletal system,ethnic,Hispanic or Latino,14,16,30
196061,Benign tumour of stomach,racial,White,28,2,30
4096271,Methadone analog adverse reaction,racial,White,0,30,30
4285139,Social maladjustment,racial,White,2,28,30
199876,Prolapse of female genital organs,racial,White,30,0,30
440366,Delay in sexual development AND/OR puberty,ethnic,Hispanic or Latino,12,18,30
439846,LVF - Left ventricular failure,racial,Asian,0,30,30
433596,Abnormal sputum,ethnic,Not Hispanic or Latino,9,21,30
432595,Amyloidosis,racial,White,30,0,30
138525,Pain in limb,racial,Native Hawaiian or Other Pacific Islander ,23,7,30
40490423,Incontinence without sensory awareness,racial,Unknown,23,7,30
376973,Cataract secondary to ocular disease,racial,White,21,9,30
376117,Cataract in degenerative disorder,racial,Asian,30,0,30
197675,Bowel incontinence,ethnic,Not Hispanic or Latino,14,16,30
72576,Benign tumour of breast,racial,Unknown,30,0,30
201265,Splenic disorder,racial,White,25,5,30
80186,Recurrent dislocation of shoulder region,racial,White,14,16,30
4062484,Cervical neoplasia screening,racial,American Indian,30,0,30
374562,Acute poliomyelitis with paralysis except bulbar,racial,Unknown,30,0,30
193277,Deliveries by caesarean,racial,White,30,0,30
78909,"Contusion, shoulder and upper arm, multiple sites",racial,White,16,14,30
4062795,Twin pregnancy unspecified,ethnic,Hispanic or Latino,30,0,30
313209,Left bundle branch hemiblock,racial,Unknown,21,9,30
443524,Mixed incontinence,racial,Asian,28,2,30
194083,Vaginitis and vulvovaginitis,racial,Filipino,30,0,30
4062650,Malnutrition screening,ethnic,Not Hispanic or Latino,14,16,30
72501,Superficial foreign body of foot without major open wound AND without infection,racial,White,16,14,30
4286333,Carcinoma in situ,racial,White,28,2,30
313989,Chronic lymphadenitis,racial,White,21,9,30
435626,Tibial collateral ligament bursitis,racial,Black or African American ,0,30,30
374027,Lesion of ulnar nerve,ethnic,Not Hispanic or Latino,9,21,30
4029488,Hepatic encephalopathy,ethnic,Not Hispanic or Latino,5,25,30
4114610,Allergic arthritis NOS,ethnic,Hispanic or Latino,23,7,30
439219,Poisoning due to venomous spider,ethnic,Hispanic or Latino,25,5,30
314381,Kawasaki syndrome,racial,White,18,12,30
440216,Abnormal glucose tolerance test,racial,Black or African American ,14,16,30
75128,Injury of chest wall,ethnic,Not Hispanic or Latino,12,18,30
139850,Acute frontal sinusitis,racial,Other Race,18,12,30
135526,Myelopathy,racial,Unknown,7,23,30
438112,Neoplastic disease,racial,White,25,5,30
133857,Acquired deformity of limb,racial,Unknown,18,12,30
375252,Disorder of eye,racial,Black or African American ,18,12,30
437540,CRAO - Central retinal artery occlusion,racial,White,12,18,30
141249,Benign tumour of thyroid gland,racial,Unknown,30,0,30
135618,Prurigo,racial,Unknown,18,12,30
75099,Coccyx sprain,racial,White,21,9,30
314054,Aortic valve disease,racial,Asian,7,23,30
318736,Migraine,racial,American Indian or Alaska Native ,25,5,30
76887,Disorders of urogenital prostheses or implants,racial,Unknown,21,9,30
138389,Benign neoplasm of scalp and skin of neck,racial,Unknown,18,12,30
435912,Endocardial cushion defect,racial,Other Race,30,0,30
435836,Disorder of nasopharynx,racial,Unknown,7,23,30
379806,Migraine variants,ethnic,Not Hispanic or Latino,25,5,30
433244,Tooth loss,ethnic,Hispanic or Latino,7,23,30
137967,"Muscle, ligament and fascia disorders",ethnic,Not Hispanic or Latino,28,2,30
434944,Scleritis,ethnic,Hispanic or Latino,23,7,30
4087756,Late latent syphilis,racial,Black or African American ,9,21,30
74135,Disorder of synovium,racial,Unknown,28,2,30
434169,Abnormal findings on diagnostic imaging of breast,racial,Black or African American ,30,0,30
133364,Second degree burn of back,ethnic,Hispanic or Latino,30,0,30
80816,Intervertebral disc degeneration,racial,Black or African American ,2,28,30
140480,Impetigo,racial,Black or African American ,14,16,30
438878,Abnormal results of liver function studies,racial,Other Race,18,12,30
139057,Disease of oral soft tissues,racial,Asian,21,9,30
78518,Observation of shoulder joint,racial,White,25,5,30
435914,Metatarsus varus,racial,White,18,12,30
4319150,Pulled elbow,ethnic,Hispanic or Latino,9,21,30
81112,Arthralgia of the lower leg,racial,Filipino,30,0,30
4283532,Psychogenic headache,racial,Unknown,30,0,30
132466,Lumbar sprain,racial,Black or African American ,5,25,30
4113650,Noninflammatory cervical disorder,ethnic,Hispanic or Latino,25,5,30
196158,Disease of penis,ethnic,Not Hispanic or Latino,0,30,30
253790,Pneumonia due to Klebsiella pneumoniae,ethnic,Not Hispanic or Latino,30,0,30
441946,Calcific tendinitis of shoulder,ethnic,Not Hispanic or Latino,21,9,30
196726,Cholelithiasis AND acute cholecystitis without obstruction,racial,White,25,5,30
374035,Keratitis,ethnic,Hispanic or Latino,23,7,30
439237,Assault,racial,White,25,5,30
253790,Pneumonia due to Klebsiella pneumoniae,racial,Asian,30,0,30
80874,Open wound of multiple sites of one upper limb without complication,racial,White,18,12,30
372424,Congenital anolmaly of eye,ethnic,Hispanic or Latino,21,9,30
138384,Acquired hypothyroidism,racial,Black or African American ,16,14,30
314971,Chronic respiratory failure,racial,Black or African American ,28,2,30
4004785,Fetal alcohol syndrome,ethnic,Not Hispanic or Latino,14,16,30
434319,Premature orgasm - male,racial,White,0,30,30
194149,Hirschsprung disease,ethnic,Hispanic or Latino,16,14,30
381859,Infective OE,racial,American Indian or Alaska Native ,23,7,30
444361,Nonvenomous insect bite of toe without infection,ethnic,Hispanic or Latino,18,12,30
196149,Acute appendicitis with generalized peritonitis,ethnic,Hispanic or Latino,2,28,30
40491340,Closed fracture of tibia,ethnic,Not Hispanic or Latino,7,23,30
432513,Animal bite wound,ethnic,Hispanic or Latino,25,5,30
318169,Varicose veins of lower extremity,racial,Other Race,30,0,30
378421,Alcoholic peripheral neuropathy,racial,White,5,25,30
432546,Herpes zoster dermatitis of eyelids,ethnic,Hispanic or Latino,16,14,30
132344,Gingival and periodontal disease,ethnic,Not Hispanic or Latino,23,7,30
4331070,Family history of polyp of colon,ethnic,Hispanic or Latino,12,18,30
81942,Enthesopathy of ankle AND/OR tarsus,racial,Unknown,25,5,30
439219,Poisoning due to venomous spider,racial,White,23,7,30
377802,Late effects of poliomyelitis,ethnic,Not Hispanic or Latino,2,28,30
4282316,Recurrent major depression,racial,White,5,25,30
436336,Herpes zoster with nervous system complication,racial,Other Race,9,21,30
140318,"Septicemia due to streptococcus, group A",ethnic,Hispanic or Latino,9,21,30
261880,Atelectasis,racial,Unknown,25,5,30
321590,Right bundle branch block AND left posterior fascicular block,ethnic,Hispanic or Latino,0,30,30
192675,Biliary cirrhosis,racial,White,14,16,30
314965,Embolism and thrombosis of an arm or leg artery,racial,White,28,2,30
194699,Liver disorder in pregnancy,racial,White,30,0,30
434084,Abscess of vulva,ethnic,Not Hispanic or Latino,30,0,30
439847,Intracranial hemorrhage,racial,White,9,21,30
25518,AS - Sickle cell trait,ethnic,Not Hispanic or Latino,12,18,30
192242,Acute hepatitis C,racial,Other Race,30,0,30
4048191,Enlargement of tonsil or adenoid,ethnic,Not Hispanic or Latino,23,7,30
320425,Heart block,racial,Unknown,0,30,30
437943,Pulp abscess of finger,racial,White,12,18,30
141213,Scarlet fever,racial,Unknown,18,12,30
435802,Blepharospasm,ethnic,Not Hispanic or Latino,30,0,30
4296204,First degree burn,racial,White,23,7,30
81403,Osteopetrosis,racial,White,30,0,30
194700,"Diabetes mellitus in mother complicating pregnancy, childbirth AND/OR puerperium",ethnic,Not Hispanic or Latino,30,0,30
135526,Myelopathy,ethnic,Not Hispanic or Latino,2,28,30
313011,Congenital abnormality of cardiac position,ethnic,Hispanic or Latino,2,28,30
4164792,Hemophilus influenzae laryngitis,racial,White,18,12,30
195321,Postmenopausal bleeding,racial,Other Race,30,0,30
137213,Fungal dermatosis,racial,Asian,16,14,30
433288,Derangement of anterior horn of lateral meniscus,ethnic,Hispanic or Latino,9,21,30
194788,Open wound of anterior abdominal wall with complication,racial,Unknown,14,16,30
192376,Rhesus isoimmunization with antenatal problem,ethnic,Not Hispanic or Latino,30,0,30
380669,Benign neoplasm of eyelid including canthus,ethnic,Hispanic or Latino,18,12,30
434742,Congenital abnormality of skull and face bones,racial,Other Race,28,2,30
78512,Joint contracture of the ankle and/or foot,racial,White,9,21,30
75051,Derangement of posterior horn of medial meniscus,racial,Unknown,23,7,30
201313,Hypertensive renal disease,racial,Unknown,16,14,30
193277,Deliveries by caesarean,ethnic,Hispanic or Latino,30,0,30
374221,Injury of brachial plexus,ethnic,Hispanic or Latino,12,18,30
374028,AAMD - Age related macular degeneration,racial,Filipino,30,0,30
379032,Acute mastoiditis with complications,ethnic,Hispanic or Latino,0,30,30
434298,Metastasis to upper limb lymph node,ethnic,Hispanic or Latino,30,0,30
432851,Secondary malignant neoplastic disease,racial,White,30,0,30
4256640,Body mass index 40+ - severely obese,racial,Unknown,16,14,30
141648,Contact dermatitis due to cosmetics,racial,White,28,2,30
377861,Disorder of refraction AND/OR accommodation,racial,Filipino,7,23,30
28461,Hypertrophy of salivary gland,ethnic,Hispanic or Latino,5,25,30
4062484,Cervical neoplasia screening,racial,Native Hawaiian or Other Pacific Islander ,30,0,30
260123,Acute inflammation of sinus,racial,Native Hawaiian or Other Pacific Islander ,18,12,30
257683,Postnasal drip,racial,Asian,25,5,30
434916,"Amfetamine or psychostimulant dependence, continuous",racial,White,0,30,30
437176,Late effect of accidental fall,racial,White,16,14,30
133510,Rapidly progressive periodontitis,racial,White,16,14,30
4100365,Schizophrenic disorders,racial,White,21,9,30
316428,Hypertrophic obstructive cardiomyopathy,ethnic,Not Hispanic or Latino,28,2,30
140480,Impetigo,racial,Asian,7,23,30
436166,Mild hyperemesis gravidarum,racial,Unknown,30,0,30
433946,Fall on same level due to impact against another person,racial,White,28,2,30
252365,MGN - Membranous glomerulonephritis,racial,Unknown,16,14,30
134668,Chronic maxillary sinusitis,ethnic,Not Hispanic or Latino,12,18,30
318566,Flushing,racial,White,23,7,30
4268980,Finding of general development,ethnic,Hispanic or Latino,30,0,30
4014231,Foot sprain NOS,ethnic,Hispanic or Latino,12,18,30
4177115,Malignant tumour of testis,ethnic,Hispanic or Latino,0,30,30
434490,Shivering,racial,Unknown,23,7,30
138225,Disease of sebaceous glands,racial,Unknown,18,12,30
318776,Rheumatic mitral regurgitation,ethnic,Hispanic or Latino,2,28,30
438727,Atypical depressive disorder,racial,Black or African American ,18,12,30
192684,"Renal hypertension complicating pregnancy, childbirth and the puerperium - not delivered",ethnic,Hispanic or Latino,5,25,30
439141,Abnormal increase in weight,racial,American Indian or Alaska Native ,0,30,30
4215003,Myasthenic crisis,racial,White,9,21,30
25780,Lorain - Levi dwarfism,ethnic,Hispanic or Latino,18,12,30
75650,Proteinuria,racial,American Indian,16,14,30
444272,Contact dermatitis due to drugs AND/OR medicine,racial,White,14,16,30
437530,Disorders of lipoid metabolism,ethnic,Not Hispanic or Latino,23,7,30
313023,Neonatal chronic respiratory disease,racial,Asian,5,25,30
76550,Sprain of metatarsophalangeal joint,ethnic,Hispanic or Latino,18,12,30
81403,Osteopetrosis,racial,Unknown,7,23,30
194992,Coeliac disease,ethnic,Not Hispanic or Latino,14,16,30
78786,Pleurisy,ethnic,Not Hispanic or Latino,23,7,30
4250023,Severe major depression with psychotic features,racial,Filipino,30,0,30
437113,Asthenia,racial,Other Race,9,21,30
4286333,Carcinoma in situ,racial,Unknown,9,18,27
314379,First degree atrioventricular block,racial,Asian,14,14,28
378414,Separation of retinal layers,racial,Unknown,14,14,28
435739,Late syphilis,racial,White,5,23,28
76786,Derangement of knee,racial,Other Race,21,7,28
4109698,Acute conjunctivitis NOS,racial,White,14,14,28
435511,Hypercalcemia,racial,Black or African American ,21,7,28
435987,Peanut-induced anaphylaxis,racial,White,9,18,27
375827,Acute non-suppurative otitis media - serous,racial,Black or African American ,7,21,28
437246,Vitamin B deficiency,racial,Other Race,23,5,28
319049,Acute respiratory failure,ethnic,Not Hispanic or Latino,5,23,28
139900,Urticaria,racial,Black or African American ,18,9,27
440794,Elderly primigravida - delivered,ethnic,Hispanic or Latino,28,0,28
80806,Climacteric arthritis of multiple sites,racial,Unknown,25,2,27
381562,"Impairment level: better eye: moderate impairment: lesser eye: blind, not further specified",racial,Unknown,25,2,27
433942,Accident whilst engaged in household activity,racial,Other Race,21,7,28
4305303,Sleep deprivation,racial,Unknown,25,2,27
4031190,Swallowed foreign body,racial,White,14,14,28
443452,Bleeding of unknown origin,racial,White,18,9,27
441692,Finding of serum tumour marker level,racial,Asian,23,5,28
75389,Current tear of lateral cartilage AND/OR meniscus of knee,racial,Unknown,18,9,27
434465,Nonallopathic lesion of rib cage,racial,White,16,12,28
28403,Acromegaly and gigantism,racial,White,2,25,27
444272,Contact dermatitis due to drugs AND/OR medicine,ethnic,Hispanic or Latino,9,18,27
438722,Non megaloblastic anemia associated with nutritional deficiency,racial,Unknown,21,7,28
4192786,Potential infectious contact,ethnic,Hispanic or Latino,28,0,28
257007,Allergic rhinitis,racial,American Indian,25,2,27
4209151,Repair of musculotendinous cuff of shoulder,racial,White,21,7,28
444457,Benign tumour of rectum,ethnic,Hispanic or Latino,0,28,28
140487,Dermatitis herpetiformis,racial,White,18,9,27
26727,Vomiting blood,racial,Unknown,18,9,27
197921,Renal osteodystrophy,racial,White,25,2,27
194802,Foreign body in vulva and vagina,racial,White,28,0,28
198194,Female genital organ symptoms,racial,American Indian or Alaska Native ,28,0,28
4053599,Open wound of forearm,racial,Unknown,16,12,28
200843,Observation of frequency of urination,racial,Black or African American ,21,7,28
81336,Rectal prolapse,racial,White,28,0,28
432347,Chronic disease of tonsils AND/OR adenoids,racial,Unknown,21,7,28
375819,TM - Tympanic membrane disorder,racial,White,12,16,28
197022,Unilateral recurrent inguinal hernia with obstruction but no gangrene,ethnic,Hispanic or Latino,0,28,28
195314,Nephrotic syndrome,racial,Filipino,0,28,28
200765,Chronic cholecystitis,racial,White,23,5,28
138821,Seborrhea,racial,Unknown,25,2,27
4308509,Impaired fasting glycaemia,racial,American Indian or Alaska Native ,2,25,27
72576,Benign tumour of breast,ethnic,Not Hispanic or Latino,28,0,28
437643,Gait abnormality,racial,American Indian or Alaska Native ,18,9,27
435325,Umbilical cord complication,ethnic,Hispanic or Latino,14,14,28
141249,Benign tumour of thyroid gland,racial,White,16,12,28
433471,Retinal neovascularization,ethnic,Hispanic or Latino,21,7,28
436466,Balanoposthitis,racial,Black or African American ,0,28,28
376965,Hypertensive retinopathy,racial,Unknown,16,12,28
72418,Scoliosis deformity of spine,ethnic,Not Hispanic or Latino,14,14,28
434207,"Insect bite, nonvenomous, of hand, without mention of infection",racial,White,14,14,28
79116,Disorder of tendon of shoulder region,racial,Unknown,28,0,28
373101,Injury of ulnar nerve,ethnic,Not Hispanic or Latino,5,23,28
26441,Bleeding ulcer of esophagus,ethnic,Hispanic or Latino,7,21,28
257905,Mucopurulent chronic bronchitis,racial,White,18,9,27
432296,Coagulation factor deficiency syndrome,ethnic,Not Hispanic or Latino,25,2,27
4234604,Disruption of cesarean wound in the puerperium,racial,White,28,0,28
439702,Residual infantile autism,ethnic,Not Hispanic or Latino,0,28,28
4124693,Hypertrophic cardiomyopathy,racial,White,28,0,28
442287,Rest pain,ethnic,Hispanic or Latino,16,12,28
433740,Immunodeficiency disorder,racial,White,9,18,27
443728,Mass of chest wall,racial,Black or African American ,28,0,28
375519,Alcohol withdrawal syndrome,ethnic,Hispanic or Latino,2,25,27
318443,Arteriosclerotic vascular disease,ethnic,Not Hispanic or Latino,25,2,27
380397,Keratoconjunctivitis,racial,White,21,7,28
439702,Residual infantile autism,racial,American Indian or Alaska Native ,0,28,28
201131,Pelvic mass,racial,Native Hawaiian or Other Pacific Islander ,0,28,28
380394,Idiopathic progressive polyneuropathy,racial,White,7,21,28
440279,Accident,ethnic,Not Hispanic or Latino,14,14,28
135688,Abrasion AND/OR friction burn of foot with infection,ethnic,Hispanic or Latino,14,14,28
437584,Ataxia,ethnic,Not Hispanic or Latino,23,5,28
432803,[X]Fall on and from ladder,ethnic,Hispanic or Latino,5,23,28
443211,Benign prostatic hypertrophy with outflow obstruction,racial,Unknown,0,28,28
315085,Enlargement of lymph nodes,racial,Black or African American ,14,14,28
433456,Acute pain,racial,Asian,9,18,27
76836,Sprain of knee and leg,racial,Asian,12,16,28
200781,Unilateral small kidney,ethnic,Hispanic or Latino,14,14,28
314171,Low blood pressure reading,ethnic,Hispanic or Latino,16,12,28
438332,Disease of possible viral origin,racial,American Indian or Alaska Native ,16,12,28
432574,Diffuse malignant lymphoma - histiocytic,ethnic,Hispanic or Latino,16,12,28
137735,Second degree burn of forearm,ethnic,Hispanic or Latino,18,9,27
4064918,Diabetes mellitus screening,racial,American Indian,14,14,28
443422,Scleroderma,racial,Asian,28,0,28
437671,Abnormal feces,ethnic,Not Hispanic or Latino,16,12,28
4169009,FH: CVA,ethnic,Not Hispanic or Latino,12,16,28
436681,Insomnia disorder related to known organic factor,racial,Unknown,18,9,27
4008089,Dysentery,racial,Unknown,28,0,28
443877,Nonvenomous insect bite of shoulder without infection,ethnic,Hispanic or Latino,18,9,27
433071,Contusion of multiple sites,racial,Unknown,16,12,28
80800,Polymyositis,racial,Unknown,28,0,28
25297,Acute pharyngitis,racial,Native Hawaiian or Other Pacific Islander ,21,7,28
138102,Benign tumour of skin,racial,Black or African American ,9,18,27
434311,Disorder of the urea cycle metabolism,ethnic,Not Hispanic or Latino,0,28,28
380403,External hordeolum,racial,Black or African American ,14,14,28
440238,Closed fracture of metatarsal bone,racial,Black or African American ,5,23,28
199867,CPH - Chronic persistent hepatitis,racial,White,23,5,28
197206,Balantidiasis,racial,Unknown,0,28,28
81878,Benign paroxysmal positional vertigo,racial,Asian,25,2,27
376422,Mucopurulent conjunctivitis,racial,Other Race,9,18,27
140480,Impetigo,racial,Filipino,2,25,27
137053,Seborrheic dermatitis,racial,Filipino,23,5,28
438865,Complete trisomy 18 syndrome,ethnic,Not Hispanic or Latino,0,28,28
133551,Vesicular eczema of hands and/or feet,ethnic,Not Hispanic or Latino,7,21,28
40490434,Abnormal arterial blood gas,ethnic,Hispanic or Latino,14,14,28
432296,Coagulation factor deficiency syndrome,racial,White,28,0,28
133294,Prepatellar bursitis,racial,Unknown,16,12,28
26052,Primary malignant neoplasm of larynx,racial,White,0,28,28
201337,Disorder of bladder and bladder neck,racial,Unknown,21,7,28
376411,Central pterygium,ethnic,Hispanic or Latino,14,14,28
380120,Strabismus in neuromuscular disorder,racial,White,2,25,27
4243973,Laparoscopic appendectomy,ethnic,Hispanic or Latino,14,14,28
74250,Burn of foot,ethnic,Hispanic or Latino,14,14,28
259055,Extrinsic asthma with asthma attack,racial,Asian,12,16,28
374360,Disorder of optic nerve,ethnic,Hispanic or Latino,23,5,28
316376,Eosinophilia,ethnic,Not Hispanic or Latino,9,18,27
197484,Diarrhea of presumed infectious origin,ethnic,Not Hispanic or Latino,21,7,28
4103640,Amputated foot,racial,Unknown,2,25,27
75637,Acquired postural kyphosis,ethnic,Not Hispanic or Latino,25,2,27
376105,Krampfe salaam attacks,ethnic,Not Hispanic or Latino,2,25,27
373784,Acute allergic serous otitis media,ethnic,Hispanic or Latino,25,2,27
4088777,Vagina observation,racial,Unknown,28,0,28
4234604,Disruption of cesarean wound in the puerperium,racial,Unknown,28,0,28
252663,Pneumonitis due to inhalation of food or vomitus,racial,Asian,0,28,28
198678,Intestinal infectious disease,racial,Black or African American ,7,21,28
440676,Neoplasm of uncertain behaviour of brain and spinal cord,ethnic,Hispanic or Latino,28,0,28
201136,Infection of navel cord,racial,Asian,0,28,28
4110047,Chronic bronchitis NOS,racial,White,18,9,27
193552,Furuncle of skin AND/OR subcutaneous tissue,racial,Other Race,21,7,28
4201717,Ileostomy present,ethnic,Hispanic or Latino,14,14,28
432611,Explosive personality disorder,racial,White,2,25,27
375801,Demyelinating disease of central nervous system,racial,Unknown,28,0,28
434303,Benign neoplasm of rectum and anal canal,ethnic,Hispanic or Latino,16,12,28
4101609,Ebstein anomaly of right atrioventricular valve,ethnic,Hispanic or Latino,23,5,28
433946,Fall on same level due to impact against another person,racial,Asian,21,7,28
80946,Tinea manus,ethnic,Not Hispanic or Latino,18,9,27
436583,[X]Falls,racial,American Indian or Alaska Native ,28,0,28
75385,"Closed fracture distal humerus, lateral epicondyle",ethnic,Hispanic or Latino,23,5,28
440840,Neonatal candidiasis,racial,White,14,14,28
78228,Joint derangement,racial,Unknown,14,14,28
4141492,Other ill-defined heart disease,racial,White,28,0,28
80141,Functional diarrhea,racial,Unknown,28,0,28
133436,Thyrotoxic crisis,racial,Native Hawaiian or Other Pacific Islander ,0,28,28
316429,Ectopics,racial,Other Race,7,21,28
198401,Neoplasm of uncertain behavior of bladder,ethnic,Hispanic or Latino,14,14,28
132397,Pilonidal cyst with no abscess,racial,Unknown,14,14,28
373786,Abnormal vision,ethnic,Not Hispanic or Latino,16,12,28
133364,Second degree burn of back,racial,Unknown,28,0,28
434549,Fall from toilet seat,racial,Unknown,23,5,28
198551,"Embryonic cyst of cervix, vagina and external female genitalia",ethnic,Hispanic or Latino,28,0,28
438865,Complete trisomy 18 syndrome,racial,Asian,0,28,28
4102348,Common migraine NOS,racial,White,16,12,28
199913,Acquired deformity of ankle AND/OR foot,racial,Black or African American ,0,28,28
75897,Polyarthropathy,racial,White,14,14,28
314479,Primary apnea in the newborn,ethnic,Hispanic or Latino,12,16,28
313502,Benign hypertensive heart disease without congestive heart failure,ethnic,Not Hispanic or Latino,7,21,28
77340,Genitourinary tract infection in pregnancy,ethnic,Not Hispanic or Latino,25,2,27
432910,Disorder of lacrimal system,ethnic,Not Hispanic or Latino,28,0,28
321042,Cardiac arrest,racial,American Indian or Alaska Native ,28,0,28
197988,General abdominal pain-symptom,racial,American Indian or Alaska Native ,16,12,28
199859,Bilateral recurrent inguinal hernia,ethnic,Hispanic or Latino,2,25,27
373202,Corneal ulcer,racial,Unknown,25,2,27
133551,Vesicular eczema of hands and/or feet,racial,Asian,25,2,27
195862,Urethritis,ethnic,Not Hispanic or Latino,5,23,28
440538,Closed fracture of lower end of radius AND ulna,racial,White,5,23,28
4150614,Communication disorder,ethnic,Hispanic or Latino,5,23,28
4166080,Decompression of median nerve,ethnic,Hispanic or Latino,23,5,28
81984,Sprain of shoulder and upper arm,racial,Black or African American ,7,21,28
259153,Throat soreness,racial,Filipino,14,14,28
195588,Cystitis,racial,Black or African American ,23,5,28
435131,Victim of neglect,ethnic,Hispanic or Latino,18,9,27
81151,Sprain of ankle joint,racial,Asian,23,5,28
442427,Cervical post-laminectomy syndrome,racial,White,23,5,28
132932,Chronic ethmoidal sinusitis,ethnic,Not Hispanic or Latino,7,21,28
435889,Decubitus ulcer of ankle,racial,White,7,21,28
318773,Dilated cardiomyopathy secondary to alcohol,racial,Unknown,0,28,28
4108079,Perceptive hearing loss NOS,racial,White,14,14,28
4290971,Amoebic ulcer of skin,ethnic,Hispanic or Latino,28,0,28
80045,Primary malignant neoplasm of anus,ethnic,Not Hispanic or Latino,12,16,28
195079,Functional urinary incontinence,racial,Black or African American ,23,5,28
27674,N&V - Nausea and vomiting,racial,Asian,21,7,28
438673,Tuberculosis of bones and joints,ethnic,Hispanic or Latino,0,28,28
440068,Psychosexual dysfunction,racial,White,0,28,28
260130,Partial bilateral paralysis of vocal cords,ethnic,Hispanic or Latino,2,25,27
141213,Scarlet fever,ethnic,Not Hispanic or Latino,14,14,28
435657,Sleep problem,racial,Unknown,7,21,28
200764,Bile duct calculus without mention of cholecystitis and no obstruction,racial,Unknown,7,21,28
4094448,Pregnancy test negative,racial,Black or African American ,28,0,28
260131,Bronchial disorder,racial,Unknown,21,7,28
200445,Chronic prostatitis,ethnic,Not Hispanic or Latino,0,28,28
194526,Injury of trunk,racial,White,14,14,28
199877,Mucous polyp of cervix,racial,Other Race,28,0,28
374341,Huntington's chorea,racial,Unknown,0,28,28
141090,PG - Pyogenic granuloma,ethnic,Not Hispanic or Latino,7,21,28
319049,Acute respiratory failure,racial,Unknown,9,18,27
441827,Disorder of amino acid and organic acid metabolism,ethnic,Hispanic or Latino,25,2,27
4181357,Malignant tumour of renal pelvis,racial,White,0,28,28
201136,Infection of navel cord,racial,White,16,12,28
4208970,History of physical abuse,racial,White,28,0,28
444262,Tuberculosis of subcutaneous cellular tissue,racial,White,25,2,27
259153,Throat soreness,racial,American Indian or Alaska Native ,21,7,28
436108,Acute closed-angle glaucoma,ethnic,Hispanic or Latino,14,14,28
199064,Chronic vascular insufficiency of intestine,racial,Unknown,0,28,28
4119298,Late onset asthma,racial,Unknown,14,14,28
196328,Enteric paratyphosis,racial,White,7,21,28
313761,Central retinal vein occlusion,racial,White,12,16,28
443913,Congenital anomaly of trachea,racial,Unknown,0,28,28
137989,Abnormal results of cardiovascular function studies,racial,White,9,18,27
79742,Primary genital syphilis,ethnic,Hispanic or Latino,0,28,28
374371,Stenosis of precerebral artery,ethnic,Hispanic or Latino,18,9,27
434889,"Hysterical neurosis, conversion type",racial,White,25,2,27
444262,Tuberculosis of subcutaneous cellular tissue,ethnic,Hispanic or Latino,25,2,27
372309,Mononeuritis,racial,Other Race,9,18,27
440977,Megaloblastic anemia due to folate deficiency,racial,White,18,9,27
439120,Aseptic necrosis of head AND/OR neck of femur,racial,Unknown,14,14,28
79903,Effusion of joint,racial,White,23,5,28
321119,Coarctation of aorta,ethnic,Hispanic or Latino,23,5,28
372828,Zoster ophthalmicus,ethnic,Hispanic or Latino,9,18,27
316814,Hyperventilation,racial,White,23,5,28
443228,"Abrasion or friction burn of foot and toe, without mention of infection",ethnic,Not Hispanic or Latino,16,12,28
435226,"Bipolar affective disorder, current episode mixed",ethnic,Hispanic or Latino,28,0,28
317576,Coronary arteriosclerosis,racial,Native Hawaiian or Other Pacific Islander ,25,2,27
78512,Joint contracture of the ankle and/or foot,ethnic,Hispanic or Latino,2,25,27
376707,Acute conjunctivitis,racial,Native Hawaiian or Other Pacific Islander ,2,25,27
434323,Disorder of sulphur-bearing amino acid metabolism,ethnic,Hispanic or Latino,9,18,27
439382,Disorder of hypothalamus,racial,White,28,0,28
74725,Displacement of cervical intervertebral disc without myelopathy,racial,Asian,28,0,28
4169009,FH: CVA,racial,White,14,14,28
4064377,Depression screening,racial,Alaska Native,9,18,27
197806,Primary malignant neoplasm of gallbladder,ethnic,Hispanic or Latino,23,5,28
192854,Interstitial uterine fibroid,racial,Black or African American ,28,0,28
380394,Idiopathic progressive polyneuropathy,ethnic,Hispanic or Latino,0,28,28
313217,Atrial fibrillation,racial,Black or African American ,9,18,27
381306,Deaf mutism,racial,Unknown,28,0,28
4210149,Substance abuse counseling,racial,Other Race,2,25,27
374041,External ophthalmoplegia,ethnic,Hispanic or Latino,25,2,27
140487,Dermatitis herpetiformis,ethnic,Hispanic or Latino,18,9,27
437496,Acute peripheral vestibulopathy,racial,White,2,25,27
30284,Motion sickness,racial,White,16,12,28
381551,Drug-related polyneuropathy,ethnic,Hispanic or Latino,0,28,28
433658,Adverse reaction to penicillins,ethnic,Hispanic or Latino,21,7,28
76273,Open wound of shoulder region without complication,ethnic,Hispanic or Latino,23,5,28
373212,Esophoria,racial,White,18,9,27
436134,Disorder of sclera,racial,White,16,12,28
435120,Blister of toe with infection,racial,White,21,7,28
72708,Traumatic arthropathy of the shoulder region,racial,White,25,2,27
81378,Chondromalacia of patella,racial,Unknown,16,12,28
196735,Acute pyelonephritis without medullary necrosis,ethnic,Not Hispanic or Latino,21,7,28
72457,Closed fracture of sacrum AND/OR coccyx without spinal cord injury,ethnic,Not Hispanic or Latino,28,0,28
72374,Unstable lie with antenatal problem,racial,White,28,0,28
438155,Optic disc glaucomatous atrophy,racial,White,16,12,28
78234,Arthralgia of the hand,racial,Black or African American ,7,21,28
199859,Bilateral recurrent inguinal hernia,racial,Black or African American ,0,28,28
195862,Urethritis,racial,Unknown,5,23,28
200845,Urinary precipitancy,racial,Black or African American ,23,5,28
77630,Disease of shoulder,racial,Filipino,28,0,28
438329,Late effect of motor vehicle accident,racial,White,25,2,27
200144,Unilateral simple femoral hernia,ethnic,Hispanic or Latino,21,7,28
316995,Coronary occlusion,racial,White,16,12,28
30978,Hereditary leptocytosis,racial,Unknown,12,16,28
437496,Acute peripheral vestibulopathy,ethnic,Hispanic or Latino,9,18,27
4109880,Varicose veins of the leg with ulcer,racial,Other Race,14,14,28
440386,Transsexualism,racial,Unknown,0,28,28
75065,Acquired deformity of spine,racial,White,18,9,27
437557,Eczematous dermatitis of eyelid,racial,White,28,0,28
320420,Vitreous degeneration,ethnic,Not Hispanic or Latino,23,5,28
435080,Biliuria,racial,White,7,21,28
197803,"Malignant neoplasm, overlapping lesion of stomach",ethnic,Hispanic or Latino,21,7,28
197440,Nonvenomous insect bite of trunk without infection,ethnic,Hispanic or Latino,16,12,28
4280828,"Carrier, infectious agent",ethnic,Not Hispanic or Latino,12,16,28
4182210,Dementia,ethnic,Hispanic or Latino,28,0,28
137792,Kaposi's varicelliform eruption,ethnic,Not Hispanic or Latino,12,16,28
381842,Petit mal status,ethnic,Hispanic or Latino,14,14,28
195873,Leukorrhagia,racial,Asian,25,2,27
135473,Dermatophytosis,racial,Other Race,14,14,28
437828,Disorder of calcium metabolism,racial,White,12,16,28
75365,Oliguria and anuria,racial,White,12,16,28
439777,Anemia,racial,Alaska Native,0,28,28
74739,Osteopathy from poliomyelitis,racial,Unknown,0,28,28
317895,Hypertension due to renovascular disease,racial,Unknown,28,0,28
258981,Kaposi's sarcoma of skin,ethnic,Hispanic or Latino,0,28,28
375519,Alcohol withdrawal syndrome,racial,White,2,25,27
201136,Infection of navel cord,ethnic,Not Hispanic or Latino,0,28,28
437655,Cryptorchism,racial,Asian,0,28,28
444211,Disease of thigh,racial,Black or African American ,28,0,28
439666,Contracture of multiple joints,racial,White,23,5,28
4092511,Malignant neoplasm of central part of female breast,racial,Unknown,28,0,28
376966,Exudative age-related macular degeneration,racial,White,16,12,28
441589,Endocarditis,racial,White,25,2,27
437896,Disorder of language,racial,White,9,18,27
77673,Sign or symptom of the urinary system,ethnic,Not Hispanic or Latino,9,18,27
78786,Pleurisy,racial,Unknown,23,5,28
436233,Delayed milestone,ethnic,Not Hispanic or Latino,7,21,28
78473,Solitary cyst of breast,racial,Asian,28,0,28
436252,Closed fracture of shaft of tibia,racial,Unknown,21,7,28
199878,Light and infrequent menstruation,racial,Other Race,28,0,28
439666,Contracture of multiple joints,ethnic,Not Hispanic or Latino,16,12,28
318776,Rheumatic mitral regurgitation,racial,Unknown,0,28,28
201909,Female infertility,ethnic,Not Hispanic or Latino,28,0,28
372886,Refractory migraine with aura,racial,White,28,0,28
375528,Spastic hemiplegia,ethnic,Not Hispanic or Latino,0,28,28
261889,Simple chronic bronchitis,racial,Other Race,16,12,28
436953,Continuous chronic alcoholism,racial,Black or African American ,0,28,28
439002,Eating disorder,ethnic,Not Hispanic or Latino,23,5,28
75971,Open wound of multiple sites of one upper limb with tendon involvement,ethnic,Hispanic or Latino,5,23,28
317302,Coronary sinus rhythm disorder,racial,Native Hawaiian or Other Pacific Islander ,0,28,28
4222138,Allergic contact dermatitis of eyelid,racial,White,25,2,27
315832,Angina decubitus,ethnic,Hispanic or Latino,23,5,28
253482,Cortical blindness,racial,Unknown,0,28,28
444457,Benign tumour of rectum,racial,White,0,28,28
255848,Pneumonia,racial,Filipino,14,14,28
194079,Post-surgical malabsorption,ethnic,Hispanic or Latino,16,12,28
134118,Atrophic condition of skin,racial,Asian,9,18,27
80805,Primary localized osteoarthrosis of forearm,racial,Unknown,21,7,28
201965,Shock,racial,White,23,5,28
381570,Mechanical ptosis,racial,Unknown,0,28,28
439975,Injury at C1-C4 level with spinal cord injury AND without bone injury,ethnic,Hispanic or Latino,28,0,28
4184877,Amputated finger,ethnic,Hispanic or Latino,0,28,28
201343,Acute alcoholic liver disease,racial,White,7,21,28
434701,"Anemia in mother complicating pregnancy, childbirth AND/OR puerperium",racial,Unknown,28,0,28
253321,Stridor,ethnic,Not Hispanic or Latino,14,14,28
444417,"Gestation period, 29 weeks",ethnic,Hispanic or Latino,0,28,28
437831,"Recurrent manic episodes, in full remission",racial,Unknown,0,28,28
380510,Congenital abnormality of eyelid,ethnic,Hispanic or Latino,25,2,27
197318,Cholesterolosis of gallbladder,ethnic,Not Hispanic or Latino,12,16,28
434822,Complication of internal prosthetic device,ethnic,Hispanic or Latino,9,18,27
372423,Reduction deformities of brain,racial,Other Race,18,9,27
78497,Cellulitis and abscess of toe,racial,Other Race,18,9,27
4329847,MI - Myocardial infarction,ethnic,Hispanic or Latino,5,23,28
376946,Senile delirium,racial,Unknown,28,0,28
28461,Hypertrophy of salivary gland,racial,White,5,23,28
440276,"Infection AND/OR inflammatory reaction due to internal prosthetic device, implant AND/OR graft",ethnic,Not Hispanic or Latino,21,7,28
198263,Right upper quadrant pain,racial,Black or African American ,18,9,27
138525,Pain in limb,racial,Filipino,7,21,28
77644,Adhesive capsulitis of shoulder,racial,American Indian or Alaska Native ,16,12,28
372903,Retinal edema,racial,Other Race,25,2,27
433134,Histoplasmosis,racial,White,0,28,28
4181357,Malignant tumour of renal pelvis,ethnic,Hispanic or Latino,0,28,28
136982,Trichiasis without entropion,racial,White,12,16,28
136575,Nonvenomous insect bite with infection,ethnic,Not Hispanic or Latino,25,2,27
373488,Pupil-sparing third nerve palsy,racial,Unknown,18,9,27
4124693,Hypertrophic cardiomyopathy,ethnic,Hispanic or Latino,28,0,28
434782,Closed fracture of tibia AND fibula,racial,White,23,5,28
4170576,Pressure ulcer,racial,Asian,5,23,28
197806,Primary malignant neoplasm of gallbladder,racial,White,23,5,28
440068,Psychosexual dysfunction,ethnic,Hispanic or Latino,0,28,28
79116,Disorder of tendon of shoulder region,ethnic,Not Hispanic or Latino,14,14,28
4096783,Total prostatectomy,ethnic,Hispanic or Latino,0,28,28
443378,Anabolic steroids adverse reaction,racial,Unknown,0,28,28
78890,Sprain of elbow and forearm,racial,Unknown,25,2,27
443891,Cementum caries,racial,White,14,14,28
438208,Atrophy of vulva,ethnic,Hispanic or Latino,28,0,28
4013457,"Closed fracture of proximal humerus, unspecified part",ethnic,Hispanic or Latino,18,9,27
320116,Acute pericarditis,racial,White,5,23,28
4147961,Screening for malignant neoplasm of breast,racial,Native Hawaiian or Other Pacific Islander ,28,0,28
4028641,Pregnancy and drug dependence,racial,Unknown,28,0,28
26727,Vomiting blood,ethnic,Not Hispanic or Latino,16,12,28
196796,Congenital biliary atresia,ethnic,Not Hispanic or Latino,16,12,28
4206460,Problem,racial,Unknown,12,16,28
4310682,Multiple open wounds with complication,ethnic,Not Hispanic or Latino,9,18,27
438791,Pulmonary congestion and hypostasis,ethnic,Hispanic or Latino,23,5,28
377811,Primary malignant neoplasm of retina (primary),ethnic,Hispanic or Latino,5,23,28
4302252,High risk pregnancy care,racial,Filipino,28,0,28
196149,Acute appendicitis with generalized peritonitis,racial,White,2,25,27
440697,Nonaggressive unsocial conduct disorder,racial,White,12,16,28
200873,Open wound of lateral abdominal wall with complication,ethnic,Hispanic or Latino,25,0,25
444069,Abrasion AND/OR friction burn of leg with infection,ethnic,Hispanic or Latino,14,12,26
372610,Post-concussion syndrome,ethnic,Not Hispanic or Latino,16,9,25
194158,Perinatal gastrointestinal hemorrhage,racial,White,9,16,25
374025,Retinal haemorrhages,racial,Unknown,16,9,25
316501,Disorder of blood vessels affecting skin,racial,Unknown,7,18,25
73673,Disorder of prosthetic joint,racial,Unknown,16,9,25
373204,Conjunctival xerosis,racial,White,2,23,25
437474,Postoperative infection,ethnic,Not Hispanic or Latino,23,2,25
74777,Closed fracture of astragalus,ethnic,Hispanic or Latino,14,12,26
74132,Degeneration of lumbosacral intervertebral disc,racial,American Indian or Alaska Native ,25,0,25
442862,"Abrasion or friction burn of hand, without mention of infection",ethnic,Not Hispanic or Latino,7,18,25
435516,Lipoprotein deficiency disorder,racial,Other Race,9,16,25
313792,PT - Paroxysmal tachycardia,ethnic,Not Hispanic or Latino,18,7,25
439382,Disorder of hypothalamus,ethnic,Not Hispanic or Latino,25,0,25
440519,Premature - weight 1000g-2499g or gestation of 28-37weeks,ethnic,Not Hispanic or Latino,5,21,26
433783,Pulmonary artery aneurysm,racial,White,25,0,25
30437,Gastroesophageal reflux disease with esophagitis,racial,Black or African American ,14,12,26
79936,Polyuria,racial,Other Race,5,21,26
4001998,Pulmonary apoplexy,racial,Unknown,25,0,25
438399,Chronic schizophrenia with acute exacerbations,racial,Unknown,0,25,25
196168,Irregular menstrual bleeding,racial,American Indian or Alaska Native ,25,0,25
133147,Primary malignant neoplasm of skin of trunk,ethnic,Hispanic or Latino,18,7,25
435657,Sleep problem,racial,White,9,16,25
442603,Malignant hypertensive heart AND renal disease,racial,White,14,12,26
437038,Blood in urine,racial,Filipino,16,9,25
40481819,Early satiety,racial,White,18,7,25
435912,Endocardial cushion defect,racial,White,9,16,25
4147414,Varicose veins of legs in pregnancy,ethnic,Hispanic or Latino,25,0,25
381854,Disorder of conjunctiva,ethnic,Hispanic or Latino,16,9,25
441553,Myoclonus,racial,Unknown,9,16,25
435875,"Complications of pregnancy, childbirth and the puerperium",racial,Unknown,23,2,25
442270,Disease of duodenum,racial,White,9,16,25
376111,Unqualified visual loss of one eye,ethnic,Not Hispanic or Latino,14,12,26
381316,CVA - Cerebrovascular accident,racial,Other Race,12,14,26
201618,Disease of intestine,racial,White,7,18,25
381295,Age-related cataract,racial,Other Race,16,9,25
4261613,Educational problem,racial,Other Race,2,23,25
4247802,Muscular dystrophy,racial,Unknown,25,0,25
4096347,Gouty arthropathy,racial,Black or African American ,16,9,25
375252,Disorder of eye,racial,Other Race,9,16,25
437943,Pulp abscess of finger,racial,Unknown,9,16,25
312950,IgE-mediated allergic asthma,racial,Native Hawaiian or Other Pacific Islander ,5,21,26
138148,Plantar nerve lesion,racial,Unknown,21,5,26
435315,Torsion of testis,ethnic,Hispanic or Latino,0,25,25
200873,Open wound of lateral abdominal wall with complication,racial,Unknown,25,0,25
439702,Residual infantile autism,racial,White,0,25,25
440829,Fetus and newborn affected by noxious influences transmitted via placenta or breast milk,ethnic,Not Hispanic or Latino,5,21,26
444438,Leucoplakia of tongue,ethnic,Hispanic or Latino,7,18,25
81379,Lateral epicondylitis,racial,Other Race,14,12,26
377811,Primary malignant neoplasm of retina (primary),racial,White,2,23,25
434146,Common ventricle,ethnic,Hispanic or Latino,25,0,25
194079,Post-surgical malabsorption,racial,Asian,25,0,25
136237,Cardiovascular system problem,ethnic,Not Hispanic or Latino,5,21,26
141666,Acute osteomyelitis of lower leg,ethnic,Hispanic or Latino,7,18,25
435636,Juvenile osteochondritis of hip AND/OR pelvis,racial,White,0,25,25
432285,Recurrent major depressive episodes,racial,Native Hawaiian or Other Pacific Islander ,7,18,25
436409,Abnormal pupil,racial,White,12,14,26
195007,Female stress incontinence,racial,American Indian or Alaska Native ,25,0,25
256909,Primary pulmonary coccidioidomycosis,racial,White,25,0,25
4112954,Unspecified spontaneous abortion without mention of complication,ethnic,Hispanic or Latino,25,0,25
372721,Congenital anomaly of cerebrovascular system,racial,Unknown,16,9,25
75344,Intervertebral disc disorder,racial,Black or African American ,0,25,25
4168213,Chest pain on breathing,racial,Black or African American ,9,16,25
432742,Closed skull fracture without intracranial injury,ethnic,Hispanic or Latino,7,18,25
4304916,Gastrointestinal tract finding,ethnic,Hispanic or Latino,25,0,25
438399,Chronic schizophrenia with acute exacerbations,ethnic,Hispanic or Latino,0,25,25
77960,Joint observation,racial,White,18,7,25
261324,Pneumonia due to Streptococcus,racial,White,21,5,26
4166776,Dupuytren contracture,racial,Unknown,12,14,26
199074,Acute pancreatitis,racial,Black or African American ,21,5,26
198198,Vaginal polyp,ethnic,Hispanic or Latino,25,0,25
81937,Traumatic arthropathy of the hand,ethnic,Hispanic or Latino,25,0,25
260130,Partial bilateral paralysis of vocal cords,racial,White,2,23,25
193239,Diverticulitis of small intestine,racial,Unknown,25,0,25
134116,Dermatitis due to drug AND/OR medicine taken internally,racial,Unknown,23,2,25
135032,Dermatitis due to substances taken internally,racial,White,18,7,25
253797,Post-inflammatory pulmonary fibrosis,racial,Asian,23,2,25
439248,"Mixed bipolar affective disorder, moderate",racial,Unknown,25,0,25
72714,Chronic polyarticular juvenile rheumatoid arthritis,ethnic,Hispanic or Latino,14,12,26
30234,Cervical sprain,racial,Black or African American ,16,9,25
435227,Nutritional deficiency,ethnic,Not Hispanic or Latino,14,12,26
377849,Retinal deposits,racial,White,23,2,25
442011,Mechanical complication due to cardiac pacemaker electrode,racial,White,23,2,25
4024361,Paralysis of glottis,racial,Asian,25,0,25
437677,Abnormal findings on diagnostic imaging of lung,racial,Black or African American ,7,18,25
436386,Severe depressed bipolar I disorder with psychotic features,racial,Black or African American ,0,25,25
197036,Vesicoureteral reflux,racial,Unknown,23,2,25
372608,Amnestic disorder,racial,Black or African American ,25,0,25
257683,Postnasal drip,racial,Black or African American ,12,14,26
199886,Simple endometrial hyperplasia,racial,White,25,0,25
75121,Burn of lower leg,ethnic,Hispanic or Latino,25,0,25
80816,Intervertebral disc degeneration,racial,Asian,14,12,26
137053,Seborrheic dermatitis,racial,American Indian or Alaska Native ,21,5,26
373474,Seeing double,ethnic,Not Hispanic or Latino,21,5,26
259865,Cyst of Bartholin's gland duct,racial,Black or African American ,25,0,25
81112,Arthralgia of the lower leg,racial,Native Hawaiian or Other Pacific Islander ,9,16,25
4283532,Psychogenic headache,ethnic,Not Hispanic or Latino,25,0,25
440916,Burn to wrist/hand - blister,ethnic,Hispanic or Latino,16,9,25
199877,Mucous polyp of cervix,racial,Asian,25,0,25
444071,Furuncle of forearm,ethnic,Not Hispanic or Latino,14,12,26
440372,Acquired thrombocytopenia,racial,White,2,23,25
438527,"Juvenile osteochondrosis of lower extremity, excluding foot",ethnic,Not Hispanic or Latino,12,14,26
434311,Disorder of the urea cycle metabolism,racial,White,7,18,25
133726,Carcinoma in situ of skin of face,ethnic,Hispanic or Latino,23,2,25
432513,Animal bite wound,ethnic,Not Hispanic or Latino,18,7,25
255334,Collagen disease,racial,White,25,0,25
436232,"Polycystic kidney disease, adult type",ethnic,Hispanic or Latino,25,0,25
79115,"Spondylopathy, NOS",racial,White,25,0,25
201111,Congenital renal dysplasia,racial,Unknown,25,0,25
441963,Prader-Willi syndrome,racial,White,0,25,25
139882,Endometriosis in scar of skin,ethnic,Hispanic or Latino,25,0,25
196454,Colostomy and enterostomy malfunction,racial,White,9,16,25
200149,Placenta previa with hemorrhage - not delivered,ethnic,Hispanic or Latino,25,0,25
434904,Persistent hypersomnia,racial,Other Race,0,25,25
141663,Osteomyelitis,racial,Unknown,14,12,26
433749,Heparin-induced thrombocytopenia,ethnic,Not Hispanic or Latino,0,25,25
444200,Neoplasm of nervous system,racial,White,18,7,25
312935,Venous hypertension,racial,White,7,18,25
433585,Klippel-Feil sequence,racial,White,7,18,25
79742,Primary genital syphilis,racial,White,0,25,25
192239,Post-herpetic polyneuropathy,racial,Other Race,0,25,25
433657,Fall from furniture,racial,Unknown,16,9,25
433031,Hallucinations,ethnic,Not Hispanic or Latino,12,14,26
374013,Secondary Parkinson's disease,racial,Black or African American ,0,25,25
138858,Pale complexion,racial,White,18,7,25
140949,Scabies,racial,Black or African American ,9,16,25
198263,Right upper quadrant pain,racial,American Indian or Alaska Native ,21,5,26
436252,Closed fracture of shaft of tibia,racial,White,16,9,25
432677,Habitual aborter-not pregnant,ethnic,Hispanic or Latino,25,0,25
433446,Mucopolysaccharidosis,ethnic,Hispanic or Latino,12,14,26
255677,Open wound of nose without complication,ethnic,Hispanic or Latino,9,16,25
197223,Enterobiasis,racial,Unknown,5,21,26
314423,"Benign essential hypertension complicating pregnancy, childbirth and the puerperium - not delivered",ethnic,Not Hispanic or Latino,25,0,25
381839,Habit disorder,racial,Unknown,2,23,25
74114,Cellulitis and abscess of foot excluding toe,racial,Other Race,2,23,25
4100369,Unspecified schizoaffective schizophrenia,ethnic,Not Hispanic or Latino,25,0,25
81902,Urinary tract infectious disease,racial,Native Hawaiian or Other Pacific Islander ,25,0,25
437477,[X]Fall involving playground equipment,ethnic,Hispanic or Latino,14,12,26
319843,Mitral valve disorder,racial,Black or African American ,25,0,25
443933,Nicotiana tabacum poisoning,racial,Unknown,14,12,26
433783,Pulmonary artery aneurysm,ethnic,Not Hispanic or Latino,25,0,25
200452,Disease of female genital organ,ethnic,Not Hispanic or Latino,25,0,25
378752,Corneal opacity,racial,Unknown,16,9,25
132408,Back problem,racial,Black or African American ,16,9,25
433600,"Problem, abnormal test",racial,White,23,2,25
372608,Amnestic disorder,ethnic,Not Hispanic or Latino,25,0,25
78593,Open wound of wrist without complication,ethnic,Hispanic or Latino,12,14,26
74211,Superficial injury of finger without infection,ethnic,Hispanic or Latino,12,14,26
439294,"Malignant neoplasm of head, neck and face",racial,White,12,14,26
442603,Malignant hypertensive heart AND renal disease,ethnic,Hispanic or Latino,14,12,26
439971,Poisoning by anticoagulant,ethnic,Hispanic or Latino,14,12,26
437947,Complication of obstetrical surgical wound,racial,White,25,0,25
439285,"Hodgkin disease, lymphocytic depletion of intra-abdominal lymph nodes",racial,Unknown,25,0,25
318712,Peripheral circulatory disorder associated with type I diabetes mellitus,racial,Other Race,2,23,25
79938,Closed fracture of scapula,ethnic,Hispanic or Latino,23,2,25
320682,Finding of white blood cell number,ethnic,Not Hispanic or Latino,18,7,25
259848,Chronic rhinitis,racial,Native Hawaiian or Other Pacific Islander ,12,14,26
4093344,Prostate observation,racial,Filipino,2,23,25
433656,Abnormal patient reaction,ethnic,Hispanic or Latino,21,5,26
73341,Closed fracture of head of radius,ethnic,Not Hispanic or Latino,9,16,25
258453,Acute upper respiratory infection of multiple sites,racial,Unknown,23,2,25
133737,Acute thyroiditis,ethnic,Hispanic or Latino,25,0,25
193306,Situs inversus,racial,White,5,21,26
375504,Psychoactive substance-induced organic mental disorder,racial,Unknown,2,23,25
4179925,Basic learning problem,racial,Unknown,21,5,26
435785,Meningitis,racial,Unknown,7,18,25
73045,Hand sprain,racial,Black or African American ,5,21,26
4100091,Child attention deficit disorder NOS,ethnic,Hispanic or Latino,7,18,25
74729,Ganglion and synovial cyst,racial,Asian,16,9,25
139850,Acute frontal sinusitis,racial,Black or African American ,7,18,25
378414,Separation of retinal layers,racial,Black or African American ,25,0,25
4064905,Venereal disease screening,racial,American Indian or Alaska Native ,21,5,26
437175,"Fall on same level from slipping, tripping or stumbling",ethnic,Not Hispanic or Latino,18,7,25
444090,Disease of foot,racial,Unknown,18,7,25
80249,Sprain of acromioclavicular ligament,ethnic,Hispanic or Latino,9,16,25
439694,Hypertensive heart and renal disease with both (congestive) heart failure and renal failure,racial,Other Race,0,25,25
434902,Autistic disorder of childhood onset,racial,Other Race,7,18,25
444198,Intracranial hemorrhage following injury with loss of consciousness,racial,American Indian or Alaska Native ,0,25,25
80568,Traumatic amputation of finger without mention of complication,racial,Unknown,0,25,25
135061,Congenital anomaly of musculoskeletal system,racial,White,14,12,26
4298697,Multiple open wounds without complication,racial,Black or African American ,12,14,26
4147466,Panic disorder with agoraphobia,racial,Unknown,25,0,25
4283532,Psychogenic headache,ethnic,Hispanic or Latino,23,2,25
442609,Friction blister without infection,ethnic,Not Hispanic or Latino,7,18,25
440385,Obstructive hydrocephalus,racial,Asian,14,12,26
137626,Seborrhoeic eczema of scalp,racial,Unknown,7,18,25
75051,Derangement of posterior horn of medial meniscus,ethnic,Not Hispanic or Latino,25,0,25
318736,Migraine,racial,American Indian,25,0,25
135777,Neoplasm of uncertain behaviour of skin,racial,Other Race,25,0,25
378442,Conductive hearing loss of combined sites,ethnic,Hispanic or Latino,5,21,26
199875,Vaginal wall prolapse without uterine prolapse,ethnic,Hispanic or Latino,25,0,25
439653,Partial epilepsy without mention of impairment of consciousness,ethnic,Hispanic or Latino,5,21,26
435553,Watery eye,ethnic,Not Hispanic or Latino,25,0,25
434146,Common ventricle,racial,White,25,0,25
443262,Lack or loss of sexual desire,ethnic,Hispanic or Latino,12,14,26
434153,Chromosomopathy,ethnic,Not Hispanic or Latino,9,16,25
443262,Lack or loss of sexual desire,racial,White,12,14,26
4100369,Unspecified schizoaffective schizophrenia,racial,White,18,7,25
194993,Intestinal malabsorption,racial,White,18,7,25
436802,Complete trisomy 13 syndrome,ethnic,Hispanic or Latino,25,0,25
4059157,Family circumstance NOS,racial,Unknown,21,5,26
201527,Neoplasm of uncertain behaviour of prostate,ethnic,Hispanic or Latino,0,25,25
312437,Dyspnea,racial,American Indian or Alaska Native ,25,0,25
4111255,Unspecified labyrinthitis,ethnic,Hispanic or Latino,5,21,26
4114314,Screening for osteoporosis,racial,Black or African American ,23,2,25
380818,Acquired deformity of head,racial,White,16,9,25
318772,Disease of pericardium,racial,Unknown,21,5,26
254387,Upper respiratory tract hypersensitivity reaction,racial,Asian,9,16,25
434272,Varicella infection,racial,Unknown,12,14,26
133280,Alopecia,racial,Other Race,16,9,25
434502,Closed fracture of phalanx of toe,racial,Other Race,16,9,25
314962,Raynaud disease,racial,Unknown,16,9,25
436348,Primary malignant neoplasm of anal canal,ethnic,Hispanic or Latino,9,16,25
437359,Osteochondritis dissecans,ethnic,Hispanic or Latino,18,7,25
376417,Middle ear conductive hearing loss,racial,Unknown,25,0,25
439081,Premenstrual tension syndrome,racial,Unknown,25,0,25
4261613,Educational problem,racial,Unknown,5,21,26
316127,Vitreous opacities,racial,Unknown,21,5,26
433527,Endometriosis,racial,Unknown,25,0,25
197044,Female infertility associated with anovulation,racial,Unknown,25,0,25
372912,Visual discomfort,racial,Unknown,14,12,26
72778,Open wound of toe(s) without mention of complication,ethnic,Not Hispanic or Latino,21,5,26
192885,Tarsal tunnel syndrome,racial,White,18,7,25
195867,Noninflammatory vaginal disorders,racial,Asian,25,0,25
436962,Sleeplessness,racial,Native Hawaiian or Other Pacific Islander ,21,5,26
74470,Congenital anomaly of upper limb,ethnic,Hispanic or Latino,14,12,26
138682,Herpes zoster auricularis,racial,Unknown,25,0,25
312723,Congenital heart disease,racial,Filipino,0,25,25
79115,"Spondylopathy, NOS",ethnic,Not Hispanic or Latino,25,0,25
4201717,Ileostomy present,racial,White,14,12,26
134331,Cauda equina syndrome without neurogenic bladder,ethnic,Hispanic or Latino,23,2,25
133794,Chronic gingivitis,racial,Asian,23,2,25
77421,Open wound of hand except fingers without complication,racial,Other Race,0,25,25
260841,Perinatal subarachnoid hemorrhage,racial,White,18,7,25
195245,Reflex sympathetic dystrophy,racial,Black or African American ,25,0,25
76835,Closed dislocation of elbow,racial,White,14,12,26
133141,Tinea pedis,racial,Filipino,5,21,26
433446,Mucopolysaccharidosis,racial,White,12,14,26
80180,Osteoarthritis,racial,Asian Indian,25,0,25
75103,Sprain of jaw,racial,White,14,12,26
443913,Congenital anomaly of trachea,ethnic,Not Hispanic or Latino,0,25,25
316127,Vitreous opacities,racial,Asian,16,9,25
75004,Frank hematuria,racial,Asian,2,23,25
440985,Phobia,ethnic,Not Hispanic or Latino,18,7,25
4165091,Lack of exercise,racial,Other Race,14,12,26
376981,Amblyopia,racial,White,7,18,25
432941,Disease of tongue,ethnic,Not Hispanic or Latino,18,7,25
377252,Neurofibromatosis type 1,ethnic,Not Hispanic or Latino,0,25,25
313878,Respiratory symptoms,racial,Native Hawaiian or Other Pacific Islander ,14,12,26
193530,Follicular cyst of ovary,ethnic,Not Hispanic or Latino,25,0,25
440203,Fetus OR newborn affected by condition of umbilical cord,ethnic,Hispanic or Latino,12,14,26
194149,Hirschsprung disease,racial,White,12,14,26
375281,Acute suppurative otitis media - tympanic membrane intact,racial,Filipino,12,14,26
318445,Post cardiac operation functional disturbance,racial,Unknown,25,0,25
134438,CD - Contact dermatitis,racial,American Indian,21,5,26
4108905,Congenital malformation of the urinary system,ethnic,Not Hispanic or Latino,14,12,26
434887,Disorders of bilirubin excretion,ethnic,Not Hispanic or Latino,14,12,26
201618,Disease of intestine,racial,Asian,25,0,25
376564,Superficial injury of eye,ethnic,Hispanic or Latino,16,9,25
4103642,Amputated toe,racial,Black or African American ,2,23,25
436077,Developmental delay,racial,Asian,16,9,25
374886,Benign neoplasm of ear,ethnic,Hispanic or Latino,18,7,25
199867,CPH - Chronic persistent hepatitis,ethnic,Not Hispanic or Latino,21,5,26
432967,Anemia during pregnancy - baby not yet delivered,racial,Asian,25,0,25
197237,Benign tumour of prostate,racial,Unknown,0,25,25
434633,Disorder of autonomic nervous system,ethnic,Hispanic or Latino,12,14,26
73291,Palindromic rheumatism of the ankle and/or foot,racial,Asian,18,7,25
199991,Complication of transplanted kidney,ethnic,Hispanic or Latino,16,9,25
194696,Menorrhalgia,racial,Asian,25,0,25
440053,Infestation by insect,ethnic,Hispanic or Latino,16,9,25
140842,Changes in skin texture,racial,Other Race,16,9,25
439150,Hypersomnia with sleep apnea,racial,Unknown,23,2,25
135473,Dermatophytosis,racial,Asian,21,5,26
200461,Endometriosis of uterus,racial,White,25,0,25
441829,Hyperosmolality and or hypernatremia,ethnic,Not Hispanic or Latino,21,5,26
79939,Sprain of tarsometatarsal joint AND/OR ligament,ethnic,Hispanic or Latino,23,2,25
438749,Posterior subcapsular polar senile cataract,ethnic,Hispanic or Latino,16,9,25
376121,Recurrent pterygium,ethnic,Hispanic or Latino,12,14,26
195453,"Colitis, enteritis and gastroenteritis presumed infectious",racial,Other Race,12,14,26
4319150,Pulled elbow,racial,White,12,14,26
136198,Cervical spondylosis with myelopathy,racial,Unknown,5,21,26
433163,Deficiency of macronutrients,racial,Other Race,25,0,25
4030270,Proliferative polycythemia,ethnic,Not Hispanic or Latino,12,14,26
4012491,Difficulty chewing,racial,Asian,7,18,25
196733,Urethral syndrome,racial,White,21,5,26
196163,Cervicitis and endocervicitis,ethnic,Not Hispanic or Latino,21,5,26
199744,Carcinoma liver and/or biliary system,ethnic,Not Hispanic or Latino,0,25,25
4016675,"Sprain, ankle joint, medial",ethnic,Not Hispanic or Latino,9,16,25
4050572,Implantation of automatic cardiac defibrillator,racial,Asian,0,25,25
4194895,Screening for disorder,racial,Other Race,12,14,26
435315,Torsion of testis,racial,White,0,25,25
4155526,Acute otitis media with effusion,racial,Unknown,14,12,26
196157,Induratio penis plastica,racial,White,0,25,25
377290,Legal blindness USA,racial,Other Race,2,23,25
80482,Suppurative arthritis,ethnic,Hispanic or Latino,14,12,26
436230,Blood chemistry abnormal,racial,Filipino,23,2,25
443545,Nonvenomous insect bite,racial,Other Race,12,14,26
192242,Acute hepatitis C,racial,American Indian or Alaska Native ,0,25,25
435372,Underweight,racial,Other Race,5,21,26
442752,Myalgia,racial,American Indian,25,0,25
314479,Primary apnea in the newborn,racial,White,7,18,25
438028,Poisoning by drug AND/OR medicinal substance,racial,White,7,18,25
440525,Prematurity of fetus,racial,Unknown,9,16,25
376417,Middle ear conductive hearing loss,ethnic,Hispanic or Latino,25,0,25
375527,Headache disorder,racial,White,7,18,25
440009,Complication of implant,racial,Unknown,21,5,26
440612,Toxic effect of tobacco and nicotine,racial,White,7,18,25
373852,Neuralgia,racial,Other Race,14,12,26
373766,Retinopathy of prematurity,racial,Black or African American ,2,23,25
444198,Intracranial hemorrhage following injury with loss of consciousness,ethnic,Not Hispanic or Latino,0,25,25
192438,Abdominal mass,racial,Unknown,25,0,25
436953,Continuous chronic alcoholism,racial,White,7,18,25
81169,Superficial foreign body of finger without major open wound AND without infection,ethnic,Hispanic or Latino,14,12,26
198978,Acute gonorrhea of lower genitourinary tract,racial,Unknown,25,0,25
4160859,Methicillin resistant staphylococcus aureus carrier,racial,Unknown,18,7,25
375827,Acute non-suppurative otitis media - serous,racial,Asian,16,9,25
4100091,Child attention deficit disorder NOS,racial,White,7,18,25
23798,Acute laryngopharyngitis,racial,Unknown,14,12,26
435517,Acidosis,racial,Black or African American ,5,21,26
4239301,Unwanted pregnancy,racial,Unknown,25,0,25
26711,Chronic pharyngitis,racial,Unknown,18,7,25
436532,Congenital cytomegalovirus infection,ethnic,Hispanic or Latino,5,21,26
443409,On examination - left lower abdominal mass,racial,Unknown,23,2,25
198101,Lipoma of skin and subcutaneous tissue (excluding face),racial,Asian,12,14,26
436409,Abnormal pupil,ethnic,Hispanic or Latino,12,14,26
439294,"Malignant neoplasm of head, neck and face",ethnic,Not Hispanic or Latino,12,14,26
253482,Cortical blindness,racial,White,16,9,25
73840,Primary localised osteoarthrosis of shoulder region,racial,Native Hawaiian or Other Pacific Islander ,25,0,25
433180,Hallucinogen dependence,ethnic,Hispanic or Latino,0,25,25
196217,Congenital malformation of diaphragm,ethnic,Not Hispanic or Latino,0,25,25
436802,Complete trisomy 13 syndrome,racial,White,25,0,25
138463,Oral aphthae,racial,Other Race,25,0,25
312723,Congenital heart disease,racial,Asian,21,5,26
374025,Retinal haemorrhages,racial,Black or African American ,2,23,25
197022,Unilateral recurrent inguinal hernia with obstruction but no gangrene,racial,White,0,25,25
440379,Episodic opioid dependence,racial,White,7,18,25
441641,FTND - Full term normal delivery,ethnic,Hispanic or Latino,25,0,25
439304,Retinal round hole without detachment,racial,Unknown,25,0,25
443774,"Disease condition determination, uncontrolled",racial,White,12,14,26
141323,Acute maxillary sinusitis,racial,Asian,23,2,25
436658,Vitamin deficiency,racial,Asian,18,7,25
432967,Anemia during pregnancy - baby not yet delivered,racial,Other Race,25,0,25
321462,Cardiac complications of care,racial,Asian,0,25,25
194081,Acute cystitis,racial,Black or African American ,21,5,26
78272,Sprain of wrist,racial,Other Race,12,14,26
132466,Lumbar sprain,racial,Asian,21,5,26
320682,Finding of white blood cell number,ethnic,Hispanic or Latino,14,12,26
4024361,Paralysis of glottis,ethnic,Not Hispanic or Latino,25,0,25
376335,Asymptomatic neurosyphilis,racial,White,0,25,25
433440,Dysthymia,racial,Other Race,18,7,25
194018,"Functional enuresis, NOS",racial,American Indian or Alaska Native ,25,0,25
134452,Miners' elbow,racial,Unknown,0,25,25
443753,Abrasion AND/OR friction burn of wrist without infection,ethnic,Not Hispanic or Latino,5,21,26
136264,Open wound of floor of mouth without complication,racial,White,12,14,26
436675,Anorexia nervosa,racial,Unknown,25,0,25
432910,Disorder of lacrimal system,racial,Asian,25,0,25
198475,Gallstone ileus,ethnic,Hispanic or Latino,18,7,25
4053600,Open wound of elbow,ethnic,Hispanic or Latino,12,14,26
4139420,Foreign body in auditory canal,racial,Black or African American ,12,14,26
40490888,Herniation of rectum into vagina,racial,Unknown,25,0,25
73231,Arthralgia of temporomandibular joint,ethnic,Not Hispanic or Latino,21,5,26
320827,Atresia and stenosis of aorta,ethnic,Hispanic or Latino,18,7,25
378161,Disorder of ear,ethnic,Not Hispanic or Latino,14,12,26
4059014,Spontaneous bruising,ethnic,Not Hispanic or Latino,21,5,26
438064,Bacterial infection due to Pseudomonas,ethnic,Hispanic or Latino,21,5,26
444417,"Gestation period, 29 weeks",racial,White,0,25,25
441407,Appetite loss - anorexia,racial,Other Race,21,5,26
78237,Bicipital tenosynovitis,racial,Unknown,21,5,26
433454,Adjustment disorder with mixed emotional features,ethnic,Not Hispanic or Latino,25,0,25
75614,Acrodermatitis continua,racial,Native Hawaiian or Other Pacific Islander ,12,14,26
200527,Splenomegaly,ethnic,Not Hispanic or Latino,7,18,25
318448,"Incomplete atrioventricular block, second degree",racial,Unknown,5,21,26
434309,Sexual precocity,racial,Unknown,25,0,25
77965,Nodular tendinous disease of finger,racial,Asian,16,9,25
437478,Bite of nonvenomous arthropod,racial,Black or African American ,14,12,26
201951,Gonadal dysgenesis,ethnic,Hispanic or Latino,25,0,25
443891,Cementum caries,ethnic,Hispanic or Latino,23,2,25
378256,Abnormal reflex,ethnic,Hispanic or Latino,12,14,26
442604,Hypertensive heart disease,racial,American Indian or Alaska Native ,0,25,25
76150,Ulcer of rectum,racial,White,14,12,26
375825,Referred otalgia,ethnic,Hispanic or Latino,25,0,25
374950,Oedema of eyelid,racial,Unknown,12,14,26
258785,Pneumococcal pneumonia,racial,Unknown,16,9,25
374040,Ill-defined disorder of eye,racial,Unknown,16,9,25
439285,"Hodgkin disease, lymphocytic depletion of intra-abdominal lymph nodes",ethnic,Hispanic or Latino,25,0,25
375822,Neonatal obstruction of nasolacrimal duct,racial,Unknown,7,18,25
196061,Benign tumour of stomach,racial,Unknown,21,5,26
73300,Radial styloid tenosynovitis,racial,Unknown,25,0,25
380415,Acute swimmer's ear,racial,Asian,7,18,25
376335,Asymptomatic neurosyphilis,ethnic,Hispanic or Latino,0,25,25
443260,Umbilical lump,racial,White,23,2,25
74723,Arthropathy associated with a neurological disorder,racial,Unknown,7,18,25
439297,Nuclear senile cataract,ethnic,Not Hispanic or Latino,5,18,23
194985,Postgastric surgery syndrome,racial,White,23,0,23
442623,Abrasion AND/OR friction burn of scalp without infection,racial,Unknown,9,14,23
432586,Mental disorder,ethnic,Not Hispanic or Latino,12,12,24
320746,Cardiomyopathy associated with another disorder,racial,Black or African American ,0,23,23
4102808,Transsexuality with homosexual history,racial,White,0,23,23
436370,"Combined drug dependence, excluding opioids",racial,White,23,0,23
441691,Atypical squamous cells of undetermined significance on vaginal Papanicolaou smear,racial,Unknown,23,0,23
134870,Pityriasis versicolor,racial,Asian,14,9,23
136775,Contact dermatitis due to solar radiation,ethnic,Not Hispanic or Latino,18,5,23
438268,Closed dislocation of finger,ethnic,Hispanic or Latino,14,9,23
132932,Chronic ethmoidal sinusitis,racial,Unknown,9,14,23
436333,Orf virus disease,racial,White,12,12,24
434610,Hyperkalemia,racial,Black or African American ,18,5,23
439224,Drug allergy,racial,Other Race,7,16,23
73842,Enthesopathy of elbow region,racial,White,18,5,23
201075,Noninflammatory disorder of cervix,racial,Unknown,23,0,23
434327,Cannabis abuse,racial,Unknown,5,18,23
377254,"Multi-infarct dementia, uncomplicated",racial,Black or African American ,23,0,23
81378,Chondromalacia of patella,racial,Black or African American ,7,16,23
78516,Arthralgia of the upper arm,racial,Asian,16,7,23
319016,Retinal lattice degeneration,ethnic,Hispanic or Latino,12,12,24
133438,Chronic lymphoid leukaemia in remission,racial,White,14,9,23
74174,Urinary symptoms,ethnic,Hispanic or Latino,9,14,23
80225,Sprain of ligament of lumbosacral joint,racial,Unknown,12,12,24
76472,Dysplasia of anus,racial,White,2,21,23
373478,Presbyopia,racial,Black or African American ,23,0,23
374041,External ophthalmoplegia,racial,Unknown,23,0,23
443883,Acute disease,racial,Unknown,2,21,23
4175807,Rheumatic disease of tricuspid valve,racial,Unknown,18,5,23
194682,Bilateral inguinal hernia with obstruction but no gangrene,ethnic,Hispanic or Latino,0,23,23
313608,Closed fracture of T7-T12 level with spinal cord injury,ethnic,Hispanic or Latino,0,23,23
132702,Erythema multiforme,racial,White,9,14,23
25844,Ulcer of esophagus,racial,White,14,9,23
24609,Hypoglycaemia,racial,Other Race,16,7,23
76939,Neoplasm of uncertain behaviour of bone and articular cartilage,ethnic,Hispanic or Latino,23,0,23
442116,Allergy to eggs,racial,Unknown,9,14,23
441155,Closed trimalleolar fracture,ethnic,Hispanic or Latino,18,5,23
198551,"Embryonic cyst of cervix, vagina and external female genitalia",racial,White,23,0,23
319845,Pulmonary valve disease,racial,Unknown,23,0,23
81611,Diverticular disease of colon,racial,American Indian or Alaska Native ,16,7,23
193807,Anorectal fistula,racial,Unknown,7,16,23
200483,Disease of pelvis,racial,Unknown,9,14,23
77644,Adhesive capsulitis of shoulder,racial,Other Race,21,2,23
434056,Late effects of cerebrovascular disease,racial,American Indian or Alaska Native ,5,18,23
4168226,Micturition frequency and polyuria,racial,Unknown,12,12,24
198246,Congenital hiatus hernia,racial,White,16,7,23
81936,Monoarthritis,racial,White,9,14,23
432345,Hypertrophy of tongue papillae,ethnic,Hispanic or Latino,16,7,23
75512,Carcinoma in situ of colon,racial,Unknown,18,5,23
77644,Adhesive capsulitis of shoulder,racial,Asian,16,7,23
137944,Bullous dermatosis,ethnic,Not Hispanic or Latino,23,0,23
4083236,Alcoholism counselling,ethnic,Not Hispanic or Latino,23,0,23
4051114,FH: Diabetes mellitus,racial,Asian,18,5,23
140641,Verruca vulgaris,racial,Filipino,21,2,23
194755,Abdominal tenderness of left lower quadrant,ethnic,Hispanic or Latino,18,5,23
444388,Blister of leg without infection,ethnic,Hispanic or Latino,14,9,23
438066,Chlamydial infection,racial,Filipino,23,0,23
440069,Drug dependence,racial,Black or African American ,2,21,23
72712,Synovial cyst,racial,White,14,9,23
196444,Angiodysplasia of intestine,ethnic,Hispanic or Latino,18,5,23
441260,Drug withdrawal syndrome,racial,White,16,7,23
437525,Overweight,racial,Alaska Native,9,14,23
79768,Neoplasm of urinary system,racial,White,16,7,23
134331,Cauda equina syndrome without neurogenic bladder,ethnic,Not Hispanic or Latino,23,0,23
133141,Tinea pedis,racial,American Indian or Alaska Native ,18,5,23
200164,Urine-induced contact dermatitis,racial,Asian,5,18,23
443753,Abrasion AND/OR friction burn of wrist without infection,racial,Unknown,12,12,24
442775,Degeneration of thoracic intervertebral disc,ethnic,Not Hispanic or Latino,23,0,23
436176,Spontaneous abortion without complication,racial,Unknown,23,0,23
376102,Partial recent retinal detachment with single defect,ethnic,Hispanic or Latino,16,7,23
136025,Gp B streptococcal septicemia,racial,White,23,0,23
195316,Atypical endometrial hyperplasia,racial,White,23,0,23
378442,Conductive hearing loss of combined sites,racial,White,5,18,23
437400,Closed fracture of shaft of ulna,racial,White,5,18,23
443776,Brachial radiculitis,racial,Asian,16,7,23
441691,Atypical squamous cells of undetermined significance on vaginal Papanicolaou smear,ethnic,Not Hispanic or Latino,23,0,23
442793,Diabetic complication,racial,Filipino,12,12,24
201093,Infection of skin AND/OR subcutaneous tissue,racial,Asian,12,12,24
201951,Gonadal dysgenesis,racial,White,23,0,23
75954,Sprain of interphalangeal joint of finger,racial,White,16,7,23
194682,Bilateral inguinal hernia with obstruction but no gangrene,racial,White,0,23,23
375479,Kaposi's sarcoma of soft tissues,racial,Unknown,0,23,23
193983,Disorder of pancreatic internal secretion,racial,White,2,21,23
434173,Fever symptoms,racial,White,12,12,24
435640,"Gestation period, 25 weeks",ethnic,Hispanic or Latino,9,14,23
436235,Taste sense altered,racial,Black or African American ,23,0,23
375239,Cerebral degeneration,ethnic,Not Hispanic or Latino,23,0,23
438836,Poliomyelitis osteopathy of the lower leg,racial,White,16,7,23
73553,Arthropathy,racial,American Indian or Alaska Native ,23,0,23
444415,Severe epithelial dysplasia of bronchus,ethnic,Hispanic or Latino,14,9,23
132391,Furuncle of face,racial,White,5,18,23
198471,Complex endometrial hyperplasia,racial,White,23,0,23
433495,"Conductive hearing loss, bilateral",racial,White,12,12,24
200662,Lymphosarcoma,racial,Unknown,14,9,23
381035,Vertigo of central origin,racial,Unknown,9,14,23
376683,Non proliferative diabetic retinopathy,racial,Filipino,18,5,23
441805,Primary malignant neoplasm of endocervix,racial,Unknown,23,0,23
4193570,Abnormal results of hearing screening test,racial,Unknown,9,14,23
444070,Tachycardia,racial,Asian,14,9,23
4104555,Other and unspecified conjunctivitis,racial,White,14,9,23
377885,Disorder of eye movements,racial,Asian,14,9,23
134976,Complex dental caries,ethnic,Not Hispanic or Latino,9,14,23
380397,Keratoconjunctivitis,ethnic,Hispanic or Latino,16,7,23
253815,Ulceration of vulva,ethnic,Not Hispanic or Latino,23,0,23
193165,Adrenal disease,ethnic,Not Hispanic or Latino,23,0,23
440383,Depressive disorder,racial,American Indian,12,12,24
4114284,Chondrocalcinosis NOS,racial,Unknown,16,7,23
193261,Vaginospasm,ethnic,Hispanic or Latino,23,0,23
4100369,Unspecified schizoaffective schizophrenia,ethnic,Hispanic or Latino,16,7,23
375550,Senile corneal changes,racial,White,0,23,23
376525,Audiogram abnormal,racial,Unknown,12,12,24
435951,"Closed fracture of tibia and fibula, shaft",ethnic,Hispanic or Latino,12,12,24
75385,"Closed fracture distal humerus, lateral epicondyle",racial,White,18,5,23
433069,Open wound of external genital organs with complication,racial,Asian,9,14,23
320073,Neutrophil count below reference range,racial,Other Race,23,0,23
320827,Atresia and stenosis of aorta,racial,White,16,7,23
140273,"Contusion, forearm area",ethnic,Not Hispanic or Latino,16,7,23
378756,Conjunctival hemorrhage,racial,Asian,12,12,24
140173,Telogen effluvium,racial,White,23,0,23
314368,Mitral stenosis with insufficiency,racial,White,23,0,23
381278,Cluster headache,ethnic,Not Hispanic or Latino,18,5,23
375557,Cerebral embolism,racial,Unknown,23,0,23
437449,Victim of child abuse,racial,Unknown,18,5,23
199978,Contusion of lower limb,ethnic,Not Hispanic or Latino,16,7,23
440379,Episodic opioid dependence,ethnic,Not Hispanic or Latino,7,16,23
440631,Mycobacterial disease,racial,Asian,0,23,23
433457,Agoraphobia without mention of panic attacks,racial,Unknown,0,23,23
198715,Premature menopause,ethnic,Not Hispanic or Latino,23,0,23
75036,Primary localized osteoarthrosis of hand,racial,Other Race,23,0,23
4318408,Subdural haematoma,racial,White,5,18,23
30441,Sialolithiasis,ethnic,Hispanic or Latino,9,14,23
74052,Labyrinthitis,racial,Unknown,9,14,23
30437,Gastroesophageal reflux disease with esophagitis,racial,American Indian or Alaska Native ,23,0,23
77310,Deep vein phlebitis and thrombophlebitis of the leg,ethnic,Not Hispanic or Latino,2,21,23
25844,Ulcer of esophagus,racial,Unknown,7,16,23
134736,Backache,racial,Native Hawaiian or Other Pacific Islander ,16,7,23
437779,Streptococcal infectious disease,racial,White,2,21,23
137785,Verruca plantaris,racial,Other Race,12,12,24
437832,Malnutrition of mild degree (Gomez: 75% to less than 90% of standard weight),ethnic,Not Hispanic or Latino,23,0,23
4013916,Closed fracture of clavicle NOS,racial,White,7,16,23
197440,Nonvenomous insect bite of trunk without infection,racial,White,14,9,23
78474,Hypertrophy of breast,racial,Black or African American ,18,5,23
200687,Renal disorder associated with type I diabetes mellitus,racial,Black or African American ,0,23,23
4064905,Venereal disease screening,racial,Native Hawaiian or Other Pacific Islander ,23,0,23
435903,Juvenile osteochondrosis of foot,ethnic,Hispanic or Latino,2,21,23
4239301,Unwanted pregnancy,ethnic,Not Hispanic or Latino,23,0,23
378144,Disease of basal ganglia,racial,Unknown,0,23,23
432741,Abnormal immunology finding,racial,Asian,18,5,23
138790,Chronic periodontitis,ethnic,Hispanic or Latino,9,14,23
77395,Current tear of semilunar cartilage,racial,Other Race,18,5,23
139099,Ingrowing nail,racial,Black or African American ,14,9,23
436546,Strain of subscapularis muscle,racial,White,14,9,23
440631,Mycobacterial disease,ethnic,Not Hispanic or Latino,0,23,23
373775,Psychophysical visual disturbance,ethnic,Hispanic or Latino,23,0,23
372925,Cholesteatoma,ethnic,Hispanic or Latino,2,21,23
193016,Cystic disease of kidney,racial,Other Race,14,9,23
436730,"Appendicitis, unqualified",ethnic,Not Hispanic or Latino,5,18,23
440535,Abnormal radiographic examination,ethnic,Not Hispanic or Latino,9,14,23
442256,Disorder of bursae of shoulder region,racial,Black or African American ,7,16,23
440668,Benign tumour of tongue,ethnic,Hispanic or Latino,16,7,23
4079687,Tumor lysis syndrome,racial,White,0,23,23
440360,Pure hyperglyceridemia,racial,American Indian,12,12,24
4287237,Vascular hamartoma of skin,racial,Unknown,2,21,23
78472,Microscopic haematuria,racial,Filipino,5,18,23
78516,Arthralgia of the upper arm,racial,Other Race,9,14,23
433968,Candidiasis,racial,Black or African American ,16,7,23
4237140,Abnormal sexual function,ethnic,Hispanic or Latino,0,23,23
440374,Obsessive compulsive disorder,racial,Asian,21,2,23
439989,Insulin adverse reaction,ethnic,Hispanic or Latino,7,16,23
439382,Disorder of hypothalamus,racial,Black or African American ,23,0,23
438261,Neonatal jaundice due to delayed conjugation associated with another disease,ethnic,Hispanic or Latino,5,18,23
30968,Diabetes insipidus,ethnic,Not Hispanic or Latino,12,12,24
4296205,Second degree burn,ethnic,Not Hispanic or Latino,12,12,24
4104157,Genital observation,racial,White,18,5,23
441077,Stenosis of cervix,racial,White,23,0,23
440653,Infection by toxoplasma gondii,racial,Unknown,0,23,23
444391,Pain around eye,racial,Asian,18,5,23
197605,Inflammatory disorder of male genital organ,racial,White,0,23,23
443617,Conduct disorder,racial,Black or African American ,12,12,24
372610,Post-concussion syndrome,racial,Unknown,5,18,23
256215,"Lung agenesis, hypoplasia and dysplasia",ethnic,Hispanic or Latino,2,21,23
74189,Sprain of cruciate ligament of knee,racial,Unknown,12,12,24
440081,Barbiturate dependence,ethnic,Not Hispanic or Latino,21,2,23
444453,Benign tumour of soft tissue of leg,ethnic,Hispanic or Latino,9,14,23
437966,Calcium deposits in tendon,racial,Unknown,21,2,23
435836,Disorder of nasopharynx,racial,White,16,7,23
312648,Benign essential hypertension,racial,American Indian,21,2,23
4299535,Pregnancy confirmed,racial,Other Race,23,0,23
444415,Severe epithelial dysplasia of bronchus,racial,White,14,9,23
194395,Bleeding diverticulosis,racial,White,14,9,23
194265,Cryptosporidiasis,racial,Black or African American ,0,23,23
137944,Bullous dermatosis,racial,Unknown,23,0,23
440829,Fetus and newborn affected by noxious influences transmitted via placenta or breast milk,racial,Black or African American ,2,21,23
4131908,Diabetic peripheral vascular disease,racial,White,23,0,23
196168,Irregular menstrual bleeding,racial,Native Hawaiian or Other Pacific Islander ,23,0,23
4103894,Hordeolum and other deep inflammation of eyelid NOS,racial,Unknown,21,2,23
193520,Urinary bladder stone,racial,Unknown,2,21,23
140489,Acquired acanthosis nigricans,racial,Other Race,5,18,23
443295,Maternal care for diminished foetal movements,ethnic,Hispanic or Latino,23,0,23
440690,Social phobia,ethnic,Not Hispanic or Latino,12,12,24
4270866,Symptomatic dermographism,ethnic,Hispanic or Latino,16,7,23
442615,Carotid artery stenosis,racial,Other Race,18,5,23
377821,Neurological disorder associated with type I diabetes mellitus,racial,Asian,0,23,23
196436,Internal haemorrhoid,racial,Unknown,14,9,23
440021,Herpes simplex without complication,racial,Other Race,16,7,23
436671,Carcinoma in situ of anal canal,racial,White,0,23,23
374360,Disorder of optic nerve,racial,White,23,0,23
140526,Congenital anomaly of endocrine gland,racial,White,12,12,24
141917,Balanitis xerotica obliterans,ethnic,Not Hispanic or Latino,0,23,23
378752,Corneal opacity,racial,Other Race,0,23,23
436040,Infection by Strongyloides,ethnic,Hispanic or Latino,2,21,23
435150,Effects of heat AND/OR light,ethnic,Hispanic or Latino,23,0,23
4083236,Alcoholism counselling,racial,Unknown,23,0,23
374639,Chronic headache disorder,racial,White,23,0,23
133147,Primary malignant neoplasm of skin of trunk,racial,White,23,0,23
4168213,Chest pain on breathing,racial,Other Race,14,9,23
432801,"Injury undetermined whether accidentally or purposely inflicted, fall from natural site",racial,Asian,0,23,23
436098,Nondependent cocaine abuse in remission,ethnic,Hispanic or Latino,9,14,23
4062650,Malnutrition screening,racial,Black or African American ,12,12,24
76791,Acquired deformity of hip,racial,Unknown,12,12,24
195603,Vulval and/or perineal noninflammatory disorders,ethnic,Not Hispanic or Latino,23,0,23
440676,Neoplasm of uncertain behaviour of brain and spinal cord,racial,White,23,0,23
133088,Late amputation stump complication,ethnic,Hispanic or Latino,2,21,23
197917,Disorder of biliary tract,racial,Unknown,12,12,24
4105880,Contact of sexually transmissible disorder,racial,Asian,21,2,23
138717,Thyrotoxicosis with diffuse goitre,racial,White,12,12,24
257011,Acute upper respiratory infection,racial,American Indian,16,7,23
375277,Non-infectious pinna disorders,ethnic,Hispanic or Latino,9,14,23
252280,Neoplasm of respiratory tract,ethnic,Hispanic or Latino,9,14,23
443879,Epididymo-orchitis with abscess,ethnic,Hispanic or Latino,0,23,23
438731,Fat pad,racial,White,21,2,23
78243,Congenital spondylolysis of lumbosacral region,ethnic,Hispanic or Latino,12,12,24
441391,"Acquired forearm deformity, excluding fingers",racial,Unknown,0,23,23
372424,Congenital anolmaly of eye,racial,White,14,9,23
254591,Secondary malignant tumour of lung,racial,Unknown,0,23,23
434877,Hodgkin's disease of lymph nodes of axilla AND/OR upper limb,ethnic,Hispanic or Latino,23,0,23
257581,Exacerbation of asthma,racial,American Indian,18,5,23
201337,Disorder of bladder and bladder neck,ethnic,Not Hispanic or Latino,16,7,23
440921,Traumatic injury,racial,Black or African American ,0,23,23
377291,"Peripheral pterygium, progressive",ethnic,Not Hispanic or Latino,23,0,23
438536,Congenital anomaly of jaw,racial,Unknown,5,18,23
4113027,Dietary intake observations,racial,Filipino,12,12,24
4218874,Scimitar syndrome,ethnic,Hispanic or Latino,2,21,23
196523,Diarrhea,racial,Filipino,16,7,23
79069,Disease of rectum,ethnic,Not Hispanic or Latino,7,16,23
434896,Benign neoplasm of skin of upper limb and shoulder,racial,Unknown,21,2,23
193983,Disorder of pancreatic internal secretion,ethnic,Not Hispanic or Latino,2,21,23
4303805,Allergic reaction to bite and/or sting,ethnic,Not Hispanic or Latino,14,9,23
433260,Mother delivered,ethnic,Hispanic or Latino,23,0,23
4084229,Primary gout,racial,American Indian or Alaska Native ,16,7,23
261326,Viral pneumonia,racial,Unknown,5,18,23
374022,Hemiplegia,racial,Native Hawaiian or Other Pacific Islander ,0,23,23
200483,Disease of pelvis,ethnic,Not Hispanic or Latino,16,7,23
199856,Varicose veins of lower extremity with inflammation,racial,Filipino,0,23,23
4108079,Perceptive hearing loss NOS,racial,Unknown,14,9,23
440979,Acquired hemolytic anemia,racial,White,16,7,23
195012,Metrorrhagia,racial,Other Race,23,0,23
4152047,Lipid screening,racial,Asian,18,5,23
432517,Posttraumatic wound infection,ethnic,Not Hispanic or Latino,7,16,23
313608,Closed fracture of T7-T12 level with spinal cord injury,racial,White,0,23,23
252280,Neoplasm of respiratory tract,racial,White,9,14,23
376103,Retinopathy,racial,Other Race,14,9,23
442427,Cervical post-laminectomy syndrome,ethnic,Not Hispanic or Latino,23,0,23
134118,Atrophic condition of skin,racial,Black or African American ,16,7,23
440840,Neonatal candidiasis,ethnic,Hispanic or Latino,9,14,23
76472,Dysplasia of anus,ethnic,Hispanic or Latino,2,21,23
4013526,ESR raised,racial,Unknown,23,0,23
381036,Multiple AND bilateral precerebral artery stenosis,racial,Unknown,0,23,23
4055642,Other diseases of lung,ethnic,Not Hispanic or Latino,0,23,23
440431,Pneumonia due to Mycoplasma pneumoniae,racial,Unknown,23,0,23
4057825,Constipation NOS,ethnic,Not Hispanic or Latino,7,16,23
432801,"Injury undetermined whether accidentally or purposely inflicted, fall from natural site",ethnic,Not Hispanic or Latino,14,9,23
194133,Low back pain,racial,American Indian,23,0,23
193261,Vaginospasm,racial,White,23,0,23
79936,Polyuria,racial,Black or African American ,2,21,23
195771,Secondary diabetes mellitus,racial,Asian,21,2,23
76194,Osteoarthrosis involving multiple sites but not designated as generalized,racial,Black or African American ,23,0,23
140266,Superficial bruising of back,racial,Unknown,21,2,23
4114284,Chondrocalcinosis NOS,ethnic,Hispanic or Latino,16,7,23
80189,Displacement of lumbar intervertebral disc without myelopathy,racial,American Indian,0,23,23
438438,Acute myocardial infarction of anterolateral wall,racial,White,2,21,23
374372,Otogenic otalgia,racial,White,18,5,23
315831,Chronic pulmonary heart disease,racial,Asian,0,23,23
435524,Sleep disorder,racial,Black or African American ,7,16,23
313219,Phlebitis and thrombophlebitis,ethnic,Not Hispanic or Latino,16,7,23
31967,Nausea,racial,Asian,21,2,23
254058,Acute bronchiolitis due to respiratory syncytial virus,racial,Unknown,9,14,23
372634,Nonphysiologic vision loss,racial,Asian,16,7,23
435790,Spurious polycythaemia,racial,Unknown,2,21,23
73754,Restless legs,racial,Black or African American ,14,9,23
135303,Cyst of oral soft tissue,racial,White,14,9,23
134976,Complex dental caries,racial,Unknown,16,7,23
375292,Perforation of tympanic membrane,racial,Other Race,12,12,24
438398,Leukocytosis,racial,Asian,2,21,23
80498,Joint ankylosis of the ankle and/or foot,racial,White,23,0,23
436314,Accidental puncture AND/OR laceration during a procedure,racial,White,12,12,24
436040,Infection by Strongyloides,racial,Unknown,2,21,23
198471,Complex endometrial hyperplasia,ethnic,Hispanic or Latino,23,0,23
375428,Second cranial nerve injury,racial,White,0,23,23
441398,Anomaly of sex chromosome,ethnic,Hispanic or Latino,9,14,23
432966,Hypertrophy of vulva,ethnic,Hispanic or Latino,23,0,23
439907,Spontaneous tendon rupture,ethnic,Hispanic or Latino,21,2,23
441260,Drug withdrawal syndrome,ethnic,Not Hispanic or Latino,9,14,23
140654,Deep seated dermatophytosis,racial,White,9,14,23
441828,Disorganized schizophrenia,ethnic,Hispanic or Latino,2,21,23
433244,Tooth loss,racial,Unknown,2,21,23
320116,Acute pericarditis,ethnic,Hispanic or Latino,0,23,23
257007,Allergic rhinitis,racial,Asian Indian,18,5,23
4165091,Lack of exercise,racial,Filipino,9,14,23
198809,Acute cholecystitis,racial,Unknown,16,7,23
4131908,Diabetic peripheral vascular disease,ethnic,Hispanic or Latino,23,0,23
4129404,Open wound of upper arm,ethnic,Hispanic or Latino,7,16,23
4079687,Tumor lysis syndrome,ethnic,Not Hispanic or Latino,0,23,23
434889,"Hysterical neurosis, conversion type",racial,Unknown,23,0,23
75053,Fracture of bone,ethnic,Not Hispanic or Latino,12,12,24
27918,Eosinophilic esophagitis,racial,White,0,23,23
442441,Grand multiparity with antenatal problem,ethnic,Hispanic or Latino,23,0,23
4307254,Closed fracture,ethnic,Not Hispanic or Latino,5,18,23
201257,Disorder of endocrine ovary,ethnic,Hispanic or Latino,23,0,23
439128,Extreme immaturity,racial,White,18,5,23
4296024,Family disruption due to divorce,ethnic,Hispanic or Latino,5,18,23
140318,"Septicemia due to streptococcus, group A",racial,White,7,16,23
138148,Plantar nerve lesion,ethnic,Not Hispanic or Latino,23,0,23
435535,Aggressive type unsocialized behavior disorder,racial,Unknown,21,2,23
4204904,Education about sexually transmitted disease prevention,racial,Other Race,12,12,24
437993,Closed fracture of cervical spine,racial,Unknown,0,23,23
4065992,Cellulitis and abscess of finger unspecified,ethnic,Hispanic or Latino,12,12,24
438567,Adult failure to thrive syndrome,racial,White,9,14,23
192273,Benign tumour of adrenal gland,racial,Unknown,2,21,23
318169,Varicose veins of lower extremity,racial,Native Hawaiian or Other Pacific Islander ,23,0,23
136779,Disease of forearm,ethnic,Hispanic or Latino,16,7,23
75128,Injury of chest wall,racial,White,12,12,24
195212,Hypercortisolism,ethnic,Hispanic or Latino,12,12,24
440548,Closed fracture of lower end of femur,ethnic,Hispanic or Latino,14,9,23
196341,Dermatophytosis of the perianal area,racial,Asian,5,18,23
194079,Post-surgical malabsorption,racial,White,14,9,23
195300,Alcoholic gastritis,racial,Unknown,12,12,24
201211,Herpetic vulvovaginitis,ethnic,Hispanic or Latino,23,0,23
195861,Small kidney,ethnic,Hispanic or Latino,23,0,23
73241,Anal and rectal polyp,racial,Asian,23,0,23
81984,Sprain of shoulder and upper arm,racial,Asian,16,7,23
318775,Venous embolism,racial,American Indian or Alaska Native ,23,0,23
374912,Leukodystrophy,racial,White,18,5,23
73575,Deformity of toe,racial,Unknown,2,21,23
440794,Elderly primigravida - delivered,racial,White,23,0,23
436651,Hodgkin's disease of extranodal AND/OR solid organ site,racial,White,7,16,23
4100857,Pickwickian syndrome,racial,Asian,16,7,23
201344,Vesico-intestinal fistula,racial,Unknown,14,9,23
4102808,Transsexuality with homosexual history,ethnic,Hispanic or Latino,0,23,23
443587,Diastolic heart failure,racial,Black or African American ,2,21,23
76887,Disorders of urogenital prostheses or implants,ethnic,Not Hispanic or Latino,21,2,23
435739,Late syphilis,racial,Other Race,21,2,23
433596,Abnormal sputum,racial,Unknown,14,9,23
4215971,Obstructed incisional ventral hernia,ethnic,Hispanic or Latino,7,16,23
4062495,Glaucoma screening,racial,Black or African American ,16,7,23
314963,Giant cell arteritis,ethnic,Not Hispanic or Latino,2,21,23
318772,Disease of pericardium,racial,White,5,18,23
377286,VFD - Visual field defect,ethnic,Not Hispanic or Latino,9,14,23
381549,Migraine with aura,racial,Other Race,21,2,23
442299,Injury of female external genital organs,ethnic,Hispanic or Latino,0,23,23
4116861,Neuromyopathy,racial,White,16,7,23
378425,Eyelid inflammation,racial,Asian,16,7,23
374882,Benign connective tissue neoplasm,racial,Unknown,18,5,23
255841,Chronic bronchitis,racial,Native Hawaiian or Other Pacific Islander ,23,0,23
438536,Congenital anomaly of jaw,racial,Other Race,12,12,24
194611,CIN 3 - Cervical intraepithelial neoplasia grade 3,racial,Asian,23,0,23
199867,CPH - Chronic persistent hepatitis,ethnic,Hispanic or Latino,18,5,23
435656,Neonatal jaundice,racial,Asian,2,21,23
440457,Threatened abortion,racial,Unknown,23,0,23
381114,Microcephalus,ethnic,Not Hispanic or Latino,5,18,23
4006788,Percutaneous transluminal coronary balloon angioplasty,racial,White,9,14,23
77081,Tibialis tendinitis,ethnic,Hispanic or Latino,21,2,23
436370,"Combined drug dependence, excluding opioids",ethnic,Hispanic or Latino,23,0,23
440379,Episodic opioid dependence,racial,Unknown,16,7,23
199878,Light and infrequent menstruation,ethnic,Not Hispanic or Latino,16,7,23
73302,Curvature of spine,ethnic,Hispanic or Latino,7,16,23
81336,Rectal prolapse,ethnic,Not Hispanic or Latino,7,16,23
4206460,Problem,racial,Asian,9,14,23
372888,Sciatic nerve lesion,ethnic,Not Hispanic or Latino,18,5,23
81459,Unilateral traumatic amputation of foot with complication,racial,White,0,23,23
256439,Allergic rhinitis due to pollen,racial,Other Race,14,9,23
432285,Recurrent major depressive episodes,racial,Filipino,23,0,23
437663,Fever,racial,Filipino,12,12,24
4184877,Amputated finger,racial,White,0,23,23
376267,Superficial injury of conjunctiva,ethnic,Hispanic or Latino,9,14,23
377845,Anoxic encephalopathy,ethnic,Hispanic or Latino,23,0,23
437090,Hemolytic disease of fetus OR newborn due to ABO immunization,ethnic,Hispanic or Latino,2,21,23
134461,Tietze disease,racial,Black or African American ,12,12,24
200771,Peptic ulcer without hemorrhage AND without perforation but with obstruction,ethnic,Not Hispanic or Latino,2,21,23
444132,Knee injury,racial,Black or African American ,12,12,24
433540,Polyhydramnios with antenatal problem,racial,White,23,0,23
373185,Drug-induced dyskinesia,racial,White,23,0,23
439926,Malaise and fatigue,racial,Native Hawaiian or Other Pacific Islander ,9,14,23
78011,Sprain of metacarpophalangeal joint,racial,White,12,12,24
195300,Alcoholic gastritis,racial,White,7,16,23
435903,Juvenile osteochondrosis of foot,racial,White,2,21,23
441132,Laboratory finding abnormal,ethnic,Hispanic or Latino,7,16,23
194410,Male genital organ disorder associated with another disorder,ethnic,Hispanic or Latino,0,23,23
439166,Closed fracture of radius,ethnic,Not Hispanic or Latino,9,14,23
443400,Peritoneal cancer,ethnic,Hispanic or Latino,7,16,23
75650,Proteinuria,racial,Filipino,14,9,23
193530,Follicular cyst of ovary,racial,Unknown,23,0,23
195856,Cholangitis,ethnic,Hispanic or Latino,18,5,23
194093,Postcoital bleeding,ethnic,Not Hispanic or Latino,16,7,23
80498,Joint ankylosis of the ankle and/or foot,ethnic,Hispanic or Latino,23,0,23
432441,Finding of length of gestation,racial,Other Race,9,14,23
435532,Episodic chronic alcoholism,ethnic,Hispanic or Latino,0,23,23
437041,Mother not delivered,racial,Filipino,23,0,23
258785,Pneumococcal pneumonia,racial,White,16,7,23
4114472,Ear problem,ethnic,Hispanic or Latino,14,9,23
4103416,Drug dependence NOS,ethnic,Not Hispanic or Latino,23,0,23
134304,Benign tumour of parathyroid gland,racial,White,23,0,23
436209,Fracture of fibula,racial,Unknown,12,12,24
198528,Acquired unequal leg length,ethnic,Not Hispanic or Latino,9,14,23
76819,Congenital unilateral subluxation of hip,racial,White,2,21,23
200444,Post-cholecystectomy syndrome,racial,White,16,7,23
4110945,Benign hypertensive heart disease NOS,ethnic,Hispanic or Latino,9,14,23
4122116,Tooth eruption disturbances,ethnic,Hispanic or Latino,18,5,23
436539,Closed fracture of patella,racial,Unknown,12,12,24
438469,"Duodenal ulcer without hemorrhage, without perforation AND without obstruction",ethnic,Hispanic or Latino,23,0,23
436134,Disorder of sclera,ethnic,Hispanic or Latino,18,5,23
443178,"Insect bite, nonvenomous, of face",racial,White,9,14,23
4055642,Other diseases of lung,racial,Black or African American ,0,23,23
441321,Chronic nasopharyngitis,racial,White,12,12,24
437995,Closed ill-defined fractures of upper limb,racial,Other Race,23,0,23
133737,Acute thyroiditis,racial,White,23,0,23
197675,Bowel incontinence,racial,Unknown,14,9,23
433675,Toxic effect of chemical,ethnic,Hispanic or Latino,9,14,23
78518,Observation of shoulder joint,racial,Unknown,18,5,23
77076,Diastasis of muscle,racial,White,5,18,23
438329,Late effect of motor vehicle accident,ethnic,Not Hispanic or Latino,18,5,23
317305,Stricture of artery,racial,Unknown,0,23,23
195339,Decubitus ulcer of hip,racial,White,0,23,23
376382,Tension-type headache,racial,Black or African American ,14,9,23
75667,Sprain of calcaneofibular ligament,ethnic,Hispanic or Latino,18,5,23
75650,Proteinuria,racial,Native Hawaiian or Other Pacific Islander ,16,7,23
320073,Neutrophil count below reference range,racial,Asian,14,9,23
136834,Closed intertrochanteric fracture,racial,White,14,9,23
434084,Abscess of vulva,racial,Unknown,23,0,23
200774,Detrusor and sphincter dyssynergia,ethnic,Hispanic or Latino,23,0,23
444070,Tachycardia,racial,Other Race,21,2,23
194265,Cryptosporidiasis,ethnic,Not Hispanic or Latino,0,23,23
441541,Lymphocytopenia,ethnic,Hispanic or Latino,7,16,23
437064,Chondrocalcinosis,racial,Unknown,14,9,23
435613,Cellulitis,racial,Filipino,23,0,23
201387,Doubling of uterus,ethnic,Hispanic or Latino,23,0,23
372425,Congenital abnormality of ear,racial,Unknown,21,2,23
4194232,Absence seizure,ethnic,Hispanic or Latino,5,18,23
4100369,Unspecified schizoaffective schizophrenia,racial,Black or African American ,23,0,23
81144,Sprain of medial collateral ligament of knee,racial,Unknown,18,2,20
254061,Pleural effusion,racial,Other Race,5,16,21
381316,CVA - Cerebrovascular accident,racial,Asian,0,21,21
435613,Cellulitis,racial,Black or African American ,18,2,20
374372,Otogenic otalgia,racial,Unknown,18,2,20
380731,OE - Otitis externa,racial,Unknown,5,16,21
193814,Chronic parametritis and pelvic cellulitis,racial,White,21,0,21
200461,Endometriosis of uterus,ethnic,Hispanic or Latino,21,0,21
201352,Cholelithiasis AND acute cholecystitis with obstruction,ethnic,Hispanic or Latino,9,12,21
200450,Disease of urethra,ethnic,Not Hispanic or Latino,9,12,21
72471,Sprain of carpometacarpal joint,ethnic,Hispanic or Latino,9,12,21
317248,Disorder of hematopoietic structure,racial,Black or African American ,5,16,21
315361,Orthopnea,racial,White,12,9,21
200391,Peripheral autonomic neuropathy disease EC,racial,Native Hawaiian or Other Pacific Islander ,0,21,21
78524,Acquired deformity of finger,racial,White,7,14,21
433390,Immunosuppressant adverse reaction,ethnic,Hispanic or Latino,14,7,21
442019,Complication of procedure,ethnic,Hispanic or Latino,12,9,21
4139915,Acute pyelitis,racial,Unknown,16,5,21
381174,Contusion of globe of eye,ethnic,Hispanic or Latino,16,5,21
4196960,Varicocele,ethnic,Not Hispanic or Latino,0,21,21
372324,Eustachian tube disorder,racial,Black or African American ,9,12,21
441334,Glossodynia,racial,Unknown,16,5,21
133295,Inflammatory spondylopathy,racial,White,9,12,21
441190,Injury of unknown intent due to fall from height,ethnic,Not Hispanic or Latino,18,2,20
436954,Drug abuse,racial,Black or African American ,5,16,21
317248,Disorder of hematopoietic structure,racial,Other Race,9,12,21
313590,Perinatal respiratory failure,ethnic,Hispanic or Latino,9,12,21
376679,PMA - Progressive muscular atrophy,racial,White,0,21,21
444391,Pain around eye,racial,Other Race,12,9,21
201527,Neoplasm of uncertain behaviour of prostate,racial,White,0,21,21
438882,Closed fracture of neck of metacarpal bone,ethnic,Not Hispanic or Latino,5,16,21
433171,Selective IgA immunodeficiency,ethnic,Not Hispanic or Latino,16,5,21
40480639,Dissecting aneurysm of thoracoabdominal aorta,racial,White,0,21,21
436944,Chronic paranoid schizophrenia,racial,Asian,0,21,21
194683,Obstructed umbilical hernia,ethnic,Hispanic or Latino,14,7,21
132408,Back problem,racial,Other Race,12,9,21
4139681,Allergy to dairy product,ethnic,Not Hispanic or Latino,18,2,20
441207,Drug reaction,racial,Other Race,18,2,20
321080,"Hypertension complicating pregnancy, childbirth and the puerperium",racial,Unknown,21,0,21
4293175,"Mental state, behaviour and/or psychosocial function finding",racial,Asian,2,18,20
4103580,Unspecified senile cataract,racial,White,9,12,21
195599,Post-hysterectomy vaginal vault prolapse,racial,Unknown,21,0,21
4149353,"Attention deficit hyperactivity disorder, predominantly inattentive type",racial,Black or African American ,2,18,20
434281,Aspergillosis,racial,White,2,18,20
4283532,Psychogenic headache,racial,White,18,2,20
435219,Schizophrenia in remission,ethnic,Not Hispanic or Latino,0,21,21
439975,Injury at C1-C4 level with spinal cord injury AND without bone injury,ethnic,Not Hispanic or Latino,2,18,20
435553,Watery eye,racial,Asian,21,0,21
372906,Both eyes total visual impairment,racial,Other Race,0,21,21
76797,Congenital deformity of genital organ,ethnic,Hispanic or Latino,5,16,21
75637,Acquired postural kyphosis,racial,Asian,21,0,21
375527,Headache disorder,ethnic,Not Hispanic or Latino,14,7,21
4149560,Hand sprain unspecified,ethnic,Hispanic or Latino,14,7,21
439154,Abnormal findings on diagnostic imaging of skull and head,racial,Unknown,9,12,21
434011,Transvestism,ethnic,Not Hispanic or Latino,21,0,21
375283,Angular blepharoconjunctivitis,racial,Unknown,18,2,20
378087,Secondary malignant neoplasm of brain and spinal cord,ethnic,Hispanic or Latino,5,16,21
4102739,Screening for cardiovascular system disease,ethnic,Not Hispanic or Latino,2,18,20
438064,Bacterial infection due to Pseudomonas,racial,Unknown,21,0,21
373487,AION - Acute ischaemic optic neuropathy,racial,White,21,0,21
435149,Complication of internal device,ethnic,Hispanic or Latino,5,16,21
201688,Urinary hesitancy,racial,Other Race,18,2,20
192438,Abdominal mass,ethnic,Not Hispanic or Latino,21,0,21
312336,Arterial aneurysm,racial,White,7,14,21
194788,Open wound of anterior abdominal wall with complication,ethnic,Hispanic or Latino,5,16,21
74132,Degeneration of lumbosacral intervertebral disc,racial,Black or African American ,9,12,21
376707,Acute conjunctivitis,racial,Filipino,7,14,21
4140734,Amniocentesis for possible chromosomal abnormality,ethnic,Hispanic or Latino,21,0,21
437881,Malignant otitis externa,racial,White,14,7,21
254980,Intrinsic asthma with asthma attack,racial,Unknown,5,16,21
199978,Contusion of lower limb,racial,Unknown,9,12,21
4201745,Disease of digestive system,racial,White,14,7,21
23164,Disease of anterior pituitary,ethnic,Hispanic or Latino,18,2,20
4296205,Second degree burn,racial,Unknown,7,14,21
376106,Disorder of the central nervous system,racial,White,14,7,21
436381,Gender identity disorder of childhood,racial,White,2,18,20
373127,Herpes simplex disciform keratitis,racial,Unknown,18,2,20
75941,Closed fracture of one rib,racial,White,9,12,21
193525,Abdominal pregnancy,ethnic,Not Hispanic or Latino,21,0,21
80205,Perinatal condition,racial,White,21,0,21
193422,Primary malignant neoplasm of body of stomach,ethnic,Hispanic or Latino,7,14,21
433288,Derangement of anterior horn of lateral meniscus,racial,White,2,18,20
194526,Injury of trunk,racial,Unknown,14,7,21
433257,Mesangiocapillary glomerulonephritis,racial,White,14,7,21
444419,Quadriparesis,racial,White,0,21,21
372721,Congenital anomaly of cerebrovascular system,racial,White,2,18,20
4171430,Screening for malignant neoplasm of rectum,racial,American Indian or Alaska Native ,16,5,21
259865,Cyst of Bartholin's gland duct,racial,Unknown,21,0,21
197950,Cellulitis and abscess of trunk,racial,Other Race,14,7,21
433996,Catatonic schizophrenia,ethnic,Hispanic or Latino,16,5,21
433996,Catatonic schizophrenia,racial,White,16,5,21
442299,Injury of female external genital organs,racial,White,0,21,21
436988,Enophthalmos due to atrophy of orbital tissue,ethnic,Hispanic or Latino,21,0,21
139757,Malignant melanoma of skin of lower limb,racial,White,14,7,21
440703,Trigeminal nerve disorder,ethnic,Hispanic or Latino,9,12,21
81426,Closed fracture of clavicle,racial,Other Race,9,12,21
4166080,Decompression of median nerve,racial,White,16,5,21
194685,Chronic non-obstructive atrophic pyelonephritis,racial,White,2,18,20
434328,"Nondependent cannabis abuse, episodic",ethnic,Hispanic or Latino,12,9,21
80187,Medial epicondylitis,ethnic,Not Hispanic or Latino,14,7,21
192286,Intestinal disaccharidase deficiency,racial,Other Race,7,14,21
312327,Acute myocardial infarction,racial,Asian,16,5,21
196444,Angiodysplasia of intestine,racial,Unknown,16,5,21
438701,UKP - Disseminated malignancy of unknown primary,racial,White,2,18,20
436839,Closed fracture of metacarpal bone,racial,Other Race,21,0,21
444413,Pyrexial convulsion,racial,Unknown,12,9,21
140190,Disorder of back,ethnic,Not Hispanic or Latino,16,5,21
372409,Sciatica neuralgia,racial,American Indian or Alaska Native ,18,2,20
373101,Injury of ulnar nerve,racial,Unknown,9,12,21
4129342,Nephrectomy of remaining or solitary kidney,racial,White,14,7,21
319825,Rheumatic heart disease,racial,Unknown,0,21,21
197921,Renal osteodystrophy,racial,Unknown,18,2,20
381292,Chronic allergic conjunctivitis,racial,Filipino,7,14,21
81685,Fracture of clavicle due to birth trauma,racial,White,7,14,21
4097272,Lipoma NOS,racial,White,12,9,21
442790,Growth and development,racial,Black or African American ,7,14,21
199151,Must strain to pass urine,racial,White,2,18,20
375791,Uncomplicated senile dementia,racial,Native Hawaiian or Other Pacific Islander ,0,21,21
135923,CP - Cleft palate,ethnic,Not Hispanic or Latino,9,12,21
192667,Atrophic gastritis,racial,Native Hawaiian or Other Pacific Islander ,21,0,21
440925,Suicide,ethnic,Hispanic or Latino,18,2,20
434459,Ganglion of tendon sheath,ethnic,Not Hispanic or Latino,16,5,21
314962,Raynaud disease,ethnic,Not Hispanic or Latino,21,0,21
375525,Athetoid cerebral palsy,racial,Other Race,21,0,21
198197,Male infertility,ethnic,Not Hispanic or Latino,0,21,21
374040,Ill-defined disorder of eye,racial,Asian,12,9,21
434467,Ostium secundum type atrial septal defect,racial,Other Race,2,18,20
77354,Primary localised osteoarthrosis of lower leg,racial,American Indian or Alaska Native ,21,0,21
434613,Generalized anxiety disorder,racial,American Indian or Alaska Native ,12,9,21
141004,Lesion of radial nerve,ethnic,Hispanic or Latino,2,18,20
438058,Rape - assault,racial,White,18,2,20
133278,Disorder of hair,ethnic,Not Hispanic or Latino,18,2,20
440973,Benign neoplasm of long bones of lower limb,racial,White,18,2,20
4171594,Family history of cancer,racial,White,14,7,21
199870,Renal vascular disorder,ethnic,Not Hispanic or Latino,2,18,20
437942,Caesarean delivery - delivered,ethnic,Not Hispanic or Latino,21,0,21
312935,Venous hypertension,racial,Black or African American ,0,21,21
435543,Primary angle-closure glaucoma,racial,Unknown,21,0,21
77644,Adhesive capsulitis of shoulder,racial,Black or African American ,21,0,21
138996,Carcinoma in situ of skin,ethnic,Not Hispanic or Latino,7,14,21
317002,Hypopiesis,racial,Other Race,16,5,21
193525,Abdominal pregnancy,racial,Unknown,21,0,21
443401,Congenital connective tissue disorder,ethnic,Not Hispanic or Latino,0,21,21
435081,Abnormal findings on diagnostic imaging of heart and coronary circulation,ethnic,Not Hispanic or Latino,12,9,21
194995,Disorder of ureter,ethnic,Not Hispanic or Latino,16,5,21
196438,Acquired arteriovenous fistula of liver,ethnic,Not Hispanic or Latino,5,16,21
132333,Acute perichondritis of pinna,ethnic,Hispanic or Latino,0,21,21
318566,Flushing,ethnic,Hispanic or Latino,14,7,21
4108242,Atrial fibrillation and flutter NOS,ethnic,Hispanic or Latino,7,14,21
192276,Chronic gouty nephropathy,racial,Other Race,0,21,21
4107924,Retinal detachment with defect NOS,racial,White,0,21,21
78228,Joint derangement,ethnic,Not Hispanic or Latino,2,18,20
380733,Otalgia,racial,Asian,18,2,20
4102166,Multiparous,ethnic,Hispanic or Latino,21,0,21
441793,Infection due to Class Cestoda and/or Class Trematoda and/or Phylum Nemata,racial,Unknown,16,5,21
435151,Physical child abuse,ethnic,Hispanic or Latino,0,21,21
435236,Acute exacerbation of chronic schizoaffective schizophrenia,ethnic,Hispanic or Latino,21,0,21
443409,On examination - left lower abdominal mass,ethnic,Not Hispanic or Latino,18,2,20
137054,Skin striae,ethnic,Hispanic or Latino,7,14,21
4332993,Childhood schizophrenia NOS,ethnic,Hispanic or Latino,2,18,20
256451,Bronchitis,racial,American Indian,14,7,21
4050793,FH: Infectious disease,ethnic,Hispanic or Latino,18,2,20
444406,Acute subendocardial infarction,racial,White,12,9,21
28779,Oesophageal varices with bleeding,racial,American Indian or Alaska Native ,21,0,21
433968,Candidiasis,racial,Other Race,12,9,21
4147414,Varicose veins of legs in pregnancy,racial,White,21,0,21
434592,B-cell lymphoma,racial,Unknown,21,0,21
373151,Primary malignant neoplasm of conjunctiva (primary),ethnic,Hispanic or Latino,0,21,21
434896,Benign neoplasm of skin of upper limb and shoulder,ethnic,Not Hispanic or Latino,7,14,21
437982,Semen observations,ethnic,Hispanic or Latino,0,21,21
434046,Unilateral mixed conductive and sensorineural hearing loss with unrestricted hearing on the contralateral side,ethnic,Hispanic or Latino,12,9,21
132412,Failed back syndrome,racial,White,5,16,21
197320,ARF - Acute renal failure,racial,Other Race,16,5,21
195245,Reflex sympathetic dystrophy,ethnic,Hispanic or Latino,9,12,21
438223,Sunburn of second degree,ethnic,Hispanic or Latino,9,12,21
440076,SS - Short stature,racial,Black or African American ,0,21,21
373852,Neuralgia,racial,Black or African American ,21,0,21
436976,Posterior subcapsular polar cataract,ethnic,Hispanic or Latino,12,9,21
77030,Disease of breast,racial,Black or African American ,21,0,21
79240,Dislocation of joint prosthesis,racial,Unknown,21,0,21
440058,Malignant lymphoma of extranodal AND/OR solid organ site,ethnic,Hispanic or Latino,18,2,20
140176,Erythema nodosum,racial,White,16,5,21
444115,Disorder of bursa,racial,Unknown,12,9,21
377368,Congenital absence of brain,ethnic,Hispanic or Latino,21,0,21
436670,MD - Metabolic disorders,racial,Other Race,18,2,20
376399,Incipient cataract,racial,Unknown,21,0,21
379019,Inflammation of conjunctiva,racial,American Indian or Alaska Native ,7,14,21
434011,Transvestism,racial,White,21,0,21
432923,SAH - Subarachnoid haemorrhage,ethnic,Not Hispanic or Latino,16,5,21
377845,Anoxic encephalopathy,racial,Unknown,21,0,21
75103,Sprain of jaw,racial,Unknown,14,7,21
196436,Internal haemorrhoid,ethnic,Not Hispanic or Latino,2,18,20
378756,Conjunctival hemorrhage,racial,Other Race,14,7,21
80177,Pyogenic arthritis of the pelvic region and thigh,racial,White,2,18,20
440695,Encopresis,racial,Unknown,12,9,21
442074,Focal membranoproliferative glomerulonephritis,racial,White,21,0,21
437655,Cryptorchism,racial,Other Race,0,21,21
319038,Postmyocardial infarction syndrome,ethnic,Hispanic or Latino,7,14,21
4308509,Impaired fasting glycaemia,racial,Filipino,7,14,21
195834,Atherosclerosis of renal artery,ethnic,Not Hispanic or Latino,5,16,21
25297,Acute pharyngitis,racial,American Indian,21,0,21
137345,Pressure ulcer stage 4,racial,Unknown,5,16,21
192673,Vascular insufficiency of intestine,racial,Unknown,21,0,21
439658,Gestosis,racial,White,16,5,21
321107,AR - Congenital aortic regurgitation,ethnic,Not Hispanic or Latino,0,21,21
441460,Late effect of sprain AND/OR strain without tendon injury,ethnic,Not Hispanic or Latino,14,7,21
440878,Open wound of jaw without complication,ethnic,Hispanic or Latino,18,2,20
195339,Decubitus ulcer of hip,racial,Unknown,21,0,21
4258683,Faeces - impacted,racial,White,14,7,21
377886,Chronic purulent otitis media,ethnic,Not Hispanic or Latino,7,14,21
196796,Congenital biliary atresia,racial,Asian,16,5,21
379784,Senile dementia with depression,ethnic,Not Hispanic or Latino,18,2,20
23325,Heartburn,racial,Asian,14,7,21
4014231,Foot sprain NOS,racial,White,5,16,21
197327,Female urinary-genital tract fistula,ethnic,Hispanic or Latino,21,0,21
78586,Sprain of interphalangeal joint of toe,racial,White,12,9,21
372914,Optic atrophy,ethnic,Not Hispanic or Latino,9,12,21
30441,Sialolithiasis,racial,White,7,14,21
141825,Non-toxic goiter,ethnic,Not Hispanic or Latino,21,0,21
437881,Malignant otitis externa,ethnic,Hispanic or Latino,14,7,21
378743,Mild nonproliferative retinopathy,ethnic,Not Hispanic or Latino,7,14,21
434328,"Nondependent cannabis abuse, episodic",racial,White,12,9,21
195864,Diverticulum of bladder,ethnic,Hispanic or Latino,16,5,21
442074,Focal membranoproliferative glomerulonephritis,ethnic,Hispanic or Latino,21,0,21
376115,Cystoid macular retinal degeneration,racial,White,12,9,21
198464,Incisional hernia,ethnic,Not Hispanic or Latino,18,2,20
136185,Abnormal granulation tissue,racial,Unknown,16,5,21
376111,Unqualified visual loss of one eye,racial,Unknown,12,9,21
192885,Tarsal tunnel syndrome,ethnic,Hispanic or Latino,14,7,21
137275,Disorder of muscle,racial,White,21,0,21
135473,Dermatophytosis,racial,Black or African American ,9,12,21
40480639,Dissecting aneurysm of thoracoabdominal aorta,ethnic,Hispanic or Latino,0,21,21
433455,Teeth grinding whilst asleep,racial,White,12,9,21
313867,Double outlet right ventricle,ethnic,Hispanic or Latino,9,12,21
72995,Joint contracture of hand,racial,Unknown,14,7,21
4215971,Obstructed incisional ventral hernia,racial,Unknown,5,16,21
437359,Osteochondritis dissecans,racial,White,14,7,21
4319325,Acquired deformity of trunk,racial,Other Race,16,5,21
140214,Eruption of skin,racial,Filipino,18,2,20
4130036,Brain damage due to hypoxia,ethnic,Not Hispanic or Latino,0,21,21
133835,Dermatitis,racial,American Indian or Alaska Native ,2,18,20
74138,Pathological fracture of vertebra,ethnic,Not Hispanic or Latino,18,2,20
443580,Systolic heart failure,ethnic,Not Hispanic or Latino,9,12,21
197928,Menstruation absent,racial,American Indian or Alaska Native ,21,0,21
313221,Rheumatic aortic stenosis,racial,Unknown,0,21,21
433846,Ankylosis of joint of lower leg,ethnic,Hispanic or Latino,21,0,21
31967,Nausea,racial,Black or African American ,16,5,21
136760,Transient hypertension of pregnancy - not delivered,racial,Unknown,21,0,21
76153,Low compliance bladder,racial,Filipino,21,0,21
435754,Ca ascending colon,racial,Asian,21,0,21
4171434,Immunization refused,racial,Asian,18,2,20
443401,Congenital connective tissue disorder,racial,Asian,0,21,21
434500,Closed fracture of neck of femur,racial,Asian,21,0,21
443879,Epididymo-orchitis with abscess,racial,White,0,21,21
321876,Disease of capillaries,ethnic,Hispanic or Latino,18,2,20
373198,Unqualified visual loss of both eyes,ethnic,Not Hispanic or Latino,7,14,21
261600,Pulmonary oedema - acute,ethnic,Hispanic or Latino,18,2,20
72992,Allergic arthritis,ethnic,Hispanic or Latino,9,12,21
134442,Thibierge-Weissenbach syndrome,ethnic,Not Hispanic or Latino,16,5,21
200843,Observation of frequency of urination,racial,American Indian or Alaska Native ,16,5,21
4223530,Spondylitis,racial,White,7,14,21
133298,Musculoskeletal disorder of the neck,racial,Other Race,9,12,21
433456,Acute pain,racial,Other Race,7,14,21
442105,Benign tumor of soft tissue,ethnic,Hispanic or Latino,5,16,21
435613,Cellulitis,racial,American Indian or Alaska Native ,14,7,21
440922,Diabetic on insulin,racial,Asian,5,16,21
192731,Digestive symptom,racial,Other Race,16,5,21
376686,Polyneuropathy associated with another disorder,racial,Black or African American ,2,18,20
437334,Cervical incompetence with antenatal problem,ethnic,Hispanic or Latino,21,0,21
135772,Goiter,racial,Other Race,21,0,21
433592,Congenital leg bone bowing,racial,White,12,9,21
199991,Complication of transplanted kidney,racial,White,14,7,21
436802,Complete trisomy 13 syndrome,racial,Black or African American ,21,0,21
75046,Old bucket handle tear of medial meniscus,ethnic,Hispanic or Latino,0,21,21
133655,Burn of forearm,racial,White,16,5,21
4126282,Chlamydial urethritis,racial,White,18,2,20
318445,Post cardiac operation functional disturbance,racial,White,9,12,21
198197,Male infertility,racial,Unknown,0,21,21
132333,Acute perichondritis of pinna,racial,White,0,21,21
201313,Hypertensive renal disease,ethnic,Not Hispanic or Latino,7,14,21
4252594,Subconjunctival injection,racial,Unknown,16,5,21
381444,Black eye,ethnic,Not Hispanic or Latino,12,9,21
4129404,Open wound of upper arm,racial,White,5,16,21
439800,"Conduct disorder, adolescent-onset type",racial,White,5,16,21
443593,Ulcer of thigh,ethnic,Hispanic or Latino,16,5,21
79127,Congenital spondylolisthesis,ethnic,Not Hispanic or Latino,21,0,21
4142479,Hyperthyroidism,racial,Unknown,16,5,21
194871,Trichomonal vulvovaginitis,ethnic,Not Hispanic or Latino,21,0,21
381292,Chronic allergic conjunctivitis,racial,American Indian or Alaska Native ,12,9,21
381548,Monoplegia,ethnic,Hispanic or Latino,21,0,21
4287237,Vascular hamartoma of skin,racial,White,14,7,21
436816,Vaginal vault smear abnormal,racial,Unknown,21,0,21
440785,Vomiting of pregnancy,racial,White,21,0,21
80512,Acquired kyphosis,racial,Unknown,12,9,21
4037738,Visual alteration,ethnic,Hispanic or Latino,14,7,21
4097272,Lipoma NOS,ethnic,Hispanic or Latino,12,9,21
432303,Cocaine abuse,racial,White,7,14,21
135061,Congenital anomaly of musculoskeletal system,ethnic,Not Hispanic or Latino,5,16,21
439014,Panuveitis,racial,Unknown,16,5,21
78235,Disorder of coccyx,ethnic,Not Hispanic or Latino,14,7,21
197717,Open wound of anterior abdominal wall without complication,racial,White,14,7,21
436953,Continuous chronic alcoholism,ethnic,Hispanic or Latino,2,18,20
441547,Oppositional defiant disorder,racial,Black or African American ,7,14,21
76819,Congenital unilateral subluxation of hip,ethnic,Hispanic or Latino,2,18,20
75036,Primary localized osteoarthrosis of hand,ethnic,Not Hispanic or Latino,12,9,21
4215003,Myasthenic crisis,ethnic,Not Hispanic or Latino,0,21,21
380055,Primary malignant neoplasm of brain,ethnic,Not Hispanic or Latino,9,12,21
199875,Vaginal wall prolapse without uterine prolapse,racial,White,21,0,21
201909,Female infertility,racial,Other Race,21,0,21
442116,Allergy to eggs,ethnic,Not Hispanic or Latino,0,21,21
436802,Complete trisomy 13 syndrome,ethnic,Not Hispanic or Latino,21,0,21
316428,Hypertrophic obstructive cardiomyopathy,racial,Asian,21,0,21
4103580,Unspecified senile cataract,racial,Unknown,14,7,21
197039,Male genital organ vascular diseases,ethnic,Hispanic or Latino,0,21,21
77650,Aseptic necrosis of bone,racial,Unknown,5,16,21
4201412,Speech therapy,ethnic,Hispanic or Latino,9,12,21
4051568,Family history of mental disorder,racial,White,16,5,21
314059,Right bundle branch block,racial,Black or African American ,0,21,21
380120,Strabismus in neuromuscular disorder,ethnic,Hispanic or Latino,5,16,21
4311159,Midline cystocele,racial,Other Race,21,0,21
138278,Sprains and strains of joints and adjacent muscles,racial,Asian,12,9,21
436675,Anorexia nervosa,racial,White,9,12,21
375239,Cerebral degeneration,racial,Asian,21,0,21
30978,Hereditary leptocytosis,racial,Other Race,18,2,20
257683,Postnasal drip,racial,Other Race,14,7,21
435754,Ca ascending colon,ethnic,Not Hispanic or Latino,21,0,21
438209,Pregnancy care of habitual aborter,racial,Unknown,21,0,21
4048727,Neoplasm screening,racial,Other Race,7,14,21
377556,Sudden visual loss,racial,White,12,9,21
440464,Complication following molar AND/OR ectopic pregnancy,ethnic,Hispanic or Latino,21,0,21
441818,Haemangioma,racial,Other Race,12,9,21
137275,Disorder of muscle,ethnic,Hispanic or Latino,18,2,20
438134,Excessive sleep,racial,Unknown,7,14,21
375824,Abnormal auditory perception,ethnic,Not Hispanic or Latino,12,9,21
4117739,Joint derangement NOS,ethnic,Not Hispanic or Latino,21,0,21
134735,Chronic osteomyelitis,racial,Unknown,21,0,21
441267,Cystic fibrosis,ethnic,Hispanic or Latino,7,14,21
74606,Benign bone tumor,racial,Unknown,21,0,21
440710,IRMA - Intraretinal microvascular abnormality,ethnic,Hispanic or Latino,2,18,20
79914,Polydactyly of toes,racial,White,18,2,20
433263,Complications following abortion and ectopic and molar pregnancies,ethnic,Hispanic or Latino,21,0,21
133711,Overlapping malignant neoplasm of female breast,ethnic,Hispanic or Latino,21,0,21
4050572,Implantation of automatic cardiac defibrillator,racial,Filipino,0,21,21
137005,Tracheostomy complication,ethnic,Hispanic or Latino,21,0,21
260315,Tuberculosis of lung with cavitation,ethnic,Hispanic or Latino,7,14,21
439937,C-reactive protein abnormal,racial,Other Race,12,9,21
132841,Malignant lymphoma of lymph nodes of multiple sites,ethnic,Hispanic or Latino,9,12,21
437878,Persistent mydriasis,ethnic,Hispanic or Latino,18,2,20
4107924,Retinal detachment with defect NOS,ethnic,Hispanic or Latino,0,21,21
434173,Fever symptoms,ethnic,Hispanic or Latino,12,9,21
4115062,Other internal knee derangement NOS,racial,White,16,5,21
380839,TS - Tuberous sclerosis,racial,White,18,2,20
441641,FTND - Full term normal delivery,racial,White,18,2,20
193693,Viral hepatitis without hepatic coma,ethnic,Hispanic or Latino,5,16,21
438555,Cyanosis,ethnic,Hispanic or Latino,9,12,21
254163,Pulmonary aspiration of gastric contents,racial,White,0,21,21
258780,Chronic obstructive bronchitis,racial,Filipino,0,21,21
193253,Nephritis,racial,Native Hawaiian or Other Pacific Islander ,5,16,21
79914,Polydactyly of toes,ethnic,Not Hispanic or Latino,18,2,20
193255,"Noninflammatory disorders of the ovary, fallopian tube and broad ligament",racial,Unknown,21,0,21
375260,Polyneuropathy in collagen vascular disease,ethnic,Not Hispanic or Latino,21,0,21
30133,Acute laryngitis,racial,Other Race,5,16,21
4051114,FH: Diabetes mellitus,racial,Black or African American ,12,9,21
376525,Audiogram abnormal,ethnic,Not Hispanic or Latino,12,9,21
4210149,Substance abuse counseling,racial,Unknown,14,7,21
135350,Acute osteomyelitis of the ankle and/or foot,racial,White,2,18,20
436541,Closed fracture of ulna,ethnic,Hispanic or Latino,16,5,21
75095,Closed fracture of ankle,racial,Asian,18,2,20
376415,Hypermetropia,racial,Unknown,16,5,21
134442,Thibierge-Weissenbach syndrome,racial,Other Race,0,21,21
201899,Unilateral recurrent inguinal hernia,racial,Filipino,0,21,21
442530,Broken tooth injury with complication,ethnic,Hispanic or Latino,5,16,21
316084,Lymphadenitis,racial,Other Race,18,2,20
433592,Congenital leg bone bowing,ethnic,Hispanic or Latino,12,9,21
137626,Seborrhoeic eczema of scalp,racial,Asian,7,14,21
374347,Blepharoconjunctivitis,racial,Unknown,12,9,21
441554,FA - Friedreich ataxia,racial,White,21,0,21
439253,"Bipolar affective disorder, currently depressed, mild",racial,Black or African American ,2,18,20
141248,Benign neoplasm of skin of lip,ethnic,Hispanic or Latino,14,7,21
432312,Anatomical narrow angle glaucoma,racial,Unknown,18,2,20
432863,Acquired coagulation factor deficiency,racial,White,18,2,20
4067435,"Joint disorder NOS, of unspecified site",ethnic,Hispanic or Latino,12,9,21
437334,Cervical incompetence with antenatal problem,racial,White,18,2,20
132822,Foot-and-mouth disease,ethnic,Hispanic or Latino,5,16,21
195312,Functional voiding disorder,racial,Asian,16,5,21
373638,Superficial injury of cornea,ethnic,Not Hispanic or Latino,7,14,21
75382,Closed fractures of tarsal AND metatarsal bones,racial,Unknown,21,0,21
313005,Congenital stenosis of pulmonary valve,ethnic,Hispanic or Latino,12,9,21
440457,Threatened abortion,ethnic,Not Hispanic or Latino,21,0,21
442753,Furuncle of trunk,racial,Other Race,5,16,21
138502,Vitiligo,racial,Asian,14,7,21
314171,Low blood pressure reading,racial,White,14,7,21
438244,Congenital hydrocephalus,racial,Asian,12,9,21
436072,Bipolar disorder in partial remission,racial,Other Race,21,0,21
4117739,Joint derangement NOS,racial,Black or African American ,21,0,21
260125,Acute bronchiolitis,racial,Filipino,2,18,20
194175,Left upper quadrant pain,racial,Other Race,7,14,21
321080,"Hypertension complicating pregnancy, childbirth and the puerperium",racial,Black or African American ,21,0,21
373766,Retinopathy of prematurity,racial,Asian,16,5,21
138896,Open wound of forehead without complication,ethnic,Not Hispanic or Latino,14,7,21
77025,Diverticulitis of colon,racial,Black or African American ,16,5,21
140214,Eruption of skin,racial,Native Hawaiian or Other Pacific Islander ,9,12,21
374044,Droopy eyelid,racial,Asian,5,16,21
381858,Dacryoadenitis,ethnic,Hispanic or Latino,7,14,21
379820,No colour perception,ethnic,Hispanic or Latino,9,12,21
4062491,Anemia screening,racial,Unknown,18,2,20
199859,Bilateral recurrent inguinal hernia,racial,White,2,18,20
200774,Detrusor and sphincter dyssynergia,racial,White,21,0,21
192674,Allergic gastroenteritis and colitis,ethnic,Hispanic or Latino,14,7,21
376679,PMA - Progressive muscular atrophy,ethnic,Hispanic or Latino,0,21,21
439003,Disorder of branched chain amino acid metabolism,ethnic,Hispanic or Latino,0,21,21
76150,Ulcer of rectum,ethnic,Hispanic or Latino,9,12,21
438155,Optic disc glaucomatous atrophy,racial,Other Race,0,21,21
441554,FA - Friedreich ataxia,ethnic,Hispanic or Latino,21,0,21
440686,Residual schizophrenia in remission,racial,White,16,5,21
78907,Superficial injury of foot without infection,ethnic,Hispanic or Latino,14,7,21
319016,Retinal lattice degeneration,racial,White,9,12,21
432795,Traumatic AND/OR non-traumatic injury,racial,Asian,16,5,21
433716,Primary malignant neoplasm of testis,ethnic,Hispanic or Latino,0,21,21
73842,Enthesopathy of elbow region,ethnic,Hispanic or Latino,16,5,21
4015843,Gonorrhea carrier,racial,White,0,21,21
437082,Marie-Strumpell spondylitis,racial,Unknown,0,21,21
318443,Arteriosclerotic vascular disease,racial,American Indian or Alaska Native ,21,0,21
443877,Nonvenomous insect bite of shoulder without infection,racial,White,12,9,21
437058,Sunburn,ethnic,Not Hispanic or Latino,9,12,21
440372,Acquired thrombocytopenia,racial,Unknown,0,21,21
77395,Current tear of semilunar cartilage,racial,Black or African American ,9,12,21
81151,Sprain of ankle joint,racial,Filipino,16,5,21
312998,Pain in thoracic spine,racial,Native Hawaiian or Other Pacific Islander ,0,21,21
193250,Gastric hemorrhage,ethnic,Hispanic or Latino,9,12,21
444070,Tachycardia,racial,Black or African American ,9,12,21
133028,Scalp injuries due to birth trauma,ethnic,Hispanic or Latino,2,18,20
441085,Elderly primip,racial,Unknown,21,0,21
439989,Insulin adverse reaction,racial,White,7,14,21
439251,"Bipolar affective disorder, currently depressed, in full remission",ethnic,Not Hispanic or Latino,9,12,21
373748,Grand mal status,ethnic,Hispanic or Latino,7,14,21
373189,Encephalomyelitis,racial,White,7,14,21
439791,Emotional upset,ethnic,Not Hispanic or Latino,14,7,21
381864,Subjective tinnitus,racial,Unknown,18,2,20
433822,Complication related to pregnancy,racial,Unknown,21,0,21
438134,Excessive sleep,ethnic,Not Hispanic or Latino,9,12,21
373151,Primary malignant neoplasm of conjunctiva (primary),racial,White,0,21,21
257581,Exacerbation of asthma,racial,Native Hawaiian or Other Pacific Islander ,16,5,21
4239721,Seafood allergy,racial,Asian,5,16,21
443570,Cervicovaginal cytology: Low grade squamous intraepithelial lesion,racial,American Indian or Alaska Native ,21,0,21
77960,Joint observation,ethnic,Not Hispanic or Latino,16,5,21
75954,Sprain of interphalangeal joint of finger,ethnic,Hispanic or Latino,14,7,21
132834,White piedra,ethnic,Hispanic or Latino,12,9,21
440387,Cannabis dependence,ethnic,Hispanic or Latino,2,18,20
375283,Angular blepharoconjunctivitis,ethnic,Hispanic or Latino,18,2,20
442794,Poisoning by wasp sting,ethnic,Not Hispanic or Latino,18,2,20
78586,Sprain of interphalangeal joint of toe,ethnic,Hispanic or Latino,9,12,21
4147497,Nervous system and sense organ diseases,racial,Black or African American ,16,5,21
138525,Pain in limb,racial,American Indian,12,9,21
436091,BM - Bacterial meningitis,ethnic,Hispanic or Latino,16,5,21
435642,Disturbance in speech,ethnic,Hispanic or Latino,0,21,21
4171434,Immunization refused,racial,Other Race,16,5,21
381281,Degenerative progressive high myopia,ethnic,Hispanic or Latino,9,12,21
199744,Carcinoma liver and/or biliary system,racial,Asian,0,21,21
441701,Sprain of hip joint,racial,Other Race,12,9,21
192671,GI - Gastrointestinal haemorrhage,racial,Native Hawaiian or Other Pacific Islander ,0,21,21
436278,Superficial bruising of thigh,ethnic,Not Hispanic or Latino,7,14,21
375519,Alcohol withdrawal syndrome,ethnic,Not Hispanic or Latino,2,18,20
201131,Pelvic mass,racial,Asian,21,0,21
200219,Abdominal pain,racial,Native Hawaiian or Other Pacific Islander ,21,0,21
197607,Polymenorrhagia,racial,Asian,21,0,21
441417,Lack of coordination,racial,Unknown,21,0,21
4064382,Skin disease screening,racial,White,12,9,21
4263325,Actinic cheilitis,ethnic,Not Hispanic or Latino,18,2,20
439035,Otosclerosis,ethnic,Hispanic or Latino,14,7,21
192964,Renal infection,ethnic,Hispanic or Latino,18,2,20
196151,Functional disorder of intestine,ethnic,Hispanic or Latino,9,12,21
75670,Sprain pelvic ligament,ethnic,Not Hispanic or Latino,18,2,20
4014230,Ankle sprain NOS,ethnic,Not Hispanic or Latino,18,2,20
134441,Chronic ulcer of skin,racial,Asian,0,21,21
444125,Satisfactory for evaluation but limited by absence of an endocervical/transformation zone component from a patient with a cervix,ethnic,Hispanic or Latino,18,0,18
75897,Polyarthropathy,racial,Other Race,18,0,18
200144,Unilateral simple femoral hernia,racial,Unknown,18,0,18
440751,Peritonsillar abscess,ethnic,Not Hispanic or Latino,2,16,18
312950,IgE-mediated allergic asthma,racial,American Indian or Alaska Native ,16,2,18
198700,Liver secondary cancer,racial,Unknown,2,16,18
443295,Maternal care for diminished foetal movements,racial,White,18,0,18
4005933,Urethral meatus underneath penis,racial,Unknown,0,18,18
434615,Cystic fibrosis without meconium ileus,racial,White,0,18,18
435082,Closed fracture nasal bone,ethnic,Not Hispanic or Latino,7,12,19
434323,Disorder of sulphur-bearing amino acid metabolism,racial,White,5,14,19
201595,Thrombosed internal hemorrhoids,ethnic,Hispanic or Latino,7,12,19
441177,Second degree burn of upper limb,ethnic,Hispanic or Latino,12,7,19
4115062,Other internal knee derangement NOS,ethnic,Not Hispanic or Latino,16,2,18
4170384,Hydatidiform mole,racial,White,18,0,18
436941,Hypervitaminosis A,ethnic,Hispanic or Latino,7,12,19
432447,Atypical glandular cells on cervical Papanicolaou smear,racial,Asian,18,0,18
432768,Corneal foreign body,ethnic,Hispanic or Latino,9,9,18
193552,Furuncle of skin AND/OR subcutaneous tissue,racial,Black or African American ,12,7,19
80593,Urinary complication,racial,White,16,2,18
4025993,Ligation of gastric varices,racial,Unknown,18,0,18
4305841,Periodic limb movement disorder,ethnic,Hispanic or Latino,14,5,19
23731,Benign tumour of larynx,racial,White,16,2,18
201907,Oedema of male genital organs,racial,Unknown,0,18,18
320835,TOF - Tetralogy of Fallot,racial,Asian,0,18,18
438555,Cyanosis,ethnic,Not Hispanic or Latino,18,0,18
4004151,Small intestine atresia and stenosis,ethnic,Hispanic or Latino,9,9,18
372894,central serous retinopathy,ethnic,Not Hispanic or Latino,14,5,19
74719,Foot ulcer,racial,Black or African American ,5,14,19
438208,Atrophy of vulva,racial,White,18,0,18
27321,Persistent vomiting,ethnic,Not Hispanic or Latino,9,9,18
31610,Disorder of oesophagus,racial,Unknown,18,0,18
81878,Benign paroxysmal positional vertigo,racial,Black or African American ,9,9,18
318397,Chronic idiopathic thrombocytopenic purpura,racial,Other Race,18,0,18
138844,Foreign body granuloma of muscle,racial,White,0,18,18
374034,Visual disturbance,racial,American Indian or Alaska Native ,12,7,19
76939,Neoplasm of uncertain behaviour of bone and articular cartilage,racial,Unknown,18,0,18
378416,Retinal disorder,ethnic,Not Hispanic or Latino,12,7,19
434376,Acute myocardial infarction of anterior wall,ethnic,Hispanic or Latino,5,14,19
381114,Microcephalus,racial,Black or African American ,5,14,19
136773,Rosacea,racial,Black or African American ,0,18,18
4110787,Other otitis externa,racial,Unknown,14,5,19
440704,Chronic pain syndrome,racial,American Indian or Alaska Native ,0,18,18
193326,Urge incontinence of urine,racial,Black or African American ,16,2,18
432250,Infective disorder,racial,Unknown,16,2,18
444453,Benign tumour of soft tissue of leg,racial,White,7,12,19
134765,General body deterioration,racial,Unknown,0,18,18
440637,Relapsing fever,racial,White,12,7,19
432725,Congenital anomaly of integument,ethnic,Not Hispanic or Latino,16,2,18
432806,Fall from cliff,racial,Other Race,0,18,18
136057,Benign neoplasm of skin of trunk,racial,Unknown,14,5,19
313878,Respiratory symptoms,racial,Filipino,9,9,18
438559,Abnormal vaginal Papanicolaou smear,ethnic,Hispanic or Latino,18,0,18
73301,Synovitis/tenosynovitis - wrist,racial,Black or African American ,18,0,18
78804,Schimmelbusch's disease,racial,Other Race,18,0,18
254761,Cough,racial,American Indian,16,2,18
440519,Premature - weight 1000g-2499g or gestation of 28-37weeks,racial,Other Race,14,5,19
196433,Aneurysm of iliac artery,ethnic,Hispanic or Latino,0,18,18
444429,Herpes simplex infection,racial,Unknown,7,12,19
433595,Interstitial edema,racial,Filipino,14,5,19
195321,Postmenopausal bleeding,racial,Black or African American ,18,0,18
321318,Angina,racial,Native Hawaiian or Other Pacific Islander ,0,18,18
256449,Bronchiectasis,racial,Unknown,18,0,18
73290,Contracture of joint,ethnic,Hispanic or Latino,5,14,19
4100367,Simple schizophrenia NOS,ethnic,Not Hispanic or Latino,18,0,18
75941,Closed fracture of one rib,racial,Unknown,14,5,19
133141,Tinea pedis,racial,Native Hawaiian or Other Pacific Islander ,2,16,18
75344,Intervertebral disc disorder,racial,Unknown,18,0,18
73560,Calcaneal spur,racial,Filipino,12,7,19
140884,Blister of hand without infection,racial,White,2,16,18
138582,"Closed fracture scapula, acromion",ethnic,Hispanic or Latino,12,7,19
139841,Chronic frontal sinusitis,racial,Unknown,14,5,19
433752,Impulse control disorder,racial,Unknown,9,9,18
139757,Malignant melanoma of skin of lower limb,ethnic,Hispanic or Latino,12,7,19
133002,Acute osteomyelitis,racial,Unknown,5,14,19
200391,Peripheral autonomic neuropathy disease EC,racial,Asian,0,18,18
4179332,Parent-child problem,ethnic,Not Hispanic or Latino,14,5,19
434942,Postseptal orbital cellulitis,ethnic,Not Hispanic or Latino,2,16,18
439796,"Nondependent cocaine abuse, continuous",ethnic,Hispanic or Latino,7,12,19
4263748,Recurrent major depression in complete remission,racial,Other Race,18,0,18
441277,Mixed receptive-expressive language disorder,racial,White,0,18,18
75406,Crush injury of finger,racial,Unknown,12,7,19
377270,Hereditary retinal dystrophy,ethnic,Hispanic or Latino,18,0,18
314659,Arteritis,racial,White,12,7,19
313005,Congenital stenosis of pulmonary valve,racial,White,9,9,18
197044,Female infertility associated with anovulation,ethnic,Not Hispanic or Latino,18,0,18
434019,"Nondependent cannabis abuse, continuous",ethnic,Hispanic or Latino,12,7,19
193249,Acute erosive gastritis,racial,Unknown,16,2,18
440916,Burn to wrist/hand - blister,racial,White,18,0,18
4105330,Chronic undifferentiated schizophrenia,racial,Other Race,0,18,18
140884,Blister of hand without infection,ethnic,Hispanic or Latino,2,16,18
434944,Scleritis,racial,White,16,2,18
439770,Ketoacidosis in type I diabetes mellitus,ethnic,Not Hispanic or Latino,0,18,18
373179,Senile degeneration of brain,ethnic,Hispanic or Latino,0,18,18
40483107,Inflamed seborrheic keratosis,racial,White,16,2,18
134398,Periodontal disease,ethnic,Not Hispanic or Latino,5,14,19
4005743,Female sterility,racial,Unknown,18,0,18
381592,Chronic mucoid otitis media,racial,Unknown,7,12,19
374919,Disseminated sclerosis,racial,Other Race,18,0,18
441246,Hemangioma of intracranial structure,ethnic,Hispanic or Latino,16,2,18
76550,Sprain of metatarsophalangeal joint,racial,White,7,12,19
437995,Closed ill-defined fractures of upper limb,racial,White,5,14,19
378679,Acute poliomyelitis,ethnic,Hispanic or Latino,9,9,18
4137127,Transplantation of heart,racial,White,18,0,18
437992,Abnormal results of kidney function studies,racial,Black or African American ,7,12,19
133637,Second degree burn of lower limb,ethnic,Hispanic or Latino,16,2,18
432306,Gender identity disorder of adolescence,ethnic,Not Hispanic or Latino,18,0,18
136773,Rosacea,racial,American Indian or Alaska Native ,18,0,18
194685,Chronic non-obstructive atrophic pyelonephritis,ethnic,Not Hispanic or Latino,0,18,18
4173498,FH: Heart disorder,racial,Black or African American ,12,7,19
195072,Medullary sponge kidney,racial,American Indian or Alaska Native ,18,0,18
195363,Congenital anomaly of kidney,ethnic,Not Hispanic or Latino,9,9,18
194394,Hernia of anterior abdominal wall with gangrene,ethnic,Hispanic or Latino,16,2,18
4059284,Cirrhosis and chronic liver disease,racial,White,14,5,19
134074,Oral soft tissue cellulitis,racial,Black or African American ,2,16,18
4345458,Staphylococcal toxic shock syndrome,ethnic,Hispanic or Latino,18,0,18
4104555,Other and unspecified conjunctivitis,ethnic,Hispanic or Latino,9,9,18
313023,Neonatal chronic respiratory disease,racial,Unknown,0,18,18
77387,Closed fracture of vertebral column with spinal cord injury,ethnic,Hispanic or Latino,0,18,18
315286,Chronic ischemic heart disease,ethnic,Not Hispanic or Latino,0,18,18
437264,Tobacco dependence syndrome,racial,Asian Indian,0,18,18
195240,Monoplegia of lower limb,racial,Unknown,0,18,18
81937,Traumatic arthropathy of the hand,racial,White,18,0,18
197494,Viral hepatitis C,racial,Asian,2,16,18
376116,Central loss of vision,racial,White,0,18,18
438129,"Severe manic bipolar I disorder with psychotic features, mood-congruent",ethnic,Not Hispanic or Latino,5,14,19
78232,Shoulder joint pain,racial,Native Hawaiian or Other Pacific Islander ,16,2,18
314131,Degeneration of cervical intervertebral disc,racial,Other Race,16,2,18
4107528,Lermoyez syndrome,racial,Unknown,18,0,18
440358,Lipoma,racial,Other Race,0,18,18
437832,Malnutrition of mild degree (Gomez: 75% to less than 90% of standard weight),racial,Unknown,12,7,19
4085922,Infection screening,ethnic,Not Hispanic or Latino,9,9,18
441838,Personality disorder,ethnic,Not Hispanic or Latino,16,2,18
135930,Musculoskeletal system observation,racial,Unknown,16,2,18
4230642,Acquired deformity of chest,ethnic,Not Hispanic or Latino,16,2,18
193517,Bile duct calculus with no mention of cholecystitis and with obstruction,ethnic,Hispanic or Latino,2,16,18
376113,Recent subtotal retinal detachment,ethnic,Hispanic or Latino,7,12,19
4109274,Stenosis and insufficiency of lacrimal passages NOS,ethnic,Hispanic or Latino,18,0,18
81660,Cervicocranial syndrome,racial,White,18,0,18
31602,Disease of the larynx,racial,White,12,7,19
255348,Polymyalgia rheumatica,racial,Black or African American ,18,0,18
435666,Closed fracture of upper end of tibia,racial,Unknown,5,14,19
436298,Adverse reaction to food,racial,Asian,2,16,18
4055337,Gallbladder calculus without mention of cholecystitis,racial,Unknown,5,14,19
139188,Open wound of scalp without complication,ethnic,Not Hispanic or Latino,2,16,18
140486,Ulcer of calf,ethnic,Not Hispanic or Latino,0,18,18
199076,Fallopian tube pregnancy,ethnic,Hispanic or Latino,18,0,18
379020,Entropion,racial,White,0,18,18
141499,Septicemia,racial,White,7,12,19
436233,Delayed milestone,racial,Black or African American ,2,16,18
433556,Derangement of posterior horn of lateral meniscus,racial,White,18,0,18
138790,Chronic periodontitis,racial,White,9,9,18
316501,Disorder of blood vessels affecting skin,racial,White,9,9,18
201111,Congenital renal dysplasia,racial,Other Race,9,9,18
375249,Traction detachment of retina,racial,White,7,12,19
441712,Open wound of ocular adnexa,ethnic,Hispanic or Latino,5,14,19
4146235,Other cellulitis and abscess,racial,White,5,14,19
435088,Senility,racial,Unknown,12,7,19
75337,Cellulitis and abscess of buttock,racial,Black or African American ,7,12,19
374912,Leukodystrophy,ethnic,Hispanic or Latino,14,5,19
4091319,Streptococcal sore throat with scarlatina NOS,racial,White,7,12,19
256215,"Lung agenesis, hypoplasia and dysplasia",racial,White,0,18,18
253549,Connective tissue disease,ethnic,Hispanic or Latino,18,0,18
199839,External haemorrhoids without complication,racial,Black or African American ,9,9,18
437899,Acute and subacute bacterial endocarditis,racial,White,16,2,18
78605,Superficial bruising of elbow,ethnic,Not Hispanic or Latino,7,12,19
377270,Hereditary retinal dystrophy,racial,Unknown,18,0,18
138278,Sprains and strains of joints and adjacent muscles,racial,American Indian or Alaska Native ,7,12,19
75426,Burn of hand,ethnic,Hispanic or Latino,7,12,19
137856,Atypical facial pain,racial,White,7,12,19
24134,Nonspecific pain in the neck region,racial,American Indian or Alaska Native ,9,9,18
132393,Pressure ulcer stage 1,ethnic,Not Hispanic or Latino,7,12,19
435956,Closed fracture of base of neck of femur,racial,Unknown,18,0,18
199062,"Acute gastric ulcer without hemorrhage, without perforation AND without obstruction",racial,Unknown,12,7,19
132706,Nail disease,racial,American Indian or Alaska Native ,18,0,18
81539,Mitochondrial disease,racial,Unknown,0,18,18
193782,End stage renal disease,racial,Filipino,0,18,18
81099,Pyogenic arthritis of shoulder region,ethnic,Hispanic or Latino,18,0,18
432454,Excessive thirst,racial,Unknown,2,16,18
433599,Abnormal biochemistry finding,racial,Asian,16,2,18
4263370,R.I.N.D. syndrome,racial,American Indian or Alaska Native ,0,18,18
375260,Polyneuropathy in collagen vascular disease,racial,Unknown,18,0,18
132659,Acute apical periodontitis,racial,Asian,9,9,18
138841,Disorder of sacrum,ethnic,Not Hispanic or Latino,16,2,18
434016,"Nondependent opioid abuse, continuous",racial,Black or African American ,0,18,18
440382,LD - Learning difficulties,racial,Black or African American ,9,9,18
198700,Liver secondary cancer,racial,Asian,0,18,18
80504,Acquired genu valgum,ethnic,Not Hispanic or Latino,14,5,19
378742,Blind hypotensive eye,racial,Unknown,18,0,18
138713,Disease of parathyroid glands,racial,White,7,12,19
192286,Intestinal disaccharidase deficiency,racial,Asian,2,16,18
136496,Cellulitis and abscess of face,racial,Asian,0,18,18
377539,Syringomyelia and syringobulbia,ethnic,Not Hispanic or Latino,16,2,18
442068,Cellulitis and abscess of forearm,racial,Black or African American ,9,9,18
319927,Heart sounds abnormal,ethnic,Hispanic or Latino,9,9,18
199860,Hernia of abdominal cavity,racial,Black or African American ,2,16,18
195312,Functional voiding disorder,racial,Other Race,7,12,19
133727,Thyrotoxicosis without goiter OR other cause,racial,Black or African American ,18,0,18
74725,Displacement of cervical intervertebral disc without myelopathy,racial,Native Hawaiian or Other Pacific Islander ,18,0,18
373127,Herpes simplex disciform keratitis,ethnic,Hispanic or Latino,18,0,18
4143966,Essential hypertension NOS,racial,American Indian or Alaska Native ,0,18,18
132740,Positive skin test reaction,racial,American Indian or Alaska Native ,16,2,18
23731,Benign tumour of larynx,ethnic,Hispanic or Latino,16,2,18
4345578,Rhabdomyolysis,racial,White,9,9,18
80874,Open wound of multiple sites of one upper limb without complication,racial,Unknown,5,14,19
313867,Double outlet right ventricle,racial,White,7,12,19
24230,Laryngeal FB - foreign body,ethnic,Hispanic or Latino,0,18,18
443554,Congenital abnormality of lacrimal drainage system,ethnic,Hispanic or Latino,2,16,18
4025993,Ligation of gastric varices,ethnic,Hispanic or Latino,18,0,18
442425,Lumbar post-laminectomy syndrome,racial,American Indian or Alaska Native ,0,18,18
381575,Disorder of external ear,racial,White,5,14,19
442588,OSA - Obstructive sleep apnoea,racial,American Indian or Alaska Native ,18,0,18
200757,Abscess of peritoneum,ethnic,Hispanic or Latino,14,5,19
442565,Gestational edema without hypertension,racial,Filipino,18,0,18
433178,Anxiety disorder of childhood OR adolescence,ethnic,Hispanic or Latino,7,12,19
195977,Contusion of trunk,ethnic,Not Hispanic or Latino,14,5,19
376116,Central loss of vision,racial,Unknown,5,14,19
437167,Accident caused by firearm missile,ethnic,Hispanic or Latino,7,12,19
435226,"Bipolar affective disorder, current episode mixed",ethnic,Not Hispanic or Latino,0,18,18
434298,Metastasis to upper limb lymph node,racial,White,18,0,18
4062636,Bacterial disease screening,racial,Black or African American ,18,0,18
4016675,"Sprain, ankle joint, medial",racial,Unknown,9,9,18
316139,HF - Heart failure,racial,Asian,5,14,19
314958,Benign secondary hypertension,ethnic,Hispanic or Latino,7,12,19
443274,Psychostimulant dependence,ethnic,Hispanic or Latino,5,14,19
74777,Closed fracture of astragalus,racial,White,7,12,19
372635,Corneal degeneration,ethnic,Hispanic or Latino,12,7,19
4058247,Anaemia during pregnancy/childbirth/puerperium NOS,racial,Unknown,18,0,18
441737,Bruising,racial,American Indian or Alaska Native ,14,5,19
4218874,Scimitar syndrome,racial,White,2,16,18
73036,Closed fracture of olecranon process of ulna,racial,White,7,12,19
440021,Herpes simplex without complication,racial,Black or African American ,12,7,19
139110,Intervertebral disc disorder of thoracic region with myelopathy,ethnic,Hispanic or Latino,14,5,19
260134,Croup,racial,Other Race,9,9,18
195363,Congenital anomaly of kidney,racial,Unknown,14,5,19
4326601,Anorectal abscess,racial,Asian,14,5,19
194394,Hernia of anterior abdominal wall with gangrene,racial,Unknown,16,2,18
379820,No colour perception,racial,White,12,7,19
438242,Talipes equinovarus,ethnic,Hispanic or Latino,2,16,18
259055,Extrinsic asthma with asthma attack,racial,Filipino,7,12,19
380403,External hordeolum,racial,Other Race,7,12,19
438867,Generalized body aches,racial,Black or African American ,12,7,19
312940,Acute-on-chronic respiratory failure,ethnic,Hispanic or Latino,9,9,18
377845,Anoxic encephalopathy,ethnic,Not Hispanic or Latino,12,7,19
432582,Neoplastic disease of uncertain behavior,racial,Unknown,12,7,19
199151,Must strain to pass urine,ethnic,Not Hispanic or Latino,0,18,18
438469,"Duodenal ulcer without hemorrhage, without perforation AND without obstruction",ethnic,Not Hispanic or Latino,18,0,18
133295,Inflammatory spondylopathy,ethnic,Hispanic or Latino,7,12,19
77670,Chest pain,racial,Native Hawaiian or Other Pacific Islander ,7,12,19
437186,Hypothermia - accidental,ethnic,Hispanic or Latino,2,16,18
438155,Optic disc glaucomatous atrophy,racial,Unknown,9,9,18
439708,Disorders of initiating and maintaining sleep,racial,Filipino,0,18,18
4296024,Family disruption due to divorce,racial,White,5,14,19
40490434,Abnormal arterial blood gas,racial,White,7,12,19
437995,Closed ill-defined fractures of upper limb,ethnic,Not Hispanic or Latino,0,18,18
81723,Contusion of hand,racial,Other Race,12,7,19
199764,Benign ovarian tumour,racial,White,18,0,18
4107528,Lermoyez syndrome,racial,White,18,0,18
444438,Leucoplakia of tongue,racial,White,7,12,19
192372,Placenta praevia without haemorrhage - not delivered,racial,Unknown,18,0,18
197444,Vascular complication of medical care,racial,White,12,7,19
28060,Strept throat,racial,American Indian or Alaska Native ,7,12,19
433656,Abnormal patient reaction,racial,White,16,2,18
440548,Closed fracture of lower end of femur,racial,White,12,7,19
377556,Sudden visual loss,ethnic,Hispanic or Latino,9,9,18
133013,Congenital spinal cord anomaly,ethnic,Hispanic or Latino,5,14,19
437116,Closed fracture of distal end of radius,ethnic,Not Hispanic or Latino,9,9,18
195213,Aldosteronism,racial,Unknown,0,18,18
443883,Acute disease,ethnic,Not Hispanic or Latino,12,7,19
316447,Chronic hypotension,ethnic,Hispanic or Latino,16,2,18
141499,Septicemia,racial,Unknown,14,5,19
4176874,Infantile melanodontia,racial,Black or African American ,0,18,18
4223530,Spondylitis,ethnic,Hispanic or Latino,5,14,19
440129,Hypertrophy of nasal turbinates,racial,Unknown,9,9,18
4112954,Unspecified spontaneous abortion without mention of complication,racial,White,18,0,18
81660,Cervicocranial syndrome,ethnic,Hispanic or Latino,18,0,18
436263,Broken tooth without complication,ethnic,Not Hispanic or Latino,12,7,19
4140107,Double anastomosis of mammary arteries to coronary arteries,ethnic,Hispanic or Latino,18,0,18
320420,Vitreous degeneration,racial,Asian,14,5,19
377853,Chronic tension-type headache,ethnic,Not Hispanic or Latino,12,7,19
436366,Benign tumour of testis,racial,White,0,18,18
375260,Polyneuropathy in collagen vascular disease,racial,White,18,0,18
440053,Infestation by insect,racial,White,14,5,19
136496,Cellulitis and abscess of face,racial,Other Race,9,9,18
436940,Insulin resistance syndrome,racial,Other Race,7,12,19
4025514,Unspecified peptic ulcer,racial,Asian,0,18,18
440973,Benign neoplasm of long bones of lower limb,ethnic,Not Hispanic or Latino,18,0,18
141095,Acne,racial,American Indian or Alaska Native ,7,12,19
4101609,Ebstein anomaly of right atrioventricular valve,racial,White,18,0,18
439918,Poliomyelitis osteopathy of the ankle and/or foot,ethnic,Hispanic or Latino,9,9,18
4288676,Acute and chronic cholecystitis,racial,Unknown,18,0,18
376337,Disease of nervous system,ethnic,Not Hispanic or Latino,2,16,18
195864,Diverticulum of bladder,racial,Unknown,16,2,18
201352,Cholelithiasis AND acute cholecystitis with obstruction,racial,White,7,12,19
256451,Bronchitis,racial,Filipino,9,9,18
313011,Congenital abnormality of cardiac position,racial,White,0,18,18
437116,Closed fracture of distal end of radius,racial,Unknown,9,9,18
438725,Disorder of magnesium metabolism,ethnic,Not Hispanic or Latino,12,7,19
313590,Perinatal respiratory failure,racial,White,7,12,19
440465,Postpartum state,racial,Black or African American ,18,0,18
374371,Stenosis of precerebral artery,racial,White,18,0,18
435570,Pulp and periapical tissue disease,ethnic,Hispanic or Latino,12,7,19
4305303,Sleep deprivation,racial,White,12,7,19
4024000,Urinary system finding,racial,Unknown,5,14,19
201817,Benign tumour of female genital organs,ethnic,Hispanic or Latino,18,0,18
138379,"Chronic lymphoid leukemia, disease",racial,Other Race,0,18,18
434153,Chromosomopathy,racial,Unknown,14,5,19
4064381,Nephropathy screening,racial,Other Race,5,14,19
316226,Complete TGA,ethnic,Hispanic or Latino,9,9,18
80809,Rheumatoid arthritis,racial,American Indian or Alaska Native ,18,0,18
196625,Viral hepatitis A without hepatic coma,racial,Unknown,14,5,19
376121,Recurrent pterygium,racial,White,12,7,19
133299,Swelling of limb,racial,Black or African American ,7,12,19
436988,Enophthalmos due to atrophy of orbital tissue,racial,Unknown,18,0,18
40484010,Unilateral conductive hearing loss,ethnic,Hispanic or Latino,2,16,18
372604,Movement disorder,racial,White,14,5,19
194992,Coeliac disease,ethnic,Hispanic or Latino,7,12,19
26662,Testicular hypofunction,racial,Asian,0,18,18
72715,Exostosis,racial,Black or African American ,18,0,18
198678,Intestinal infectious disease,racial,Asian,14,5,19
313989,Chronic lymphadenitis,ethnic,Not Hispanic or Latino,16,2,18
372765,Open wound of head without complication,ethnic,Not Hispanic or Latino,2,16,18
436254,Closed fractures of multiple bones of lower limb,racial,White,12,7,19
4140107,Double anastomosis of mammary arteries to coronary arteries,racial,Unknown,18,0,18
4144997,Osteoarthritis NOS,ethnic,Not Hispanic or Latino,9,9,18
4346969,Joint mice in knee,racial,White,16,2,18
137054,Skin striae,racial,White,5,14,19
139057,Disease of oral soft tissues,racial,Black or African American ,9,9,18
201603,Disease of teeth AND/OR supporting structures,racial,Native Hawaiian or Other Pacific Islander ,16,2,18
4004151,Small intestine atresia and stenosis,racial,White,9,9,18
4218764,Gastroschisis,racial,White,2,16,18
256451,Bronchitis,racial,Native Hawaiian or Other Pacific Islander ,12,7,19
4109274,Stenosis and insufficiency of lacrimal passages NOS,racial,Unknown,18,0,18
4064918,Diabetes mellitus screening,racial,Asian Indian,2,16,18
4096347,Gouty arthropathy,racial,Native Hawaiian or Other Pacific Islander ,16,2,18
435459,Staphylococcal infectious disease,ethnic,Hispanic or Latino,9,9,18
134324,Lipodystrophy,ethnic,Not Hispanic or Latino,2,16,18
40481091,Partial edentulism,ethnic,Hispanic or Latino,5,14,19
444287,Carbuncle of neck,racial,Unknown,5,14,19
313504,Osler hemorrhagic telangiectasia syndrome,ethnic,Hispanic or Latino,18,0,18
138713,Disease of parathyroid glands,ethnic,Hispanic or Latino,14,5,19
4064206,O/E - tuning fork testing,ethnic,Hispanic or Latino,14,5,19
377291,"Peripheral pterygium, progressive",racial,White,5,14,19
134074,Oral soft tissue cellulitis,racial,Unknown,14,5,19
4002644,Rotator cuff shoulder syndrome and allied disorders,racial,Other Race,0,18,18
141370,Toxic erythema,ethnic,Hispanic or Latino,14,5,19
315830,Variant angina,racial,White,18,0,18
381551,Drug-related polyneuropathy,racial,Unknown,0,18,18
312337,Arterial embolic and thrombotic occlusion,racial,Unknown,18,0,18
442119,Adhesions of temporomandibular joint,racial,White,9,9,18
435789,Megaloblastic anemia,racial,Unknown,12,7,19
80824,Senile osteoporosis,racial,Black or African American ,18,0,18
77129,Closed fracture of pelvis,racial,White,16,2,18
436155,Redundant prepuce and phimosis,racial,Asian,0,18,18
376552,Cerebral laceration and contusion,racial,White,9,9,18
441840,Clinical finding,racial,Black or African American ,2,16,18
138389,Benign neoplasm of scalp and skin of neck,ethnic,Not Hispanic or Latino,9,9,18
374923,Bell palsy,racial,Asian,0,18,18
378144,Disease of basal ganglia,racial,White,14,5,19
443554,Congenital abnormality of lacrimal drainage system,racial,White,2,16,18
441155,Closed trimalleolar fracture,racial,Unknown,14,5,19
134460,Plantar fascial fibromatosis,racial,American Indian or Alaska Native ,5,14,19
4143966,Essential hypertension NOS,ethnic,Not Hispanic or Latino,0,18,18
434615,Cystic fibrosis without meconium ileus,ethnic,Hispanic or Latino,5,14,19
318566,Flushing,ethnic,Not Hispanic or Latino,14,5,19
254163,Pulmonary aspiration of gastric contents,ethnic,Not Hispanic or Latino,0,18,18
378256,Abnormal reflex,racial,White,9,9,18
436249,Closed fracture of femoral condyle of femur,racial,White,5,14,19
4213085,Family history of prostate cancer,racial,Unknown,0,18,18
4179214,Family history of malignant neoplasm of gastrointestinal tract,racial,Asian,18,0,18
444219,Osteitis deformans without bone tumor,ethnic,Hispanic or Latino,16,2,18
438242,Talipes equinovarus,racial,Asian,0,18,18
440039,Specific viral infections,ethnic,Hispanic or Latino,14,5,19
432870,Thrombocytopenia,racial,American Indian or Alaska Native ,12,7,19
321638,"Benign essential hypertension complicating pregnancy, childbirth and the puerperium",ethnic,Hispanic or Latino,18,0,18
4112816,Other respiratory system diseases,racial,Unknown,12,7,19
76790,Familial ligamentous laxity,ethnic,Hispanic or Latino,9,9,18
136495,Lichenification and lichen simplex chronicus,racial,Unknown,7,12,19
196724,Disease of diaphragm,ethnic,Hispanic or Latino,12,7,19
382034,Injury of sciatic nerve,ethnic,Hispanic or Latino,16,2,18
4013457,"Closed fracture of proximal humerus, unspecified part",racial,White,9,9,18
441039,Phlebitis of lower limb vein,racial,White,16,2,18
442167,Neoplasm of uncertain behaviour of craniopharyngeal duct,racial,White,7,12,19
257012,Chronic rhinosinusitis,racial,American Indian,14,5,19
437221,Chlamydia trachomatis infection,ethnic,Not Hispanic or Latino,18,0,18
197145,Open wound of pelvic region without complication,racial,White,18,0,18
4152053,Amfetamine or other psychostimulant dependence,ethnic,Hispanic or Latino,18,0,18
434063,Jaw to cranial base anomaly,ethnic,Hispanic or Latino,18,0,18
318443,Arteriosclerotic vascular disease,racial,White,7,12,19
380702,Cerebral cysts,ethnic,Not Hispanic or Latino,0,18,18
134743,Congenital ichthyosis of skin,ethnic,Not Hispanic or Latino,16,2,18
440230,Closed fracture of anatomical neck of humerus,ethnic,Hispanic or Latino,16,2,18
138379,"Chronic lymphoid leukemia, disease",racial,Unknown,12,7,19
434019,"Nondependent cannabis abuse, continuous",racial,White,9,9,18
137977,Icteric,racial,Other Race,16,2,18
432545,Bacterial disease,racial,Other Race,18,0,18
374221,Injury of brachial plexus,racial,White,12,7,19
435532,Episodic chronic alcoholism,racial,White,0,18,18
379832,Mixed conductive and sensorineural deafness,ethnic,Not Hispanic or Latino,9,9,18
4149382,Endocrine/metabolic screening,ethnic,Not Hispanic or Latino,14,5,19
435993,Foreign body in conjunctival sac,racial,White,2,16,18
433885,Closed supracondylar fracture of humerus,ethnic,Not Hispanic or Latino,9,9,18
435850,Cyst of jaw,ethnic,Hispanic or Latino,14,5,19
137627,Prickly heat,ethnic,Not Hispanic or Latino,12,7,19
375551,Blepharochalasis,ethnic,Hispanic or Latino,18,0,18
4182210,Dementia,racial,White,18,0,18
438244,Congenital hydrocephalus,racial,Black or African American ,2,16,18
441277,Mixed receptive-expressive language disorder,ethnic,Hispanic or Latino,0,18,18
78771,Labyrinthine dysfunction,ethnic,Hispanic or Latino,9,9,18
443458,Closed fracture of facial bone,ethnic,Hispanic or Latino,12,7,19
132706,Nail disease,racial,Other Race,7,12,19
257583,Allergic bronchopulmonary aspergillosis,racial,White,0,18,18
4104561,Ptosis of eyelid NOS,racial,White,16,2,18
376399,Incipient cataract,racial,White,9,9,18
437579,Paroxysmal ventricular tachycardia,racial,White,9,9,18
4064382,Skin disease screening,ethnic,Hispanic or Latino,9,9,18
4109253,Pterygium NOS,racial,White,2,16,18
4113650,Noninflammatory cervical disorder,racial,White,18,0,18
4137127,Transplantation of heart,ethnic,Hispanic or Latino,18,0,18
320827,Atresia and stenosis of aorta,racial,Unknown,18,0,18
436204,Subcutaneous hematoma,ethnic,Hispanic or Latino,12,7,19
315832,Angina decubitus,racial,Unknown,16,2,18
444384,Nonvenomous insect bite of leg with infection,ethnic,Hispanic or Latino,5,14,19
195213,Aldosteronism,ethnic,Not Hispanic or Latino,0,18,18
435534,"Nondependent alcohol abuse, continuous",racial,Other Race,0,18,18
381581,Chalazion,racial,Other Race,5,14,19
318459,Respiratory insufficiency,racial,Unknown,12,7,19
134144,Cleft palate with cleft lip,racial,Asian,18,0,18
4094448,Pregnancy test negative,racial,Other Race,18,0,18
4194895,Screening for disorder,racial,Asian,5,14,19
40480431,Speech and language developmental delay due to hearing loss,racial,Unknown,9,9,18
81670,Congenital anomaly of spine,racial,Unknown,0,18,18
136184,Pruritic disorder,racial,Black or African American ,12,7,19
261774,"Respiratory tuberculosis, not confirmed bacteriologically or histologically",racial,White,5,14,19
4059284,Cirrhosis and chronic liver disease,ethnic,Hispanic or Latino,14,5,19
378523,Residual foreign body in soft tissue,racial,Unknown,5,14,19
436551,Closed fracture trapezoid,racial,Other Race,18,0,18
440392,Retinal vascular occlusion,racial,White,14,5,19
438242,Talipes equinovarus,ethnic,Not Hispanic or Latino,0,18,18
443783,Chronic disease,racial,Native Hawaiian or Other Pacific Islander ,5,14,19
432598,Subchronic schizophrenia with acute exacerbations,ethnic,Hispanic or Latino,18,0,18
4102348,Common migraine NOS,ethnic,Hispanic or Latino,16,2,18
4340380,Hepatitis C carrier,racial,Other Race,2,16,18
78232,Shoulder joint pain,racial,Asian Indian,2,16,18
441126,Monosomy and deletion from autosome,racial,Asian,18,0,18
134312,Iatrogenic hypothyroidism,racial,Unknown,16,2,18
72418,Scoliosis deformity of spine,racial,American Indian or Alaska Native ,18,0,18
193422,Primary malignant neoplasm of body of stomach,racial,White,5,14,19
198802,Occlusion of ureter,ethnic,Hispanic or Latino,18,0,18
74135,Disorder of synovium,ethnic,Not Hispanic or Latino,14,5,19
256531,Head and neck swelling,racial,Native Hawaiian or Other Pacific Islander ,5,14,19
441482,Administrative reason for encounter,racial,Other Race,5,14,19
4051119,FH: Osteoporosis,ethnic,Hispanic or Latino,18,0,18
374009,Organic mental disorder,ethnic,Not Hispanic or Latino,12,7,19
4091319,Streptococcal sore throat with scarlatina NOS,ethnic,Hispanic or Latino,7,12,19
372907,Macular scar,racial,White,0,18,18
440155,Postartificial menopausal syndrome,ethnic,Not Hispanic or Latino,16,2,18
260123,Acute inflammation of sinus,racial,American Indian,12,7,19
440228,Closed fracture of lower end of humerus,ethnic,Not Hispanic or Latino,16,2,18
376564,Superficial injury of eye,racial,White,14,5,19
135852,Teething syndrome,racial,Asian,0,18,18
435613,Cellulitis,racial,Asian,7,12,19
133228,Dental caries,racial,American Indian or Alaska Native ,7,12,19
193795,Acute gastric ulcer with hemorrhage but without obstruction,racial,White,5,14,19
440653,Infection by toxoplasma gondii,racial,White,0,18,18
77156,Superficial foreign body of toe without major open wound but with infection,ethnic,Hispanic or Latino,16,2,18
24075,Esophageal stricture and stenosis,racial,Other Race,14,5,19
377889,Hearing loss,racial,American Indian or Alaska Native ,18,0,18
439237,Assault,racial,Unknown,16,2,18
435640,"Gestation period, 25 weeks",ethnic,Not Hispanic or Latino,2,16,18
74472,Congenital deformity of foot,ethnic,Not Hispanic or Latino,2,16,18
257583,Allergic bronchopulmonary aspergillosis,ethnic,Not Hispanic or Latino,0,18,18
201075,Noninflammatory disorder of cervix,racial,White,18,0,18
201817,Benign tumour of female genital organs,racial,White,18,0,18
435380,Closed fracture of radius AND ulna,racial,White,14,5,19
440431,Pneumonia due to Mycoplasma pneumoniae,ethnic,Not Hispanic or Latino,14,5,19
198289,Nonvenomous insect bite of hip without infection,racial,Unknown,18,0,18
433073,Superficial burn of back of hand,ethnic,Hispanic or Latino,16,2,18
140976,Toxic uninodular goiter,ethnic,Hispanic or Latino,16,2,18
433934,Accident caused by needle,ethnic,Hispanic or Latino,16,2,18
440547,Closed fracture of shaft of metacarpal bone,racial,White,12,7,19
196064,Carcinoma in situ of digestive organ,racial,White,9,9,18
79145,Ehlers-Danlos syndrome,racial,White,7,12,19
441737,Bruising,racial,Other Race,16,2,18
76548,Closed dislocation of hip,racial,Unknown,16,2,18
433320,Excessive crying of child,ethnic,Hispanic or Latino,9,9,18
380706,Regular astigmatism,ethnic,Hispanic or Latino,16,2,18
4144149,Cared for by family,ethnic,Hispanic or Latino,7,12,19
436551,Closed fracture trapezoid,ethnic,Hispanic or Latino,18,0,18
197223,Enterobiasis,ethnic,Not Hispanic or Latino,9,9,18
4050091,Open wound of penis,ethnic,Hispanic or Latino,0,18,18
80232,Closed fracture of calcaneus,ethnic,Hispanic or Latino,7,12,19
201072,Benign prostatic hypertrophy without outflow obstruction,ethnic,Not Hispanic or Latino,0,18,18
133810,Secondary hyperparathyroidism of renal origin,racial,Other Race,14,5,19
438546,Congenital anomaly of anterior chamber of eye,racial,Unknown,12,7,19
4170384,Hydatidiform mole,ethnic,Hispanic or Latino,18,0,18
135888,Decubitus ulcer,racial,Unknown,12,7,19
77734,Contusion of lower leg,ethnic,Not Hispanic or Latino,12,7,19
443446,Reflex sympathetic dystrophy of lower extremity,racial,White,14,5,19
435088,Senility,ethnic,Not Hispanic or Latino,5,14,19
73036,Closed fracture of olecranon process of ulna,ethnic,Hispanic or Latino,9,9,18
31602,Disease of the larynx,ethnic,Hispanic or Latino,7,12,19
443617,Conduct disorder,racial,Asian,5,14,19
132659,Acute apical periodontitis,racial,Black or African American ,12,7,19
72995,Joint contracture of hand,ethnic,Not Hispanic or Latino,5,14,19
435796,Dehydration,racial,Black or African American ,5,14,19
75044,"Stiff joint NEC, of the hand",ethnic,Not Hispanic or Latino,7,12,19
196341,Dermatophytosis of the perianal area,racial,Black or African American ,5,14,19
30770,Chronic peptic ulcer with hemorrhage but without obstruction,racial,White,16,2,18
4326681,Family history of malignant neoplasm of ovary,ethnic,Hispanic or Latino,18,0,18
438058,Rape - assault,ethnic,Hispanic or Latino,16,2,18
443556,Primary focal hyperhidrosis,racial,Unknown,14,5,19
374221,Injury of brachial plexus,racial,Unknown,0,18,18
195498,Benign tumour of kidney,racial,White,18,0,18
435151,Physical child abuse,racial,White,0,18,18
4173811,Congenital quadriplegia,racial,Black or African American ,0,18,18
134312,Iatrogenic hypothyroidism,ethnic,Not Hispanic or Latino,16,2,18
313989,Chronic lymphadenitis,ethnic,Hispanic or Latino,5,14,19
135208,Benign tumor of lip,ethnic,Hispanic or Latino,16,2,18
195072,Medullary sponge kidney,ethnic,Not Hispanic or Latino,18,0,18
4296204,First degree burn,racial,Unknown,18,0,18
440387,Cannabis dependence,racial,White,0,18,18
193795,Acute gastric ulcer with hemorrhage but without obstruction,ethnic,Hispanic or Latino,5,14,19
4148407,Family history: Cardiovascular disease,racial,Unknown,14,5,19
438138,Paralytic syndromes,ethnic,Hispanic or Latino,18,0,18
434626,Borderline personality disorder,racial,White,14,5,19
4066163,Ureteric colic,ethnic,Not Hispanic or Latino,16,2,18
4299535,Pregnancy confirmed,racial,Asian,18,0,18
78257,Osteogenesis imperfecta,ethnic,Hispanic or Latino,12,7,19
435131,Victim of neglect,racial,White,5,14,19
79061,Colonic constipation,ethnic,Not Hispanic or Latino,16,2,18
439262,"Single manic episode, severe, with psychosis",ethnic,Hispanic or Latino,0,18,18
4305303,Sleep deprivation,ethnic,Not Hispanic or Latino,12,7,19
138844,Foreign body granuloma of muscle,ethnic,Hispanic or Latino,0,18,18
438872,Hyperphagia,ethnic,Hispanic or Latino,12,7,19
438867,Generalized body aches,racial,American Indian or Alaska Native ,9,9,18
440276,"Infection AND/OR inflammatory reaction due to internal prosthetic device, implant AND/OR graft",racial,Unknown,9,9,18
432806,Fall from cliff,ethnic,Hispanic or Latino,0,18,18
197145,Open wound of pelvic region without complication,ethnic,Not Hispanic or Latino,18,0,18
381854,Disorder of conjunctiva,racial,White,12,7,19
199066,Female digestive-genital tract fistula,racial,White,18,0,18
133711,Overlapping malignant neoplasm of female breast,racial,White,18,0,18
136934,Primary hyperparathyroidism,racial,Other Race,18,0,18
140673,Hypothyroid,racial,Asian Indian,12,7,19
436972,Glaucoma associated with systemic syndromes,racial,American Indian or Alaska Native ,16,2,18
375525,Athetoid cerebral palsy,racial,White,12,7,19
4012297,Closed fracture of one or more phalanges of hand NOS,ethnic,Hispanic or Latino,12,7,19
73026,Abnormal respiratory sounds,ethnic,Not Hispanic or Latino,5,14,19
4171075,Bite of animal,racial,White,9,9,18
438855,Klinefelter's syndrome,ethnic,Hispanic or Latino,0,18,18
192683,Uterovaginal prolapse,racial,Unknown,18,0,18
373503,Intermittent cerebral ischaemia,racial,American Indian or Alaska Native ,18,0,18
436096,Chronic pain,racial,American Indian,0,18,18
4110945,Benign hypertensive heart disease NOS,racial,White,7,12,19
442609,Friction blister without infection,racial,Other Race,7,12,19
80177,Pyogenic arthritis of the pelvic region and thigh,ethnic,Hispanic or Latino,0,18,18
75010,Fibroadenosis of breast,racial,Unknown,18,0,18
193020,Incomplete emptying of bladder,racial,White,12,7,19
197237,Benign tumour of prostate,racial,Black or African American ,0,18,18
134116,Dermatitis due to drug AND/OR medicine taken internally,ethnic,Not Hispanic or Latino,9,9,18
197381,Epigastric pain,racial,Native Hawaiian or Other Pacific Islander ,7,12,19
441840,Clinical finding,racial,Other Race,14,5,19
436118,After-cataract with vision obscured,ethnic,Not Hispanic or Latino,12,7,19
433403,Viral meningitis,racial,White,12,7,19
436373,DSD - Developmental speech disorder,racial,American Indian or Alaska Native ,14,5,19
432621,Purulent endophthalmitis,ethnic,Hispanic or Latino,14,5,19
436667,Stammer,racial,Unknown,0,16,16
4094865,Ca intrahepatic bile ducts,ethnic,Hispanic or Latino,0,16,16
4096204,Disorders of amino acid transport and metabolism,racial,Asian,16,0,16
443754,"Lyell toxic epidermal necrolysis, subepidermal type",ethnic,Hispanic or Latino,0,16,16
78579,Closed fracture of first cervical vertebra,racial,White,16,0,16
261116,Acquired nasal deformity,ethnic,Hispanic or Latino,7,9,16
132740,Positive skin test reaction,racial,Native Hawaiian or Other Pacific Islander ,12,5,17
141508,Dermatophytosis of scalp or beard,racial,Black or African American ,5,12,17
24970,Chronic laryngitis,racial,Unknown,7,9,16
312902,Benign intracranial hypertension,ethnic,Hispanic or Latino,16,0,16
376124,Pinguecula,ethnic,Not Hispanic or Latino,7,9,16
141090,PG - Pyogenic granuloma,racial,Other Race,7,9,16
25780,Lorain - Levi dwarfism,racial,White,2,14,16
4049623,"Moderate major depression, single episode",racial,Black or African American ,5,12,17
4173498,FH: Heart disorder,racial,Other Race,7,9,16
141475,Second degree burn of foot,racial,White,7,9,16
432795,Traumatic AND/OR non-traumatic injury,racial,Other Race,5,12,17
201257,Disorder of endocrine ovary,racial,White,16,0,16
4278672,Fracture of forearm,racial,Unknown,5,12,17
133294,Prepatellar bursitis,ethnic,Not Hispanic or Latino,0,16,16
437784,Pfeiffer's disease,ethnic,Not Hispanic or Latino,7,9,16
376712,Purulent otitis media,racial,White,12,5,17
4015843,Gonorrhea carrier,ethnic,Hispanic or Latino,0,16,16
436108,Acute closed-angle glaucoma,racial,Black or African American ,16,0,16
199870,Renal vascular disorder,ethnic,Hispanic or Latino,9,7,16
435993,Foreign body in conjunctival sac,ethnic,Hispanic or Latino,2,14,16
439656,A/N care: grand multip,ethnic,Not Hispanic or Latino,16,0,16
437758,Dependance on enabling machine or device,racial,White,2,14,16
197028,Calculus of lower urinary tract,racial,White,0,16,16
4215884,Unilateral radical mastectomy,ethnic,Hispanic or Latino,16,0,16
135496,Acute leukemia in remission,racial,White,9,7,16
438438,Acute myocardial infarction of anterolateral wall,ethnic,Hispanic or Latino,5,12,17
381677,SBO - Spina bifida occulta,ethnic,Not Hispanic or Latino,2,14,16
437243,Chronic paranoid schizophrenia with acute exacerbation,ethnic,Not Hispanic or Latino,0,16,16
4100857,Pickwickian syndrome,racial,American Indian or Alaska Native ,7,9,16
375825,Referred otalgia,ethnic,Not Hispanic or Latino,2,14,16
74606,Benign bone tumor,ethnic,Not Hispanic or Latino,5,12,17
443454,Cerebral infarction,racial,Native Hawaiian or Other Pacific Islander ,0,16,16
316814,Hyperventilation,ethnic,Hispanic or Latino,12,5,17
4181604,Subcutaneous contraceptive implant,racial,Unknown,16,0,16
201688,Urinary hesitancy,ethnic,Not Hispanic or Latino,2,14,16
372604,Movement disorder,ethnic,Hispanic or Latino,7,9,16
440544,"Closed fracture radius and ulna, proximal",ethnic,Hispanic or Latino,5,12,17
319793,CCHS - Congenital central hypoventilation,racial,White,7,9,16
137951,Acquired keratoderma,racial,Asian,16,0,16
441172,Late effect of burn,ethnic,Hispanic or Latino,0,16,16
440358,Lipoma,racial,Asian,7,9,16
75052,Enthesopathy of wrist AND/OR carpus,ethnic,Not Hispanic or Latino,12,5,17
432863,Acquired coagulation factor deficiency,ethnic,Not Hispanic or Latino,14,2,16
434689,Incomplete abortion,ethnic,Hispanic or Latino,16,0,16
438917,Superficial foreign body without major open wound AND without infection,racial,White,9,7,16
258981,Kaposi's sarcoma of skin,racial,White,0,16,16
381573,Acute mastoiditis without complications,ethnic,Hispanic or Latino,16,0,16
4055742,Acute pericementitis,racial,White,5,12,17
436541,Closed fracture of ulna,racial,White,14,2,16
194382,External haemorrhoid,racial,Native Hawaiian or Other Pacific Islander ,16,0,16
312902,Benign intracranial hypertension,racial,Other Race,16,0,16
4002644,Rotator cuff shoulder syndrome and allied disorders,ethnic,Not Hispanic or Latino,0,16,16
444287,Carbuncle of neck,racial,White,0,16,16
201773,Enteritis,ethnic,Hispanic or Latino,7,9,16
432546,Herpes zoster dermatitis of eyelids,racial,Unknown,7,9,16
4108817,"Tricuspid valve disorders, non-rheumatic",ethnic,Not Hispanic or Latino,0,16,16
76745,Capsular breast contracture of breast implant,ethnic,Hispanic or Latino,16,0,16
432621,Purulent endophthalmitis,ethnic,Not Hispanic or Latino,14,2,16
73560,Calcaneal spur,racial,Asian,5,12,17
438242,Talipes equinovarus,racial,White,2,14,16
438066,Chlamydial infection,racial,Other Race,7,9,16
192855,CIS - Carcinoma in situ of bladder,racial,Unknown,0,16,16
199067,Inflammatory disease of female pelvic organs AND/OR tissues,ethnic,Not Hispanic or Latino,16,0,16
433095,Fall on or from steps,ethnic,Not Hispanic or Latino,9,7,16
4239721,Seafood allergy,racial,Unknown,14,2,16
377554,Hereditary peripheral neuropathy,ethnic,Hispanic or Latino,2,14,16
4196362,Genetic counselling,racial,Unknown,14,2,16
4064989,Lung function testing abnormal,racial,White,0,16,16
4169568,Rheumatic endocarditis,ethnic,Hispanic or Latino,2,14,16
444297,Vertiginous syndrome,racial,White,14,2,16
436957,Functional disorders of polymorphonuclear neutrophils,ethnic,Hispanic or Latino,12,5,17
132583,Postablative hypothyroidism,ethnic,Not Hispanic or Latino,16,0,16
440385,Obstructive hydrocephalus,racial,Black or African American ,9,7,16
438688,Sarcoidosis,ethnic,Not Hispanic or Latino,16,0,16
79903,Effusion of joint,racial,Unknown,2,14,16
376969,Orofacial dyskinesia,racial,White,9,7,16
23653,Foreign body in esophagus,ethnic,Hispanic or Latino,7,9,16
374168,Complex febrile seizure,ethnic,Hispanic or Latino,7,9,16
375547,Anisometropia,ethnic,Hispanic or Latino,9,7,16
80946,Tinea manus,racial,Unknown,7,9,16
252658,Intrinsic asthma without status asthmaticus,racial,Black or African American ,14,2,16
378087,Secondary malignant neoplasm of brain and spinal cord,racial,Unknown,0,16,16
439777,Anemia,racial,American Indian,16,0,16
436020,Actinomycotic infection,ethnic,Hispanic or Latino,16,0,16
77638,Displacement of intervertebral disc without myelopathy,racial,Other Race,14,2,16
195212,Hypercortisolism,racial,White,12,5,17
141405,Congenital absence of muscle AND/OR tendon,racial,White,12,5,17
4297375,Victim of abuse,ethnic,Hispanic or Latino,16,0,16
81696,Closed fracture of acetabulum,ethnic,Hispanic or Latino,2,14,16
442441,Grand multiparity with antenatal problem,racial,White,16,0,16
77072,Joint effusion of ankle AND/OR foot,racial,Other Race,2,14,16
374954,Optic neuritis,ethnic,Not Hispanic or Latino,14,2,16
438039,Injury caused by animal,ethnic,Hispanic or Latino,14,2,16
381252,Benign neoplasm of eye,racial,Other Race,16,0,16
438297,"Mechanical complication of cardiac device, implant AND/OR graft",ethnic,Hispanic or Latino,12,5,17
199767,Neoplasm of uncertain behaviour of liver and/or biliary passages,ethnic,Hispanic or Latino,14,2,16
319927,Heart sounds abnormal,ethnic,Not Hispanic or Latino,0,16,16
4062998,Infantile paralytic paralysis,ethnic,Hispanic or Latino,16,0,16
4062636,Bacterial disease screening,racial,American Indian,16,0,16
377848,Toxic maculopathy,racial,Unknown,16,0,16
4265600,Gastric ulcer,ethnic,Hispanic or Latino,14,2,16
443216,Graft versus host disease,racial,White,0,16,16
435149,Complication of internal device,racial,White,2,14,16
195769,Submucous uterine leiomyoma,ethnic,Hispanic or Latino,16,0,16
194981,Bilateral femoral hernia without obstruction AND without gangrene,ethnic,Hispanic or Latino,7,9,16
435325,Umbilical cord complication,racial,Unknown,7,9,16
139099,Ingrowing nail,racial,American Indian or Alaska Native ,14,2,16
197928,Menstruation absent,racial,Filipino,16,0,16
75382,Closed fractures of tarsal AND metatarsal bones,ethnic,Not Hispanic or Latino,14,2,16
440203,Fetus OR newborn affected by condition of umbilical cord,racial,White,9,7,16
4243973,Laparoscopic appendectomy,racial,White,5,12,17
138824,Contact dermatitis due to metal,racial,Unknown,9,7,16
438555,Cyanosis,racial,White,5,12,17
4215568,Sensory disturbance in limb,ethnic,Hispanic or Latino,12,5,17
442262,Blister of toe without infection,ethnic,Not Hispanic or Latino,9,7,16
439961,Superficial injury without infection,racial,Unknown,14,2,16
437113,Asthenia,ethnic,Not Hispanic or Latino,7,9,16
138864,Congenital anomaly of nail,ethnic,Hispanic or Latino,16,0,16
440846,"Blood coagulation disorder, categorized by value of screening test",racial,Unknown,9,7,16
74729,Ganglion and synovial cyst,racial,Other Race,9,7,16
435574,Abnormal form of root of tooth,ethnic,Hispanic or Latino,16,0,16
134870,Pityriasis versicolor,racial,Black or African American ,5,12,17
441589,Endocarditis,ethnic,Not Hispanic or Latino,12,5,17
73338,Sprain of lateral collateral ligament of knee,racial,Unknown,5,12,17
4060929,Orchitis and epididymitis NOS,ethnic,Hispanic or Latino,0,16,16
439654,Partial epilepsy with impairment of consciousness,racial,Native Hawaiian or Other Pacific Islander ,0,16,16
433623,Intracranial hemorrhage following injury with open intracranial wound AND brief loss of consciousness (less than one hour),ethnic,Hispanic or Latino,0,16,16
199066,Female digestive-genital tract fistula,ethnic,Hispanic or Latino,16,0,16
441267,Cystic fibrosis,racial,White,5,12,17
441851,Serous detachment of retinal pigment epithelium,racial,Unknown,16,0,16
443447,Iatrogenic hypotension,ethnic,Not Hispanic or Latino,0,16,16
375527,Headache disorder,racial,Unknown,16,0,16
382034,Injury of sciatic nerve,racial,Unknown,14,2,16
444100,Mood disorder,racial,Other Race,5,12,17
438719,Active rickets,ethnic,Hispanic or Latino,16,0,16
438268,Closed dislocation of finger,racial,White,9,7,16
197928,Menstruation absent,racial,American Indian,16,0,16
438867,Generalized body aches,racial,Asian,14,2,16
443587,Diastolic heart failure,racial,Native Hawaiian or Other Pacific Islander ,9,7,16
4146235,Other cellulitis and abscess,ethnic,Hispanic or Latino,2,14,16
374957,Acquired stenosis of external ear canal,racial,White,2,14,16
134618,Toxic diffuse goiter with thyrotoxic crisis,ethnic,Hispanic or Latino,16,0,16
432877,Socialised behaviour disorder,racial,White,0,16,16
314958,Benign secondary hypertension,racial,White,7,9,16
28457,Hypertrophy of tonsils,racial,Other Race,5,12,17
140020,Viral exanthem,racial,Other Race,7,9,16
134159,Precordial pain,racial,Filipino,5,12,17
76194,Osteoarthrosis involving multiple sites but not designated as generalized,racial,Other Race,16,0,16
80241,Closed fracture navicular,racial,White,14,2,16
437611,Ectopic pregnancy,ethnic,Hispanic or Latino,16,0,16
196463,Alcoholic cirrhosis,racial,American Indian or Alaska Native ,16,0,16
4302252,High risk pregnancy care,racial,Other Race,16,0,16
432256,Primary malignant neoplasm of Meckel diverticulum,ethnic,Hispanic or Latino,16,0,16
377830,Alcohol withdrawal delirium,ethnic,Hispanic or Latino,2,14,16
192854,Interstitial uterine fibroid,racial,American Indian or Alaska Native ,16,0,16
138717,Thyrotoxicosis with diffuse goitre,racial,Unknown,16,0,16
4345578,Rhabdomyolysis,racial,Unknown,16,0,16
139179,Open wound of lip without complication,ethnic,Not Hispanic or Latino,7,9,16
4107655,Observations relating to psychosocial functioning,racial,Other Race,9,7,16
434339,Adolescent - emotional problem,ethnic,Not Hispanic or Latino,5,12,17
72471,Sprain of carpometacarpal joint,racial,White,5,12,17
434319,Premature orgasm - male,racial,Unknown,0,16,16
4055742,Acute pericementitis,ethnic,Hispanic or Latino,5,12,17
4064989,Lung function testing abnormal,ethnic,Not Hispanic or Latino,0,16,16
25518,AS - Sickle cell trait,racial,Black or African American ,7,9,16
140489,Acquired acanthosis nigricans,racial,Filipino,9,7,16
378424,Astigmatism,racial,Unknown,5,12,17
136661,Nodular goiter,racial,White,16,0,16
440009,Complication of implant,racial,White,12,5,17
380109,Exophoria,ethnic,Hispanic or Latino,12,5,17
4064383,Rheumatoid arthritis screening,ethnic,Not Hispanic or Latino,12,5,17
4051238,Family history of deafness,racial,White,2,14,16
4079499,Convalescence after radiotherapy,ethnic,Hispanic or Latino,16,0,16
375551,Blepharochalasis,racial,Unknown,16,0,16
312902,Benign intracranial hypertension,ethnic,Not Hispanic or Latino,16,0,16
75667,Sprain of calcaneofibular ligament,racial,White,16,0,16
193255,"Noninflammatory disorders of the ovary, fallopian tube and broad ligament",ethnic,Not Hispanic or Latino,16,0,16
440032,CMV - Cytomegalovirus infection,racial,Black or African American ,16,0,16
258684,Pulmonary cryptococcosis,ethnic,Hispanic or Latino,0,16,16
435412,Second degree burn of breast,racial,White,16,0,16
196734,Disease of prostate,ethnic,Not Hispanic or Latino,0,16,16
138845,Rheumatism,racial,White,16,0,16
198803,Nodular hyperplasia of prostate gland,racial,Native Hawaiian or Other Pacific Islander ,0,16,16
24978,Chronic adenotonsillitis,ethnic,Hispanic or Latino,9,7,16
77373,Congenital deformity of hip joint,racial,Asian,16,0,16
432801,"Injury undetermined whether accidentally or purposely inflicted, fall from natural site",racial,White,12,5,17
441443,Injury of superior vena cava,racial,White,16,0,16
134743,Congenital ichthyosis of skin,racial,Black or African American ,16,0,16
76161,Impotence of organic origin,racial,American Indian,0,16,16
435372,Underweight,racial,Asian,12,5,17
4100912,Screening for rheumatoid conditions,racial,Unknown,16,0,16
372907,Macular scar,racial,Unknown,14,2,16
72714,Chronic polyarticular juvenile rheumatoid arthritis,racial,White,5,12,17
4215884,Unilateral radical mastectomy,racial,Unknown,16,0,16
374748,Perinatal anoxic-ischemic brain injury,racial,White,0,16,16
313224,Anomalous atrioventricular excitation,ethnic,Not Hispanic or Latino,5,12,17
379019,Inflammation of conjunctiva,racial,Filipino,7,9,16
4096783,Total prostatectomy,racial,Unknown,0,16,16
441092,Advanced maternal age gravida,racial,Black or African American ,16,0,16
434016,"Nondependent opioid abuse, continuous",racial,Other Race,16,0,16
436583,[X]Falls,racial,Native Hawaiian or Other Pacific Islander ,0,16,16
4147837,Generalized metabolic disorder,racial,Unknown,0,16,16
4204904,Education about sexually transmitted disease prevention,racial,Black or African American ,5,12,17
75652,Congenital valgus deformity of foot,racial,Unknown,0,16,16
76034,Herpes simplex whitlow,ethnic,Hispanic or Latino,9,7,16
437543,Multiple cranial nerve palsy,racial,White,5,12,17
73008,Enthesopathy,racial,Asian,9,7,16
436682,Moderate mental handicap,racial,Asian,0,16,16
436075,Adjustment disorder with anxious mood,racial,Black or African American ,0,16,16
4210149,Substance abuse counseling,racial,Asian,2,14,16
441834,"Bipolar affective disorder, currently manic, mild",ethnic,Hispanic or Latino,5,12,17
374655,Mastoiditis,racial,Unknown,14,2,16
4094865,Ca intrahepatic bile ducts,racial,White,0,16,16
442926,"Motor vehicle traffic accident involving collision with another motor vehicle, parked, driver of motor vehicle injured",ethnic,Hispanic or Latino,9,7,16
81377,Climacteric arthritis of the lower leg,racial,White,16,0,16
195209,Benign neoplasm of liver and/or biliary ducts,ethnic,Hispanic or Latino,12,5,17
79917,Acquired deformity of toe,racial,Unknown,7,9,16
312902,Benign intracranial hypertension,racial,White,16,0,16
4147494,Nonspecific mesenteric adenitis,ethnic,Not Hispanic or Latino,5,12,17
28457,Hypertrophy of tonsils,racial,Black or African American ,5,12,17
374221,Injury of brachial plexus,ethnic,Not Hispanic or Latino,0,16,16
72469,Closed dislocation of shoulder region,ethnic,Not Hispanic or Latino,9,7,16
74698,Breech presentation,ethnic,Not Hispanic or Latino,12,5,17
437246,Vitamin B deficiency,racial,Asian,16,0,16
4070287,Preauricular sinus and fistula,ethnic,Hispanic or Latino,5,12,17
432621,Purulent endophthalmitis,racial,Unknown,16,0,16
4079499,Convalescence after radiotherapy,racial,White,16,0,16
198201,Chronic salpingo-oophoritis,racial,White,16,0,16
442598,Fracture of radius AND ulna,ethnic,Hispanic or Latino,14,2,16
4016352,Tuberculosis contact,racial,Unknown,9,7,16
374357,Acquired stenosis of nasolacrimal duct,ethnic,Not Hispanic or Latino,7,9,16
195861,Small kidney,racial,White,16,0,16
24966,OV - Oesophageal varices,ethnic,Not Hispanic or Latino,0,16,16
438990,Benign neuroendocrine tumor,racial,White,16,0,16
75128,Injury of chest wall,racial,Black or African American ,0,16,16
4103640,Amputated foot,ethnic,Not Hispanic or Latino,2,14,16
198191,Acquired hypertrophic pyloric stenosis,racial,White,7,9,16
442282,Urinary casts,racial,Other Race,12,5,17
80573,Contusion of ankle,ethnic,Not Hispanic or Latino,14,2,16
440228,Closed fracture of lower end of humerus,racial,Unknown,12,5,17
74719,Foot ulcer,racial,Native Hawaiian or Other Pacific Islander ,2,14,16
436381,Gender identity disorder of childhood,racial,Unknown,0,16,16
317898,Malignant essential hypertension,racial,Black or African American ,0,16,16
440155,Postartificial menopausal syndrome,racial,Unknown,16,0,16
432661,Stomatitis,racial,Asian,12,5,17
441417,Lack of coordination,racial,Black or African American ,0,16,16
443274,Psychostimulant dependence,racial,White,5,12,17
261327,Empyema of pleura without fistula,ethnic,Hispanic or Latino,5,12,17
314754,Wheezing,racial,American Indian,9,7,16
26638,Primary malignant neoplasm of oesophagus,racial,White,0,16,16
377282,Conjunctivitis with mucocutaneous disorder,racial,White,14,2,16
195769,Submucous uterine leiomyoma,racial,White,16,0,16
433069,Open wound of external genital organs with complication,racial,Other Race,9,7,16
435524,Sleep disorder,racial,Other Race,14,2,16
4144783,Old healed fracture of bone,ethnic,Hispanic or Latino,16,0,16
434610,Hyperkalemia,racial,Native Hawaiian or Other Pacific Islander ,9,7,16
376125,Disorder of eyelid,racial,Unknown,16,0,16
314090,PET - Mild pre-eclamptic toxaemia,ethnic,Hispanic or Latino,16,0,16
314054,Aortic valve disease,racial,Native Hawaiian or Other Pacific Islander ,12,5,17
199192,Abrasion AND/OR friction burn of trunk without infection,ethnic,Not Hispanic or Latino,9,7,16
377848,Toxic maculopathy,ethnic,Hispanic or Latino,16,0,16
4114314,Screening for osteoporosis,racial,Filipino,16,0,16
319793,CCHS - Congenital central hypoventilation,ethnic,Hispanic or Latino,7,9,16
372309,Mononeuritis,racial,Asian,14,2,16
258453,Acute upper respiratory infection of multiple sites,ethnic,Not Hispanic or Latino,9,7,16
432791,Urticaria-angio-oedema,racial,Black or African American ,14,2,16
435244,Developmental disorder,ethnic,Not Hispanic or Latino,12,5,17
40490888,Herniation of rectum into vagina,ethnic,Not Hispanic or Latino,16,0,16
438178,Postmastectomy lymphedema syndrome,ethnic,Hispanic or Latino,16,0,16
198334,Campylobacter diarrhoea,ethnic,Hispanic or Latino,9,7,16
196991,Chronic renal disease,racial,American Indian or Alaska Native ,16,0,16
4210149,Substance abuse counseling,racial,Black or African American ,9,7,16
133384,Burn any degree involving less than 10 percent of body surface,ethnic,Hispanic or Latino,9,7,16
377885,Disorder of eye movements,racial,Black or African American ,12,5,17
4292726,Contact - infectious disease,racial,Black or African American ,0,16,16
373648,Superficial injury of eyelid AND/OR periocular area,ethnic,Hispanic or Latino,5,12,17
4100515,Cocaine type drug dependence,ethnic,Not Hispanic or Latino,0,16,16
30234,Cervical sprain,racial,American Indian or Alaska Native ,16,0,16
441201,"[X]Fall from, out of or through building or structure",racial,White,16,0,16
200662,Lymphosarcoma,ethnic,Not Hispanic or Latino,7,9,16
444219,Osteitis deformans without bone tumor,racial,Unknown,16,0,16
435642,Disturbance in speech,racial,White,0,16,16
4062637,TB - Tuberculosis screening,racial,American Indian,9,7,16
4310682,Multiple open wounds with complication,racial,Unknown,14,2,16
443865,Non-infective colitis,racial,Filipino,9,7,16
4071485,Foetus or neonate affected by caesarean section,racial,White,16,0,16
435516,Lipoprotein deficiency disorder,racial,Black or African American ,7,9,16
376964,Partial recent retinal detachment with giant tear,ethnic,Hispanic or Latino,2,14,16
374649,Strabismic amblyopia,racial,White,14,2,16
4015842,Viral hepatitis carrier,racial,White,7,9,16
437127,Closed dislocation of acromioclavicular joint,ethnic,Not Hispanic or Latino,0,16,16
194710,Placenta previa without hemorrhage,ethnic,Hispanic or Latino,16,0,16
80571,Open wound of foot with complication,racial,Unknown,16,0,16
79939,Sprain of tarsometatarsal joint AND/OR ligament,racial,White,16,0,16
80497,Disorder of cervical spine,racial,Unknown,12,5,17
374888,Dementia associated with another disease,racial,Filipino,16,0,16
199867,CPH - Chronic persistent hepatitis,racial,Unknown,14,2,16
198187,"Acute peptic ulcer without hemorrhage, without perforation AND without obstruction",racial,White,16,0,16
81250,Carcinoma in situ of breast,racial,Asian,16,0,16
443887,Superficial foreign body of ankle without major open wound AND without infection,ethnic,Hispanic or Latino,5,12,17
4104561,Ptosis of eyelid NOS,ethnic,Hispanic or Latino,16,0,16
200687,Renal disorder associated with type I diabetes mellitus,racial,American Indian or Alaska Native ,16,0,16
442862,"Abrasion or friction burn of hand, without mention of infection",racial,Unknown,2,14,16
440905,Toxic effect of venom,racial,Other Race,5,12,17
4201745,Disease of digestive system,ethnic,Hispanic or Latino,12,5,17
4109545,Unspecified cataracta complicata,ethnic,Hispanic or Latino,9,7,16
137829,Erythroid aplasia,ethnic,Not Hispanic or Latino,7,9,16
76745,Capsular breast contracture of breast implant,racial,White,16,0,16
321414,Hemoglobinuria,ethnic,Hispanic or Latino,7,9,16
197381,Epigastric pain,racial,Filipino,9,7,16
374748,Perinatal anoxic-ischemic brain injury,ethnic,Not Hispanic or Latino,0,16,16
433762,Disseminated chorioretinitis,racial,White,16,0,16
256215,"Lung agenesis, hypoplasia and dysplasia",ethnic,Not Hispanic or Latino,0,16,16
439304,Retinal round hole without detachment,racial,White,16,0,16
440637,Relapsing fever,ethnic,Hispanic or Latino,12,5,17
434854,FP - Food poisoning,racial,Unknown,9,7,16
377873,Lid lag,racial,White,16,0,16
442105,Benign tumor of soft tissue,racial,Unknown,2,14,16
198201,Chronic salpingo-oophoritis,racial,Unknown,16,0,16
81685,Fracture of clavicle due to birth trauma,ethnic,Hispanic or Latino,2,14,16
372912,Visual discomfort,ethnic,Not Hispanic or Latino,14,2,16
4256640,Body mass index 40+ - severely obese,racial,Black or African American ,16,0,16
377830,Alcohol withdrawal delirium,racial,White,0,16,16
441482,Administrative reason for encounter,racial,American Indian or Alaska Native ,16,0,16
380533,Neonatal seizures,ethnic,Hispanic or Latino,16,0,16
442609,Friction blister without infection,racial,Unknown,14,2,16
133351,Open wound of cheek without complication,ethnic,Hispanic or Latino,9,7,16
138340,Septicaemia due to Staphylococcus aureus,ethnic,Hispanic or Latino,0,16,16
134304,Benign tumour of parathyroid gland,racial,Unknown,16,0,16
4110047,Chronic bronchitis NOS,ethnic,Not Hispanic or Latino,2,14,16
135618,Prurigo,racial,Black or African American ,12,5,17
197028,Calculus of lower urinary tract,ethnic,Not Hispanic or Latino,0,16,16
4111255,Unspecified labyrinthitis,racial,Unknown,0,16,16
81893,Chronic ulcerative colitis,racial,Asian,2,14,16
196569,Contusion of abdominal wall,racial,Unknown,7,9,16
433556,Derangement of posterior horn of lateral meniscus,ethnic,Not Hispanic or Latino,16,0,16
312336,Arterial aneurysm,ethnic,Not Hispanic or Latino,2,14,16
441851,Serous detachment of retinal pigment epithelium,ethnic,Hispanic or Latino,16,0,16
440426,Vertigo as late effect of stroke,racial,Filipino,16,0,16
135772,Goiter,racial,American Indian or Alaska Native ,16,0,16
77030,Disease of breast,racial,Other Race,16,0,16
80045,Primary malignant neoplasm of anus,racial,Black or African American ,0,16,16
194993,Intestinal malabsorption,ethnic,Not Hispanic or Latino,14,2,16
193518,Intestinal obstruction,ethnic,Not Hispanic or Latino,5,12,17
77358,Observation of hand region,ethnic,Hispanic or Latino,5,12,17
378425,Eyelid inflammation,racial,Other Race,12,5,17
140648,Onychomycosis due to dermatophyte,racial,Filipino,7,9,16
4064989,Lung function testing abnormal,ethnic,Hispanic or Latino,7,9,16
440032,CMV - Cytomegalovirus infection,ethnic,Not Hispanic or Latino,16,0,16
441207,Drug reaction,racial,Asian,14,2,16
314664,Long Q-T syndrome,racial,Unknown,16,0,16
75617,Polyarticular osteoarthritis,racial,Native Hawaiian or Other Pacific Islander ,16,0,16
74470,Congenital anomaly of upper limb,racial,White,9,7,16
200771,Peptic ulcer without hemorrhage AND without perforation but with obstruction,racial,White,9,7,16
77650,Aseptic necrosis of bone,ethnic,Not Hispanic or Latino,16,0,16
198520,Lumbar spondylosis with myelopathy,ethnic,Not Hispanic or Latino,16,0,16
75623,Old disruption of anterior cruciate ligament,racial,Other Race,0,16,16
4169568,Rheumatic endocarditis,racial,White,2,14,16
4264281,Open fracture,ethnic,Hispanic or Latino,16,0,16
261116,Acquired nasal deformity,racial,White,7,9,16
253896,Traumatic pneumothorax without open wound into thorax,ethnic,Hispanic or Latino,0,16,16
436826,Closed fracture of shaft of radius,ethnic,Hispanic or Latino,12,5,17
195453,"Colitis, enteritis and gastroenteritis presumed infectious",racial,Asian,9,7,16
435658,Atypical squamous cells on vaginal Papanicolaou smear cannot exclude high grade squamous intraepithelial lesion,ethnic,Hispanic or Latino,16,0,16
201265,Splenic disorder,ethnic,Not Hispanic or Latino,5,12,17
4133029,Primigravida,racial,Native Hawaiian or Other Pacific Islander ,16,0,16
444375,"Contact dermatitis due to plants, except food",ethnic,Not Hispanic or Latino,9,7,16
197044,Female infertility associated with anovulation,racial,Other Race,16,0,16
316127,Vitreous opacities,racial,Other Race,9,7,16
435127,Sequelae of intracranial injury,racial,White,0,16,16
137083,Unilateral incomplete cleft palate,ethnic,Hispanic or Latino,0,16,16
440828,Renal pelvis and ureter obstructive defects,ethnic,Hispanic or Latino,0,16,16
433069,Open wound of external genital organs with complication,racial,Black or African American ,9,7,16
432452,Anemia of prematurity,racial,White,14,2,16
380513,Congenital cataract,ethnic,Not Hispanic or Latino,5,12,17
433617,Open fracture of femoral condyle of femur,ethnic,Hispanic or Latino,0,16,16
4060929,Orchitis and epididymitis NOS,racial,White,0,16,16
376382,Tension-type headache,racial,American Indian or Alaska Native ,12,5,17
432587,Polyclonal hypergammaglobulinemia,ethnic,Hispanic or Latino,7,9,16
442603,Malignant hypertensive heart AND renal disease,ethnic,Not Hispanic or Latino,16,0,16
4012297,Closed fracture of one or more phalanges of hand NOS,racial,White,9,7,16
141667,Laxity of ligament,ethnic,Hispanic or Latino,16,0,16
81064,Pseudopolyposis of colon,ethnic,Hispanic or Latino,9,7,16
81942,Enthesopathy of ankle AND/OR tarsus,ethnic,Not Hispanic or Latino,14,2,16
377849,Retinal deposits,ethnic,Not Hispanic or Latino,16,0,16
375529,Infantile cerebral palsy,racial,Native Hawaiian or Other Pacific Islander ,12,5,17
374649,Strabismic amblyopia,racial,Unknown,12,5,17
257660,Partial anomalous pulmonary venous connection,ethnic,Hispanic or Latino,0,16,16
40482203,Karyotype evaluation abnormal,racial,White,16,0,16
320536,Abnormal EKG finding,racial,American Indian or Alaska Native ,16,0,16
439005,Chronic alcoholism in remission,racial,Other Race,0,16,16
442609,Friction blister without infection,racial,Black or African American ,5,12,17
192279,Diabetic nephropathy,racial,Filipino,16,0,16
441840,Clinical finding,racial,Asian,14,2,16
440544,"Closed fracture radius and ulna, proximal",racial,White,5,12,17
433762,Disseminated chorioretinitis,ethnic,Hispanic or Latino,16,0,16
440786,Threatened premature labor,ethnic,Hispanic or Latino,16,0,16
380510,Congenital abnormality of eyelid,ethnic,Not Hispanic or Latino,0,16,16
439298,Bronchitis and pneumonitis due to chemical fumes,ethnic,Hispanic or Latino,9,7,16
4096204,Disorders of amino acid transport and metabolism,ethnic,Hispanic or Latino,16,0,16
437220,Primary malignant neoplasm of ventral surface of tongue,racial,White,0,16,16
433260,Mother delivered,ethnic,Not Hispanic or Latino,16,0,16
436812,Tongue tie,racial,Asian,0,16,16
440321,Helicobacter-associated disease,racial,Native Hawaiian or Other Pacific Islander ,9,7,16
30679,Benign tumour major salivary gland,racial,Black or African American ,16,0,16
136496,Cellulitis and abscess of face,racial,Black or African American ,5,12,17
435940,"Closed fracture of humerus, shaft",racial,White,12,5,17
196443,Gastric ulcer without hemorrhage AND without perforation but with obstruction,racial,Unknown,16,0,16
435636,Juvenile osteochondritis of hip AND/OR pelvis,ethnic,Not Hispanic or Latino,0,16,16
444129,Wrist injury,racial,Other Race,0,16,16
194286,"Malignant neoplasm of corpus uteri, excluding isthmus",racial,Unknown,16,0,16
435604,"Viral disease in mother complicating pregnancy, childbirth AND/OR puerperium",ethnic,Hispanic or Latino,14,2,16
433577,Hammer toe,racial,Other Race,14,2,16
438244,Congenital hydrocephalus,racial,Unknown,0,16,16
138604,"Contusion of face, scalp and neck, excluding eye(s)",racial,Asian,9,7,16
439971,Poisoning by anticoagulant,racial,White,7,9,16
380120,Strabismus in neuromuscular disorder,ethnic,Not Hispanic or Latino,0,16,16
437217,Coccidioidomycosis,racial,White,0,16,16
375415,Injury of head region,racial,American Indian or Alaska Native ,9,7,16
4093344,Prostate observation,racial,Alaska Native,0,16,16
4150614,Communication disorder,racial,White,0,16,16
444243,Neurotic disorder,racial,Asian,2,14,16
381548,Monoplegia,ethnic,Not Hispanic or Latino,0,16,16
4166776,Dupuytren contracture,ethnic,Not Hispanic or Latino,12,5,17
72992,Allergic arthritis,racial,Unknown,7,9,16
198995,Type 1 diabetes mellitus - poor control,racial,American Indian,16,0,16
319927,Heart sounds abnormal,racial,White,2,14,16
320536,Abnormal EKG finding,racial,Native Hawaiian or Other Pacific Islander ,9,7,16
4086918,Viral screening,racial,Asian Indian,7,9,16
374366,Sensorineural hearing loss,racial,Black or African American ,14,2,16
320206,Congenital atresia of pulmonary valve,ethnic,Hispanic or Latino,9,7,16
193251,Umbilical hernia without obstruction AND without gangrene,racial,Asian,9,7,16
433171,Selective IgA immunodeficiency,racial,Other Race,16,0,16
135888,Decubitus ulcer,ethnic,Not Hispanic or Latino,2,14,16
257315,Bacterial pneumonia,racial,Filipino,9,7,16
200171,Carbuncle of skin AND/OR subcutaneous tissue,ethnic,Not Hispanic or Latino,2,14,16
4095918,Other disorders of thyroid,racial,White,16,0,16
443115,Closed fracture finger proximal phalanx,racial,Unknown,9,7,16
201418,"Flatulence, eructation and gas pain",racial,Black or African American ,12,5,17
30284,Motion sickness,racial,Unknown,14,2,16
76797,Congenital deformity of genital organ,racial,White,0,16,16
141405,Congenital absence of muscle AND/OR tendon,ethnic,Hispanic or Latino,12,5,17
4100515,Cocaine type drug dependence,racial,Black or African American ,0,16,16
316822,Finding of heart murmur,racial,Filipino,12,5,17
443429,Endothelial corneal dystrophy,ethnic,Hispanic or Latino,16,0,16
138864,Congenital anomaly of nail,racial,White,12,5,17
443593,Ulcer of thigh,racial,Unknown,16,0,16
79118,Deformity of calcaneum,racial,White,7,9,16
320827,Atresia and stenosis of aorta,ethnic,Not Hispanic or Latino,16,0,16
195401,Superficial bruising of hip,racial,Unknown,16,0,16
432874,Lipidosis,racial,White,0,16,16
75924,Osteodystrophy,racial,White,2,14,16
140602,"Mechanical complication of internal orthopedic device, implant and graft",ethnic,Hispanic or Latino,9,7,16
4196362,Genetic counselling,ethnic,Not Hispanic or Latino,16,0,16
200051,Primary malignant neoplasm of ovary,racial,Other Race,16,0,16
437382,Urine observation,racial,Filipino,12,5,17
372828,Zoster ophthalmicus,racial,Other Race,0,16,16
436097,"Nondependent mixed drug abuse, continuous",ethnic,Hispanic or Latino,7,9,16
435127,Sequelae of intracranial injury,ethnic,Hispanic or Latino,0,16,16
80492,Knee joint contracture,ethnic,Hispanic or Latino,16,0,16
441284,Open-angle glaucoma,racial,Black or African American ,16,0,16
200771,Peptic ulcer without hemorrhage AND without perforation but with obstruction,racial,Asian,2,14,16
432284,Single major depressive episode,racial,Filipino,14,2,16
434303,Benign neoplasm of rectum and anal canal,racial,Unknown,16,0,16
198075,Venereal wart,racial,Other Race,14,2,16
433881,Additional general conditions of patient,ethnic,Not Hispanic or Latino,12,5,17
443216,Graft versus host disease,ethnic,Hispanic or Latino,0,16,16
440207,Hypoplastic left heart syndrome,racial,White,9,7,16
438719,Active rickets,racial,White,16,0,16
4305841,Periodic limb movement disorder,racial,White,5,12,17
440129,Hypertrophy of nasal turbinates,racial,Asian,5,12,17
437543,Multiple cranial nerve palsy,ethnic,Hispanic or Latino,5,12,17
435459,Staphylococcal infectious disease,racial,White,7,9,16
4061081,Other male genital organ diseases OS,ethnic,Hispanic or Latino,0,16,16
76836,Sprain of knee and leg,racial,Native Hawaiian or Other Pacific Islander ,5,12,17
30361,Hypoglycemic disorder,racial,Unknown,14,2,16
4005603,Congenital cystic kidney disease NOS,ethnic,Hispanic or Latino,0,16,16
434622,Deficiency anemias,racial,Asian,14,2,16
134159,Precordial pain,racial,American Indian or Alaska Native ,14,2,16
433585,Klippel-Feil sequence,ethnic,Hispanic or Latino,5,12,17
443616,Refractory migraine without aura,racial,White,16,0,16
438480,"Abnormal glucose tolerance in mother complicating pregnancy, childbirth AND/OR puerperium",racial,Black or African American ,16,0,16
192855,CIS - Carcinoma in situ of bladder,ethnic,Hispanic or Latino,0,16,16
440685,"Nondependent alcohol abuse, episodic",racial,Black or African American ,0,16,16
321319,Cardiomyopathy,racial,Asian,0,16,16
432877,Socialised behaviour disorder,ethnic,Hispanic or Latino,0,16,16
439003,Disorder of branched chain amino acid metabolism,ethnic,Not Hispanic or Latino,0,16,16
4204967,Laryngismus,ethnic,Hispanic or Latino,7,9,16
432256,Primary malignant neoplasm of Meckel diverticulum,racial,White,16,0,16
377539,Syringomyelia and syringobulbia,racial,White,16,0,16
4088920,Womb absent,racial,Asian,16,0,16
434097,Twin pregnancy with antenatal problem,racial,Asian,16,0,16
433617,Open fracture of femoral condyle of femur,racial,White,0,16,16
137005,Tracheostomy complication,racial,Unknown,16,0,16
437217,Coccidioidomycosis,ethnic,Hispanic or Latino,0,16,16
200762,Autoimmune hepatitis,racial,Unknown,16,0,16
381575,Disorder of external ear,ethnic,Not Hispanic or Latino,12,5,17
81380,Cervical syndrome,ethnic,Hispanic or Latino,16,0,16
442023,Poisoning of undetermined intent,racial,White,9,7,16
197444,Vascular complication of medical care,ethnic,Hispanic or Latino,16,0,16
4024361,Paralysis of glottis,racial,White,0,16,16
433675,Toxic effect of chemical,racial,White,7,9,16
444361,Nonvenomous insect bite of toe without infection,racial,White,12,5,17
441532,Monoclonal paraproteinaemia,ethnic,Not Hispanic or Latino,16,0,16
441874,Cerebral thrombosis,ethnic,Not Hispanic or Latino,12,5,17
442753,Furuncle of trunk,racial,Unknown,7,9,16
201079,Acute parametritis and pelvic cellulitis,racial,Unknown,16,0,16
80269,Mechanical complication of internal joint prosthesis,ethnic,Hispanic or Latino,16,0,16
193520,Urinary bladder stone,ethnic,Not Hispanic or Latino,0,16,16
75053,Fracture of bone,racial,Unknown,9,7,16
4053599,Open wound of forearm,ethnic,Not Hispanic or Latino,12,5,17
4051238,Family history of deafness,ethnic,Hispanic or Latino,2,14,16
29056,Sialoadenitis,racial,Asian,2,14,16
432881,Pancytopenia,racial,Other Race,16,0,16
313236,Cough variant asthma,racial,Filipino,7,9,16
441408,Vomiting,racial,Native Hawaiian or Other Pacific Islander ,5,12,17
437058,Sunburn,racial,Unknown,7,9,16
201916,Ureteric stone,ethnic,Not Hispanic or Latino,16,0,16
198678,Intestinal infectious disease,racial,Filipino,14,2,16
197981,Abdominal tenderness,ethnic,Not Hispanic or Latino,14,2,16
435236,Acute exacerbation of chronic schizoaffective schizophrenia,racial,White,16,0,16
439695,Hypertensive heart and renal disease with renal failure,racial,Other Race,16,0,16
198124,Disorder of kidney,racial,Native Hawaiian or Other Pacific Islander ,12,5,17
81106,Acquired genu varum,racial,Unknown,9,7,16
73754,Restless legs,racial,Asian,5,12,17
320206,Congenital atresia of pulmonary valve,racial,White,9,7,16
443754,"Lyell toxic epidermal necrolysis, subepidermal type",racial,White,0,16,16
437382,Urine observation,racial,Native Hawaiian or Other Pacific Islander ,14,2,16
4085075,At risk state,ethnic,Hispanic or Latino,9,7,16
373999,Diabetic oculopathy associated with type I diabetes mellitus,racial,Filipino,16,0,16
436348,Primary malignant neoplasm of anal canal,racial,White,0,16,16
378741,Brachial plexus lesion,ethnic,Not Hispanic or Latino,0,16,16
261327,Empyema of pleura without fistula,ethnic,Not Hispanic or Latino,16,0,16
132659,Acute apical periodontitis,racial,Other Race,7,9,16
433992,"Bipolar affective disorder, currently manic, moderate",racial,Black or African American ,0,16,16
373166,Benign neoplasm of lower jaw bone,racial,Unknown,16,0,16
437791,Chickenpox with complication,ethnic,Hispanic or Latino,7,9,16
195834,Atherosclerosis of renal artery,ethnic,Hispanic or Latino,16,0,16
436108,Acute closed-angle glaucoma,racial,White,7,9,16
439154,Abnormal findings on diagnostic imaging of skull and head,ethnic,Not Hispanic or Latino,7,9,16
440193,Wristdrop,ethnic,Hispanic or Latino,0,16,16
138717,Thyrotoxicosis with diffuse goitre,ethnic,Not Hispanic or Latino,14,2,16
435380,Closed fracture of radius AND ulna,ethnic,Not Hispanic or Latino,14,2,16
198928,Mechanical complication due to intrauterine contraceptive device,ethnic,Not Hispanic or Latino,14,2,16
74104,Fetal condition affecting obstetrical care of mother,racial,White,16,0,16
316135,AVB - Atrioventricular block,ethnic,Not Hispanic or Latino,5,12,17
438129,"Severe manic bipolar I disorder with psychotic features, mood-congruent",racial,White,5,12,17
72465,Closed fracture of one or more phalanges of hand,racial,Black or African American ,7,9,16
195314,Nephrotic syndrome,racial,Unknown,5,12,17
4147639,Cellulitis and abscess of toe NOS,ethnic,Not Hispanic or Latino,2,14,16
141372,Contact dermatitis due to solvents,ethnic,Not Hispanic or Latino,5,12,17
4114610,Allergic arthritis NOS,racial,White,12,5,17
440689,Agranulocytosis,ethnic,Not Hispanic or Latino,14,2,16
440748,Interstitial emphysema of lung,racial,Asian,0,16,16
434119,Hidradenitis,racial,Other Race,16,0,16
433623,Intracranial hemorrhage following injury with open intracranial wound AND brief loss of consciousness (less than one hour),racial,White,0,16,16
4340379,Hepatitis B carrier,racial,Unknown,7,9,16
138455,Stomatitis,racial,Unknown,7,9,16
321822,Peripheral circulatory disorder associated with diabetes mellitus,ethnic,Hispanic or Latino,2,14,16
141666,Acute osteomyelitis of lower leg,racial,Other Race,0,16,16
436155,Redundant prepuce and phimosis,racial,Other Race,0,16,16
4239975,Myocardial disease,ethnic,Hispanic or Latino,0,16,16
132822,Foot-and-mouth disease,racial,White,5,12,17
201355,Erosion and ectropion of the cervix,ethnic,Hispanic or Latino,16,0,16
315922,Patent ductus arteriosus,racial,Asian,16,0,16
4273391,Suicidal thoughts,racial,Unknown,16,0,16
4140207,Nephrosclerosis,ethnic,Hispanic or Latino,12,5,17
80497,Disorder of cervical spine,racial,Other Race,0,16,16
443949,Disease type AND/OR category unknown,ethnic,Hispanic or Latino,14,2,16
439981,Wound dehiscence,racial,White,7,9,16
436665,Manic-depressive psychosis,racial,Filipino,16,0,16
437758,Dependance on enabling machine or device,ethnic,Not Hispanic or Latino,2,14,16
198197,Male infertility,racial,Asian,0,16,16
436108,Acute closed-angle glaucoma,ethnic,Not Hispanic or Latino,16,0,16
73300,Radial styloid tenosynovitis,racial,Black or African American ,9,7,16
73840,Primary localised osteoarthrosis of shoulder region,racial,Other Race,14,2,16
4290927,Impairment level: low vision of both eyes,racial,Other Race,14,2,16
438882,Closed fracture of neck of metacarpal bone,racial,Unknown,9,7,16
133728,Congenital hypothyroidism,racial,White,16,0,16
439035,Otosclerosis,racial,Unknown,12,5,17
443698,Abnormal anal Papanicolaou smear,racial,White,16,0,16
4201387,Tracheostomy in situ,racial,Asian,2,14,16
374347,Blepharoconjunctivitis,racial,White,12,5,17
440846,"Blood coagulation disorder, categorized by value of screening test",racial,Black or African American ,16,0,16
433069,Open wound of external genital organs with complication,racial,American Indian or Alaska Native ,9,7,16
257581,Exacerbation of asthma,racial,American Indian or Alaska Native ,12,5,17
197518,Neoplasm of uncertain behavior of male genital organ,ethnic,Hispanic or Latino,2,14,16
27918,Eosinophilic esophagitis,ethnic,Hispanic or Latino,0,16,16
433031,Hallucinations,racial,Asian,12,5,17
4201472,Varicella contact,ethnic,Hispanic or Latino,14,2,16
379006,Cerebral degeneration in childhood,ethnic,Not Hispanic or Latino,16,0,16
375815,Bullous keratopathy,racial,Unknown,5,12,17
4061056,Endometriosis NOS,racial,White,16,0,16
260134,Croup,racial,Black or African American ,12,5,17
193322,Right lower quadrant pain,racial,American Indian or Alaska Native ,14,2,16
444406,Acute subendocardial infarction,racial,Unknown,9,7,16
80482,Suppurative arthritis,racial,White,7,9,16
134305,Acute lymphoid leukaemia,ethnic,Hispanic or Latino,0,16,16
441266,Thiamin deficiency,ethnic,Hispanic or Latino,9,7,16
432874,Lipidosis,ethnic,Hispanic or Latino,12,5,17
438990,Benign neuroendocrine tumor,ethnic,Hispanic or Latino,16,0,16
73562,Solitary sacroiliitis,racial,Unknown,12,5,17
24075,Esophageal stricture and stenosis,racial,White,7,9,16
136917,Primary malignant neoplasm of skin of face,racial,Unknown,16,0,16
434339,Adolescent - emotional problem,racial,Unknown,5,12,17
438959,Amoebiasis,racial,White,9,7,16
433760,Dysreflexia,ethnic,Not Hispanic or Latino,0,16,16
442774,Intermittent claudication,racial,Other Race,2,14,16
4171594,Family history of cancer,ethnic,Not Hispanic or Latino,14,2,16
138906,Superficial injury of face without infection,ethnic,Hispanic or Latino,7,9,16
433131,Mumps without complication,ethnic,Hispanic or Latino,14,2,16
137682,Skin sensation disturbance,racial,American Indian or Alaska Native ,16,0,16
435506,Benign neoplastic disease,ethnic,Hispanic or Latino,14,2,16
442603,Malignant hypertensive heart AND renal disease,racial,Black or African American ,16,0,16
133726,Carcinoma in situ of skin of face,racial,White,12,5,17
444419,Quadriparesis,ethnic,Hispanic or Latino,0,16,16
433033,Abnormal cervical Papanicolaou smear,ethnic,Not Hispanic or Latino,16,0,16
137063,Corns and callus,racial,Black or African American ,5,12,17
4098297,Unspecified latent schizophrenia,racial,Unknown,0,16,16
194395,Bleeding diverticulosis,racial,Unknown,12,5,17
433957,Progressive multifocal leukoencephalopathy,racial,White,0,16,16
73847,Observation of elbow joint,racial,White,2,14,16
260759,Malocclusion of teeth,ethnic,Hispanic or Latino,12,5,17
25582,Tracheesophageal fistula,ethnic,Hispanic or Latino,5,12,17
201070,Cholelithiasis AND cholecystitis without obstruction,racial,Unknown,14,2,16
78508,Arthralgia of the ankle and/or foot,racial,American Indian or Alaska Native ,16,0,16
432742,Closed skull fracture without intracranial injury,racial,Unknown,2,14,16
199076,Fallopian tube pregnancy,racial,White,9,7,16
4110655,Pupil-involving third nerve palsy,racial,White,7,9,16
80523,Congenital fusion of spine,racial,White,16,0,16
373499,Disorder of eye region,racial,Asian,16,0,16
198187,"Acute peptic ulcer without hemorrhage, without perforation AND without obstruction",ethnic,Hispanic or Latino,12,5,17
255919,Finding of head and neck region,racial,Black or African American ,2,14,16
380415,Acute swimmer's ear,racial,Black or African American ,16,0,16
195926,Slowing of urinary stream,racial,White,7,9,16
432417,Acquired hallux malleus,ethnic,Hispanic or Latino,16,0,16
4098297,Unspecified latent schizophrenia,ethnic,Hispanic or Latino,2,14,16
441408,Vomiting,racial,American Indian or Alaska Native ,7,9,16
437611,Ectopic pregnancy,racial,White,16,0,16
381858,Dacryoadenitis,racial,White,7,9,16
80182,Dermatomyositis,racial,White,12,5,17
192676,Cervical intraepithelial neoplasia grade 1,racial,Asian,16,0,16
435443,[X]Fall involving wheelchair,racial,Unknown,12,5,17
195083,Left lower quadrant pain,racial,American Indian or Alaska Native ,2,14,16
375806,Idiopathic peripheral neuropathy,racial,American Indian or Alaska Native ,12,5,17
433457,Agoraphobia without mention of panic attacks,ethnic,Not Hispanic or Latino,16,0,16
197095,Embryonic cyst of fallopian tube and broad ligament,racial,White,16,0,16
443571,Cervicovaginal cytology: High grade squamous intraepithelial lesion or carcinoma,racial,Other Race,16,0,16
4091320,Meningococcal infection NOS,ethnic,Hispanic or Latino,14,2,16
441443,Injury of superior vena cava,ethnic,Hispanic or Latino,16,0,16
432303,Cocaine abuse,ethnic,Hispanic or Latino,2,14,16
72245,Chlamydial infection of lower genitourinary tract,racial,Unknown,16,0,16
4230642,Acquired deformity of chest,racial,Other Race,16,0,16
442942,"Crush injury, toe(s)",ethnic,Hispanic or Latino,12,5,17
315833,Secondary cardiomyopathy,ethnic,Not Hispanic or Latino,0,16,16
254676,Lung involvement associated with another disorder,ethnic,Hispanic or Latino,16,0,16
137379,Musculoskeletal symptom,racial,Other Race,7,9,16
257315,Bacterial pneumonia,racial,Black or African American ,9,7,16
4237140,Abnormal sexual function,racial,White,0,16,16
375291,Bullous myringitis,racial,White,12,5,17
78831,Disease of ankle,racial,Other Race,16,0,16
4065355,Urticaria due to cold and heat,racial,White,16,0,16
378523,Residual foreign body in soft tissue,ethnic,Not Hispanic or Latino,5,12,17
40389897,"Neoplasm of uncertain behaviour of trachea, bronchus and lung",racial,White,0,16,16
437779,Streptococcal infectious disease,ethnic,Hispanic or Latino,5,12,17
4059637,Work environment deleterious,racial,Unknown,7,9,16
437220,Primary malignant neoplasm of ventral surface of tongue,ethnic,Not Hispanic or Latino,0,16,16
439658,Gestosis,ethnic,Hispanic or Latino,16,0,16
141648,Contact dermatitis due to cosmetics,ethnic,Hispanic or Latino,16,0,16
380727,Transient refractive change,ethnic,Hispanic or Latino,14,2,16
4273095,Acute tracheitis without obstruction,ethnic,Not Hispanic or Latino,2,14,16
196715,Budd-Chiari syndrome,ethnic,Hispanic or Latino,16,0,16
198198,Vaginal polyp,racial,White,16,0,16
321462,Cardiac complications of care,racial,Other Race,5,12,17
436665,Manic-depressive psychosis,racial,American Indian or Alaska Native ,14,2,16
196369,Adrenogenital disorder,racial,White,12,5,17
195873,Leukorrhagia,racial,Filipino,16,0,16
138225,Disease of sebaceous glands,racial,Asian,14,2,16
78235,Disorder of coccyx,racial,Other Race,12,5,17
4025176,Respiratory system diseases NOS,ethnic,Hispanic or Latino,2,14,16
141370,Toxic erythema,racial,White,12,5,17
198978,Acute gonorrhea of lower genitourinary tract,racial,Other Race,16,0,16
258684,Pulmonary cryptococcosis,racial,White,0,16,16
201061,Diaphragmatic hernia,racial,Black or African American ,5,12,17
443446,Reflex sympathetic dystrophy of lower extremity,ethnic,Hispanic or Latino,16,0,16
138340,Septicaemia due to Staphylococcus aureus,racial,White,0,16,16
137351,Epidermoid cyst of skin,racial,Black or African American ,9,7,16
443429,Endothelial corneal dystrophy,racial,Unknown,16,0,16
135061,Congenital anomaly of musculoskeletal system,racial,Unknown,0,16,16
79145,Ehlers-Danlos syndrome,ethnic,Hispanic or Latino,9,7,16
200149,Placenta previa with hemorrhage - not delivered,racial,White,16,0,16
254068,Upper respiratory disease,racial,Black or African American ,12,5,17
80070,Uric acid urolithiasis,racial,Asian,0,16,16
435516,Lipoprotein deficiency disorder,racial,Asian,14,2,16
193520,Urinary bladder stone,racial,White,0,16,16
4050793,FH: Infectious disease,racial,White,14,2,16
432791,Urticaria-angio-oedema,racial,Asian,16,0,16
440925,Suicide,ethnic,Not Hispanic or Latino,16,0,16
378427,Tear film insufficiency,racial,Native Hawaiian or Other Pacific Islander ,16,0,16
198985,Primary malignant neoplasm of kidney,racial,Other Race,5,12,17
4144274,Housing lack,racial,Black or African American ,7,9,16
381001,Subjective visual disturbance,racial,Unknown,2,14,16
441830,Disorder of fluid AND/OR electrolyte,racial,Asian,9,7,16
440938,Infection by Shigella,ethnic,Hispanic or Latino,9,7,16
134438,CD - Contact dermatitis,racial,Asian Indian,2,14,16
440084,Aphemesthaesia,ethnic,Hispanic or Latino,2,14,16
4096347,Gouty arthropathy,racial,Other Race,0,16,16
433178,Anxiety disorder of childhood OR adolescence,racial,White,5,12,17
257660,Partial anomalous pulmonary venous connection,racial,Unknown,0,16,16
433990,Subchronic catatonic schizophrenia,ethnic,Not Hispanic or Latino,0,16,16
439003,Disorder of branched chain amino acid metabolism,racial,Black or African American ,0,16,16
440814,Torticollis,racial,Other Race,9,7,16
438172,Atrial septal defect as current complication following acute myocardial infarction,ethnic,Hispanic or Latino,16,0,16
195851,"Gastric ulcer without hemorrhage, without perforation AND without obstruction",racial,Other Race,5,9,14
380669,Benign neoplasm of eyelid including canthus,racial,White,7,7,14
192276,Chronic gouty nephropathy,ethnic,Not Hispanic or Latino,14,0,14
440372,Acquired thrombocytopenia,ethnic,Not Hispanic or Latino,2,12,14
436539,Closed fracture of patella,racial,Black or African American ,0,14,14
432868,Hemoglobinopathy,ethnic,Not Hispanic or Latino,5,9,14
133013,Congenital spinal cord anomaly,ethnic,Not Hispanic or Latino,12,2,14
381570,Mechanical ptosis,racial,White,12,2,14
442068,Cellulitis and abscess of forearm,racial,Other Race,14,0,14
81112,Arthralgia of the lower leg,racial,Asian Indian,14,0,14
318852,Congenital malformation of vitreous body,ethnic,Not Hispanic or Latino,14,0,14
195209,Benign neoplasm of liver and/or biliary ducts,racial,White,9,5,14
433716,Primary malignant neoplasm of testis,racial,Unknown,0,14,14
73008,Enthesopathy,racial,Black or African American ,5,9,14
195501,Polycystic ovaries,racial,Other Race,14,0,14
380834,Coma,racial,White,2,12,14
78200,Benign mammary dysplasia,racial,Asian,14,0,14
22340,Esophageal varices without bleeding,ethnic,Not Hispanic or Latino,7,7,14
194788,Open wound of anterior abdominal wall with complication,ethnic,Not Hispanic or Latino,14,0,14
437557,Eczematous dermatitis of eyelid,ethnic,Not Hispanic or Latino,7,7,14
194996,Postoperative urethral stricture,ethnic,Hispanic or Latino,5,9,14
4110047,Chronic bronchitis NOS,racial,Black or African American ,0,14,14
374886,Benign neoplasm of ear,racial,Unknown,12,2,14
436166,Mild hyperemesis gravidarum,racial,Black or African American ,14,0,14
4331070,Family history of polyp of colon,racial,Unknown,5,9,14
437677,Abnormal findings on diagnostic imaging of lung,racial,Asian,9,5,14
4115062,Other internal knee derangement NOS,ethnic,Hispanic or Latino,0,14,14
377573,Pars tensa central perforation,ethnic,Hispanic or Latino,5,9,14
432252,Sequelae of infectious and parasitic diseases,racial,Unknown,0,14,14
443260,Umbilical lump,ethnic,Not Hispanic or Latino,14,0,14
4083236,Alcoholism counselling,ethnic,Hispanic or Latino,0,14,14
378424,Astigmatism,ethnic,Not Hispanic or Latino,7,7,14
434374,Anisocoria,racial,White,5,9,14
442068,Cellulitis and abscess of forearm,racial,American Indian or Alaska Native ,5,9,14
377001,Unruptured cerebral aneurysm,racial,Other Race,14,0,14
439221,"Adverse effect, due to correct medicinal substance properly administered",racial,Asian,7,7,14
372912,Visual discomfort,racial,White,9,5,14
78272,Sprain of wrist,racial,Black or African American ,7,7,14
198860,Congenital anomaly of lower alimentary tract,ethnic,Hispanic or Latino,14,0,14
196569,Contusion of abdominal wall,racial,White,5,9,14
4030398,Amputation of arm through shoulder,ethnic,Hispanic or Latino,2,12,14
74211,Superficial injury of finger without infection,racial,White,7,7,14
4326681,Family history of malignant neoplasm of ovary,racial,White,14,0,14
438917,Superficial foreign body without major open wound AND without infection,ethnic,Hispanic or Latino,7,7,14
4092845,Candidiasis NOS,ethnic,Hispanic or Latino,2,12,14
4089980,Early congenital syphilis - latent,ethnic,Hispanic or Latino,0,14,14
4002828,Acute osteomyelitis NOS,racial,White,0,14,14
75946,Sprain of proximal tibiofibular ligament,ethnic,Hispanic or Latino,14,0,14
444055,Thrombophlebitis of superficial veins of lower extremity,racial,White,12,2,14
137497,Dermatophytosis of the body,racial,American Indian or Alaska Native ,14,0,14
373463,Benign cough headache,ethnic,Hispanic or Latino,12,2,14
443622,Aneurysm of thoracic aorta,racial,Unknown,0,14,14
317376,Tachypnoeic,ethnic,Not Hispanic or Latino,2,12,14
316814,Hyperventilation,ethnic,Not Hispanic or Latino,12,2,14
76240,Closed fracture of pubis,racial,Unknown,14,0,14
197330,Finding of urethral sphincter function,ethnic,Hispanic or Latino,5,9,14
72618,Disorder of muscle,ethnic,Not Hispanic or Latino,5,9,14
139036,Systolic dysfunction,racial,White,2,12,14
40480943,Lateral cystocele,racial,White,14,0,14
443862,Complication of internal anastomosis,ethnic,Hispanic or Latino,14,0,14
192276,Chronic gouty nephropathy,racial,Black or African American ,14,0,14
198802,Occlusion of ureter,ethnic,Not Hispanic or Latino,5,9,14
200781,Unilateral small kidney,racial,White,0,14,14
197500,Primary malignant neoplasm of colon,racial,Other Race,0,14,14
74725,Displacement of cervical intervertebral disc without myelopathy,racial,Other Race,14,0,14
442287,Rest pain,racial,White,5,9,14
374645,Phantom limb syndrome,ethnic,Not Hispanic or Latino,0,14,14
434675,Complication of gastrostomy,ethnic,Not Hispanic or Latino,5,9,14
437176,Late effect of accidental fall,ethnic,Not Hispanic or Latino,12,2,14
436957,Functional disorders of polymorphonuclear neutrophils,racial,Other Race,14,0,14
78219,Cellulitis and abscess of hand excluding digits,racial,Asian,0,14,14
4177115,Malignant tumour of testis,racial,White,0,14,14
432417,Acquired hallux malleus,racial,White,12,2,14
30163,Cellulitis and abscess of neck,racial,Unknown,12,2,14
442010,Seafood-induced anaphylaxis,ethnic,Hispanic or Latino,7,7,14
438407,BN - Bulimia nervosa,ethnic,Not Hispanic or Latino,9,5,14
374940,Blepharophimosis syndrome,racial,White,2,12,14
4042836,Disease of head,ethnic,Hispanic or Latino,14,0,14
4185471,Disorder of pigmentation,racial,Black or African American ,5,9,14
25582,Tracheesophageal fistula,racial,White,0,14,14
435950,Closed Colles' fracture,racial,Other Race,14,0,14
443732,Disorder associated with type II diabetes melliltus,racial,Black or African American ,14,0,14
192273,Benign tumour of adrenal gland,ethnic,Not Hispanic or Latino,9,5,14
440193,Wristdrop,racial,White,0,14,14
4298824,Free skin graft,racial,Unknown,12,2,14
192367,Dysplasia of cervix,racial,Unknown,14,0,14
441827,Disorder of amino acid and organic acid metabolism,racial,Unknown,14,0,14
195770,Subserous uterine fibroid,racial,White,14,0,14
439314,Thrombophlebitis of the femoral vein,racial,Unknown,14,0,14
4095918,Other disorders of thyroid,ethnic,Hispanic or Latino,14,0,14
79936,Polyuria,racial,Asian,9,5,14
75924,Osteodystrophy,ethnic,Hispanic or Latino,2,12,14
4021168,Natural contraception,ethnic,Hispanic or Latino,14,0,14
196438,Acquired arteriovenous fistula of liver,racial,Asian,0,14,14
4144149,Cared for by family,racial,White,7,7,14
78272,Sprain of wrist,racial,Asian,14,0,14
138876,Closed fracture of T1-T6 level with spinal cord injury,ethnic,Hispanic or Latino,14,0,14
442310,Acute heart failure,racial,White,5,9,14
261782,Herpetic ulceration of vulva,racial,Unknown,14,0,14
200769,"Chronic gastric ulcer without hemorrhage, without perforation AND without obstruction",ethnic,Not Hispanic or Latino,14,0,14
135710,"Burn involving 30-39 percent of body surface, with 20-29 percent of body surface with full thickness burn",ethnic,Not Hispanic or Latino,0,14,14
441092,Advanced maternal age gravida,racial,Asian,14,0,14
440374,Obsessive compulsive disorder,racial,American Indian or Alaska Native ,2,12,14
439799,Leg cramps,racial,Asian,14,0,14
200391,Peripheral autonomic neuropathy disease EC,racial,Other Race,7,7,14
442747,Contact dermatitis due to food in contact with skin,racial,White,7,7,14
373404,Ophthalmic herpes simplex,ethnic,Hispanic or Latino,12,2,14
435325,Umbilical cord complication,racial,White,5,9,14
439685,"Malignant neoplasm, overlapping lesion of digestive system",ethnic,Hispanic or Latino,14,0,14
375800,Dystonia,ethnic,Hispanic or Latino,14,0,14
4046893,Lifestyle,racial,Black or African American ,2,12,14
4213085,Family history of prostate cancer,ethnic,Not Hispanic or Latino,0,14,14
436033,Syphilis,racial,Black or African American ,0,14,14
438120,Opioid dependence,racial,Native Hawaiian or Other Pacific Islander ,0,14,14
73017,Congenital anomaly of toe,ethnic,Hispanic or Latino,14,0,14
75426,Burn of hand,racial,White,5,9,14
196796,Congenital biliary atresia,ethnic,Hispanic or Latino,14,0,14
4318408,Subdural haematoma,racial,Black or African American ,2,12,14
438297,"Mechanical complication of cardiac device, implant AND/OR graft",racial,White,0,14,14
437982,Semen observations,racial,White,0,14,14
77030,Disease of breast,racial,Asian,14,0,14
73318,Polydactyly of fingers,ethnic,Hispanic or Latino,14,0,14
443525,Monoplegia of dominant upper limb as a late effect of cerebrovascular accident,ethnic,Hispanic or Latino,0,14,14
438567,Adult failure to thrive syndrome,ethnic,Not Hispanic or Latino,5,9,14
4143915,Cholestasis,racial,White,9,5,14
441261,Episodic acute alcoholic intoxication in alcoholism,ethnic,Not Hispanic or Latino,14,0,14
79884,Galactorrhea not associated with childbirth,racial,Black or African American ,14,0,14
439003,Disorder of branched chain amino acid metabolism,racial,White,0,14,14
4066036,Gastroduodenal fistula,ethnic,Hispanic or Latino,14,0,14
439246,"Mixed bipolar affective disorder, severe, with psychosis",racial,White,9,5,14
438116,Benign neoplasm of short bones of lower limb,ethnic,Hispanic or Latino,7,7,14
435792,Drug-induced sleep disorder,ethnic,Hispanic or Latino,7,7,14
4143915,Cholestasis,racial,Unknown,12,2,14
73819,Painful breasts,racial,American Indian or Alaska Native ,14,0,14
443788,Peritoneal adhesions with obstruction,ethnic,Hispanic or Latino,12,2,14
374934,Impairment level: one eye: severe impairment: other eye: near-normal vision,racial,Unknown,2,12,14
434885,Benign neoplasm of skull and facial bones,ethnic,Hispanic or Latino,7,7,14
77968,Hallux valgus AND bunion,racial,Native Hawaiian or Other Pacific Islander ,14,0,14
135287,Non-neoplastic naevus,racial,Filipino,14,0,14
437541,Glaucoma,racial,Filipino,9,5,14
138858,Pale complexion,racial,Unknown,5,9,14
192673,Vascular insufficiency of intestine,racial,White,12,2,14
200680,Tumour of urinary bladder,ethnic,Hispanic or Latino,5,9,14
433015,Congenital anomaly of aortic arch,ethnic,Not Hispanic or Latino,5,9,14
256571,FB - Nasal foreign body,ethnic,Not Hispanic or Latino,9,5,14
200779,Intrauterine polyp,racial,Unknown,14,0,14
194964,Aneurysm of splenic artery,racial,White,14,0,14
444234,Late effect of complications of trauma,ethnic,Hispanic or Latino,2,12,14
132702,Erythema multiforme,racial,Unknown,7,7,14
75103,Sprain of jaw,ethnic,Not Hispanic or Latino,14,0,14
441422,Closed fracture of humerus,racial,Asian,14,0,14
375504,Psychoactive substance-induced organic mental disorder,ethnic,Not Hispanic or Latino,5,9,14
432729,Crying infant,ethnic,Not Hispanic or Latino,7,7,14
440956,Primary malignant neoplasm of upper inner quadrant of female breast,racial,Unknown,14,0,14
372635,Corneal degeneration,racial,Unknown,9,5,14
376400,Combined form of senile cataract,racial,Native Hawaiian or Other Pacific Islander ,14,0,14
437038,Blood in urine,racial,American Indian,0,14,14
256215,"Lung agenesis, hypoplasia and dysplasia",racial,Other Race,14,0,14
312336,Arterial aneurysm,racial,Unknown,12,2,14
440350,"Malignant lymphoma - lymphocytic, intermediate differentiation",racial,White,0,14,14
79121,Aseptic necrosis of talus,racial,White,14,0,14
137520,Chronic thyroiditis,ethnic,Hispanic or Latino,12,2,14
78842,Acquired postural lordosis,ethnic,Hispanic or Latino,12,2,14
199876,Prolapse of female genital organs,ethnic,Not Hispanic or Latino,14,0,14
4107655,Observations relating to psychosocial functioning,racial,Black or African American ,7,7,14
134398,Periodontal disease,racial,Unknown,5,9,14
437537,Shyness disorder of childhood,ethnic,Hispanic or Latino,2,12,14
133727,Thyrotoxicosis without goiter OR other cause,racial,American Indian or Alaska Native ,14,0,14
136775,Contact dermatitis due to solar radiation,racial,Unknown,9,5,14
133728,Congenital hypothyroidism,racial,Unknown,14,0,14
197239,Haemangioma of intra-abdominal structure,racial,Unknown,5,9,14
4103403,Psychosexual disorder NOS,racial,White,2,12,14
438469,"Duodenal ulcer without hemorrhage, without perforation AND without obstruction",racial,Asian,14,0,14
4173498,FH: Heart disorder,racial,Unknown,9,5,14
312922,Coronary bypass graft observation,racial,Black or African American ,2,12,14
441262,"Amfetamine or psychostimulant dependence, episodic",ethnic,Not Hispanic or Latino,7,7,14
201093,Infection of skin AND/OR subcutaneous tissue,racial,Black or African American ,9,5,14
437243,Chronic paranoid schizophrenia with acute exacerbation,racial,Black or African American ,0,14,14
4318408,Subdural haematoma,ethnic,Not Hispanic or Latino,2,12,14
377298,Chronic otitis externa,ethnic,Not Hispanic or Latino,7,7,14
434549,Fall from toilet seat,racial,White,9,5,14
435457,Primary progressive tuberculosis,racial,White,0,14,14
138845,Rheumatism,racial,Unknown,14,0,14
434056,Late effects of cerebrovascular disease,racial,Native Hawaiian or Other Pacific Islander ,0,14,14
313224,Anomalous atrioventricular excitation,racial,Unknown,5,9,14
436532,Congenital cytomegalovirus infection,racial,White,5,9,14
434821,SIRS - System inflammatory response syndrome,racial,Other Race,7,7,14
31317,Can't get food down,racial,Filipino,0,14,14
4168217,Generalized hyperhidrosis,racial,Asian,12,2,14
443442,Finding of vaginal vault smear result,ethnic,Not Hispanic or Latino,14,0,14
198101,Lipoma of skin and subcutaneous tissue (excluding face),racial,Other Race,7,7,14
4066820,Ingestion dermatitis due to food,racial,Unknown,9,5,14
24970,Chronic laryngitis,racial,Other Race,12,2,14
72576,Benign tumour of breast,racial,Asian,14,0,14
141004,Lesion of radial nerve,racial,Unknown,5,9,14
440238,Closed fracture of metatarsal bone,racial,Other Race,14,0,14
376422,Mucopurulent conjunctivitis,racial,Black or African American ,5,9,14
433948,Accident caused by handgun,racial,White,0,14,14
196751,Haemorrhage from placenta previa,ethnic,Hispanic or Latino,14,0,14
444382,Thoracic radiculitis,racial,Black or African American ,7,7,14
80045,Primary malignant neoplasm of anus,racial,Unknown,7,7,14
433621,Sprain of sternoclavicular joint AND/OR ligament,racial,White,9,5,14
444256,Polyp of labia,ethnic,Hispanic or Latino,14,0,14
437744,Heat exhaustion,ethnic,Hispanic or Latino,5,9,14
73336,Closed traumatic dislocation ankle joint,ethnic,Hispanic or Latino,9,5,14
442775,Degeneration of thoracic intervertebral disc,racial,Unknown,12,2,14
197950,Cellulitis and abscess of trunk,racial,Black or African American ,2,12,14
4055758,Temporomandibular joint disorder NOS,racial,Unknown,12,2,14
377873,Lid lag,racial,Unknown,0,14,14
140027,Herpetic gingivostomatitis,racial,Asian,9,5,14
201620,Calculus of kidney,racial,American Indian or Alaska Native ,14,0,14
438205,Maternal syphilis during pregnancy - baby not yet delivered,ethnic,Hispanic or Latino,14,0,14
442444,"Motor vehicle traffic accident involving pedestrian hit by motor vehicle, pedestrian injured",ethnic,Hispanic or Latino,14,0,14
4225928,Heteronymous hemianopsia,ethnic,Hispanic or Latino,9,5,14
377556,Sudden visual loss,ethnic,Not Hispanic or Latino,14,0,14
443767,Diabetic oculopathy,racial,Asian Indian,14,0,14
197324,Disease of peritoneum,ethnic,Hispanic or Latino,7,7,14
441968,Acetonuria,ethnic,Not Hispanic or Latino,14,0,14
80232,Closed fracture of calcaneus,ethnic,Not Hispanic or Latino,0,14,14
201907,Oedema of male genital organs,ethnic,Not Hispanic or Latino,0,14,14
256197,Rheumatoid lung disease,racial,White,0,14,14
435141,Haemorrhage AND/OR haematoma complicating procedure,racial,White,14,0,14
4270866,Symptomatic dermographism,racial,White,12,2,14
80593,Urinary complication,ethnic,Hispanic or Latino,14,0,14
438409,Attention deficit hyperactivity disorder,racial,Native Hawaiian or Other Pacific Islander ,0,14,14
79189,Open wound of chest wall with complication,ethnic,Not Hispanic or Latino,0,14,14
442013,Burn,racial,Other Race,9,5,14
74125,Inflammatory polyarthropathy,ethnic,Not Hispanic or Latino,5,9,14
4060434,Unstable lie unspecified,ethnic,Hispanic or Latino,14,0,14
442936,"Motor vehicle traffic accident due to motor vehicle going out of control due to failure of mechanical part, without collision on the highway, passenger of motor vehicle injured",ethnic,Hispanic or Latino,12,2,14
23220,Chronic tonsillitis,ethnic,Not Hispanic or Latino,2,12,14
198400,Haemangioma of skin and subcutaneous tissue,racial,Other Race,2,12,14
435141,Haemorrhage AND/OR haematoma complicating procedure,racial,Unknown,0,14,14
4251787,Tuberculosis of rectum,ethnic,Hispanic or Latino,14,0,14
40481819,Early satiety,racial,Unknown,9,5,14
443360,Eye mass,racial,Unknown,12,2,14
435787,Vitamin B6 deficiency,racial,Unknown,14,0,14
375822,Neonatal obstruction of nasolacrimal duct,ethnic,Not Hispanic or Latino,9,5,14
197036,Vesicoureteral reflux,racial,Other Race,0,14,14
442295,Disorder of carbohydrate transport,ethnic,Hispanic or Latino,9,5,14
440612,Toxic effect of tobacco and nicotine,ethnic,Not Hispanic or Latino,2,12,14
135852,Teething syndrome,racial,Other Race,7,7,14
193250,Gastric hemorrhage,racial,White,0,14,14
194079,Post-surgical malabsorption,racial,Native Hawaiian or Other Pacific Islander ,0,14,14
4049623,"Moderate major depression, single episode",racial,Filipino,0,14,14
441818,Haemangioma,racial,Black or African American ,12,2,14
321109,Congenital anomaly of coronary artery,ethnic,Hispanic or Latino,5,9,14
433701,Mycosis,racial,Unknown,9,5,14
4147497,Nervous system and sense organ diseases,racial,Other Race,5,9,14
4006788,Percutaneous transluminal coronary balloon angioplasty,racial,Unknown,12,2,14
4100367,Simple schizophrenia NOS,racial,White,12,2,14
433031,Hallucinations,racial,Other Race,9,5,14
376387,Spasmodic torticollis,ethnic,Hispanic or Latino,7,7,14
78235,Disorder of coccyx,racial,Asian,12,2,14
442308,Abrasion AND/OR friction burn of thigh without infection,racial,Other Race,2,12,14
134404,Anal spasm,ethnic,Hispanic or Latino,7,7,14
193787,Varicose veins of lower extremity with ulcer AND inflammation,ethnic,Not Hispanic or Latino,2,12,14
4104042,Strabismus (squint) and other disorders of binocular eye movements,ethnic,Hispanic or Latino,14,0,14
199978,Contusion of lower limb,racial,Other Race,2,12,14
198240,Congenital buried penis,ethnic,Hispanic or Latino,0,14,14
319845,Pulmonary valve disease,ethnic,Not Hispanic or Latino,14,0,14
436366,Benign tumour of testis,ethnic,Hispanic or Latino,0,14,14
435080,Biliuria,ethnic,Not Hispanic or Latino,5,9,14
320749,Periarteritis nodosa,ethnic,Hispanic or Latino,12,2,14
434592,B-cell lymphoma,racial,White,14,0,14
201614,Calculus of bile duct with cholecystitis,racial,Unknown,7,7,14
441351,Early onset of delivery - delivered,ethnic,Hispanic or Latino,7,7,14
134442,Thibierge-Weissenbach syndrome,racial,Asian,14,0,14
437226,Malignant neoplasm of nasopharyngeal wall,racial,Asian,0,14,14
376946,Senile delirium,racial,Filipino,14,0,14
4168226,Micturition frequency and polyuria,ethnic,Not Hispanic or Latino,9,5,14
196168,Irregular menstrual bleeding,racial,Filipino,14,0,14
4037738,Visual alteration,racial,Unknown,9,5,14
79189,Open wound of chest wall with complication,racial,Black or African American ,0,14,14
440029,Viral disease,racial,American Indian or Alaska Native ,9,5,14
79897,Obstetric non-purulent mastitis - delivered with postnatal complication,racial,Unknown,14,0,14
443269,Elderly primiparous with labor,ethnic,Hispanic or Latino,14,0,14
73043,Open traumatic dislocation of shoulder,racial,Unknown,14,0,14
4171594,Family history of cancer,ethnic,Hispanic or Latino,9,5,14
256723,Pneumonia and influenza,racial,White,0,14,14
439777,Anemia,racial,Asian Indian,14,0,14
437226,Malignant neoplasm of nasopharyngeal wall,ethnic,Not Hispanic or Latino,0,14,14
201595,Thrombosed internal hemorrhoids,racial,White,2,12,14
77647,Mallet finger,ethnic,Not Hispanic or Latino,7,7,14
196733,Urethral syndrome,racial,Unknown,12,2,14
441818,Haemangioma,racial,Asian,5,9,14
77960,Joint observation,racial,Unknown,5,9,14
261255,Benign neoplasm of bronchus and lung,racial,White,7,7,14
442794,Poisoning by wasp sting,racial,Unknown,7,7,14
255677,Open wound of nose without complication,racial,Unknown,2,12,14
316501,Disorder of blood vessels affecting skin,ethnic,Not Hispanic or Latino,7,7,14
377845,Anoxic encephalopathy,racial,White,9,5,14
444401,Delusions,ethnic,Hispanic or Latino,12,2,14
441532,Monoclonal paraproteinaemia,racial,Asian,14,0,14
194693,Postprocedural pelvic peritoneal adhesions,ethnic,Hispanic or Latino,14,0,14
440631,Mycobacterial disease,ethnic,Hispanic or Latino,5,9,14
434750,Feeding difficulties and mismanagement,racial,Filipino,14,0,14
434908,Disorder of porphyrin and haem metabolism,racial,White,9,5,14
381384,Congenital absence of external ear,racial,White,9,5,14
40482203,Karyotype evaluation abnormal,ethnic,Hispanic or Latino,12,2,14
142026,Disorder of cardiovascular prostheses and implants,racial,White,7,7,14
435524,Sleep disorder,racial,Asian,12,2,14
252663,Pneumonitis due to inhalation of food or vomitus,racial,Unknown,9,5,14
378743,Mild nonproliferative retinopathy,racial,Other Race,2,12,14
25572,Disease of salivary gland,racial,Unknown,5,9,14
432620,Disorder of choroid of eye,ethnic,Hispanic or Latino,12,2,14
433403,Viral meningitis,racial,Unknown,14,0,14
197988,General abdominal pain-symptom,racial,Black or African American ,7,7,14
320136,Disease of respiratory system,racial,Other Race,5,9,14
201606,Crohn's disease,racial,Black or African American ,7,7,14
73564,Complete rupture of rotator cuff,ethnic,Not Hispanic or Latino,7,7,14
194684,Crohn's disease of large bowel,ethnic,Hispanic or Latino,12,2,14
436352,Primary malignant neoplasm of laryngeal cartilage,racial,White,0,14,14
80806,Climacteric arthritis of multiple sites,racial,White,7,7,14
4056329,Vaginitis and vulvovaginitis NOS,racial,Black or African American ,14,0,14
4179925,Basic learning problem,racial,Black or African American ,2,12,14
375538,"Degeneration of macula due to cyst, hole or pseudohole",racial,Unknown,14,0,14
201059,Hypertrophic gastritis,ethnic,Hispanic or Latino,7,7,14
253549,Connective tissue disease,racial,Unknown,14,0,14
434557,Tuberculosis,racial,White,0,14,14
376647,Primary malignant neoplasm of soft tissues,racial,White,14,0,14
81141,Closed fracture of ilium,ethnic,Hispanic or Latino,14,0,14
440112,Chloasma of eyelid,ethnic,Hispanic or Latino,9,5,14
81169,Superficial foreign body of finger without major open wound AND without infection,racial,Unknown,7,7,14
259865,Cyst of Bartholin's gland duct,racial,Other Race,14,0,14
375550,Senile corneal changes,racial,Unknown,14,0,14
377294,Exotropia,ethnic,Not Hispanic or Latino,7,7,14
4013916,Closed fracture of clavicle NOS,racial,Unknown,14,0,14
444105,Burn any degree involving 70-79 percent of body surface,racial,White,0,14,14
372604,Movement disorder,ethnic,Not Hispanic or Latino,14,0,14
436667,Stammer,racial,White,5,9,14
78516,Arthralgia of the upper arm,racial,American Indian or Alaska Native ,12,2,14
4065992,Cellulitis and abscess of finger unspecified,racial,White,5,9,14
4134875,Weil's disease,racial,White,0,14,14
197723,Open wound of lateral abdominal wall without complication,ethnic,Hispanic or Latino,9,5,14
195587,Cholelithiasis AND cholecystitis with obstruction,racial,White,14,0,14
433869,Congenital rubella syndrome,racial,White,0,14,14
201211,Herpetic vulvovaginitis,racial,White,14,0,14
196991,Chronic renal disease,racial,Native Hawaiian or Other Pacific Islander ,2,12,14
4308509,Impaired fasting glycaemia,racial,Native Hawaiian or Other Pacific Islander ,2,12,14
316135,AVB - Atrioventricular block,racial,Unknown,0,14,14
132344,Gingival and periodontal disease,racial,Asian,7,7,14
436581,Accidental poisoning,ethnic,Hispanic or Latino,0,14,14
194411,Unilateral simple inguinal hernia,racial,Asian,0,14,14
137820,Postoperative hypothyroidism,racial,Black or African American ,14,0,14
40479849,Sexual abuse of adult,ethnic,Hispanic or Latino,9,5,14
192433,Congenital hypertrophic pyloric stenosis,racial,White,2,12,14
196431,Hypersensitivity angiitis,ethnic,Hispanic or Latino,7,7,14
433822,Complication related to pregnancy,ethnic,Not Hispanic or Latino,12,2,14
442600,Manic bipolar I disorder in partial remission,ethnic,Hispanic or Latino,14,0,14
321882,Generalised atherosclerosis,racial,American Indian or Alaska Native ,12,2,14
436941,Hypervitaminosis A,racial,White,5,9,14
375277,Non-infectious pinna disorders,racial,Unknown,0,14,14
436097,"Nondependent mixed drug abuse, continuous",racial,White,7,7,14
199062,"Acute gastric ulcer without hemorrhage, without perforation AND without obstruction",ethnic,Not Hispanic or Latino,2,12,14
261774,"Respiratory tuberculosis, not confirmed bacteriologically or histologically",ethnic,Hispanic or Latino,5,9,14
136661,Nodular goiter,ethnic,Hispanic or Latino,14,0,14
4051564,FH: Metabolic disorder,ethnic,Not Hispanic or Latino,12,2,14
375404,Ocular laceration with prolapse AND/OR exposure of intraocular tissue,racial,White,0,14,14
433246,"Chronic duodenal ulcer without hemorrhage, without perforation AND without obstruction",ethnic,Not Hispanic or Latino,14,0,14
438796,Chronic duodenal ulcer with hemorrhage AND with perforation but without obstruction,ethnic,Hispanic or Latino,0,14,14
436088,Nondependent opioid abuse in remission,racial,Unknown,0,14,14
376065,Neurologic disorder associated with type II diabetes mellitus,racial,American Indian,9,5,14
80201,Longitudinal deficiency of phalanges of hand,racial,White,2,12,14
432463,"Closed fracture clavicle, lateral end",ethnic,Hispanic or Latino,12,2,14
432768,Corneal foreign body,racial,White,5,9,14
192376,Rhesus isoimmunization with antenatal problem,racial,Asian,14,0,14
4210151,HIV counseling,racial,Unknown,0,14,14
4012570,High risk sexual behavior,racial,Asian,0,14,14
4188027,Food allergy,racial,Black or African American ,7,7,14
440108,Thyrotoxic exophthalmos,ethnic,Hispanic or Latino,0,14,14
4005603,Congenital cystic kidney disease NOS,racial,White,0,14,14
434944,Scleritis,racial,Unknown,9,5,14
4047937,Neonatal urinary tract infection,racial,Unknown,14,0,14
4164707,Canceled operative procedure,racial,Black or African American ,9,5,14
437942,Caesarean delivery - delivered,racial,Unknown,14,0,14
437643,Gait abnormality,racial,Native Hawaiian or Other Pacific Islander ,7,7,14
4014231,Foot sprain NOS,ethnic,Not Hispanic or Latino,14,0,14
378421,Alcoholic peripheral neuropathy,ethnic,Not Hispanic or Latino,5,9,14
4067537,Other disc disorders of unspecified site,racial,White,7,7,14
200174,Disease of skin AND/OR subcutaneous tissue,racial,Native Hawaiian or Other Pacific Islander ,5,9,14
377552,Moderate nonproliferative diabetic retinopathy,racial,Other Race,14,0,14
432436,Symbolic dysfunction,ethnic,Hispanic or Latino,7,7,14
442612,Burn any degree involving 50-59 percent of body surface,racial,White,0,14,14
139902,Allergic urticaria,racial,Other Race,2,12,14
440530,Oropharyngeal dysphagia,ethnic,Not Hispanic or Latino,5,9,14
78890,Sprain of elbow and forearm,ethnic,Not Hispanic or Latino,9,5,14
133438,Chronic lymphoid leukaemia in remission,ethnic,Not Hispanic or Latino,14,0,14
444084,Extrinsic allergic alveolitis,ethnic,Hispanic or Latino,2,12,14
132736,Bacteremia,racial,Unknown,9,5,14
4110046,Obstructive chronic bronchitis NOS,racial,Black or African American ,0,14,14
132553,Herpangina,racial,Other Race,12,2,14
4103638,Amputated - transfemoral,racial,Asian,2,12,14
438555,Cyanosis,racial,Black or African American ,14,0,14
436076,Adjustment disorder with mixed disturbance of emotions AND conduct,racial,White,5,9,14
73819,Painful breasts,racial,Native Hawaiian or Other Pacific Islander ,14,0,14
198806,Abscess of prostate,ethnic,Hispanic or Latino,0,14,14
77963,Achilles tendinitis,racial,Black or African American ,14,0,14
4114772,Other specified arthropathy,racial,White,0,14,14
80552,Closed fracture of the scaphoid,racial,Unknown,14,0,14
197145,Open wound of pelvic region without complication,ethnic,Hispanic or Latino,12,2,14
137548,Cervical root lesion,racial,Black or African American ,0,14,14
40481920,Periumbilical pain,racial,Other Race,5,9,14
438699,Primary malignant neoplasm of rectosigmoid junction,racial,White,0,14,14
373775,Psychophysical visual disturbance,racial,White,12,2,14
434030,Glaucoma with lens disorder,ethnic,Hispanic or Latino,0,14,14
440426,Vertigo as late effect of stroke,racial,American Indian or Alaska Native ,14,0,14
433862,Congenital anomaly of tongue,ethnic,Hispanic or Latino,7,7,14
260315,Tuberculosis of lung with cavitation,racial,Unknown,0,14,14
440112,Chloasma of eyelid,racial,Black or African American ,14,0,14
197330,Finding of urethral sphincter function,racial,White,5,9,14
4100912,Screening for rheumatoid conditions,ethnic,Not Hispanic or Latino,14,0,14
196217,Congenital malformation of diaphragm,racial,Unknown,7,7,14
440558,Closed dislocation of interphalangeal joint of finger,ethnic,Hispanic or Latino,0,14,14
444410,Carcinoma in situ of skin of ear,ethnic,Hispanic or Latino,14,0,14
437655,Cryptorchism,racial,Filipino,0,14,14
72618,Disorder of muscle,racial,Unknown,14,0,14
438701,UKP - Disseminated malignancy of unknown primary,ethnic,Not Hispanic or Latino,14,0,14
4215568,Sensory disturbance in limb,racial,White,14,0,14
4059014,Spontaneous bruising,racial,Other Race,9,5,14
73904,Open wound of buttock without complication,ethnic,Hispanic or Latino,7,7,14
254061,Pleural effusion,racial,Black or African American ,7,7,14
135710,"Burn involving 30-39 percent of body surface, with 20-29 percent of body surface with full thickness burn",racial,White,0,14,14
439082,Menopausal syndrome,racial,American Indian or Alaska Native ,14,0,14
200769,"Chronic gastric ulcer without hemorrhage, without perforation AND without obstruction",racial,White,14,0,14
132466,Lumbar sprain,racial,American Indian or Alaska Native ,12,2,14
4064375,Iron deficiency screening,racial,American Indian,12,2,14
434902,Autistic disorder of childhood onset,racial,Native Hawaiian or Other Pacific Islander ,0,14,14
437677,Abnormal findings on diagnostic imaging of lung,racial,Other Race,7,7,14
436232,"Polycystic kidney disease, adult type",racial,White,14,0,14
377570,Toxic optic neuropathy,ethnic,Hispanic or Latino,0,14,14
434782,Closed fracture of tibia AND fibula,racial,Unknown,12,2,14
75652,Congenital valgus deformity of foot,ethnic,Not Hispanic or Latino,0,14,14
373784,Acute allergic serous otitis media,racial,White,12,2,14
4004785,Fetal alcohol syndrome,racial,White,14,0,14
315833,Secondary cardiomyopathy,racial,Black or African American ,0,14,14
192785,Second degree burn of abdominal wall,ethnic,Hispanic or Latino,12,2,14
77068,Secondary localised osteoarthrosis of lower leg,racial,White,9,5,14
75354,Osteochondropathy,racial,American Indian or Alaska Native ,14,0,14
321887,Disorder of artery,racial,Asian,12,2,14
434459,Ganglion of tendon sheath,racial,Unknown,12,2,14
195770,Subserous uterine fibroid,ethnic,Hispanic or Latino,14,0,14
134718,Hirsutism,racial,Unknown,14,0,14
77234,Benign tumour of colon,racial,Black or African American ,7,7,14
443698,Abnormal anal Papanicolaou smear,ethnic,Hispanic or Latino,14,0,14
435517,Acidosis,racial,White,7,7,14
199839,External haemorrhoids without complication,racial,Other Race,5,9,14
4061056,Endometriosis NOS,ethnic,Hispanic or Latino,14,0,14
438398,Leukocytosis,racial,American Indian or Alaska Native ,14,0,14
194406,Urinary tract obstruction,racial,Black or African American ,0,14,14
78505,"Localised, primary osteoarthritis of the ankle and/or foot",ethnic,Not Hispanic or Latino,2,12,14
4149560,Hand sprain unspecified,racial,White,9,5,14
437233,Plasmacytic myeloma,racial,Black or African American ,14,0,14
75721,Prosthetic joint mechanical failure,ethnic,Not Hispanic or Latino,0,14,14
440373,Subchronic schizophrenia,racial,White,12,2,14
443563,Arteriosclerosis in coronary artery bypass graft,racial,Asian,0,14,14
376094,Arteriosclerotic dementia with delirium,racial,Unknown,9,5,14
4099356,Haemangioma of unspecified site,racial,White,9,5,14
440377,Paralysis,ethnic,Not Hispanic or Latino,0,14,14
318800,GERD - Gastro-esophageal reflux disease,racial,American Indian,12,2,14
77156,Superficial foreign body of toe without major open wound but with infection,racial,White,12,2,14
374044,Droopy eyelid,racial,Black or African American ,7,7,14
440009,Complication of implant,ethnic,Not Hispanic or Latino,9,5,14
73302,Curvature of spine,racial,White,7,7,14
380834,Coma,ethnic,Hispanic or Latino,12,2,14
192276,Chronic gouty nephropathy,racial,Unknown,5,9,14
374049,Acute mucoid otitis media,ethnic,Hispanic or Latino,9,5,14
318443,Arteriosclerotic vascular disease,racial,Unknown,12,2,14
200052,Primary malignant neoplasm of uterine adnexa,ethnic,Hispanic or Latino,14,0,14
436249,Closed fracture of femoral condyle of femur,ethnic,Hispanic or Latino,5,9,14
193739,Ovarian failure,ethnic,Hispanic or Latino,14,0,14
377085,Congenital anomaly of brain,ethnic,Not Hispanic or Latino,0,14,14
133013,Congenital spinal cord anomaly,racial,White,5,9,14
194406,Urinary tract obstruction,racial,Asian,0,14,14
4050091,Open wound of penis,racial,White,0,14,14
380702,Cerebral cysts,racial,Asian,0,14,14
4171430,Screening for malignant neoplasm of rectum,racial,Filipino,5,9,14
198860,Congenital anomaly of lower alimentary tract,racial,White,14,0,14
136773,Rosacea,racial,Asian,5,9,14
318852,Congenital malformation of vitreous body,racial,White,14,0,14
432252,Sequelae of infectious and parasitic diseases,ethnic,Hispanic or Latino,0,14,14
73008,Enthesopathy,racial,Other Race,9,5,14
434298,Metastasis to upper limb lymph node,racial,Unknown,14,0,14
432312,Anatomical narrow angle glaucoma,ethnic,Not Hispanic or Latino,12,2,14
136198,Cervical spondylosis with myelopathy,racial,Black or African American ,14,0,14
315564,Aortic valve regurgitation,ethnic,Hispanic or Latino,5,9,14
4089980,Early congenital syphilis - latent,racial,White,0,14,14
4002828,Acute osteomyelitis NOS,ethnic,Hispanic or Latino,0,14,14
376964,Partial recent retinal detachment with giant tear,racial,Unknown,0,14,14
374957,Acquired stenosis of external ear canal,ethnic,Hispanic or Latino,2,12,14
253234,Upper respiratory inflammation due to fumes AND/OR vapors,ethnic,Hispanic or Latino,9,5,14
443344,Barrett esophagus,racial,Asian,7,7,14
4265600,Gastric ulcer,racial,White,12,2,14
75721,Prosthetic joint mechanical failure,racial,Black or African American ,0,14,14
436957,Functional disorders of polymorphonuclear neutrophils,ethnic,Not Hispanic or Latino,14,0,14
441049,Enamel caries,racial,White,12,2,14
377291,"Peripheral pterygium, progressive",racial,Unknown,5,9,14
435517,Acidosis,racial,Other Race,0,14,14
379801,Trigeminal neuralgia,racial,Asian,12,2,14
4109260,Other eyelid disorders,ethnic,Hispanic or Latino,9,5,14
377566,Palsy of conjugate gaze,ethnic,Hispanic or Latino,14,0,14
432895,Cortical senile cataract,racial,Asian,7,7,14
437741,Accidental burning caused by caustic and corrosive substance,ethnic,Hispanic or Latino,0,14,14
197239,Haemangioma of intra-abdominal structure,ethnic,Not Hispanic or Latino,14,0,14
440350,"Malignant lymphoma - lymphocytic, intermediate differentiation",ethnic,Hispanic or Latino,0,14,14
79121,Aseptic necrosis of talus,ethnic,Hispanic or Latino,14,0,14
4141201,Beta lactam resistant bacterial infection,ethnic,Hispanic or Latino,12,2,14
316447,Chronic hypotension,racial,White,12,2,14
257315,Bacterial pneumonia,racial,Other Race,7,7,14
193252,Diverticulosis of small intestine,ethnic,Hispanic or Latino,12,2,14
444129,Wrist injury,racial,Black or African American ,7,7,14
432966,Hypertrophy of vulva,racial,White,14,0,14
434633,Disorder of autonomic nervous system,ethnic,Not Hispanic or Latino,9,5,14
437969,Acquired pes planus,racial,Asian,5,9,14
432311,Angle-closure glaucoma - borderline,racial,Other Race,14,0,14
4103403,Psychosexual disorder NOS,ethnic,Hispanic or Latino,2,12,14
435242,Cerebellar ataxia,racial,White,2,12,14
435457,Primary progressive tuberculosis,ethnic,Hispanic or Latino,0,14,14
437384,Raised laboratory findings,ethnic,Hispanic or Latino,14,0,14
443428,Torus fracture of radius,ethnic,Hispanic or Latino,5,9,14
80571,Open wound of foot with complication,ethnic,Not Hispanic or Latino,12,2,14
4100529,Misuse of drugs NOS,racial,Black or African American ,2,12,14
374950,Oedema of eyelid,ethnic,Not Hispanic or Latino,12,2,14
435726,Mechanical complication of device,ethnic,Hispanic or Latino,7,7,14
376973,Cataract secondary to ocular disease,racial,Unknown,7,7,14
79098,Suppressed lactation,ethnic,Not Hispanic or Latino,0,14,14
4173498,FH: Heart disorder,racial,Asian,0,14,14
435372,Underweight,racial,American Indian,14,0,14
372425,Congenital abnormality of ear,racial,White,2,12,14
135204,Mycosis fungoides of extranodal AND/OR solid organ site,ethnic,Hispanic or Latino,14,0,14
438725,Disorder of magnesium metabolism,ethnic,Hispanic or Latino,12,2,14
441788,Human papilloma virus infection,racial,Asian,14,0,14
4003982,Other specified skin anomalies,racial,White,2,12,14
4108664,Hypertensive heart disease NOS,racial,Unknown,14,0,14
443111,Tenosynovitis of foot,racial,Black or African American ,2,12,14
77074,Joint pain,racial,American Indian or Alaska Native ,14,0,14
440385,Obstructive hydrocephalus,racial,Unknown,0,14,14
438469,"Duodenal ulcer without hemorrhage, without perforation AND without obstruction",racial,White,14,0,14
433320,Excessive crying of child,racial,White,5,9,14
4088920,Womb absent,racial,Black or African American ,14,0,14
4346969,Joint mice in knee,racial,Unknown,2,12,14
4167406,Eye disorder screening,racial,Asian,14,0,14
195314,Nephrotic syndrome,ethnic,Not Hispanic or Latino,0,14,14
132776,Injury involving multiple body regions,ethnic,Hispanic or Latino,7,7,14
199078,Vaginal wall prolapse,ethnic,Not Hispanic or Latino,14,0,14
196160,Fistula of intestine,racial,Black or African American ,14,0,14
436098,Nondependent cocaine abuse in remission,racial,White,0,14,14
197675,Bowel incontinence,racial,Asian,0,14,14
435849,Parietoalveolar pneumopathy,ethnic,Hispanic or Latino,2,12,14
433948,Accident caused by handgun,ethnic,Hispanic or Latino,0,14,14
137057,Paronychia,racial,Other Race,5,9,14
442286,Abscess of digit,racial,Other Race,9,5,14
74635,Lumbosacral root lesion,racial,Other Race,5,9,14
374384,Cerebral ischemia,racial,White,0,14,14
441896,Plicated tongue,ethnic,Hispanic or Latino,12,2,14
441547,Oppositional defiant disorder,racial,Unknown,0,14,14
201093,Infection of skin AND/OR subcutaneous tissue,racial,Other Race,14,0,14
314090,PET - Mild pre-eclamptic toxaemia,racial,White,14,0,14
198199,Pyelonephritis,racial,Black or African American ,12,2,14
437787,Secondary syphilis,ethnic,Not Hispanic or Latino,0,14,14
439685,"Malignant neoplasm, overlapping lesion of digestive system",racial,White,14,0,14
374948,Acute nonsuppurative otitis media,racial,Other Race,12,2,14
195847,Gastroparesis syndrome,racial,Black or African American ,5,9,14
132834,White piedra,racial,White,5,9,14
375800,Dystonia,racial,White,9,5,14
442747,Contact dermatitis due to food in contact with skin,ethnic,Hispanic or Latino,9,5,14
196369,Adrenogenital disorder,ethnic,Not Hispanic or Latino,2,12,14
254443,Sicca syndrome,racial,Other Race,14,0,14
444388,Blister of leg without infection,racial,White,9,5,14
440238,Closed fracture of metatarsal bone,racial,Asian,14,0,14
319921,Congenital pulmonary valve abnormality,ethnic,Hispanic or Latino,12,2,14
375527,Headache disorder,racial,Asian,14,0,14
197928,Menstruation absent,racial,Native Hawaiian or Other Pacific Islander ,14,0,14
4005823,Tobacco user,racial,American Indian or Alaska Native ,9,5,14
440956,Primary malignant neoplasm of upper inner quadrant of female breast,ethnic,Hispanic or Latino,14,0,14
77129,Closed fracture of pelvis,racial,Black or African American ,14,0,14
439928,Gangrenous disorder,racial,Other Race,2,12,14
4168217,Generalized hyperhidrosis,racial,Other Race,7,7,14
194964,Aneurysm of splenic artery,ethnic,Not Hispanic or Latino,7,7,14
443447,Iatrogenic hypotension,racial,White,12,2,14
440392,Retinal vascular occlusion,racial,Unknown,12,2,14
73318,Polydactyly of fingers,racial,White,14,0,14
374934,Impairment level: one eye: severe impairment: other eye: near-normal vision,ethnic,Hispanic or Latino,2,12,14
75614,Acrodermatitis continua,racial,Black or African American ,2,12,14
381306,Deaf mutism,racial,Black or African American ,14,0,14
434547,Complication of surgical procedure,ethnic,Hispanic or Latino,7,7,14
377280,Corneal disorder,racial,White,9,5,14
73847,Observation of elbow joint,ethnic,Hispanic or Latino,2,12,14
77025,Diverticulitis of colon,racial,Other Race,7,7,14
80070,Uric acid urolithiasis,racial,Unknown,14,0,14
435723,Wound seroma,racial,Unknown,14,0,14
436700,Eye displaced forwards,racial,White,12,2,14
200779,Intrauterine polyp,ethnic,Not Hispanic or Latino,14,0,14
195289,Goodpasture's syndrome,racial,White,9,5,14
4073997,Stretching of prepuce,ethnic,Hispanic or Latino,0,14,14
4179963,Family history of malignant neoplasm of breast,racial,Black or African American ,14,0,14
4100857,Pickwickian syndrome,racial,Filipino,2,12,14
434376,Acute myocardial infarction of anterior wall,racial,Unknown,0,14,14
4066376,Pilonidal sinus with abscess,racial,Black or African American ,0,14,14
439791,Emotional upset,racial,Unknown,12,2,14
135930,Musculoskeletal system observation,ethnic,Not Hispanic or Latino,14,0,14
4024000,Urinary system finding,ethnic,Not Hispanic or Latino,5,9,14
254443,Sicca syndrome,racial,American Indian or Alaska Native ,14,0,14
440083,Acute stress disorder,racial,Asian,14,0,14
321661,Spinal stenosis of thoracic region,ethnic,Not Hispanic or Latino,12,2,14
141038,Diastolic dysfunction,racial,Other Race,0,14,14
441246,Hemangioma of intracranial structure,racial,White,12,2,14
4157605,Infection due to resistant organism,ethnic,Hispanic or Latino,5,9,14
196156,Urethral diverticulum,ethnic,Hispanic or Latino,14,0,14
437902,Teeth development and eruption disorders,racial,Asian,0,14,14
74458,Enthesopathy of knee region,racial,Unknown,14,0,14
194964,Aneurysm of splenic artery,ethnic,Hispanic or Latino,14,0,14
78579,Closed fracture of first cervical vertebra,racial,Unknown,14,0,14
133367,Second degree burn of wrist,ethnic,Hispanic or Latino,14,0,14
372925,Cholesteatoma,racial,Asian,0,14,14
261255,Benign neoplasm of bronchus and lung,ethnic,Not Hispanic or Latino,7,7,14
441177,Second degree burn of upper limb,racial,Unknown,2,12,14
4104042,Strabismus (squint) and other disorders of binocular eye movements,racial,White,14,0,14
434467,Ostium secundum type atrial septal defect,racial,Asian,7,7,14
75897,Polyarthropathy,racial,Unknown,14,0,14
320749,Periarteritis nodosa,racial,White,12,2,14
436134,Disorder of sclera,ethnic,Not Hispanic or Latino,5,9,14
380094,Carpal tunnel syndrome,racial,American Indian or Alaska Native ,14,0,14
435887,Antepartum deep phlebothrombosis,ethnic,Not Hispanic or Latino,14,0,14
439653,Partial epilepsy without mention of impairment of consciousness,racial,Unknown,2,12,14
435506,Benign neoplastic disease,racial,White,14,0,14
81379,Lateral epicondylitis,racial,American Indian or Alaska Native ,14,0,14
440021,Herpes simplex without complication,racial,Asian,9,5,14
433911,Contusion of eye AND ocular adnexa,ethnic,Not Hispanic or Latino,7,7,14
79911,Effusion of joint of upper arm,racial,White,9,5,14
4292726,Contact - infectious disease,racial,Asian,7,7,14
443454,Cerebral infarction,racial,American Indian or Alaska Native ,0,14,14
372903,Retinal edema,ethnic,Not Hispanic or Latino,7,7,14
375824,Abnormal auditory perception,racial,Unknown,9,5,14
75863,Chronic interstitial cystitis,racial,Other Race,14,0,14
321638,"Benign essential hypertension complicating pregnancy, childbirth and the puerperium",racial,White,14,0,14
316084,Lymphadenitis,racial,Black or African American ,7,7,14
195584,Acute peptic ulcer without hemorrhage AND without perforation but with obstruction,ethnic,Hispanic or Latino,12,2,14
200452,Disease of female genital organ,racial,Unknown,14,0,14
313209,Left bundle branch hemiblock,ethnic,Not Hispanic or Latino,9,5,14
76565,Shoulder bruise,racial,Unknown,9,5,14
320744,Complete atrioventricular block,ethnic,Not Hispanic or Latino,9,5,14
76202,Non-traumatic rupture of Achilles tendon,racial,White,2,12,14
440366,Delay in sexual development AND/OR puberty,racial,White,2,12,14
76034,Herpes simplex whitlow,racial,White,7,7,14
26711,Chronic pharyngitis,racial,Asian,2,12,14
4288676,Acute and chronic cholecystitis,ethnic,Not Hispanic or Latino,5,9,14
381859,Infective OE,racial,Native Hawaiian or Other Pacific Islander ,9,5,14
4170137,Non-suppurative otitis media,racial,Black or African American ,2,12,14
4261613,Educational problem,racial,Black or African American ,0,14,14
444093,Patient status finding,racial,Black or African American ,5,9,14
73043,Open traumatic dislocation of shoulder,ethnic,Hispanic or Latino,14,0,14
441460,Late effect of sprain AND/OR strain without tendon injury,racial,Unknown,12,2,14
200349,Malignant lymphoma of intra-abdominal lymph nodes,ethnic,Hispanic or Latino,14,0,14
194693,Postprocedural pelvic peritoneal adhesions,racial,White,14,0,14
441507,"Early latent syphilis, positive serology, negative cerebrospinal fluid, less than 2 years after infection",racial,Unknown,0,14,14
256723,Pneumonia and influenza,ethnic,Not Hispanic or Latino,0,14,14
197609,"Cervical, vaginal and vulval inflammatory diseases",racial,White,14,0,14
444291,Cochlear hearing loss,ethnic,Not Hispanic or Latino,12,2,14
435987,Peanut-induced anaphylaxis,ethnic,Not Hispanic or Latino,2,12,14
201614,Calculus of bile duct with cholecystitis,ethnic,Hispanic or Latino,7,7,14
138176,Acute gingivitis,racial,Black or African American ,5,9,14
438130,Opioid abuse,racial,White,2,12,14
141248,Benign neoplasm of skin of lip,racial,White,9,5,14
437851,Open angle with borderline intraocular pressure,racial,White,12,2,14
80180,Osteoarthritis,racial,Native Hawaiian or Other Pacific Islander ,5,9,14
434301,Benign neoplasm of ribs and/or sternum and/or clavicle,ethnic,Hispanic or Latino,14,0,14
380727,Transient refractive change,racial,White,12,2,14
139737,Pediculosis corporis,ethnic,Hispanic or Latino,12,2,14
197518,Neoplasm of uncertain behavior of male genital organ,racial,White,2,12,14
435887,Antepartum deep phlebothrombosis,racial,Black or African American ,14,0,14
133299,Swelling of limb,racial,American Indian or Alaska Native ,5,9,14
138824,Contact dermatitis due to metal,racial,White,12,2,14
193239,Diverticulitis of small intestine,racial,White,7,7,14
375671,Concussion with loss of consciousness,ethnic,Hispanic or Latino,12,2,14
436445,Abrasion of teeth,ethnic,Not Hispanic or Latino,5,9,14
432525,Thyroid agent adverse reaction,racial,White,12,2,14
137682,Skin sensation disturbance,racial,Filipino,9,5,14
140966,Benign neoplasm of skin of face,racial,Other Race,14,0,14
4282684,Impairment level: low vision of one eye,ethnic,Not Hispanic or Latino,12,2,14
198191,Acquired hypertrophic pyloric stenosis,racial,Unknown,14,0,14
4215909,Artificial pacemaker rate check,ethnic,Hispanic or Latino,12,2,14
436670,MD - Metabolic disorders,racial,Black or African American ,14,0,14
28127,"Multiple endocrine neoplasia, type 1",racial,White,0,14,14
4102739,Screening for cardiovascular system disease,racial,Asian,0,14,14
256197,Rheumatoid lung disease,ethnic,Hispanic or Latino,0,14,14
373166,Benign neoplasm of lower jaw bone,ethnic,Not Hispanic or Latino,14,0,14
376063,Benign neoplasm of cerebral meninges,ethnic,Not Hispanic or Latino,2,12,14
312940,Acute-on-chronic respiratory failure,racial,Unknown,5,9,14
435787,Vitamin B6 deficiency,ethnic,Hispanic or Latino,14,0,14
4158567,Post percutaneous transluminal coronary angioplasty,racial,Filipino,0,14,14
4251787,Tuberculosis of rectum,racial,Unknown,14,0,14
440760,Inflammatory disorder of jaw,ethnic,Hispanic or Latino,7,7,14
192363,Obstruction of gallbladder,ethnic,Hispanic or Latino,14,0,14
319826,Secondary hypertension,racial,White,14,0,14
79119,Thoracic spondylosis with myelopathy,racial,Unknown,14,0,14
433740,Immunodeficiency disorder,ethnic,Not Hispanic or Latino,9,5,14
142032,Partial thickness burn of lower leg,ethnic,Hispanic or Latino,14,0,14
4053600,Open wound of elbow,racial,Unknown,12,2,14
139179,Open wound of lip without complication,racial,Unknown,5,9,14
435374,Closed fracture of distal end of ulna,ethnic,Hispanic or Latino,5,9,14
201621,Chronic cystitis,ethnic,Not Hispanic or Latino,14,0,14
435088,Senility,racial,Asian,2,12,14
435534,"Nondependent alcohol abuse, continuous",racial,American Indian or Alaska Native ,14,0,14
139899,Pemphigoid,ethnic,Not Hispanic or Latino,14,0,14
440703,Trigeminal nerve disorder,racial,White,2,12,14
437165,Motor vehicle traffic accident,racial,Black or African American ,9,5,14
381001,Subjective visual disturbance,racial,White,2,12,14
441025,Stenosis of lacrimal canaliculi,racial,White,7,7,14
80232,Closed fracture of calcaneus,racial,White,7,7,14
439262,"Single manic episode, severe, with psychosis",racial,Other Race,0,14,14
78907,Superficial injury of foot without infection,racial,White,14,0,14
194152,Renal agenesis and dysgenesis,ethnic,Not Hispanic or Latino,14,0,14
380407,Chronic infective otitis externa,ethnic,Hispanic or Latino,9,5,14
80241,Closed fracture navicular,ethnic,Hispanic or Latino,7,7,14
440750,Thrombophlebitis of deep veins of upper extremities,racial,Unknown,14,0,14
194526,Injury of trunk,ethnic,Not Hispanic or Latino,14,0,14
137785,Verruca plantaris,racial,Asian,0,14,14
141825,Non-toxic goiter,racial,Asian,14,0,14
436027,Coxsackie virus disease,racial,White,5,9,14
140641,Verruca vulgaris,racial,American Indian or Alaska Native ,2,12,14
318772,Disease of pericardium,ethnic,Not Hispanic or Latino,12,2,14
375404,Ocular laceration with prolapse AND/OR exposure of intraocular tissue,ethnic,Hispanic or Latino,0,14,14
200780,Disease of uterus,racial,White,14,0,14
315558,Atherosclerosis of arteries of the extremities,racial,Other Race,0,14,14
134118,Atrophic condition of skin,racial,American Indian or Alaska Native ,14,0,14
4311591,Cramp in limb,racial,Other Race,9,5,14
372892,Metabolic encephalopathy,ethnic,Hispanic or Latino,7,7,14
80201,Longitudinal deficiency of phalanges of hand,ethnic,Hispanic or Latino,2,12,14
40389897,"Neoplasm of uncertain behaviour of trachea, bronchus and lung",racial,Unknown,14,0,14
135858,Disorder of lip,racial,Asian,7,7,14
257012,Chronic rhinosinusitis,racial,Filipino,5,9,14
78888,Open fracture of ankle,racial,White,14,0,14
133726,Carcinoma in situ of skin of face,racial,Unknown,14,0,14
442119,Adhesions of temporomandibular joint,ethnic,Hispanic or Latino,5,9,14
76835,Closed dislocation of elbow,ethnic,Not Hispanic or Latino,12,2,14
4034214,Open wound of ear,ethnic,Hispanic or Latino,7,7,14
138255,Abnormal cardiovascular function,ethnic,Hispanic or Latino,14,0,14
436088,Nondependent opioid abuse in remission,ethnic,Not Hispanic or Latino,7,7,14
193522,Acute prostatitis,racial,Other Race,0,14,14
4056171,Prostatic hyperplasia NOS,racial,White,0,14,14
4141481,"Hand, foot and mouth disease",racial,Other Race,7,7,14
374317,Alcohol-induced psychosis,racial,White,2,12,14
135777,Neoplasm of uncertain behaviour of skin,racial,Black or African American ,0,14,14
198806,Abscess of prostate,racial,Unknown,0,14,14
80883,Nonvenomous insect bite of elbow with infection,ethnic,Hispanic or Latino,2,12,14
442019,Complication of procedure,racial,White,5,9,14
433246,"Chronic duodenal ulcer without hemorrhage, without perforation AND without obstruction",racial,White,14,0,14
443350,Lower urinary tract symptoms,racial,Alaska Native,0,14,14
141371,PR - Pityriasis rosea,racial,Black or African American ,9,5,14
192450,Not passing urine,racial,American Indian or Alaska Native ,0,14,14
257012,Chronic rhinosinusitis,racial,American Indian or Alaska Native ,5,9,14
4144274,Housing lack,racial,Unknown,2,12,14
4114772,Other specified arthropathy,ethnic,Hispanic or Latino,0,14,14
377680,Facial nerve injury as birth trauma,ethnic,Hispanic or Latino,9,5,14
80180,Osteoarthritis,racial,American Indian,14,0,14
201346,Oedema of penis,ethnic,Hispanic or Latino,0,14,14
132736,Bacteremia,ethnic,Not Hispanic or Latino,2,12,14
373748,Grand mal status,racial,Unknown,0,14,14
4268980,Finding of general development,racial,White,14,0,14
438796,Chronic duodenal ulcer with hemorrhage AND with perforation but without obstruction,racial,Unknown,0,14,14
376120,"Keratoconjunctivitis sicca, not specified as Sjogren's",ethnic,Not Hispanic or Latino,9,5,14
436027,Coxsackie virus disease,racial,Unknown,9,5,14
438039,Injury caused by animal,racial,White,9,5,14
442612,Burn any degree involving 50-59 percent of body surface,ethnic,Not Hispanic or Latino,0,14,14
137809,Primary malignant neoplasm of female breast,racial,Native Hawaiian or Other Pacific Islander ,14,0,14
139902,Allergic urticaria,racial,Black or African American ,5,9,14
318736,Migraine,racial,Filipino,7,7,14
434309,Sexual precocity,racial,Other Race,9,5,14
27918,Eosinophilic esophagitis,ethnic,Not Hispanic or Latino,0,14,14
376965,Hypertensive retinopathy,ethnic,Not Hispanic or Latino,7,7,14
442558,"Gestation period, 32 weeks",ethnic,Not Hispanic or Latino,0,14,14
433869,Congenital rubella syndrome,ethnic,Not Hispanic or Latino,0,14,14
432803,[X]Fall on and from ladder,racial,White,5,9,14
376713,Cerebral hemorrhage,racial,Other Race,9,5,14
134159,Precordial pain,racial,Other Race,5,9,14
4051568,Family history of mental disorder,ethnic,Hispanic or Latino,12,2,14
201059,Hypertrophic gastritis,racial,White,7,7,14
436352,Primary malignant neoplasm of laryngeal cartilage,ethnic,Hispanic or Latino,0,14,14
4134875,Weil's disease,ethnic,Not Hispanic or Latino,0,14,14
201344,Vesico-intestinal fistula,racial,White,12,2,14
138896,Open wound of forehead without complication,racial,Unknown,9,5,14
79072,Inflammatory disorder of breast,racial,Black or African American ,14,0,14
441834,"Bipolar affective disorder, currently manic, mild",racial,White,0,14,14
434557,Tuberculosis,ethnic,Hispanic or Latino,0,14,14
135526,Myelopathy,racial,Asian,0,14,14
374035,Keratitis,racial,Unknown,12,2,14
198194,Female genital organ symptoms,racial,American Indian,14,0,14
141667,Laxity of ligament,racial,White,14,0,14
197095,Embryonic cyst of fallopian tube and broad ligament,ethnic,Not Hispanic or Latino,14,0,14
376124,Pinguecula,racial,Other Race,14,0,14
316139,HF - Heart failure,racial,Filipino,0,14,14
435850,Cyst of jaw,racial,White,12,2,14
434005,Morbid obesity,racial,Alaska Native,0,14,14
315361,Orthopnea,racial,Unknown,14,0,14
4167069,Aneurysm clipping,ethnic,Hispanic or Latino,12,2,14
75650,Proteinuria,racial,American Indian or Alaska Native ,14,0,14
76161,Impotence of organic origin,racial,American Indian or Alaska Native ,0,14,14
253896,Traumatic pneumothorax without open wound into thorax,racial,Unknown,0,14,14
4164792,Hemophilus influenzae laryngitis,racial,Unknown,14,0,14
195587,Cholelithiasis AND cholecystitis with obstruction,ethnic,Hispanic or Latino,14,0,14
193322,Right lower quadrant pain,racial,Black or African American ,2,12,14
138821,Seborrhea,racial,Asian,12,2,14
261880,Atelectasis,ethnic,Not Hispanic or Latino,0,14,14
257778,Pertussis,racial,Unknown,9,5,14
443723,Finding of cellular component of blood,racial,Asian,14,0,14
433957,Progressive multifocal leukoencephalopathy,ethnic,Hispanic or Latino,0,14,14
135215,Hashimoto thyroiditis,ethnic,Not Hispanic or Latino,14,0,14
192680,Portal hypertension,ethnic,Not Hispanic or Latino,0,14,14
376683,Non proliferative diabetic retinopathy,racial,Black or African American ,12,2,14
193165,Adrenal disease,racial,Unknown,14,0,14
77968,Hallux valgus AND bunion,racial,Asian,7,7,14
4050572,Implantation of automatic cardiac defibrillator,racial,Black or African American ,0,14,14
4208970,History of physical abuse,ethnic,Not Hispanic or Latino,9,5,14
192433,Congenital hypertrophic pyloric stenosis,ethnic,Hispanic or Latino,5,9,14
40479849,Sexual abuse of adult,racial,White,9,5,14
30365,Panhypopituitarism,ethnic,Not Hispanic or Latino,14,0,14
435613,Cellulitis,racial,Other Race,7,7,14
436581,Accidental poisoning,racial,White,0,14,14
194382,External haemorrhoid,racial,Asian,9,5,14
444105,Burn any degree involving 70-79 percent of body surface,ethnic,Not Hispanic or Latino,0,14,14
74052,Labyrinthitis,ethnic,Not Hispanic or Latino,9,5,14
432571,Malignant lymphoma,racial,Black or African American ,0,14,14
81141,Closed fracture of ilium,racial,Unknown,14,0,14
435569,Disorder of jaw,racial,Other Race,14,0,14
432632,Noninfectious secondary iridocyclitis,ethnic,Hispanic or Latino,9,2,11
196158,Disease of penis,racial,Other Race,0,12,12
4273391,Suicidal thoughts,racial,Black or African American ,5,7,12
4199440,Congenital hip dysplasia,ethnic,Hispanic or Latino,12,0,12
440535,Abnormal radiographic examination,racial,Other Race,2,9,11
441604,Acute appendicitis without peritonitis,racial,Unknown,5,7,12
434327,Cannabis abuse,ethnic,Not Hispanic or Latino,2,9,11
133468,Disease of extremity,racial,Unknown,0,12,12
133406,Roseola infantum due to human herpesvirus 6,racial,White,5,7,12
436147,Glossitis,racial,Unknown,12,0,12
192360,Cyst and pseudocyst of pancreas,racial,Other Race,0,12,12
4021168,Natural contraception,racial,White,12,0,12
194878,Nodular lymphoma of extranodal AND/OR solid organ site,ethnic,Hispanic or Latino,7,5,12
432453,General clinical state finding,racial,Asian,7,5,12
192357,Paralytic ileus,racial,White,7,5,12
137820,Postoperative hypothyroidism,racial,Other Race,0,12,12
437986,FTT - Failure to thrive,racial,American Indian or Alaska Native ,12,0,12
198715,Premature menopause,racial,Other Race,12,0,12
4278083,Viral tracheitis,ethnic,Hispanic or Latino,0,12,12
435412,Second degree burn of breast,ethnic,Not Hispanic or Latino,12,0,12
4219847,Disease suspected,ethnic,Hispanic or Latino,12,0,12
439254,"Bipolar affective disorder, current episode depression",racial,Black or African American ,0,12,12
433750,"Single major depressive episode, in full remission",racial,Asian,0,12,12
433658,Adverse reaction to penicillins,racial,White,7,5,12
78831,Disease of ankle,racial,Black or African American ,9,2,11
440532,Heavy-for-dates infant regardless of gestation period,ethnic,Hispanic or Latino,12,0,12
312998,Pain in thoracic spine,racial,Black or African American ,12,0,12
138479,Thyroid dysfunction during pregnancy - baby not yet delivered,racial,American Indian or Alaska Native ,12,0,12
440358,Lipoma,racial,American Indian or Alaska Native ,12,0,12
380394,Idiopathic progressive polyneuropathy,ethnic,Not Hispanic or Latino,7,5,12
194175,Left upper quadrant pain,racial,Black or African American ,9,2,11
438039,Injury caused by animal,ethnic,Not Hispanic or Latino,2,9,11
438536,Congenital anomaly of jaw,racial,Asian,0,12,12
4269584,Finding relating to religious movement or belief,ethnic,Hispanic or Latino,9,2,11
437120,Closed dislocation of foot,ethnic,Hispanic or Latino,7,5,12
381174,Contusion of globe of eye,racial,White,7,5,12
4046500,Acute peptic ulcer with hemorrhage,racial,White,12,0,12
432451,Abnormal results of function studies of central nervous system,ethnic,Hispanic or Latino,12,0,12
4181604,Subcutaneous contraceptive implant,ethnic,Not Hispanic or Latino,12,0,12
432884,Amfetamine or psychostimulant dependence in remission,racial,White,0,12,12
78497,Cellulitis and abscess of toe,racial,Asian,5,7,12
441868,Optic disc oedema,racial,Unknown,12,0,12
4164707,Canceled operative procedure,racial,Other Race,9,2,11
138906,Superficial injury of face without infection,racial,White,5,7,12
433805,Abnormal jaw closure,ethnic,Hispanic or Latino,9,2,11
372604,Movement disorder,racial,Unknown,7,5,12
254669,Disease of vocal cords,ethnic,Hispanic or Latino,5,7,12
200836,Congenital anomaly of gastrointestinal tract,racial,White,9,2,11
438406,"Major depressive disorder, single episode, severe with psychotic features",ethnic,Not Hispanic or Latino,9,2,11
197304,Ulcer of lower limb,racial,American Indian or Alaska Native ,12,0,12
138841,Disorder of sacrum,racial,Other Race,9,2,11
135745,Exanthema subitum,ethnic,Not Hispanic or Latino,0,12,12
139200,"Crush injury, forearm",ethnic,Hispanic or Latino,0,12,12
138502,Vitiligo,racial,Native Hawaiian or Other Pacific Islander ,12,0,12
4023168,Home alone,racial,White,7,5,12
434610,Hyperkalemia,racial,American Indian or Alaska Native ,12,0,12
4099356,Haemangioma of unspecified site,ethnic,Hispanic or Latino,9,2,11
378548,Polyotia,racial,White,0,12,12
433701,Mycosis,ethnic,Not Hispanic or Latino,5,7,12
441737,Bruising,racial,Asian,7,5,12
193517,Bile duct calculus with no mention of cholecystitis and with obstruction,racial,Asian,12,0,12
381285,Peroneal muscular atrophy,racial,White,5,7,12
201061,Diaphragmatic hernia,racial,American Indian or Alaska Native ,12,0,12
436681,Insomnia disorder related to known organic factor,ethnic,Not Hispanic or Latino,2,9,11
441422,Closed fracture of humerus,racial,Black or African American ,12,0,12
436812,Tongue tie,racial,Other Race,0,12,12
321661,Spinal stenosis of thoracic region,racial,Asian,12,0,12
439846,LVF - Left ventricular failure,racial,Other Race,0,12,12
438297,"Mechanical complication of cardiac device, implant AND/OR graft",ethnic,Not Hispanic or Latino,0,12,12
374313,Neoplasm of uncertain behaviour of connective and other soft tissues,racial,White,2,9,11
200837,Congenital anomaly of fixation of intestine,racial,White,9,2,11
259043,Emphysematous bleb of lung,racial,White,9,2,11
436539,Closed fracture of patella,ethnic,Not Hispanic or Latino,9,2,11
26052,Primary malignant neoplasm of larynx,racial,Unknown,5,7,12
438872,Hyperphagia,racial,White,9,2,11
444234,Late effect of complications of trauma,racial,White,0,12,12
73291,Palindromic rheumatism of the ankle and/or foot,racial,American Indian or Alaska Native ,2,9,11
200579,Superficial injury of hip without infection,ethnic,Hispanic or Latino,12,0,12
194985,Postgastric surgery syndrome,ethnic,Hispanic or Latino,12,0,12
440072,Hypogammaglobulinemia,ethnic,Not Hispanic or Latino,9,2,11
75670,Sprain pelvic ligament,racial,Unknown,9,2,11
31317,Can't get food down,racial,American Indian,9,2,11
438304,Rat bite,ethnic,Hispanic or Latino,5,7,12
4147961,Screening for malignant neoplasm of breast,racial,American Indian,12,0,12
443430,HPV - Human papillomavirus test positive,racial,Asian,12,0,12
435224,Leukopenia,racial,Asian,7,5,12
31057,Disorder of pharynx,ethnic,Hispanic or Latino,9,2,11
198124,Disorder of kidney,racial,Filipino,7,5,12
4028641,Pregnancy and drug dependence,racial,Black or African American ,12,0,12
440379,Episodic opioid dependence,racial,Black or African American ,2,9,11
135975,Blister of finger without infection,ethnic,Hispanic or Latino,9,2,11
440076,SS - Short stature,racial,Other Race,0,12,12
443674,Traumatic amputation of toe(s) with complication,ethnic,Hispanic or Latino,0,12,12
133013,Congenital spinal cord anomaly,racial,Black or African American ,9,2,11
4113027,Dietary intake observations,racial,American Indian or Alaska Native ,2,9,11
438250,Congenital talipes varus,racial,White,9,2,11
200461,Endometriosis of uterus,ethnic,Not Hispanic or Latino,12,0,12
439800,"Conduct disorder, adolescent-onset type",ethnic,Not Hispanic or Latino,2,9,11
433992,"Bipolar affective disorder, currently manic, moderate",ethnic,Hispanic or Latino,12,0,12
4152047,Lipid screening,racial,Black or African American ,12,0,12
4170929,Watery eye,ethnic,Hispanic or Latino,12,0,12
4102348,Common migraine NOS,ethnic,Not Hispanic or Latino,2,9,11
443400,Peritoneal cancer,ethnic,Not Hispanic or Latino,12,0,12
377527,Presenile dementia with depression,racial,Other Race,12,0,12
74130,Thoracic spondylosis without myelopathy,ethnic,Not Hispanic or Latino,9,2,11
72748,Strain of rotator cuff of shoulder,racial,Asian,7,5,12
4098006,Iron deficiency anemia NOS,ethnic,Hispanic or Latino,9,2,11
433168,Iron deficiency anaemia secondary to inadequate dietary iron intake,ethnic,Not Hispanic or Latino,2,9,11
141050,Disease of hard tissues of teeth,ethnic,Hispanic or Latino,9,2,11
4179214,Family history of malignant neoplasm of gastrointestinal tract,racial,Other Race,9,2,11
4176878,Calculus of cystic duct with cholecystitis,racial,White,9,2,11
4098006,Iron deficiency anemia NOS,racial,White,9,2,11
377849,Retinal deposits,ethnic,Hispanic or Latino,9,2,11
433134,Histoplasmosis,ethnic,Not Hispanic or Latino,12,0,12
435170,Effects of thirst,ethnic,Hispanic or Latino,12,0,12
437409,Intracranial injury,racial,Asian,12,0,12
4222138,Allergic contact dermatitis of eyelid,racial,Unknown,7,5,12
201530,"Diabetes mellitus, adult onset, with hyperosmolar coma",ethnic,Not Hispanic or Latino,12,0,12
253788,Nasal polyp,racial,Black or African American ,2,9,11
441828,Disorganized schizophrenia,racial,White,5,7,12
4115379,"Localised, primary osteoarthritis of the pelvic region and thigh",racial,Asian,12,0,12
4004785,Fetal alcohol syndrome,racial,Black or African American ,0,12,12
4116761,Lateral meniscus derangement unspecified,ethnic,Hispanic or Latino,9,2,11
439926,Malaise and fatigue,racial,Filipino,5,7,12
434455,Acquired claw toes,ethnic,Hispanic or Latino,9,2,11
134741,Congenital anomaly of limb,racial,White,0,12,12
441039,Phlebitis of lower limb vein,ethnic,Not Hispanic or Latino,0,12,12
444388,Blister of leg without infection,racial,Unknown,9,2,11
4046804,Disorder of fluency,ethnic,Hispanic or Latino,0,12,12
78219,Cellulitis and abscess of hand excluding digits,racial,Other Race,7,5,12
194878,Nodular lymphoma of extranodal AND/OR solid organ site,racial,Asian,0,12,12
313800,Thrombotic microangiopathy,ethnic,Hispanic or Latino,12,0,12
437614,Early onset of delivery,racial,White,12,0,12
200763,Chronic hepatitis,racial,Black or African American ,12,0,12
72712,Synovial cyst,racial,Unknown,12,0,12
138519,Spondylosis without myelopathy,racial,Other Race,7,5,12
4005743,Female sterility,ethnic,Not Hispanic or Latino,12,0,12
440758,Posteruptive color change of tooth,ethnic,Hispanic or Latino,7,5,12
436333,Orf virus disease,racial,Unknown,9,2,11
432289,Drug-induced neutropenia,ethnic,Hispanic or Latino,2,9,11
441259,Non-thrombocytopenic purpura,ethnic,Not Hispanic or Latino,12,0,12
440230,Closed fracture of anatomical neck of humerus,racial,Unknown,12,0,12
141056,Acute ethmoidal sinusitis,racial,Unknown,9,2,11
253549,Connective tissue disease,racial,White,12,0,12
4108676,Other chronic ischaemic heart disease NOS,ethnic,Hispanic or Latino,0,12,12
442310,Acute heart failure,racial,Unknown,0,12,12
320347,Nodular lymphoma of lymph nodes of multiple sites,ethnic,Hispanic or Latino,5,7,12
4005933,Urethral meatus underneath penis,racial,Other Race,0,12,12
374028,AAMD - Age related macular degeneration,racial,Black or African American ,7,5,12
80523,Congenital fusion of spine,ethnic,Hispanic or Latino,12,0,12
438559,Abnormal vaginal Papanicolaou smear,racial,White,12,0,12
438284,Sprain of chondrosternal joint,ethnic,Hispanic or Latino,5,7,12
196365,Neoplasm of uncertain behaviour of adrenal gland,ethnic,Hispanic or Latino,7,5,12
4018734,Sprain of costal cartilage,racial,Black or African American ,7,5,12
436876,Toxic effect of lead compound,ethnic,Hispanic or Latino,5,7,12
4109691,Persistent alcohol abuse,ethnic,Hispanic or Latino,2,9,11
4334644,Decubitus ulcer of lower back,racial,White,9,2,11
438205,Maternal syphilis during pregnancy - baby not yet delivered,racial,White,12,0,12
440069,Drug dependence,racial,Other Race,2,9,11
443545,Nonvenomous insect bite,racial,Filipino,9,2,11
4170929,Watery eye,racial,Unknown,12,0,12
4143966,Essential hypertension NOS,ethnic,Hispanic or Latino,9,2,11
319921,Congenital pulmonary valve abnormality,racial,Unknown,12,0,12
442944,"Splinter of trunk, without major open wound or mention of infection",ethnic,Hispanic or Latino,9,2,11
318247,Apnea in the newborn,ethnic,Hispanic or Latino,5,7,12
372324,Eustachian tube disorder,racial,American Indian or Alaska Native ,12,0,12
436477,Abnormal products of conception,ethnic,Not Hispanic or Latino,12,0,12
76273,Open wound of shoulder region without complication,racial,White,7,5,12
135208,Benign tumor of lip,racial,White,9,2,11
192785,Second degree burn of abdominal wall,racial,White,12,0,12
442010,Seafood-induced anaphylaxis,racial,Unknown,5,7,12
201322,Internal hemorrhoids without complication,racial,American Indian or Alaska Native ,9,2,11
433131,Mumps without complication,racial,Unknown,12,0,12
198846,Enthesopathy of hip region,racial,American Indian or Alaska Native ,12,0,12
440846,"Blood coagulation disorder, categorized by value of screening test",racial,American Indian or Alaska Native ,0,12,12
4240902,Allergy to peanuts,racial,Black or African American ,5,7,12
4012491,Difficulty chewing,racial,Other Race,9,2,11
199062,"Acute gastric ulcer without hemorrhage, without perforation AND without obstruction",racial,Other Race,2,9,11
4114472,Ear problem,racial,White,5,7,12
441408,Vomiting,racial,Filipino,5,7,12
201111,Congenital renal dysplasia,ethnic,Not Hispanic or Latino,2,9,11
434008,White blood cell disorder,racial,Unknown,5,7,12
77139,Open wound of finger without complication,racial,Other Race,9,2,11
194574,Chronic type B viral hepatitis,racial,Unknown,0,12,12
4104862,Other forms of migraine,racial,White,12,0,12
440508,Congenital disease,racial,Other Race,0,12,12
4196206,beta^+^ Thalassemia,ethnic,Hispanic or Latino,12,0,12
433909,Foreign body on external eye,racial,Unknown,0,12,12
435388,"Cortex contusion with open intracranial wound, with more than 24 hours loss of consciousness and return to pre-existing conscious level",racial,Unknown,0,12,12
135778,Toxic multinodular goitre,ethnic,Not Hispanic or Latino,12,0,12
443949,Disease type AND/OR category unknown,racial,Unknown,12,0,12
141249,Benign tumour of thyroid gland,racial,Black or African American ,12,0,12
436091,BM - Bacterial meningitis,racial,Unknown,7,5,12
79898,Cellulitis and abscess of finger,racial,Asian,7,5,12
437257,Continuous acute alcoholic intoxication in alcoholism,ethnic,Hispanic or Latino,7,5,12
437175,"Fall on same level from slipping, tripping or stumbling",racial,Asian,7,5,12
138388,Secondary hyperparathyroidism,ethnic,Hispanic or Latino,7,5,12
40482247,Organic sleep apnea,racial,White,2,9,11
136917,Primary malignant neoplasm of skin of face,racial,White,9,2,11
436001,Emotional abuse of adult,racial,Unknown,12,0,12
260841,Perinatal subarachnoid hemorrhage,racial,Unknown,9,2,11
440693,Continuous opioid dependence,racial,American Indian or Alaska Native ,0,12,12
377575,Tinnitus,racial,American Indian or Alaska Native ,12,0,12
258785,Pneumococcal pneumonia,ethnic,Not Hispanic or Latino,5,7,12
194847,Mechanical complication due to urethral indwelling catheter,ethnic,Hispanic or Latino,0,12,12
437589,Pulpitis,racial,White,7,5,12
379009,Retinopathy of prematurity stage 3 - ridge with extraretinal fibrovascular proliferation,racial,White,7,5,12
198700,Liver secondary cancer,racial,Other Race,12,0,12
436232,"Polycystic kidney disease, adult type",racial,Other Race,12,0,12
80509,Bone cyst,ethnic,Not Hispanic or Latino,2,9,11
441541,Lymphocytopenia,racial,White,5,7,12
439162,"Closed fracture ankle, medial malleolus",ethnic,Not Hispanic or Latino,9,2,11
192363,Obstruction of gallbladder,racial,White,12,0,12
195482,Primary malignant neoplasm of intestinal tract,ethnic,Hispanic or Latino,12,0,12
193239,Diverticulitis of small intestine,ethnic,Not Hispanic or Latino,5,7,12
437262,Common peroneal nerve lesion,racial,White,12,0,12
255677,Open wound of nose without complication,racial,White,5,7,12
382014,Injury of facial nerve,racial,White,0,12,12
139895,"Thyroid dysfunction during pregnancy, childbirth and the puerperium",racial,Unknown,12,0,12
378163,Sounds seem unnaturally loud,ethnic,Hispanic or Latino,2,9,11
4167069,Aneurysm clipping,racial,White,12,0,12
135688,Abrasion AND/OR friction burn of foot with infection,racial,White,0,12,12
440454,Abortion without complication,racial,White,12,0,12
439800,"Conduct disorder, adolescent-onset type",ethnic,Hispanic or Latino,5,7,12
439166,Closed fracture of radius,racial,Black or African American ,12,0,12
73819,Painful breasts,racial,Black or African American ,12,0,12
4024567,Respiratory observation,ethnic,Not Hispanic or Latino,12,0,12
434890,Repetitive stereotyped movement,racial,White,0,12,12
436020,Actinomycotic infection,racial,Unknown,12,0,12
443782,Tremor,racial,Black or African American ,12,0,12
434311,Disorder of the urea cycle metabolism,ethnic,Hispanic or Latino,9,2,11
380094,Carpal tunnel syndrome,racial,Filipino,12,0,12
78560,Congenital deformity and malformation of feet and toes,ethnic,Not Hispanic or Latino,0,12,12
140357,Neoplasm of uncertain behaviour of endocrine gland,ethnic,Hispanic or Latino,12,0,12
4249474,Generalized seborrheic dermatitis of infants,ethnic,Not Hispanic or Latino,2,9,11
76836,Sprain of knee and leg,racial,American Indian or Alaska Native ,12,0,12
439928,Gangrenous disorder,ethnic,Not Hispanic or Latino,0,12,12
197654,Congenital cystic disease of liver,ethnic,Hispanic or Latino,0,12,12
434462,VSD - Ventricular septal defect,racial,Asian,0,12,12
374946,Recurrent erosion syndrome,ethnic,Hispanic or Latino,0,12,12
432447,Atypical glandular cells on cervical Papanicolaou smear,racial,Other Race,12,0,12
200837,Congenital anomaly of fixation of intestine,ethnic,Not Hispanic or Latino,12,0,12
321689,Apneic,racial,Other Race,7,5,12
439297,Nuclear senile cataract,racial,Other Race,5,7,12
135032,Dermatitis due to substances taken internally,racial,Unknown,9,2,11
376401,Traumatic cataract,ethnic,Hispanic or Latino,12,0,12
376229,Abnormal involuntary movement,racial,Black or African American ,2,9,11
76202,Non-traumatic rupture of Achilles tendon,ethnic,Hispanic or Latino,0,12,12
318445,Post cardiac operation functional disturbance,ethnic,Hispanic or Latino,2,9,11
141831,Branchial arch syndrome,racial,Asian,12,0,12
434893,Selective IgM immunodeficiency,ethnic,Not Hispanic or Latino,9,2,11
376707,Acute conjunctivitis,racial,American Indian or Alaska Native ,9,2,11
192954,Acute gastric ulcer without hemorrhage AND without perforation but with obstruction,racial,White,5,7,12
439554,Hypnotic or anxiolytic abuse,racial,Other Race,0,12,12
201675,Autosomal recessive polycystic kidney disease,racial,White,12,0,12
4023168,Home alone,ethnic,Hispanic or Latino,7,5,12
437671,Abnormal feces,racial,Asian,5,7,12
374915,Localisation-related epilepsy,racial,White,12,0,12
373982,Benign tumour of conjunctiva,ethnic,Not Hispanic or Latino,9,2,11
432454,Excessive thirst,racial,Black or African American ,2,9,11
444115,Disorder of bursa,ethnic,Not Hispanic or Latino,5,7,12
140173,Telogen effluvium,ethnic,Not Hispanic or Latino,9,2,11
81713,Carpal joint sprain,racial,White,7,5,12
433471,Retinal neovascularization,racial,Unknown,12,0,12
75911,Acquired hallux valgus,racial,Black or African American ,2,9,11
137967,"Muscle, ligament and fascia disorders",racial,Unknown,12,0,12
199076,Fallopian tube pregnancy,ethnic,Not Hispanic or Latino,5,7,12
4236391,Acute necrotizing otitis media,ethnic,Hispanic or Latino,0,12,12
4270866,Symptomatic dermographism,ethnic,Not Hispanic or Latino,7,5,12
195306,Gastroduodenitis,racial,Native Hawaiian or Other Pacific Islander ,9,2,11
373724,Neoplasm of brain,ethnic,Not Hispanic or Latino,5,7,12
81169,Superficial foreign body of finger without major open wound AND without infection,racial,White,7,5,12
141648,Contact dermatitis due to cosmetics,ethnic,Not Hispanic or Latino,9,2,11
321844,Initial apnea,ethnic,Not Hispanic or Latino,0,12,12
194878,Nodular lymphoma of extranodal AND/OR solid organ site,ethnic,Not Hispanic or Latino,0,12,12
437833,Hypokalaemia,racial,American Indian or Alaska Native ,12,0,12
141050,Disease of hard tissues of teeth,racial,Unknown,9,2,11
200761,Retroperitoneal abscess,ethnic,Hispanic or Latino,0,12,12
373775,Psychophysical visual disturbance,ethnic,Not Hispanic or Latino,5,7,12
77421,Open wound of hand except fingers without complication,racial,Black or African American ,2,9,11
201927,Cellulitis and abscess of leg,racial,American Indian,9,2,11
440083,Acute stress disorder,racial,Black or African American ,12,0,12
438329,Late effect of motor vehicle accident,racial,Unknown,12,0,12
439249,"Mixed bipolar affective disorder, mild",ethnic,Hispanic or Latino,0,12,12
133794,Chronic gingivitis,racial,Other Race,2,9,11
193517,Bile duct calculus with no mention of cholecystitis and with obstruction,ethnic,Not Hispanic or Latino,12,0,12
442325,Furuncle of foot,ethnic,Hispanic or Latino,2,9,11
381572,Abducens nerve palsy,ethnic,Not Hispanic or Latino,0,12,12
137626,Seborrhoeic eczema of scalp,racial,Other Race,7,5,12
77646,Disorder of bone and articular cartilage,ethnic,Not Hispanic or Latino,7,5,12
444283,Superficial foreign body of hand without major open wound AND without infection,racial,White,2,9,11
135204,Mycosis fungoides of extranodal AND/OR solid organ site,racial,White,12,0,12
140435,Arrested dental caries,ethnic,Hispanic or Latino,9,2,11
4310768,Fall on steps,ethnic,Not Hispanic or Latino,2,9,11
438261,Neonatal jaundice due to delayed conjugation associated with another disease,racial,White,2,9,11
28457,Hypertrophy of tonsils,racial,Asian,2,9,11
139899,Pemphigoid,racial,Asian,12,0,12
4064363,Intest helminthiasis screening,racial,Unknown,0,12,12
433134,Histoplasmosis,racial,Asian,12,0,12
77968,Hallux valgus AND bunion,racial,American Indian or Alaska Native ,9,2,11
438430,Squamous blepharitis,ethnic,Hispanic or Latino,9,2,11
4016352,Tuberculosis contact,racial,Asian,2,9,11
137813,Benign neoplasm of mouth region,racial,White,5,7,12
198246,Congenital hiatus hernia,racial,Unknown,9,2,11
377298,Chronic otitis externa,racial,Unknown,12,0,12
441407,Appetite loss - anorexia,racial,Black or African American ,9,2,11
75344,Intervertebral disc disorder,racial,Other Race,2,9,11
440631,Mycobacterial disease,racial,White,5,7,12
440925,Suicide,racial,Asian,12,0,12
372247,Candidal otomycosis,racial,Unknown,9,2,11
195072,Medullary sponge kidney,ethnic,Hispanic or Latino,12,0,12
30437,Gastroesophageal reflux disease with esophagitis,racial,Asian Indian,12,0,12
4235140,Operation for bone injury of phalanges of hand,racial,Unknown,9,2,11
4219847,Disease suspected,racial,White,12,0,12
197327,Female urinary-genital tract fistula,racial,Unknown,12,0,12
4110787,Other otitis externa,ethnic,Not Hispanic or Latino,0,12,12
132841,Malignant lymphoma of lymph nodes of multiple sites,racial,White,9,2,11
135778,Toxic multinodular goitre,racial,White,12,0,12
195083,Left lower quadrant pain,racial,Black or African American ,9,2,11
135777,Neoplasm of uncertain behaviour of skin,racial,Asian,7,5,12
196044,Primary malignant neoplasm of stomach,ethnic,Not Hispanic or Latino,7,5,12
438047,Contusion of orbital tissues,racial,White,2,9,11
200485,Decubitus ulcer of buttock,racial,Asian,0,12,12
436096,Chronic pain,racial,Filipino,0,12,12
195584,Acute peptic ulcer without hemorrhage AND without perforation but with obstruction,racial,Unknown,12,0,12
437753,Seen by surgical fitting - service,racial,Unknown,12,0,12
321119,Coarctation of aorta,racial,White,5,7,12
434301,Benign neoplasm of ribs and/or sternum and/or clavicle,racial,Unknown,12,0,12
318736,Migraine,racial,Native Hawaiian or Other Pacific Islander ,12,0,12
4079876,Familial combined hyperlipidemia,racial,Alaska Native,0,12,12
373054,Open wound of auricle of ear without complication,ethnic,Hispanic or Latino,2,9,11
434742,Congenital abnormality of skull and face bones,racial,Unknown,2,9,11
443447,Iatrogenic hypotension,racial,Asian,0,12,12
439666,Contracture of multiple joints,racial,Black or African American ,0,12,12
198185,Chronic renal failure syndrome,ethnic,Not Hispanic or Latino,2,9,11
4085075,At risk state,racial,White,5,7,12
4112819,Pneumonia due to other specified bacteria,ethnic,Hispanic or Latino,9,2,11
321052,Peripheral vascular disease,racial,Native Hawaiian or Other Pacific Islander ,5,7,12
435217,Paranoid schizophrenia in remission,ethnic,Hispanic or Latino,0,12,12
443454,Cerebral infarction,racial,Other Race,0,12,12
4124794,FH: - kidney disorder,ethnic,Hispanic or Latino,2,9,11
76207,Scoliosis due to radiation,ethnic,Hispanic or Latino,12,0,12
375479,Kaposi's sarcoma of soft tissues,racial,White,0,12,12
259070,PGN - Acute proliferative glomerulonephritis,ethnic,Hispanic or Latino,12,0,12
73183,Myotonic disorder,racial,White,12,0,12
137005,Tracheostomy complication,racial,White,12,0,12
318186,Achalasia of esophagus,racial,White,5,7,12
201338,Urethral fistula,ethnic,Hispanic or Latino,2,9,11
439128,Extreme immaturity,ethnic,Not Hispanic or Latino,12,0,12
376965,Hypertensive retinopathy,racial,Black or African American ,0,12,12
443428,Torus fracture of radius,racial,White,5,7,12
136774,Pityriasis rubra pilaris,racial,White,7,5,12
74250,Burn of foot,racial,White,9,2,11
192362,Nephrotic syndrome with membranoproliferative glomerulonephritis,racial,Unknown,0,12,12
375546,Combined nonsenile cataract,racial,Unknown,2,9,11
381033,Aphakia,ethnic,Hispanic or Latino,2,9,11
4025176,Respiratory system diseases NOS,racial,White,2,9,11
78237,Bicipital tenosynovitis,racial,American Indian or Alaska Native ,12,0,12
254980,Intrinsic asthma with asthma attack,ethnic,Not Hispanic or Latino,9,2,11
432312,Anatomical narrow angle glaucoma,racial,Asian,12,0,12
78593,Open wound of wrist without complication,ethnic,Not Hispanic or Latino,5,7,12
378752,Corneal opacity,ethnic,Not Hispanic or Latino,0,12,12
196431,Hypersensitivity angiitis,racial,White,5,7,12
4177243,Cancer of pharynx,ethnic,Hispanic or Latino,5,7,12
313800,Thrombotic microangiopathy,racial,White,12,0,12
374645,Phantom limb syndrome,racial,Unknown,2,9,11
201131,Pelvic mass,racial,American Indian or Alaska Native ,12,0,12
133444,Thyroiditis,ethnic,Not Hispanic or Latino,5,7,12
437464,"Injury undetermined whether accidentally or purposely inflicted, fall from residential premises",racial,White,9,2,11
4114610,Allergic arthritis NOS,racial,Unknown,12,0,12
441835,Chronic schizoaffective schizophrenia,racial,Asian,0,12,12
192964,Renal infection,racial,White,9,2,11
315286,Chronic ischemic heart disease,racial,Other Race,12,0,12
316437,Cerebral atherosclerosis,racial,American Indian or Alaska Native ,12,0,12
29056,Sialoadenitis,racial,Black or African American ,12,0,12
74809,Crushing injury of hand,ethnic,Hispanic or Latino,7,5,12
257011,Acute upper respiratory infection,racial,Asian Indian,0,12,12
138913,Second degree burn of two OR more fingers including thumb,ethnic,Hispanic or Latino,2,9,11
373999,Diabetic oculopathy associated with type I diabetes mellitus,racial,Asian,12,0,12
194703,Leucoplakia of vagina,racial,White,12,0,12
438688,Sarcoidosis,racial,Black or African American ,12,0,12
192353,Disorder of gallbladder,racial,Other Race,0,12,12
4014454,Single stillbirth,racial,White,12,0,12
435658,Atypical squamous cells on vaginal Papanicolaou smear cannot exclude high grade squamous intraepithelial lesion,racial,White,12,0,12
257905,Mucopurulent chronic bronchitis,ethnic,Not Hispanic or Latino,7,5,12
201129,Newborn swallowing maternal blood causing hematemesis or melena,ethnic,Hispanic or Latino,9,2,11
4062998,Infantile paralytic paralysis,racial,Unknown,12,0,12
4062641,Malaria screening,ethnic,Not Hispanic or Latino,7,5,12
442286,Abscess of digit,racial,Asian,7,5,12
132397,Pilonidal cyst with no abscess,ethnic,Not Hispanic or Latino,0,12,12
440388,[X]Developmental co - ordination disorder,ethnic,Not Hispanic or Latino,0,12,12
133685,Salmonellosis,ethnic,Hispanic or Latino,2,9,11
436972,Glaucoma associated with systemic syndromes,racial,Filipino,0,12,12
4102738,Screening for mental disorders,ethnic,Hispanic or Latino,5,7,12
195599,Post-hysterectomy vaginal vault prolapse,racial,White,12,0,12
433911,Contusion of eye AND ocular adnexa,racial,Unknown,2,9,11
441191,Poisoning by arthropod,ethnic,Hispanic or Latino,12,0,12
4003982,Other specified skin anomalies,ethnic,Not Hispanic or Latino,0,12,12
81247,Carcinoma in situ of urinary system,ethnic,Hispanic or Latino,12,0,12
434622,Deficiency anemias,racial,Other Race,12,0,12
201387,Doubling of uterus,racial,Unknown,12,0,12
372423,Reduction deformities of brain,racial,Filipino,12,0,12
435315,Torsion of testis,ethnic,Not Hispanic or Latino,0,12,12
137057,Paronychia,racial,Black or African American ,5,7,12
253321,Stridor,racial,Other Race,0,12,12
321502,Chagas' disease with heart involvement,ethnic,Hispanic or Latino,0,12,12
438791,Pulmonary congestion and hypostasis,racial,Unknown,12,0,12
139900,Urticaria,racial,Filipino,0,12,12
4261613,Educational problem,racial,Asian,7,5,12
4110022,Acute bronchitis and/or bronchiolitis,ethnic,Hispanic or Latino,2,9,11
196436,Internal haemorrhoid,racial,Other Race,12,0,12
138717,Thyrotoxicosis with diffuse goitre,racial,Asian,12,0,12
4181328,CA - Cancer of adrenal gland,ethnic,Hispanic or Latino,5,7,12
433450,Paranoid schizophrenia,racial,Black or African American ,9,2,11
437688,Abnormal findings on antenatal screening of mother,ethnic,Not Hispanic or Latino,12,0,12
436741,Vulvodynia,ethnic,Hispanic or Latino,12,0,12
4177966,Kaposi's sarcoma,ethnic,Hispanic or Latino,0,12,12
136279,Injury at T1-T6 level with spinal cord injury AND without bone injury,ethnic,Hispanic or Latino,12,0,12
436072,Bipolar disorder in partial remission,ethnic,Not Hispanic or Latino,12,0,12
195770,Subserous uterine fibroid,ethnic,Not Hispanic or Latino,12,0,12
443748,Congenital anomaly of the bladder,ethnic,Hispanic or Latino,7,5,12
439746,Primary malignant neoplasm of hypopharynx,ethnic,Hispanic or Latino,12,0,12
4014296,Twins - both live born,ethnic,Not Hispanic or Latino,9,2,11
435233,Disorders of fatty-acid metabolism,ethnic,Not Hispanic or Latino,12,0,12
435380,Closed fracture of radius AND ulna,ethnic,Hispanic or Latino,7,5,12
314131,Degeneration of cervical intervertebral disc,racial,Black or African American ,9,2,11
376966,Exudative age-related macular degeneration,racial,Asian,0,12,12
378157,Mechanical strabismus,racial,Unknown,12,0,12
77354,Primary localised osteoarthrosis of lower leg,racial,Filipino,12,0,12
321879,Dissecting aneurysm of coronary artery,ethnic,Hispanic or Latino,12,0,12
438722,Non megaloblastic anemia associated with nutritional deficiency,ethnic,Not Hispanic or Latino,2,9,11
374338,Nondiabetic proliferative retinopathy,racial,White,5,7,12
440508,Congenital disease,racial,Black or African American ,7,5,12
432508,"Mechanical complication of nervous system device, implant AND/OR graft",ethnic,Hispanic or Latino,0,12,12
79911,Effusion of joint of upper arm,racial,Other Race,5,7,12
436222,Altered mental status,racial,Other Race,7,5,12
442944,"Splinter of trunk, without major open wound or mention of infection",racial,White,9,2,11
133150,Malignant neoplasm of skin of lower limb and hip,ethnic,Hispanic or Latino,5,7,12
136497,Scar conditions and fibrosis of skin,ethnic,Not Hispanic or Latino,5,7,12
4166443,Family history: Arthritis,ethnic,Hispanic or Latino,5,7,12
77631,Secondary localized osteoarthrosis of shoulder region,ethnic,Hispanic or Latino,9,2,11
141372,Contact dermatitis due to solvents,racial,White,9,2,11
73153,Malignant neoplasm of lateral wall of urinary bladder,racial,Asian,0,12,12
433073,Superficial burn of back of hand,racial,White,12,0,12
433768,Glaucoma with increased episcleral venous pressure,ethnic,Hispanic or Latino,12,0,12
319825,Rheumatic heart disease,racial,White,12,0,12
439796,"Nondependent cocaine abuse, continuous",racial,White,0,12,12
4104862,Other forms of migraine,ethnic,Hispanic or Latino,12,0,12
372315,Anterior subcapsular polar cataract,ethnic,Hispanic or Latino,2,9,11
261053,Pneumonia with aspergillosis,racial,White,0,12,12
433533,Incomplete spontaneous abortion with no mention of complication,racial,Unknown,12,0,12
434908,Disorder of porphyrin and haem metabolism,ethnic,Hispanic or Latino,9,2,11
437092,Physiological development failure,racial,Filipino,0,12,12
4149560,Hand sprain unspecified,racial,Unknown,9,2,11
200171,Carbuncle of skin AND/OR subcutaneous tissue,racial,Unknown,7,5,12
136185,Abnormal granulation tissue,racial,Black or African American ,2,9,11
437013,"Primary dental caries, pit and fissure origin",racial,Unknown,0,12,12
434455,Acquired claw toes,racial,White,9,2,11
138813,Early or threatened labour,ethnic,Hispanic or Latino,12,0,12
77066,Derangement of medial meniscus,racial,Other Race,0,12,12
441962,Congenital bowing of tibia and/or fibula,ethnic,Hispanic or Latino,5,7,12
442295,Disorder of carbohydrate transport,racial,Unknown,7,5,12
133406,Roseola infantum due to human herpesvirus 6,ethnic,Hispanic or Latino,5,7,12
4094876,"Malignant neoplasm of lower lobe, bronchus or lung",ethnic,Hispanic or Latino,2,9,11
4201472,Varicella contact,racial,White,9,2,11
75365,Oliguria and anuria,racial,Unknown,12,0,12
139180,Open wound of multiple sites of face without complication,ethnic,Hispanic or Latino,5,7,12
138973,Chancroid,ethnic,Hispanic or Latino,7,5,12
195867,Noninflammatory vaginal disorders,racial,Black or African American ,12,0,12
137792,Kaposi's varicelliform eruption,racial,Unknown,5,7,12
4211231,Panic disorder without agoraphobia,racial,Asian,9,2,11
201346,Oedema of penis,racial,White,0,12,12
441192,Accidentally struck by or against objects or persons,racial,White,9,2,11
376709,Discharge of eye,racial,Asian,2,9,11
133298,Musculoskeletal disorder of the neck,racial,American Indian or Alaska Native ,5,7,12
137735,Second degree burn of forearm,racial,White,7,5,12
315296,Preinfarction syndrome,racial,Asian,0,12,12
78593,Open wound of wrist without complication,racial,Unknown,12,0,12
80578,Superficial injury of finger with infection,ethnic,Hispanic or Latino,9,2,11
194985,Postgastric surgery syndrome,ethnic,Not Hispanic or Latino,12,0,12
4009750,Open fracture of other tarsal and metatarsal bones,racial,Black or African American ,0,12,12
443708,Cervical Papanicolaou smear positive for malignant neoplasm,ethnic,Hispanic or Latino,12,0,12
441968,Acetonuria,racial,Unknown,9,2,11
4218420,Postinflammatory perforation of ear drum,racial,White,12,0,12
436700,Eye displaced forwards,ethnic,Not Hispanic or Latino,12,0,12
382014,Injury of facial nerve,ethnic,Hispanic or Latino,0,12,12
319054,Thrombophlebitis of upper extremities,ethnic,Hispanic or Latino,2,9,11
315276,Vitreous hemorrhage,ethnic,Not Hispanic or Latino,0,12,12
442598,Fracture of radius AND ulna,racial,White,7,5,12
4315363,"Accidents caused by knives, swords and daggers",ethnic,Not Hispanic or Latino,12,0,12
440279,Accident,racial,Other Race,9,2,11
442011,Mechanical complication due to cardiac pacemaker electrode,ethnic,Not Hispanic or Latino,2,9,11
432904,Blood in anterior chamber,racial,White,9,2,11
136774,Pityriasis rubra pilaris,ethnic,Hispanic or Latino,7,5,12
200757,Abscess of peritoneum,racial,White,7,5,12
140803,Idiopathic angio-oedema-urticaria,ethnic,Not Hispanic or Latino,12,0,12
192671,GI - Gastrointestinal haemorrhage,racial,American Indian or Alaska Native ,12,0,12
437449,Victim of child abuse,ethnic,Not Hispanic or Latino,9,2,11
434309,Sexual precocity,racial,Black or African American ,5,7,12
437222,Respiratory syncytial virus infection,ethnic,Not Hispanic or Latino,0,12,12
4162218,Vaginal enterocele,ethnic,Hispanic or Latino,12,0,12
315564,Aortic valve regurgitation,racial,White,0,12,12
439274,Acute exacerbation of subchronic latent schizophrenia,racial,White,0,12,12
73338,Sprain of lateral collateral ligament of knee,ethnic,Not Hispanic or Latino,0,12,12
4129482,Ovary observations,ethnic,Hispanic or Latino,12,0,12
443539,Motor vehicle injury,ethnic,Hispanic or Latino,5,7,12
376117,Cataract in degenerative disorder,racial,Other Race,0,12,12
318772,Disease of pericardium,racial,Black or African American ,9,2,11
195072,Medullary sponge kidney,racial,White,12,0,12
193242,Perforation of intestine,racial,White,12,0,12
40484522,Hemiplegia of dominant side as late effect of cerebrovascular disease,racial,Native Hawaiian or Other Pacific Islander ,0,12,12
440366,Delay in sexual development AND/OR puberty,racial,Unknown,5,7,12
4104555,Other and unspecified conjunctivitis,ethnic,Not Hispanic or Latino,12,0,12
4014454,Single stillbirth,ethnic,Hispanic or Latino,12,0,12
4015641,"Fracture of tibia and fibula, NOS",ethnic,Hispanic or Latino,12,0,12
192956,Cholecystitis,ethnic,Not Hispanic or Latino,12,0,12
194491,Tenderness of epigastrium,racial,Unknown,12,0,12
441604,Acute appendicitis without peritonitis,ethnic,Not Hispanic or Latino,0,12,12
195079,Functional urinary incontinence,racial,Other Race,12,0,12
75652,Congenital valgus deformity of foot,ethnic,Hispanic or Latino,0,12,12
444125,Satisfactory for evaluation but limited by absence of an endocervical/transformation zone component from a patient with a cervix,racial,White,12,0,12
432895,Cortical senile cataract,racial,Other Race,5,7,12
198363,Candidiasis of vagina,racial,American Indian or Alaska Native ,12,0,12
441848,Cranial nerve disorder,ethnic,Hispanic or Latino,9,2,11
75091,Closed fracture of carpal bone,racial,Black or African American ,0,12,12
4297375,Victim of abuse,racial,Unknown,12,0,12
439727,HIV - Human immunodeficiency virus infection,racial,American Indian,0,12,12
437544,Arterial retinal branch occlusion,ethnic,Hispanic or Latino,12,0,12
441276,Nondependent alcohol abuse in remission,racial,Black or African American ,0,12,12
435644,Metatarsal bone fracture,ethnic,Hispanic or Latino,7,5,12
4059157,Family circumstance NOS,racial,Other Race,0,12,12
316822,Finding of heart murmur,racial,American Indian or Alaska Native ,7,5,12
4141492,Other ill-defined heart disease,racial,American Indian or Alaska Native ,12,0,12
78621,Crushing injury of knee,ethnic,Hispanic or Latino,9,2,11
4057371,Diverticulosis NOS,ethnic,Hispanic or Latino,7,5,12
76506,Effusion of joint of lower leg,racial,Other Race,5,7,12
138876,Closed fracture of T1-T6 level with spinal cord injury,racial,Unknown,12,0,12
441333,Geographic tongue,racial,Unknown,7,5,12
199067,Inflammatory disease of female pelvic organs AND/OR tissues,racial,Unknown,12,0,12
443934,Prostatitis associated with another disease,racial,White,0,12,12
134618,Toxic diffuse goiter with thyrotoxic crisis,racial,White,12,0,12
261600,Pulmonary oedema - acute,racial,White,9,2,11
132408,Back problem,racial,Asian,7,5,12
438792,Crowding of teeth,ethnic,Hispanic or Latino,5,7,12
31602,Disease of the larynx,ethnic,Not Hispanic or Latino,12,0,12
139850,Acute frontal sinusitis,racial,Asian,12,0,12
381285,Peroneal muscular atrophy,ethnic,Hispanic or Latino,5,7,12
376387,Spasmodic torticollis,racial,White,9,2,11
194475,Singultus,ethnic,Not Hispanic or Latino,2,9,11
75670,Sprain pelvic ligament,racial,Black or African American ,12,0,12
256448,Chronic asthmatic bronchitis,racial,Other Race,9,2,11
432801,"Injury undetermined whether accidentally or purposely inflicted, fall from natural site",racial,Filipino,12,0,12
200831,Congenital anomaly of penis,racial,Unknown,0,12,12
443982,Traumatic amputation of thumb,ethnic,Hispanic or Latino,0,12,12
4185302,Chronic myocardial ischemia,racial,Black or African American ,2,9,11
436510,Acquired cavus foot deformity,racial,White,9,2,11
438725,Disorder of magnesium metabolism,racial,White,7,5,12
73021,Bilateral congenital dislocation of hip,racial,White,12,0,12
4141622,Asthma NOS,racial,Black or African American ,2,9,11
24075,Esophageal stricture and stenosis,ethnic,Not Hispanic or Latino,5,7,12
315273,MS - Mitral stenosis,racial,Unknown,9,2,11
439348,Pregnancy complications,racial,White,12,0,12
4064383,Rheumatoid arthritis screening,racial,Unknown,5,7,12
443447,Iatrogenic hypotension,racial,Unknown,2,9,11
196724,Disease of diaphragm,racial,White,12,0,12
4149353,"Attention deficit hyperactivity disorder, predominantly inattentive type",racial,American Indian or Alaska Native ,12,0,12
379832,Mixed conductive and sensorineural deafness,racial,Asian,7,5,12
196359,Primary malignant neoplasm of uterine cervix,racial,Asian,12,0,12
442901,"Motor vehicle traffic accident involving collision with another motor vehicle, stopped, occupant of tram injured",ethnic,Hispanic or Latino,5,7,12
27587,Disturbance of salivary secretion,ethnic,Not Hispanic or Latino,2,9,11
137083,Unilateral incomplete cleft palate,racial,White,0,12,12
74806,Open wound of finger with complication,ethnic,Hispanic or Latino,2,9,11
444445,Benign neoplasm of skin of leg,ethnic,Not Hispanic or Latino,9,2,11
374313,Neoplasm of uncertain behaviour of connective and other soft tissues,ethnic,Hispanic or Latino,2,9,11
375547,Anisometropia,racial,White,2,9,11
136760,Transient hypertension of pregnancy - not delivered,racial,Other Race,12,0,12
443582,Disorder of joint of hand,ethnic,Hispanic or Latino,9,2,11
137813,Benign neoplasm of mouth region,ethnic,Hispanic or Latino,5,7,12
376690,Cerebral edema,racial,White,12,0,12
75052,Enthesopathy of wrist AND/OR carpus,racial,Unknown,9,2,11
375794,Alcohol-induced sleep disorder,racial,White,0,12,12
435318,Complete spontaneous abortion with genital tract or pelvic infection,racial,White,12,0,12
321844,Initial apnea,racial,White,0,12,12
436670,MD - Metabolic disorders,racial,Asian,12,0,12
442441,Grand multiparity with antenatal problem,racial,Unknown,12,0,12
4119298,Late onset asthma,ethnic,Not Hispanic or Latino,2,9,11
441025,Stenosis of lacrimal canaliculi,ethnic,Hispanic or Latino,5,7,12
4192786,Potential infectious contact,racial,Unknown,12,0,12
442942,"Crush injury, toe(s)",racial,Unknown,9,2,11
433403,Viral meningitis,ethnic,Not Hispanic or Latino,5,7,12
432597,Schizoaffective schizophrenia,racial,Asian,0,12,12
198075,Venereal wart,racial,Black or African American ,9,2,11
194683,Obstructed umbilical hernia,racial,Unknown,12,0,12
378160,Otorrhea,ethnic,Not Hispanic or Latino,9,2,11
380097,Diabetic macular edema,ethnic,Not Hispanic or Latino,9,2,11
4077382,Familial lipoprotein lipase deficiency,ethnic,Hispanic or Latino,12,0,12
73090,Superficial bruising of foot,racial,Other Race,12,0,12
4316068,TP - Total pancreatectomy,racial,White,0,12,12
192858,Ovarian hyperfunction,racial,White,12,0,12
376938,NF - Neurofibromatosis,racial,American Indian or Alaska Native ,12,0,12
435120,Blister of toe with infection,racial,Unknown,7,5,12
437384,Raised laboratory findings,racial,White,12,0,12
4171075,Bite of animal,racial,Unknown,9,2,11
437791,Chickenpox with complication,racial,Unknown,7,5,12
140486,Ulcer of calf,racial,Unknown,9,2,11
4101602,Henoch-Schonlein purpura,ethnic,Not Hispanic or Latino,0,12,12
381290,Ocular hypertension,ethnic,Not Hispanic or Latino,7,5,12
4015842,Viral hepatitis carrier,ethnic,Hispanic or Latino,12,0,12
81336,Rectal prolapse,racial,Black or African American ,0,12,12
443604,Factitious disorder with predominantly psychological signs and symptoms,ethnic,Hispanic or Latino,12,0,12
4149455,Baby birth weight 2.0-2.5kg,ethnic,Hispanic or Latino,0,12,12
4056022,Chronic pyelonephritis NOS,racial,White,2,9,11
376113,Recent subtotal retinal detachment,racial,White,7,5,12
381732,Nerve injury,ethnic,Hispanic or Latino,9,2,11
4196206,beta^+^ Thalassemia,racial,White,12,0,12
443239,Precerebral arterial occlusion,ethnic,Hispanic or Latino,12,0,12
134442,Thibierge-Weissenbach syndrome,racial,Unknown,7,5,12
76482,MA - Missed abortion,racial,Black or African American ,12,0,12
138519,Spondylosis without myelopathy,racial,Black or African American ,12,0,12
4090255,Colloid bodies in retina,racial,White,9,2,11
77029,Epididymo-orchitis without abscess,ethnic,Not Hispanic or Latino,0,12,12
432626,Glaucoma associated with vascular disorder,racial,White,12,0,12
432302,Cocaine dependence in remission,racial,White,0,12,12
194091,Calculus in urethra,racial,White,0,12,12
444247,Venous thrombosis,racial,Black or African American ,5,7,12
315947,Thoracic back sprain,racial,Other Race,9,2,11
444069,Abrasion AND/OR friction burn of leg with infection,racial,Unknown,9,2,11
4073997,Stretching of prepuce,racial,White,0,12,12
377254,"Multi-infarct dementia, uncomplicated",racial,American Indian or Alaska Native ,12,0,12
374338,Nondiabetic proliferative retinopathy,racial,Unknown,0,12,12
73183,Myotonic disorder,ethnic,Not Hispanic or Latino,12,0,12
40482247,Organic sleep apnea,ethnic,Hispanic or Latino,5,7,12
432611,Explosive personality disorder,racial,Unknown,0,12,12
194686,Acquired renal cyst,racial,Black or African American ,9,2,11
4098600,Gouty nephropathy unspecified,ethnic,Hispanic or Latino,12,0,12
31120,Congenital anomaly of upper alimentary tract,ethnic,Hispanic or Latino,5,7,12
25486,Primary malignant neoplasm of islets of Langerhans,racial,White,0,12,12
433516,Duodenitis,racial,Unknown,7,5,12
439795,Minimal cognitive impairment,racial,Black or African American ,12,0,12
134057,Disease of cardiovascular system,racial,Asian,0,12,12
76472,Dysplasia of anus,racial,Asian,0,12,12
438887,Closed fracture shaft of femur,ethnic,Hispanic or Latino,5,7,12
441081,Maternal gonorrhoea during pregnancy - baby not yet delivered,racial,White,12,0,12
255891,Lupus erythematosus,racial,Other Race,12,0,12
195770,Subserous uterine fibroid,racial,Black or African American ,12,0,12
4305589,"Neoplasm, benign",ethnic,Not Hispanic or Latino,5,7,12
436583,[X]Falls,racial,Filipino,2,9,11
141253,Disease of thyroid gland,racial,Black or African American ,7,5,12
4056022,Chronic pyelonephritis NOS,ethnic,Hispanic or Latino,2,9,11
140654,Deep seated dermatophytosis,racial,Unknown,5,7,12
436837,Closed fracture of neck of radius,ethnic,Hispanic or Latino,12,0,12
198082,Overlapping malignant neoplasm of body of uterus,ethnic,Hispanic or Latino,12,0,12
80997,Myopathy due to endocrine disease EC,ethnic,Hispanic or Latino,12,0,12
198240,Congenital buried penis,racial,White,0,12,12
435443,[X]Fall involving wheelchair,racial,White,9,2,11
442626,Benign hypertensive heart AND renal disease,racial,White,12,0,12
436080,"Neoplasm of uncertain behaviour of lip, oral cavity and pharynx",ethnic,Hispanic or Latino,5,7,12
439013,Insomnia disorder related to another mental disorder,ethnic,Not Hispanic or Latino,7,5,12
435233,Disorders of fatty-acid metabolism,racial,Other Race,12,0,12
78529,Kyphoscoliosis and scoliosis,racial,Asian,9,2,11
4144783,Old healed fracture of bone,racial,White,12,0,12
4105187,Speech or language developmental disorder NOS,ethnic,Not Hispanic or Latino,5,7,12
4108533,Unspecified otalgia,racial,Black or African American ,12,0,12
81893,Chronic ulcerative colitis,racial,Black or African American ,12,0,12
441177,Second degree burn of upper limb,racial,White,7,5,12
435569,Disorder of jaw,racial,Unknown,7,5,12
135360,Fainting,racial,Filipino,12,0,12
201340,Gastritis,racial,Filipino,2,9,11
432526,Needs influenza immunisation,racial,Alaska Native,0,12,12
4058399,Placenta praevia without haemorrhage unspecified,ethnic,Hispanic or Latino,12,0,12
443392,Malignant neoplastic disease,ethnic,Hispanic or Latino,12,0,12
436510,Acquired cavus foot deformity,ethnic,Not Hispanic or Latino,9,2,11
260134,Croup,racial,Asian,5,7,12
141305,Unilateral sensorineural hearing loss with unrestricted hearing on the contralateral side,racial,Other Race,12,0,12
74434,Infection of the breast AND/OR nipple associated with childbirth,racial,White,12,0,12
433658,Adverse reaction to penicillins,racial,Unknown,9,2,11
381581,Chalazion,racial,Black or African American ,9,2,11
4077382,Familial lipoprotein lipase deficiency,ethnic,Not Hispanic or Latino,0,12,12
195583,Chronic gastric ulcer without hemorrhage AND without perforation but with obstruction,ethnic,Hispanic or Latino,12,0,12
374364,Disorder of middle ear,racial,White,2,9,11
192364,Nephrotic syndrome associated with another disorder,racial,White,2,9,11
4148404,Family history: Anemia,racial,White,7,5,12
444371,Abrasion AND/OR friction burn of finger without infection,racial,Unknown,12,0,12
439439,Injury of unknown intent by cutting instrument,ethnic,Hispanic or Latino,2,9,11
4112003,Hypotension NOS,ethnic,Hispanic or Latino,5,7,12
373962,Tabes dorsalis - neurosyphilis,ethnic,Hispanic or Latino,9,2,11
4097716,"Benign neoplasm of lip, oral cavity and pharynx NOS",ethnic,Hispanic or Latino,2,9,11
74322,Benign neoplasm of scrotum,ethnic,Not Hispanic or Latino,0,12,12
133510,Rapidly progressive periodontitis,ethnic,Not Hispanic or Latino,5,7,12
75046,Old bucket handle tear of medial meniscus,racial,White,0,12,12
25486,Primary malignant neoplasm of islets of Langerhans,ethnic,Hispanic or Latino,0,12,12
436700,Eye displaced forwards,racial,Unknown,7,5,12
198809,Acute cholecystitis,ethnic,Not Hispanic or Latino,7,5,12
437013,"Primary dental caries, pit and fissure origin",ethnic,Hispanic or Latino,0,12,12
376425,Chronic non-suppurative otitis media,ethnic,Not Hispanic or Latino,9,2,11
4166443,Family history: Arthritis,racial,White,5,7,12
437478,Bite of nonvenomous arthropod,racial,Other Race,0,12,12
194993,Intestinal malabsorption,racial,Black or African American ,12,0,12
200761,Retroperitoneal abscess,racial,White,0,12,12
432303,Cocaine abuse,ethnic,Not Hispanic or Latino,5,7,12
443934,Prostatitis associated with another disease,ethnic,Hispanic or Latino,0,12,12
260131,Bronchial disorder,ethnic,Not Hispanic or Latino,12,0,12
80492,Knee joint contracture,racial,White,12,0,12
201675,Autosomal recessive polycystic kidney disease,ethnic,Hispanic or Latino,12,0,12
4103471,Observation of body mass index,racial,Arab,12,0,12
434303,Benign neoplasm of rectum and anal canal,racial,White,0,12,12
4065355,Urticaria due to cold and heat,ethnic,Hispanic or Latino,12,0,12
434033,Chorioretinitis,ethnic,Hispanic or Latino,5,7,12
439005,Chronic alcoholism in remission,racial,Black or African American ,5,7,12
136779,Disease of forearm,racial,White,12,0,12
433505,Subclavian steal syndrome,ethnic,Hispanic or Latino,9,2,11
433633,Late effect of superficial injury,ethnic,Hispanic or Latino,12,0,12
28457,Hypertrophy of tonsils,racial,American Indian or Alaska Native ,9,2,11
4150307,Dental restoration observation,racial,Black or African American ,12,0,12
437703,Closed fracture of intracapsular section of femur,ethnic,Hispanic or Latino,12,0,12
439274,Acute exacerbation of subchronic latent schizophrenia,ethnic,Not Hispanic or Latino,0,12,12
201620,Calculus of kidney,racial,Black or African American ,7,5,12
141831,Branchial arch syndrome,ethnic,Not Hispanic or Latino,12,0,12
192671,GI - Gastrointestinal haemorrhage,racial,Black or African American ,2,9,11
440029,Viral disease,racial,Filipino,5,7,12
134898,Non-toxic single thyroid nodule,racial,Black or African American ,5,7,12
439391,Physical abuse of adult,racial,Unknown,12,0,12
441805,Primary malignant neoplasm of endocervix,racial,White,12,0,12
373425,Metastasis to nervous system,ethnic,Hispanic or Latino,12,0,12
194175,Left upper quadrant pain,racial,American Indian or Alaska Native ,9,2,11
194699,Liver disorder in pregnancy,racial,Unknown,12,0,12
4315363,"Accidents caused by knives, swords and daggers",racial,White,12,0,12
439940,Closed fracture of upper end of forearm,ethnic,Hispanic or Latino,5,7,12
443357,Ankle joint observation,ethnic,Hispanic or Latino,5,7,12
31057,Disorder of pharynx,racial,White,9,2,11
436675,Anorexia nervosa,ethnic,Not Hispanic or Latino,2,9,11
4103574,Chronic depression,racial,Black or African American ,5,7,12
4273095,Acute tracheitis without obstruction,racial,Unknown,0,12,12
193688,Clostridium difficile infection,racial,Black or African American ,9,2,11
441589,Endocarditis,racial,Asian,12,0,12
140173,Telogen effluvium,racial,Unknown,12,0,12
376686,Polyneuropathy associated with another disorder,racial,Asian,0,12,12
437689,Multiple closed fractures of cervical vertebrae,ethnic,Hispanic or Latino,0,12,12
437779,Streptococcal infectious disease,ethnic,Not Hispanic or Latino,0,12,12
377802,Late effects of poliomyelitis,racial,Other Race,0,12,12
4014231,Foot sprain NOS,racial,Unknown,9,2,11
435217,Paranoid schizophrenia in remission,racial,White,0,12,12
77074,Joint pain,racial,Native Hawaiian or Other Pacific Islander ,9,2,11
4051702,FH: Congenital anomaly,racial,White,12,0,12
4057371,Diverticulosis NOS,racial,White,7,5,12
74434,Infection of the breast AND/OR nipple associated with childbirth,ethnic,Hispanic or Latino,12,0,12
374645,Phantom limb syndrome,racial,Black or African American ,0,12,12
321822,Peripheral circulatory disorder associated with diabetes mellitus,racial,Unknown,7,5,12
437400,Closed fracture of shaft of ulna,racial,Unknown,2,9,11
317895,Hypertension due to renovascular disease,racial,White,7,5,12
81336,Rectal prolapse,racial,Unknown,12,0,12
436747,Legal abortion without complication,racial,White,12,0,12
76201,Non-traumatic rupture of biceps brachii tendon,racial,White,5,7,12
442936,"Motor vehicle traffic accident due to motor vehicle going out of control due to failure of mechanical part, without collision on the highway, passenger of motor vehicle injured",racial,White,12,0,12
200052,Primary malignant neoplasm of uterine adnexa,racial,White,12,0,12
373648,Superficial injury of eyelid AND/OR periocular area,racial,Unknown,5,7,12
4176878,Calculus of cystic duct with cholecystitis,ethnic,Hispanic or Latino,9,2,11
137005,Tracheostomy complication,ethnic,Not Hispanic or Latino,12,0,12
433599,Abnormal biochemistry finding,racial,American Indian or Alaska Native ,12,0,12
373425,Metastasis to nervous system,racial,White,12,0,12
434165,Abnormal cervical smear,racial,Black or African American ,12,0,12
77630,Disease of shoulder,racial,American Indian or Alaska Native ,12,0,12
200772,Gastroenteritis due to radiation,ethnic,Hispanic or Latino,9,2,11
316998,Left bundle branch block,racial,Asian,12,0,12
80141,Functional diarrhea,racial,Black or African American ,12,0,12
200452,Disease of female genital organ,racial,Asian,12,0,12
378253,HA - Headache,racial,Native Hawaiian or Other Pacific Islander ,12,0,12
198198,Vaginal polyp,racial,Unknown,12,0,12
138582,"Closed fracture scapula, acromion",racial,Unknown,12,0,12
4053045,Dog bite,racial,Other Race,12,0,12
314664,Long Q-T syndrome,racial,White,12,0,12
252365,MGN - Membranous glomerulonephritis,racial,Asian,0,12,12
433400,Emergency contraception,racial,Black or African American ,12,0,12
256439,Allergic rhinitis due to pollen,racial,Asian,9,2,11
376966,Exudative age-related macular degeneration,ethnic,Not Hispanic or Latino,0,12,12
73065,"Contusion, genital organs",ethnic,Hispanic or Latino,12,0,12
377575,Tinnitus,racial,Black or African American ,9,2,11
4147494,Nonspecific mesenteric adenitis,racial,Unknown,0,12,12
380669,Benign neoplasm of eyelid including canthus,racial,Unknown,9,2,11
141249,Benign tumour of thyroid gland,ethnic,Not Hispanic or Latino,12,0,12
432302,Cocaine dependence in remission,ethnic,Hispanic or Latino,0,12,12
321502,Chagas' disease with heart involvement,racial,Other Race,0,12,12
437525,Overweight,racial,Arab,12,0,12
374905,Non-organic sleep disorder,racial,Black or African American ,9,2,11
4232212,Hypoglycemic shock,ethnic,Hispanic or Latino,0,12,12
433621,Sprain of sternoclavicular joint AND/OR ligament,ethnic,Hispanic or Latino,7,5,12
201823,Benign tumour of penis,ethnic,Not Hispanic or Latino,0,12,12
432345,Hypertrophy of tongue papillae,racial,Unknown,7,5,12
439745,Primary malignant neoplasm of salivary gland duct,racial,White,12,0,12
380100,Glossopharyngeal neuralgia,ethnic,Hispanic or Latino,12,0,12
135699,Burn any degree involving 10-19 percent of body surface,ethnic,Not Hispanic or Latino,2,9,11
377271,Parsonage-Turner syndrome,ethnic,Hispanic or Latino,0,12,12
76201,Non-traumatic rupture of biceps brachii tendon,ethnic,Hispanic or Latino,5,7,12
435151,Physical child abuse,ethnic,Not Hispanic or Latino,2,9,11
133228,Dental caries,racial,Filipino,5,7,12
442626,Benign hypertensive heart AND renal disease,ethnic,Hispanic or Latino,12,0,12
138825,Actinic keratosis,racial,American Indian or Alaska Native ,7,5,12
194091,Calculus in urethra,ethnic,Hispanic or Latino,0,12,12
199754,Primary malignant neoplasm of pancreas,racial,Asian,9,2,11
372616,Werdnig-Hoffmann disease,ethnic,Not Hispanic or Latino,9,2,11
380093,Episodic cluster headache,ethnic,Hispanic or Latino,9,2,11
4332993,Childhood schizophrenia NOS,racial,White,0,12,12
438788,Hypertrophy of adenoids,ethnic,Not Hispanic or Latino,2,9,11
197654,Congenital cystic disease of liver,racial,White,0,12,12
196442,Chronic gastric ulcer with hemorrhage AND with perforation but without obstruction,ethnic,Hispanic or Latino,12,0,12
77234,Benign tumour of colon,racial,American Indian or Alaska Native ,12,0,12
4051568,Family history of mental disorder,ethnic,Not Hispanic or Latino,7,5,12
4108676,Other chronic ischaemic heart disease NOS,racial,White,0,12,12
134765,General body deterioration,racial,Asian,0,12,12
444069,Abrasion AND/OR friction burn of leg with infection,racial,White,5,7,12
432295,Pernicious anemia,ethnic,Not Hispanic or Latino,0,12,12
76472,Dysplasia of anus,ethnic,Not Hispanic or Latino,0,12,12
439658,Gestosis,ethnic,Not Hispanic or Latino,7,5,12
437589,Pulpitis,ethnic,Not Hispanic or Latino,5,7,12
134460,Plantar fascial fibromatosis,racial,Filipino,5,7,12
436263,Broken tooth without complication,racial,Other Race,9,2,11
436948,Benign neoplasm of choroid,ethnic,Hispanic or Latino,2,9,11
4192786,Potential infectious contact,racial,White,12,0,12
201823,Benign tumour of penis,racial,White,0,12,12
196734,Disease of prostate,racial,Other Race,0,12,12
133438,Chronic lymphoid leukaemia in remission,ethnic,Hispanic or Latino,0,12,12
81454,Injury of finger,racial,Black or African American ,0,12,12
4109545,Unspecified cataracta complicata,racial,White,5,7,12
138896,Open wound of forehead without complication,racial,Other Race,5,7,12
373212,Esophoria,racial,Unknown,7,5,12
140020,Viral exanthem,racial,Black or African American ,9,2,11
72418,Scoliosis deformity of spine,racial,Other Race,12,0,12
435782,Chronic schizophrenic,racial,Filipino,12,0,12
4092845,Candidiasis NOS,racial,White,2,9,11
375794,Alcohol-induced sleep disorder,ethnic,Not Hispanic or Latino,0,12,12
194871,Trichomonal vulvovaginitis,racial,Unknown,12,0,12
436659,Iron deficiency anaemia,racial,Native Hawaiian or Other Pacific Islander ,5,7,12
442287,Rest pain,racial,Unknown,9,2,11
439706,Psychosis with origin in childhood,racial,Black or African American ,0,12,12
23798,Acute laryngopharyngitis,ethnic,Not Hispanic or Latino,2,9,11
141475,Second degree burn of foot,ethnic,Hispanic or Latino,5,7,12
72710,Effusion of joint of forearm,ethnic,Not Hispanic or Latino,5,7,12
4064363,Intest helminthiasis screening,ethnic,Hispanic or Latino,0,12,12
75686,Open wound of hand except fingers with complication,racial,White,0,12,12
135618,Prurigo,racial,Asian,0,12,12
201618,Disease of intestine,racial,Unknown,9,2,11
376552,Cerebral laceration and contusion,ethnic,Not Hispanic or Latino,2,9,11
434547,Complication of surgical procedure,racial,White,9,2,11
74855,Genital herpes simplex,racial,Asian,9,2,11
432508,"Mechanical complication of nervous system device, implant AND/OR graft",racial,White,0,12,12
439249,"Mixed bipolar affective disorder, mild",racial,White,0,12,12
435604,"Viral disease in mother complicating pregnancy, childbirth AND/OR puerperium",racial,White,9,2,11
434663,Acute endocarditis,ethnic,Hispanic or Latino,5,7,12
81938,Climacteric arthritis of the shoulder region,ethnic,Hispanic or Latino,12,0,12
4316068,TP - Total pancreatectomy,ethnic,Hispanic or Latino,0,12,12
441385,Corrected transposition of great vessels,ethnic,Hispanic or Latino,9,2,11
434701,"Anemia in mother complicating pregnancy, childbirth AND/OR puerperium",ethnic,Not Hispanic or Latino,12,0,12
319054,Thrombophlebitis of upper extremities,racial,White,2,9,11
201914,Premenopausal menorrhagia,racial,Asian,12,0,12
318556,Nosebleed,racial,Filipino,2,9,11
441846,After-cataract not obscuring vision,ethnic,Hispanic or Latino,12,0,12
73089,Contusion of buttock,ethnic,Not Hispanic or Latino,7,5,12
314962,Raynaud disease,racial,Asian,12,0,12
444055,Thrombophlebitis of superficial veins of lower extremity,racial,Unknown,7,5,12
28385,Disorder of posterior pituitary,racial,Asian,12,0,12
4009750,Open fracture of other tarsal and metatarsal bones,ethnic,Not Hispanic or Latino,0,12,12
432601,Childhood and adolescent disturbance with elective mutism,ethnic,Not Hispanic or Latino,12,0,12
199075,Neurogenic bladder,racial,Black or African American ,0,12,12
4269719,Finding of growth of fungi,ethnic,Not Hispanic or Latino,2,9,11
138519,Spondylosis without myelopathy,racial,Native Hawaiian or Other Pacific Islander ,0,12,12
4228802,Mild recurrent major depression,racial,Black or African American ,5,7,12
74082,Acontractile detrusor,racial,Other Race,0,12,12
439656,A/N care: grand multip,racial,White,12,0,12
4064989,Lung function testing abnormal,racial,Unknown,5,7,12
443876,Obsessive compulsive personality disorder,racial,White,7,5,12
316211,Acquired spondylolisthesis,ethnic,Not Hispanic or Latino,2,9,11
199879,Fistula of the female genital organs,racial,White,12,0,12
439745,Primary malignant neoplasm of salivary gland duct,ethnic,Hispanic or Latino,12,0,12
378157,Mechanical strabismus,ethnic,Hispanic or Latino,12,0,12
433735,Alcohol dependence with acute alcoholic intoxication,ethnic,Not Hispanic or Latino,0,12,12
78593,Open wound of wrist without complication,racial,White,5,7,12
4236391,Acute necrotizing otitis media,racial,White,0,12,12
438447,Acute myocardial infarction of inferolateral wall,racial,Unknown,12,0,12
374924,Generalized convulsive epilepsy,racial,Filipino,0,12,12
316376,Eosinophilia,racial,Unknown,5,7,12
441264,Primary thrombocytopenia,racial,Other Race,9,2,11
138255,Abnormal cardiovascular function,racial,White,12,0,12
433736,Obesity,racial,Middle Eastern or North African,12,0,12
134681,Spasm of oesophagus,racial,White,7,5,12
198082,Overlapping malignant neoplasm of body of uterus,racial,Other Race,12,0,12
255454,"Tuberculosis of lung, confirmed by sputum microscopy with or without culture",ethnic,Hispanic or Latino,7,5,12
381857,Impairment level: one eye: total impairment: other eye: not specified,racial,Other Race,9,2,11
4152045,Screening for malignant neoplasm of respiratory tract,ethnic,Hispanic or Latino,12,0,12
435836,Disorder of nasopharynx,ethnic,Not Hispanic or Latino,9,2,11
199076,Fallopian tube pregnancy,racial,Unknown,12,0,12
141095,Acne,racial,Filipino,9,2,11
4115173,Atrial premature complex,racial,Black or African American ,9,2,11
135923,CP - Cleft palate,racial,Other Race,12,0,12
78472,Microscopic haematuria,racial,Native Hawaiian or Other Pacific Islander ,12,0,12
373747,Extrapyramidal disease,ethnic,Not Hispanic or Latino,7,5,12
434490,Shivering,ethnic,Not Hispanic or Latino,5,7,12
380055,Primary malignant neoplasm of brain,racial,Unknown,0,12,12
312664,Influenza with respiratory manifestation other than pneumonia,racial,Filipino,0,12,12
434916,"Amfetamine or psychostimulant dependence, continuous",racial,Unknown,12,0,12
260427,Common cold,racial,American Indian or Alaska Native ,12,0,12
198928,Mechanical complication due to intrauterine contraceptive device,racial,Unknown,12,0,12
435388,"Cortex contusion with open intracranial wound, with more than 24 hours loss of consciousness and return to pre-existing conscious level",ethnic,Hispanic or Latino,0,12,12
317893,Paroxysmal supraventricular tachycardia,racial,Other Race,0,12,12
381865,Sensorimotor disorder of eyelid,ethnic,Hispanic or Latino,7,5,12
192359,RF - Renal failure,racial,Other Race,9,2,11
376657,Lipoma of face,racial,Unknown,12,0,12
4059637,Work environment deleterious,ethnic,Not Hispanic or Latino,9,2,11
440846,"Blood coagulation disorder, categorized by value of screening test",racial,Asian,0,12,12
441829,Hyperosmolality and or hypernatremia,racial,Asian,12,0,12
30284,Motion sickness,ethnic,Not Hispanic or Latino,9,2,11
374338,Nondiabetic proliferative retinopathy,racial,Black or African American ,0,12,12
201449,Unilateral traumatic amputation of leg below knee without complication,racial,White,5,7,12
4278083,Viral tracheitis,racial,White,0,12,12
437478,Bite of nonvenomous arthropod,racial,Asian,5,7,12
79173,Closed dislocation of jaw,racial,White,9,2,11
79109,Climacteric arthritis,ethnic,Hispanic or Latino,12,0,12
439893,Excessive weight gain in pregnancy,ethnic,Hispanic or Latino,5,7,12
197676,Hepatomegaly,racial,Other Race,0,12,12
437064,Chondrocalcinosis,racial,White,9,2,11
26441,Bleeding ulcer of esophagus,racial,White,0,12,12
439893,Excessive weight gain in pregnancy,racial,White,5,7,12
4240902,Allergy to peanuts,racial,Other Race,0,12,12
441628,Menopausal and postmenopausal disorders,racial,Black or African American ,12,0,12
443563,Arteriosclerosis in coronary artery bypass graft,racial,Other Race,0,12,12
436799,Talipes cavus,racial,White,7,5,12
74725,Displacement of cervical intervertebral disc without myelopathy,racial,Black or African American ,12,0,12
4059014,Spontaneous bruising,racial,Black or African American ,0,12,12
432382,Complication of labor AND/OR delivery,ethnic,Hispanic or Latino,12,0,12
436089,"Nondependent cocaine abuse, episodic",ethnic,Hispanic or Latino,0,12,12
432884,Amfetamine or psychostimulant dependence in remission,ethnic,Hispanic or Latino,0,12,12
140027,Herpetic gingivostomatitis,racial,Other Race,12,0,12
199856,Varicose veins of lower extremity with inflammation,racial,Black or African American ,0,12,12
438460,Edentulous alveolar ridge atrophy,racial,White,12,0,12
74082,Acontractile detrusor,ethnic,Hispanic or Latino,0,12,12
4023168,Home alone,ethnic,Not Hispanic or Latino,9,2,11
255454,"Tuberculosis of lung, confirmed by sputum microscopy with or without culture",racial,White,7,5,12
194990,Inflammatory disorder of liver,racial,Black or African American ,2,9,11
440388,[X]Developmental co - ordination disorder,racial,Black or African American ,0,12,12
374907,Tics of organic origin,ethnic,Hispanic or Latino,2,9,11
432910,Disorder of lacrimal system,racial,Unknown,2,9,11
4115062,Other internal knee derangement NOS,racial,Unknown,0,12,12
436314,Accidental puncture AND/OR laceration during a procedure,ethnic,Not Hispanic or Latino,0,12,12
4288028,Mural pregnancy,ethnic,Hispanic or Latino,12,0,12
193983,Disorder of pancreatic internal secretion,ethnic,Hispanic or Latino,9,2,11
4179214,Family history of malignant neoplasm of gastrointestinal tract,racial,Black or African American ,5,7,12
192279,Diabetic nephropathy,racial,Alaska Native,12,0,12
198470,Unilateral inguinal hernia with obstruction but no gangrene,racial,Unknown,0,12,12
435080,Biliuria,racial,Unknown,7,5,12
138502,Vitiligo,racial,Other Race,2,9,11
4024361,Paralysis of glottis,racial,Other Race,12,0,12
196456,Cholecystolithiasis,racial,Asian Indian,0,12,12
380378,Epilepsy,racial,American Indian or Alaska Native ,7,5,12
443891,Cementum caries,ethnic,Not Hispanic or Latino,0,12,12
374915,Localisation-related epilepsy,ethnic,Not Hispanic or Latino,12,0,12
4015641,"Fracture of tibia and fibula, NOS",racial,White,12,0,12
376938,NF - Neurofibromatosis,ethnic,Not Hispanic or Latino,12,0,12
81713,Carpal joint sprain,ethnic,Hispanic or Latino,7,5,12
201079,Acute parametritis and pelvic cellulitis,ethnic,Not Hispanic or Latino,9,2,11
195500,Benign tumour of uterus,racial,White,9,2,11
442444,"Motor vehicle traffic accident involving pedestrian hit by motor vehicle, pedestrian injured",racial,Other Race,12,0,12
137977,Icteric,racial,Asian,5,7,12
4100382,Acute hysterical psychosis,ethnic,Hispanic or Latino,9,2,11
4061081,Other male genital organ diseases OS,racial,White,0,12,12
74472,Congenital deformity of foot,racial,Other Race,0,12,12
444361,Nonvenomous insect bite of toe without infection,racial,Unknown,5,7,12
440053,Infestation by insect,ethnic,Not Hispanic or Latino,12,0,12
137111,"Closed fracture scapula, coracoid",ethnic,Hispanic or Latino,0,12,12
379784,Senile dementia with depression,racial,Asian,9,2,11
432898,Severe mental handicap,racial,Black or African American ,0,12,12
432311,Angle-closure glaucoma - borderline,racial,White,9,2,11
440072,Hypogammaglobulinemia,racial,White,9,2,11
432626,Glaucoma associated with vascular disorder,racial,Unknown,2,9,11
141372,Contact dermatitis due to solvents,racial,Black or African American ,0,12,12
435569,Disorder of jaw,ethnic,Not Hispanic or Latino,12,0,12
435849,Parietoalveolar pneumopathy,racial,White,7,5,12
4165070,Unilateral breast implant,ethnic,Hispanic or Latino,12,0,12
138604,"Contusion of face, scalp and neck, excluding eye(s)",racial,Other Race,2,9,11
439554,Hypnotic or anxiolytic abuse,ethnic,Not Hispanic or Latino,0,12,12
26823,Oral phase dysphagia,racial,Other Race,12,0,12
4165070,Unilateral breast implant,racial,Unknown,12,0,12
442023,Poisoning of undetermined intent,racial,Unknown,9,2,11
138825,Actinic keratosis,racial,Other Race,5,7,12
4067435,"Joint disorder NOS, of unspecified site",racial,Unknown,2,9,11
321588,Heart disease,racial,Asian,0,12,12
4093344,Prostate observation,racial,American Indian or Alaska Native ,0,12,12
201461,Disorder affecting transplant,ethnic,Hispanic or Latino,9,2,11
434854,FP - Food poisoning,ethnic,Not Hispanic or Latino,5,7,12
432874,Lipidosis,ethnic,Not Hispanic or Latino,0,12,12
432875,Anemia due to chronic blood loss,ethnic,Not Hispanic or Latino,9,2,11
319843,Mitral valve disorder,racial,Other Race,9,2,11
438430,Squamous blepharitis,racial,Unknown,9,2,11
440668,Benign tumour of tongue,racial,White,5,7,12
138616,Superficial burn of hand,ethnic,Hispanic or Latino,5,7,12
439004,Restzustand,ethnic,Not Hispanic or Latino,0,12,12
437474,Postoperative infection,racial,Unknown,7,5,12
133685,Salmonellosis,racial,White,2,9,11
256723,Pneumonia and influenza,ethnic,Hispanic or Latino,7,5,12
321882,Generalised atherosclerosis,ethnic,Not Hispanic or Latino,2,9,11
441260,Drug withdrawal syndrome,racial,Unknown,9,2,11
78273,Closed fracture multiple ribs,racial,Other Race,0,12,12
376411,Central pterygium,racial,Unknown,9,2,11
437843,Childhood conduct disorder,racial,Unknown,5,7,12
434890,Repetitive stereotyped movement,ethnic,Hispanic or Latino,0,12,12
376690,Cerebral edema,ethnic,Not Hispanic or Latino,12,0,12
433196,Chorioretinal scar,ethnic,Hispanic or Latino,12,0,12
374357,Acquired stenosis of nasolacrimal duct,racial,Asian,0,12,12
4104016,Ts and As - Tonsillectomy and adenoidectomy,ethnic,Hispanic or Latino,5,7,12
195245,Reflex sympathetic dystrophy,racial,Unknown,0,12,12
141693,Elevated blood-pressure reading without diagnosis of hypertension,racial,American Indian,0,12,12
4161978,Patient on oxygen,racial,Black or African American ,0,12,12
435508,Adrenal cortical hypofunction,racial,American Indian,12,0,12
138667,Stoma observations,ethnic,Hispanic or Latino,9,2,11
200768,Inflammatory disease of vagina and/or vulva,ethnic,Not Hispanic or Latino,12,0,12
140486,Ulcer of calf,racial,Other Race,0,12,12
40481374,Allergic rhinitis due to food,ethnic,Not Hispanic or Latino,12,0,12
443350,Lower urinary tract symptoms,racial,Filipino,0,12,12
442752,Myalgia,racial,Asian Indian,12,0,12
79072,Inflammatory disorder of breast,racial,Other Race,12,0,12
80478,Engorgement of breasts associated with childbirth,racial,White,12,0,12
435782,Chronic schizophrenic,racial,American Indian or Alaska Native ,0,12,12
438130,Opioid abuse,ethnic,Not Hispanic or Latino,2,9,11
4281232,Type B viral hepatitis,ethnic,Not Hispanic or Latino,5,7,12
79098,Suppressed lactation,racial,Black or African American ,0,12,12
133637,Second degree burn of lower limb,racial,White,9,2,11
444253,Blister of scalp without infection,ethnic,Hispanic or Latino,7,5,12
192362,Nephrotic syndrome with membranoproliferative glomerulonephritis,ethnic,Hispanic or Latino,0,12,12
380403,External hordeolum,racial,Native Hawaiian or Other Pacific Islander ,7,5,12
197672,Urinary incontinence,racial,Filipino,7,5,12
437664,Does not vocalise,ethnic,Hispanic or Latino,2,9,11
433390,Immunosuppressant adverse reaction,racial,Unknown,12,0,12
439128,Extreme immaturity,racial,Asian,12,0,12
433930,Motor vehicle on road in collision with another motor vehicle,ethnic,Hispanic or Latino,9,2,11
193984,Adrenal hypofunction,racial,White,2,9,11
192606,Paraplegia,racial,Black or African American ,0,12,12
4008517,"Fracture of rib(s), sternum, larynx and trachea",ethnic,Hispanic or Latino,0,12,12
437664,Does not vocalise,racial,Unknown,2,9,11
441266,Thiamin deficiency,racial,White,9,2,11
434742,Congenital abnormality of skull and face bones,racial,Black or African American ,2,9,11
4046804,Disorder of fluency,racial,White,0,12,12
439961,Superficial injury without infection,ethnic,Not Hispanic or Latino,9,2,11
315586,Priapism,racial,White,0,9,9
194091,Calculus in urethra,ethnic,Not Hispanic or Latino,9,0,9
4115173,Atrial premature complex,ethnic,Not Hispanic or Latino,7,2,9
4208970,History of physical abuse,racial,Unknown,5,5,10
435644,Metatarsal bone fracture,racial,Unknown,2,7,9
441351,Early onset of delivery - delivered,racial,Black or African American ,2,7,9
437097,Congenital anomaly of cartilage,racial,Unknown,9,0,9
439971,Poisoning by anticoagulant,racial,Unknown,7,2,9
134741,Congenital anomaly of limb,ethnic,Not Hispanic or Latino,2,7,9
4013457,"Closed fracture of proximal humerus, unspecified part",ethnic,Not Hispanic or Latino,0,9,9
4115370,Arthralgia NOS,racial,Unknown,9,0,9
136495,Lichenification and lichen simplex chronicus,racial,Other Race,7,2,9
4064925,Hypertension screening,ethnic,Not Hispanic or Latino,7,2,9
318096,Secondary lymph node cancer,ethnic,Hispanic or Latino,0,9,9
4148121,Tonsil and/or adenoid hypertrophy,ethnic,Hispanic or Latino,5,5,10
434900,Drug-induced psychosis,ethnic,Not Hispanic or Latino,9,0,9
4177243,Cancer of pharynx,racial,Unknown,5,5,10
192815,Intestinal infection due to E. coli,racial,White,5,5,10
376094,Arteriosclerotic dementia with delirium,racial,White,9,0,9
132446,Congenital anomaly of skin,racial,Black or African American ,5,5,10
196515,Congenital chordee,ethnic,Hispanic or Latino,0,9,9
201727,Superficial injury of trunk without infection,ethnic,Hispanic or Latino,7,2,9
436667,Stammer,ethnic,Not Hispanic or Latino,0,9,9
438788,Hypertrophy of adenoids,racial,Black or African American ,0,9,9
440078,"Bipolar affective disorder, current episode manic",racial,Unknown,0,9,9
80478,Engorgement of breasts associated with childbirth,ethnic,Hispanic or Latino,9,0,9
433968,Candidiasis,racial,Asian,2,7,9
433917,Burns of multiple sites,ethnic,Hispanic or Latino,0,9,9
193445,Periodic disease,ethnic,Hispanic or Latino,0,9,9
257094,Congenital anomaly of lung,ethnic,Hispanic or Latino,5,5,10
4211657,Closed fracture of lower leg,ethnic,Hispanic or Latino,0,9,9
194686,Acquired renal cyst,racial,Asian,0,9,9
253235,Pneumonia in pertussis,ethnic,Hispanic or Latino,7,2,9
4141201,Beta lactam resistant bacterial infection,racial,Unknown,7,2,9
376394,Menstrual migraine,ethnic,Hispanic or Latino,9,0,9
439719,Disseminated mycobacteriosis,racial,Unknown,0,9,9
439763,Benign tumour of trachea,racial,White,0,9,9
193020,Incomplete emptying of bladder,ethnic,Not Hispanic or Latino,9,0,9
200169,Pruritus ani,racial,Black or African American ,5,5,10
4051564,FH: Metabolic disorder,racial,Unknown,5,5,10
4239069,Closed fracture of metacarpal bone,racial,White,0,9,9
442623,Abrasion AND/OR friction burn of scalp without infection,racial,Black or African American ,5,5,10
437390,Hypoxaemia,racial,Asian,0,9,9
443539,Motor vehicle injury,racial,Asian,0,9,9
22281,Sickle cell disease,ethnic,Hispanic or Latino,0,9,9
443585,Abrasion AND/OR friction burn of multiple sites,racial,Other Race,5,5,10
4197217,Arteriovenous anastomosis for renal dialysis,ethnic,Hispanic or Latino,2,7,9
437744,Heat exhaustion,racial,White,2,7,9
440668,Benign tumour of tongue,racial,Unknown,9,0,9
73720,Overlapping malignant neoplasm of urinary system,ethnic,Hispanic or Latino,9,0,9
432574,Diffuse malignant lymphoma - histiocytic,racial,Unknown,2,7,9
375251,Retinopathy of prematurity stage 2 - intraretinal ridge,ethnic,Hispanic or Latino,7,2,9
22340,Esophageal varices without bleeding,racial,Other Race,9,0,9
321414,Hemoglobinuria,racial,White,5,5,10
374034,Visual disturbance,racial,Native Hawaiian or Other Pacific Islander ,7,2,9
75686,Open wound of hand except fingers with complication,ethnic,Hispanic or Latino,0,9,9
4102166,Multiparous,racial,White,9,0,9
439394,Congenital anomaly of face,ethnic,Hispanic or Latino,7,2,9
4053378,FH: Blood disorder,racial,White,9,0,9
4088930,Confirmation of pregnancy,racial,Black or African American ,9,0,9
376683,Non proliferative diabetic retinopathy,racial,American Indian or Alaska Native ,9,0,9
4302979,Blepharorrhaphy,ethnic,Hispanic or Latino,9,0,9
141771,"Injury undetermined whether accidentally or purposely inflicted, by crashing of motor vehicle",ethnic,Hispanic or Latino,5,5,10
260139,Acute bronchitis,racial,Asian Indian,0,9,9
256451,Bronchitis,racial,Asian Indian,2,7,9
374049,Acute mucoid otitis media,racial,White,5,5,10
4093309,Secondary syphilis of skin and mucous membrane,ethnic,Hispanic or Latino,0,9,9
437477,[X]Fall involving playground equipment,racial,White,5,5,10
133713,Malignant melanoma of skin of face,ethnic,Hispanic or Latino,0,9,9
438959,Amoebiasis,racial,Unknown,7,2,9
432741,Abnormal immunology finding,racial,Black or African American ,2,7,9
4176890,Male sterility,racial,Unknown,0,9,9
440438,Anodontia,racial,Black or African American ,7,2,9
78834,Effusion of joint of hand,ethnic,Hispanic or Latino,5,5,10
438931,Foreign body accidentally entering eye and adnexa,racial,White,0,9,9
439857,Parainfluenza virus pneumonia,ethnic,Hispanic or Latino,2,7,9
77630,Disease of shoulder,racial,Black or African American ,5,5,10
81711,Glenoid labrum detachment,ethnic,Not Hispanic or Latino,2,7,9
436658,Vitamin deficiency,racial,Black or African American ,9,0,9
438250,Congenital talipes varus,ethnic,Hispanic or Latino,7,2,9
23988,Hemolytic anemia due to glutathione metabolism disorder,ethnic,Not Hispanic or Latino,2,7,9
137077,Chronic osteomyelitis of the ankle and/or foot,ethnic,Hispanic or Latino,2,7,9
438917,Superficial foreign body without major open wound AND without infection,ethnic,Not Hispanic or Latino,9,0,9
438223,Sunburn of second degree,racial,Unknown,2,7,9
442256,Disorder of bursae of shoulder region,racial,American Indian or Alaska Native ,5,5,10
4245252,Raised prostate specific antigen,racial,Native Hawaiian or Other Pacific Islander ,0,9,9
434272,Varicella infection,ethnic,Not Hispanic or Latino,2,7,9
72996,"Stiff joint NEC, of the lower leg",ethnic,Hispanic or Latino,7,2,9
442862,"Abrasion or friction burn of hand, without mention of infection",racial,Black or African American ,0,9,9
261053,Pneumonia with aspergillosis,ethnic,Hispanic or Latino,0,9,9
432878,Drug abuse using speed,racial,Unknown,2,7,9
134618,Toxic diffuse goiter with thyrotoxic crisis,ethnic,Not Hispanic or Latino,9,0,9
444437,Congenital abnormality of cervix,ethnic,Not Hispanic or Latino,9,0,9
196359,Primary malignant neoplasm of uterine cervix,racial,Black or African American ,9,0,9
436314,Accidental puncture AND/OR laceration during a procedure,racial,Unknown,5,5,10
4005823,Tobacco user,racial,Filipino,0,9,9
440735,Rheumatic fever without heart involvement,racial,White,0,9,9
4046893,Lifestyle,racial,Other Race,2,7,9
437995,Closed ill-defined fractures of upper limb,racial,Asian,0,9,9
138713,Disease of parathyroid glands,ethnic,Not Hispanic or Latino,2,7,9
319049,Acute respiratory failure,racial,Black or African American ,0,9,9
198995,Type 1 diabetes mellitus - poor control,racial,Asian Indian,0,9,9
74211,Superficial injury of finger without infection,racial,Unknown,9,0,9
4305841,Periodic limb movement disorder,ethnic,Not Hispanic or Latino,2,7,9
378726,Alcoholic dementia,ethnic,Not Hispanic or Latino,0,9,9
320128,Essential hypertension,racial,European,0,9,9
436078,Malnutrition of moderate degree (Gomez: 60% to less than 75% of standard weight),ethnic,Not Hispanic or Latino,9,0,9
440649,Primary malignant neoplasm of head of pancreas,ethnic,Hispanic or Latino,0,9,9
375826,Central hearing loss,racial,American Indian or Alaska Native ,9,0,9
4068748,Coarctation of aorta NOS,racial,White,9,0,9
442601,Sedative abuse,racial,White,5,5,10
81539,Mitochondrial disease,racial,Other Race,7,2,9
201958,Perinatal dermatological disorders,ethnic,Hispanic or Latino,9,0,9
316429,Ectopics,racial,Asian,7,2,9
437292,Coloboma of optic nerve,racial,White,7,2,9
314368,Mitral stenosis with insufficiency,racial,Unknown,9,0,9
4113027,Dietary intake observations,racial,Asian,2,7,9
437530,Disorders of lipoid metabolism,racial,American Indian or Alaska Native ,9,0,9
437217,Coccidioidomycosis,ethnic,Not Hispanic or Latino,0,9,9
195588,Cystitis,racial,Native Hawaiian or Other Pacific Islander ,9,0,9
436940,Insulin resistance syndrome,racial,Filipino,0,9,9
434842,Cause of overdose - accidental,racial,White,2,7,9
81454,Injury of finger,racial,Other Race,5,5,10
192901,HSP - Hereditary spastic paraplegia,ethnic,Hispanic or Latino,0,9,9
440112,Chloasma of eyelid,racial,Unknown,7,2,9
197145,Open wound of pelvic region without complication,racial,Unknown,9,0,9
200771,Peptic ulcer without hemorrhage AND without perforation but with obstruction,racial,Unknown,2,7,9
133857,Acquired deformity of limb,racial,Other Race,0,9,9
75668,Sprain of sacroiliac region,ethnic,Hispanic or Latino,9,0,9
199764,Benign ovarian tumour,racial,Other Race,9,0,9
28179,Polyp of vocal cord or larynx,racial,White,5,5,10
321037,Cholesterol embolisation syndrome,racial,White,9,0,9
76777,Arthropathy associated with infection,ethnic,Hispanic or Latino,7,2,9
81106,Acquired genu varum,ethnic,Not Hispanic or Latino,0,9,9
201916,Ureteric stone,racial,Other Race,9,0,9
441628,Menopausal and postmenopausal disorders,racial,American Indian or Alaska Native ,9,0,9
4111255,Unspecified labyrinthitis,racial,White,5,5,10
25572,Disease of salivary gland,ethnic,Not Hispanic or Latino,7,2,9
4149547,Fracture of vertebra without spinal cord lesion,ethnic,Hispanic or Latino,0,9,9
4238673,Arthrodesis of elbow,racial,White,2,7,9
434480,Syndrome of infant of diabetic mother,ethnic,Hispanic or Latino,9,0,9
133444,Thyroiditis,racial,Unknown,9,0,9
438332,Disease of possible viral origin,racial,Asian Indian,5,5,10
380095,Lesions of nerves plexuses and roots,ethnic,Hispanic or Latino,9,0,9
437899,Acute and subacute bacterial endocarditis,racial,Unknown,7,2,9
312998,Pain in thoracic spine,racial,Asian,7,2,9
432529,"Motor vehicle traffic accident involving pedestrian dragged by motor vehicle, driver of motor vehicle injured",ethnic,Hispanic or Latino,9,0,9
200051,Primary malignant neoplasm of ovary,ethnic,Not Hispanic or Latino,9,0,9
133593,Transverse deficiency of upper limb,racial,White,0,9,9
81672,Nonallopathic lesion of thoracic region,ethnic,Hispanic or Latino,9,0,9
374336,Infantile hemiplegia,racial,White,7,2,9
437113,Asthenia,racial,Asian,2,7,9
76744,Azoospermia,racial,White,0,9,9
439672,Viral hepatitis C with coma,racial,Asian,9,0,9
317971,Respiratory system congenital anomalies,ethnic,Hispanic or Latino,7,2,9
443949,Disease type AND/OR category unknown,racial,White,2,7,9
434063,Jaw to cranial base anomaly,ethnic,Not Hispanic or Latino,2,7,9
440029,Viral disease,racial,Native Hawaiian or Other Pacific Islander ,5,5,10
4109698,Acute conjunctivitis NOS,racial,Unknown,7,2,9
76002,Mechanical complication due to breast prosthesis,ethnic,Hispanic or Latino,9,0,9
4042836,Disease of head,racial,Unknown,9,0,9
440853,Closed fracture of surgical neck of humerus,racial,Asian,9,0,9
4012570,High risk sexual behavior,racial,Other Race,9,0,9
31884,Acquired diverticulum of esophagus,ethnic,Hispanic or Latino,9,0,9
375246,Mononeuritis of upper limb,ethnic,Not Hispanic or Latino,9,0,9
436976,Posterior subcapsular polar cataract,racial,Other Race,2,7,9
435368,Congenital pigeon chest,racial,Unknown,0,9,9
4097716,"Benign neoplasm of lip, oral cavity and pharynx NOS",racial,White,0,9,9
137497,Dermatophytosis of the body,racial,Filipino,7,2,9
373654,Second degree burn of face AND/OR head,ethnic,Hispanic or Latino,2,7,9
137945,Pressure ulcer stage 2,ethnic,Not Hispanic or Latino,7,2,9
192450,Not passing urine,racial,Other Race,0,9,9
4124268,Faecal smear,ethnic,Hispanic or Latino,5,5,10
134305,Acute lymphoid leukaemia,ethnic,Not Hispanic or Latino,9,0,9
257007,Allergic rhinitis,racial,Alaska Native,0,9,9
4052837,Open wound of breast,ethnic,Hispanic or Latino,9,0,9
440990,Chorea,racial,Asian,0,9,9
436839,Closed fracture of metacarpal bone,racial,Black or African American ,0,9,9
436070,Vitamin D deficiency,racial,American Indian or Alaska Native ,9,0,9
434901,Subchronic paranoid schizophrenia with acute exacerbation,ethnic,Hispanic or Latino,9,0,9
374168,Complex febrile seizure,racial,White,5,5,10
438105,Benign tumour of mediastinum,ethnic,Hispanic or Latino,7,2,9
436097,"Nondependent mixed drug abuse, continuous",ethnic,Not Hispanic or Latino,0,9,9
28974,Candidiasis of oesophagus,ethnic,Not Hispanic or Latino,2,7,9
4303710,Infection due to Entamoeba histolytica,ethnic,Hispanic or Latino,0,9,9
4331070,Family history of polyp of colon,racial,White,7,2,9
4113650,Noninflammatory cervical disorder,ethnic,Not Hispanic or Latino,9,0,9
81723,Contusion of hand,racial,Black or African American ,5,5,10
438116,Benign neoplasm of short bones of lower limb,racial,White,5,5,10
79939,Sprain of tarsometatarsal joint AND/OR ligament,racial,Unknown,7,2,9
255334,Collagen disease,ethnic,Not Hispanic or Latino,9,0,9
28109,Carcinoma in situ of esophagus,ethnic,Hispanic or Latino,2,7,9
312622,BVO - Branch retinal occlusion,racial,Asian,0,9,9
312334,Constrictive pericarditis,ethnic,Hispanic or Latino,0,9,9
435570,Pulp and periapical tissue disease,ethnic,Not Hispanic or Latino,7,2,9
441073,Complete legal abortion,ethnic,Hispanic or Latino,9,0,9
438477,Atrophy of testis,racial,Unknown,0,9,9
201894,Acute intestinal vascular insufficiency,ethnic,Not Hispanic or Latino,2,7,9
443257,Swellings and lumps,racial,Native Hawaiian or Other Pacific Islander ,0,9,9
436381,Gender identity disorder of childhood,ethnic,Not Hispanic or Latino,5,5,10
437584,Ataxia,racial,Asian,9,0,9
380702,Cerebral cysts,racial,Unknown,7,2,9
4302252,High risk pregnancy care,racial,American Indian or Alaska Native ,9,0,9
141095,Acne,racial,Asian Indian,2,7,9
436231,Abnormal findings diagnostic imaging of liver and biliary tract,racial,Unknown,9,0,9
135496,Acute leukemia in remission,ethnic,Hispanic or Latino,2,7,9
4091532,Bowel observation,racial,Asian,2,7,9
201265,Splenic disorder,racial,Unknown,5,5,10
441712,Open wound of ocular adnexa,racial,White,2,7,9
4070287,Preauricular sinus and fistula,racial,Unknown,2,7,9
438630,Exposure to radiation,racial,White,9,0,9
257010,Abscess of lung,racial,White,0,9,9
444283,Superficial foreign body of hand without major open wound AND without infection,racial,Unknown,9,0,9
433811,Hydronephrosis,racial,Black or African American ,7,2,9
196160,Fistula of intestine,ethnic,Hispanic or Latino,9,0,9
4108242,Atrial fibrillation and flutter NOS,racial,White,0,9,9
436398,Glaucoma associated with ocular disorder,racial,Asian,9,0,9
81723,Contusion of hand,racial,Asian,2,7,9
434323,Disorder of sulphur-bearing amino acid metabolism,ethnic,Not Hispanic or Latino,5,5,10
73866,Congenital anomaly of breast,racial,Unknown,9,0,9
194589,Primary malignant neoplasm of biliary tract,racial,Black or African American ,9,0,9
434153,Chromosomopathy,racial,Black or African American ,0,9,9
436336,Herpes zoster with nervous system complication,racial,Asian,2,7,9
437292,Coloboma of optic nerve,ethnic,Hispanic or Latino,7,2,9
4077577,Moderate recurrent major depression,racial,Black or African American ,0,9,9
377877,Convergent squint,racial,Black or African American ,2,7,9
375519,Alcohol withdrawal syndrome,racial,Unknown,0,9,9
76506,Effusion of joint of lower leg,racial,Black or African American ,2,7,9
141305,Unilateral sensorineural hearing loss with unrestricted hearing on the contralateral side,ethnic,Not Hispanic or Latino,7,2,9
134452,Miners' elbow,ethnic,Not Hispanic or Latino,2,7,9
432632,Noninfectious secondary iridocyclitis,racial,Unknown,7,2,9
136516,Congenital pes planus,racial,Black or African American ,7,2,9
4303710,Infection due to Entamoeba histolytica,racial,Unknown,0,9,9
135360,Fainting,racial,American Indian or Alaska Native ,7,2,9
433758,Childhood emotional disorder,racial,White,0,9,9
436265,Open wound of multiple sites of one lower limb AND thigh without complication,ethnic,Not Hispanic or Latino,2,7,9
141663,Osteomyelitis,racial,Other Race,9,0,9
193874,Bed wetting,racial,Other Race,5,5,10
440085,Schizoid personality disorder,ethnic,Not Hispanic or Latino,0,9,9
313867,Double outlet right ventricle,ethnic,Not Hispanic or Latino,9,0,9
432354,Chronic duodenal ulcer with perforation but without obstruction,ethnic,Hispanic or Latino,0,9,9
313791,Bundle branch block,racial,White,0,9,9
441177,Second degree burn of upper limb,ethnic,Not Hispanic or Latino,0,9,9
200837,Congenital anomaly of fixation of intestine,ethnic,Hispanic or Latino,7,2,9
435170,Effects of thirst,racial,White,9,0,9
443936,Microglossia,ethnic,Not Hispanic or Latino,9,0,9
316137,Phlebitis and/or thrombophlebitis of iliac vein,racial,Unknown,9,0,9
133303,Congenital anomaly of mouth,racial,White,0,9,9
440973,Benign neoplasm of long bones of lower limb,ethnic,Hispanic or Latino,0,9,9
30163,Cellulitis and abscess of neck,racial,Other Race,2,7,9
444253,Blister of scalp without infection,racial,White,2,7,9
201916,Ureteric stone,racial,Unknown,5,5,10
433197,PXF - Pseudoexfoliation of lens capsule,racial,Unknown,0,9,9
134736,Backache,racial,Filipino,2,7,9
4295261,Postmenopausal state,racial,Other Race,9,0,9
436001,Emotional abuse of adult,racial,White,9,0,9
132573,Benign neoplasm of floor of mouth,ethnic,Hispanic or Latino,2,7,9
27419,Open wound of neck without complication,racial,White,2,7,9
439439,Injury of unknown intent by cutting instrument,racial,White,0,9,9
440213,Consciousness and/or awareness finding,ethnic,Hispanic or Latino,5,5,10
437470,Adverse reaction to benzodiazepine-based tranquilliser,ethnic,Hispanic or Latino,9,0,9
437046,Complete abortion,racial,Black or African American ,9,0,9
435522,Hypervitaminosis D,racial,White,9,0,9
79126,Polysyndactyly,ethnic,Hispanic or Latino,0,9,9
434465,Nonallopathic lesion of rib cage,racial,Unknown,7,2,9
443887,Superficial foreign body of ankle without major open wound AND without infection,racial,Unknown,0,9,9
4066376,Pilonidal sinus with abscess,racial,Native Hawaiian or Other Pacific Islander ,9,0,9
441039,Phlebitis of lower limb vein,racial,Black or African American ,0,9,9
432236,Tuberculosis of peripheral lymph nodes,racial,Asian,9,0,9
443564,Malignant neoplasm of bone,racial,Unknown,0,9,9
23808,"Chronic peptic ulcer without hemorrhage, without perforation AND without obstruction",ethnic,Hispanic or Latino,5,5,10
372599,Severe mixed bipolar I disorder without psychotic features,racial,Unknown,9,0,9
373474,Seeing double,racial,Asian,7,2,9
135473,Dermatophytosis,racial,Filipino,7,2,9
438409,Attention deficit hyperactivity disorder,racial,Filipino,0,9,9
442530,Broken tooth injury with complication,racial,White,7,2,9
4340379,Hepatitis B carrier,racial,American Indian or Alaska Native ,9,0,9
4068748,Coarctation of aorta NOS,ethnic,Hispanic or Latino,9,0,9
195012,Metrorrhagia,racial,Black or African American ,9,0,9
78771,Labyrinthine dysfunction,racial,White,9,0,9
438855,Klinefelter's syndrome,racial,White,0,9,9
4087420,Other specified miliary tuberculosis,ethnic,Hispanic or Latino,9,0,9
435925,Very premature - less than 1000g or less than 28 weeks,racial,White,7,2,9
76725,Fissure in ano,racial,Black or African American ,2,7,9
436651,Hodgkin's disease of extranodal AND/OR solid organ site,racial,Other Race,0,9,9
441385,Corrected transposition of great vessels,racial,Unknown,9,0,9
317299,Disorder of vitreous body,ethnic,Hispanic or Latino,5,5,10
4071485,Foetus or neonate affected by caesarean section,racial,Unknown,9,0,9
377910,Deviated nasal septum,racial,Asian,0,9,9
23868,Congenital anomaly of esophagus,racial,White,5,5,10
319049,Acute respiratory failure,racial,Other Race,7,2,9
138388,Secondary hyperparathyroidism,racial,Unknown,9,0,9
4152813,Family disruption,racial,Other Race,0,9,9
4112003,Hypotension NOS,racial,White,2,7,9
438699,Primary malignant neoplasm of rectosigmoid junction,ethnic,Not Hispanic or Latino,0,9,9
73723,Benign tumour of epididymis,ethnic,Hispanic or Latino,0,9,9
442942,"Crush injury, toe(s)",racial,White,7,2,9
199064,Chronic vascular insufficiency of intestine,racial,White,9,0,9
434942,Postseptal orbital cellulitis,racial,Unknown,7,2,9
432803,[X]Fall on and from ladder,ethnic,Not Hispanic or Latino,0,9,9
376229,Abnormal involuntary movement,racial,American Indian or Alaska Native ,7,2,9
438855,Klinefelter's syndrome,racial,Black or African American ,0,9,9
433813,Bladder neck obstruction,ethnic,Hispanic or Latino,7,2,9
134248,Second degree burn of thumb,ethnic,Hispanic or Latino,2,7,9
80197,Poliomyelitis osteopathy of multiple sites,ethnic,Hispanic or Latino,0,9,9
437167,Accident caused by firearm missile,racial,White,0,9,9
196991,Chronic renal disease,racial,American Indian,9,0,9
194984,Hepatopathy,racial,Other Race,7,2,9
196325,Protozoal intestinal disease,racial,White,0,9,9
433195,Transient arterial retinal occlusion,racial,White,9,0,9
137951,Acquired keratoderma,racial,Black or African American ,0,9,9
141955,Pectus excavatum,racial,Unknown,2,7,9
138641,Foreign body in tracheobronchial tree,racial,Other Race,9,0,9
75580,Chronic ulcerative proctitis,ethnic,Not Hispanic or Latino,9,0,9
439918,Poliomyelitis osteopathy of the ankle and/or foot,racial,White,9,0,9
433758,Childhood emotional disorder,ethnic,Hispanic or Latino,0,9,9
198475,Gallstone ileus,racial,White,5,5,10
433514,Abnormal hard tissue formation in pulp,racial,Black or African American ,0,9,9
435207,"Nodular lymphoma of lymph nodes of head, face and neck",racial,Unknown,7,2,9
194092,Uterine prolapse without vaginal wall prolapse,racial,Other Race,9,0,9
438172,Atrial septal defect as current complication following acute myocardial infarction,racial,Unknown,9,0,9
444028,Open wound of alveolar process without complication,ethnic,Hispanic or Latino,5,5,10
199877,Mucous polyp of cervix,racial,Filipino,9,0,9
433454,Adjustment disorder with mixed emotional features,racial,Asian,9,0,9
75128,Injury of chest wall,racial,Unknown,5,5,10
200660,Reticulosarcoma of lymph nodes of inguinal region and lower limb,ethnic,Hispanic or Latino,9,0,9
436245,Atypical glandular cells on vaginal Papanicolaou smear,racial,Other Race,9,0,9
437557,Eczematous dermatitis of eyelid,racial,Unknown,5,5,10
75091,Closed fracture of carpal bone,racial,American Indian,9,0,9
437537,Shyness disorder of childhood,racial,Unknown,0,9,9
138592,Open wound of lip with complication,ethnic,Hispanic or Latino,7,2,9
4238673,Arthrodesis of elbow,ethnic,Hispanic or Latino,2,7,9
134736,Backache,racial,Asian Indian,0,9,9
372616,Werdnig-Hoffmann disease,racial,White,9,0,9
377001,Unruptured cerebral aneurysm,racial,Black or African American ,0,9,9
316137,Phlebitis and/or thrombophlebitis of iliac vein,ethnic,Hispanic or Latino,9,0,9
193155,Carcinoid tumour of large intestine,ethnic,Hispanic or Latino,9,0,9
316535,Closed fracture of dorsal vertebra without spinal cord injury,ethnic,Not Hispanic or Latino,7,2,9
440820,Contracture of wrist joint,ethnic,Hispanic or Latino,7,2,9
440916,Burn to wrist/hand - blister,ethnic,Not Hispanic or Latino,9,0,9
443747,Acute laryngotracheitis without obstruction,racial,White,0,9,9
198683,Viral hepatitis B without hepatic coma,racial,Black or African American ,9,0,9
80249,Sprain of acromioclavicular ligament,racial,Unknown,9,0,9
318448,"Incomplete atrioventricular block, second degree",racial,White,2,7,9
433740,Immunodeficiency disorder,racial,Other Race,9,0,9
374924,Generalized convulsive epilepsy,racial,American Indian or Alaska Native ,0,9,9
435644,Metatarsal bone fracture,racial,White,5,5,10
4331070,Family history of polyp of colon,racial,Other Race,0,9,9
441919,Twin pregnancy,ethnic,Hispanic or Latino,9,0,9
438931,Foreign body accidentally entering eye and adnexa,ethnic,Hispanic or Latino,0,9,9
443269,Elderly primiparous with labor,racial,White,9,0,9
194410,Male genital organ disorder associated with another disorder,racial,White,0,9,9
79833,Meniere's disease,racial,Native Hawaiian or Other Pacific Islander ,9,0,9
4112534,Chronic laryngitis and laryngotracheitis,racial,Unknown,0,9,9
432968,Anemia during pregnancy - baby delivered,racial,White,9,0,9
313011,Congenital abnormality of cardiac position,ethnic,Not Hispanic or Latino,0,9,9
4062495,Glaucoma screening,racial,American Indian or Alaska Native ,9,0,9
4284118,Fall on escalator,ethnic,Hispanic or Latino,5,5,10
194683,Obstructed umbilical hernia,ethnic,Not Hispanic or Latino,9,0,9
4139420,Foreign body in auditory canal,racial,Asian,7,2,9
78524,Acquired deformity of finger,ethnic,Not Hispanic or Latino,7,2,9
381573,Acute mastoiditis without complications,racial,White,9,0,9
31120,Congenital anomaly of upper alimentary tract,racial,White,2,7,9
4166080,Decompression of median nerve,ethnic,Not Hispanic or Latino,5,5,10
437833,Hypokalaemia,racial,Asian,9,0,9
75046,Old bucket handle tear of medial meniscus,racial,Unknown,0,9,9
4239069,Closed fracture of metacarpal bone,ethnic,Hispanic or Latino,0,9,9
438546,Congenital anomaly of anterior chamber of eye,ethnic,Hispanic or Latino,5,5,10
373175,Organic hallucinosis,ethnic,Hispanic or Latino,7,2,9
317248,Disorder of hematopoietic structure,racial,Asian,7,2,9
4090255,Colloid bodies in retina,racial,Unknown,9,0,9
200219,Abdominal pain,racial,American Indian,7,2,9
442011,Mechanical complication due to cardiac pacemaker electrode,racial,Asian,0,9,9
198483,Stricture or atresia of the vagina,ethnic,Hispanic or Latino,9,0,9
77317,Chronic ulcerative rectosigmoiditis,racial,White,9,0,9
374906,Cerebral lipidosis,ethnic,Hispanic or Latino,9,0,9
432870,Thrombocytopenia,racial,Black or African American ,0,9,9
380397,Keratoconjunctivitis,ethnic,Not Hispanic or Latino,9,0,9
438887,Closed fracture shaft of femur,racial,White,2,7,9
438630,Exposure to radiation,ethnic,Not Hispanic or Latino,9,0,9
435636,Juvenile osteochondritis of hip AND/OR pelvis,ethnic,Hispanic or Latino,0,9,9
132553,Herpangina,racial,Asian,7,2,9
199860,Hernia of abdominal cavity,racial,Asian,0,9,9
79127,Congenital spondylolisthesis,racial,Other Race,9,0,9
135360,Fainting,racial,Native Hawaiian or Other Pacific Islander ,9,0,9
4140207,Nephrosclerosis,racial,White,5,5,10
4008683,Anxiety neurosis,ethnic,Not Hispanic or Latino,9,0,9
253321,Stridor,racial,Asian,0,9,9
201355,Erosion and ectropion of the cervix,racial,White,7,2,9
81671,Unilateral congenital dislocation of hip,ethnic,Not Hispanic or Latino,9,0,9
194001,Abnormality of secretion of gastrin,racial,White,0,9,9
4145796,Family history: Musculoskeletal disease,ethnic,Not Hispanic or Latino,5,5,10
78232,Shoulder joint pain,racial,Filipino,9,0,9
435959,Subarachnoid hemorrhage following injury without open intracranial wound,racial,White,5,5,10
75337,Cellulitis and abscess of buttock,racial,Asian,5,5,10
4053378,FH: Blood disorder,ethnic,Not Hispanic or Latino,9,0,9
27419,Open wound of neck without complication,ethnic,Hispanic or Latino,2,7,9
4182210,Dementia,racial,Unknown,9,0,9
4215003,Myasthenic crisis,ethnic,Hispanic or Latino,9,0,9
4109691,Persistent alcohol abuse,racial,White,2,7,9
4058497,"Contusion, shoulder or upper arm",racial,Unknown,9,0,9
193809,Melena due to gastrointestinal hemorrhage,racial,American Indian or Alaska Native ,9,0,9
141216,MC - Molluscum contagiosum,racial,Other Race,5,5,10
380093,Episodic cluster headache,racial,White,7,2,9
196738,Male genital organ disease,racial,Black or African American ,0,9,9
4014231,Foot sprain NOS,racial,Asian,9,0,9
137792,Kaposi's varicelliform eruption,racial,Asian,9,0,9
443936,Microglossia,racial,White,9,0,9
197781,Shigella sonnei (group D),ethnic,Hispanic or Latino,2,7,9
79072,Inflammatory disorder of breast,racial,Asian,9,0,9
194175,Left upper quadrant pain,racial,Asian,9,0,9
442774,Intermittent claudication,racial,American Indian or Alaska Native ,0,9,9
439770,Ketoacidosis in type I diabetes mellitus,racial,Unknown,2,7,9
440358,Lipoma,racial,Native Hawaiian or Other Pacific Islander ,0,9,9
4005933,Urethral meatus underneath penis,racial,Asian,0,9,9
80070,Uric acid urolithiasis,racial,White,0,9,9
4177966,Kaposi's sarcoma,racial,White,0,9,9
194710,Placenta previa without hemorrhage,racial,Unknown,9,0,9
380403,External hordeolum,racial,Asian,7,2,9
441974,Closed fracture of forearm,racial,Asian,9,0,9
433985,Hypercarotinemia,racial,Black or African American ,2,7,9
433585,Klippel-Feil sequence,ethnic,Not Hispanic or Latino,2,7,9
78560,Congenital deformity and malformation of feet and toes,racial,Unknown,5,5,10
381304,Impulsive acoustic trauma,ethnic,Hispanic or Latino,2,7,9
23868,Congenital anomaly of esophagus,ethnic,Hispanic or Latino,5,5,10
433514,Abnormal hard tissue formation in pulp,ethnic,Not Hispanic or Latino,0,9,9
4185471,Disorder of pigmentation,racial,Asian,5,5,10
4098600,Gouty nephropathy unspecified,racial,White,9,0,9
432517,Posttraumatic wound infection,racial,Asian,2,7,9
73045,Hand sprain,racial,Other Race,7,2,9
442584,Carbuncle of buttock,racial,Black or African American ,0,9,9
433495,"Conductive hearing loss, bilateral",racial,Unknown,9,0,9
438138,Paralytic syndromes,racial,White,9,0,9
78529,Kyphoscoliosis and scoliosis,racial,Filipino,9,0,9
4058399,Placenta praevia without haemorrhage unspecified,racial,White,9,0,9
434203,Late effect of contusion,racial,Unknown,2,7,9
78518,Observation of shoulder joint,ethnic,Not Hispanic or Latino,7,2,9
77178,Contusion of multiple sites of upper limb,ethnic,Hispanic or Latino,7,2,9
195876,Hematometra,racial,White,0,9,9
380421,Tympanic membrane marginal perforation,racial,Unknown,0,9,9
199192,Abrasion AND/OR friction burn of trunk without infection,racial,Unknown,2,7,9
138346,Erysipelas,ethnic,Hispanic or Latino,9,0,9
380394,Idiopathic progressive polyneuropathy,racial,Unknown,0,9,9
201313,Hypertensive renal disease,racial,Other Race,9,0,9
432621,Purulent endophthalmitis,racial,White,5,5,10
257010,Abscess of lung,ethnic,Hispanic or Latino,2,7,9
73649,Contusion of finger,racial,Other Race,9,0,9
201045,Thrombosed external haemorrhoids,ethnic,Not Hispanic or Latino,7,2,9
4169009,FH: CVA,ethnic,Hispanic or Latino,7,2,9
440990,Chorea,ethnic,Not Hispanic or Latino,0,9,9
440938,Infection by Shigella,racial,White,9,0,9
40389850,"Neoplasm of uncertain behaviour of stomach, intestines and rectum",ethnic,Hispanic or Latino,0,9,9
72990,Localised osteoarthrosis uncertain if primary OR secondary,ethnic,Not Hispanic or Latino,5,5,10
195596,Chronic pancreatitis,racial,American Indian or Alaska Native ,9,0,9
440787,"Drug dependence in mother complicating pregnancy, childbirth AND/OR puerperium",ethnic,Hispanic or Latino,7,2,9
435792,Drug-induced sleep disorder,ethnic,Not Hispanic or Latino,9,0,9
377539,Syringomyelia and syringobulbia,racial,Unknown,9,0,9
436837,Closed fracture of neck of radius,racial,Unknown,9,0,9
4164222,Tendon contracture,ethnic,Not Hispanic or Latino,2,7,9
432436,Symbolic dysfunction,racial,White,5,5,10
316995,Coronary occlusion,ethnic,Not Hispanic or Latino,5,5,10
24660,Acute tonsillitis,racial,American Indian or Alaska Native ,5,5,10
4232212,Hypoglycemic shock,racial,White,0,9,9
435783,Schizophrenia,racial,Filipino,9,0,9
260034,Chronic pulmonary coccidioidomycosis,racial,Unknown,0,9,9
201129,Newborn swallowing maternal blood causing hematemesis or melena,racial,Unknown,5,5,10
74174,Urinary symptoms,racial,White,9,0,9
4104388,"Better eye: moderate visual impairment, Lesser eye: near total visual impairment",ethnic,Hispanic or Latino,0,9,9
374384,Cerebral ischemia,ethnic,Hispanic or Latino,0,9,9
440638,Lyme disease,racial,White,7,2,9
4096657,Toxic multinodular goitre NOS,ethnic,Hispanic or Latino,9,0,9
138388,Secondary hyperparathyroidism,racial,White,7,2,9
194700,"Diabetes mellitus in mother complicating pregnancy, childbirth AND/OR puerperium",racial,Asian,9,0,9
197320,ARF - Acute renal failure,racial,Native Hawaiian or Other Pacific Islander ,0,9,9
139057,Disease of oral soft tissues,racial,Other Race,5,5,10
133685,Salmonellosis,racial,Unknown,9,0,9
78621,Crushing injury of knee,racial,Unknown,9,0,9
435237,Reactive psychoses,racial,White,9,0,9
376971,Retinal tear,ethnic,Hispanic or Latino,5,5,10
441260,Drug withdrawal syndrome,racial,Other Race,2,7,9
436651,Hodgkin's disease of extranodal AND/OR solid organ site,racial,Unknown,7,2,9
253234,Upper respiratory inflammation due to fumes AND/OR vapors,racial,White,9,0,9
376104,Posttraumatic headache,ethnic,Not Hispanic or Latino,7,2,9
135611,Furuncle of hand,racial,White,9,0,9
140823,Acquired musculoskeletal deformity,ethnic,Hispanic or Latino,7,2,9
375806,Idiopathic peripheral neuropathy,racial,Native Hawaiian or Other Pacific Islander ,2,7,9
437082,Marie-Strumpell spondylitis,racial,Asian,9,0,9
441077,Stenosis of cervix,ethnic,Not Hispanic or Latino,9,0,9
72995,Joint contracture of hand,racial,Other Race,0,9,9
72737,Microcalcifications of the breast,racial,Other Race,9,0,9
438204,Edema or excessive weight gain in pregnancy without mention of hypertension,racial,White,9,0,9
437943,Pulp abscess of finger,ethnic,Not Hispanic or Latino,0,9,9
439707,Folie a deux,racial,Unknown,9,0,9
81983,Multiple dislocations,ethnic,Hispanic or Latino,7,2,9
4010838,Increased body growth,racial,White,2,7,9
4077382,Familial lipoprotein lipase deficiency,racial,Unknown,5,5,10
193326,Urge incontinence of urine,racial,Native Hawaiian or Other Pacific Islander ,9,0,9
4180783,Malignant tumour of lingual tonsil,ethnic,Hispanic or Latino,9,0,9
133414,Candidiasis of skin and nails,racial,Other Race,7,2,9
314666,Healed coronary,racial,Native Hawaiian or Other Pacific Islander ,7,2,9
4121123,Haemophagocytic lymphohistiocytosis,ethnic,Hispanic or Latino,9,0,9
441737,Bruising,racial,Native Hawaiian or Other Pacific Islander ,0,9,9
433752,Impulse control disorder,racial,Other Race,9,0,9
134118,Atrophic condition of skin,racial,Filipino,9,0,9
78834,Effusion of joint of hand,racial,White,7,2,9
377572,Noise effect on inner ear,ethnic,Hispanic or Latino,7,2,9
194395,Bleeding diverticulosis,ethnic,Not Hispanic or Latino,9,0,9
444384,Nonvenomous insect bite of leg with infection,racial,Unknown,2,7,9
435216,Disorder associated with type I diabetes mellitus,racial,Asian,0,9,9
4113102,Amputated at hip,ethnic,Hispanic or Latino,9,0,9
380055,Primary malignant neoplasm of brain,racial,Other Race,0,9,9
73574,Nonunion of fracture,ethnic,Hispanic or Latino,0,9,9
4090550,Evening colic,racial,Unknown,7,2,9
443260,Umbilical lump,racial,Other Race,9,0,9
439857,Parainfluenza virus pneumonia,racial,White,2,7,9
80495,Palindromic rheumatism of the pelvic region and thigh,racial,Black or African American ,9,0,9
434900,Drug-induced psychosis,racial,White,9,0,9
436176,Spontaneous abortion without complication,racial,Black or African American ,9,0,9
434926,Iridocyclitis,racial,Unknown,5,5,10
134386,Gingival recession,racial,Unknown,5,5,10
435696,Early trauma complications,racial,White,5,5,10
141508,Dermatophytosis of scalp or beard,racial,Other Race,2,7,9
136773,Rosacea,racial,Other Race,9,0,9
74114,Cellulitis and abscess of foot excluding toe,racial,Filipino,0,9,9
78200,Benign mammary dysplasia,racial,Black or African American ,9,0,9
320835,TOF - Tetralogy of Fallot,racial,Other Race,9,0,9
435661,Closed orbital blow-out fracture,ethnic,Hispanic or Latino,0,9,9
4296611,Chronic gastric ulcer without hemorrhage AND without perforation,ethnic,Hispanic or Latino,9,0,9
198062,"Infectious colitis, enteritis and gastroenteritis",racial,Other Race,9,0,9
432860,Benign tumor of epipharynx,racial,White,9,0,9
432695,Post-term pregnancy,racial,Unknown,9,0,9
439695,Hypertensive heart and renal disease with renal failure,ethnic,Not Hispanic or Latino,5,5,10
196473,Hypertrophy of uterus,racial,Black or African American ,9,0,9
4103723,Other refraction and accommodation disorders,ethnic,Not Hispanic or Latino,9,0,9
4064206,O/E - tuning fork testing,racial,White,7,2,9
376224,Spina bifida without hydrocephalus,racial,Other Race,9,0,9
4109544,"Total, mature senile cataract",racial,Unknown,9,0,9
77030,Disease of breast,racial,Native Hawaiian or Other Pacific Islander ,9,0,9
433716,Primary malignant neoplasm of testis,racial,White,0,9,9
435299,Failure of dental prosthesis,ethnic,Hispanic or Latino,9,0,9
194589,Primary malignant neoplasm of biliary tract,ethnic,Not Hispanic or Latino,9,0,9
372646,"Peripheral pterygium, stationary",racial,White,7,2,9
78234,Arthralgia of the hand,racial,Filipino,0,9,9
434626,Borderline personality disorder,ethnic,Hispanic or Latino,9,0,9
4100382,Acute hysterical psychosis,racial,Unknown,7,2,9
434752,Positive serological AND/OR viral culture findings for human immunodeficiency virus,racial,American Indian or Alaska Native ,5,5,10
132391,Furuncle of face,racial,Unknown,0,9,9
315361,Orthopnea,ethnic,Not Hispanic or Latino,9,0,9
441351,Early onset of delivery - delivered,ethnic,Not Hispanic or Latino,5,5,10
72487,Crush injury of foot,ethnic,Hispanic or Latino,9,0,9
435380,Closed fracture of radius AND ulna,racial,Unknown,7,2,9
437489,Herpes zoster with complication,racial,White,2,7,9
4008573,Advanced open-angle glaucoma,racial,Unknown,9,0,9
28714,Syndrome of diencephalo-hypophyseal origin,racial,American Indian or Alaska Native ,9,0,9
200524,Perinatal digestive system disorders,racial,White,0,9,9
314379,First degree atrioventricular block,racial,Black or African American ,2,7,9
312334,Constrictive pericarditis,racial,White,0,9,9
134736,Backache,racial,American Indian,9,0,9
434885,Benign neoplasm of skull and facial bones,racial,Unknown,5,5,10
135923,CP - Cleft palate,racial,Unknown,2,7,9
437374,Neonatal aspiration of meconium,ethnic,Hispanic or Latino,7,2,9
75373,Open fracture of head of radius,ethnic,Not Hispanic or Latino,9,0,9
194683,Obstructed umbilical hernia,racial,American Indian or Alaska Native ,9,0,9
378741,Brachial plexus lesion,racial,Other Race,0,9,9
137627,Prickly heat,racial,Other Race,7,2,9
372924,Cerebral arterial occlusion,racial,Unknown,9,0,9
198465,"Megacolon, not Hirschsprung's",ethnic,Hispanic or Latino,0,9,9
4091928,Chronic leukemia NOS,racial,White,9,0,9
4064375,Iron deficiency screening,racial,Asian Indian,5,5,10
440695,Encopresis,ethnic,Not Hispanic or Latino,0,9,9
200845,Urinary precipitancy,racial,Filipino,9,0,9
321587,Bilateral bundle branch block,racial,Unknown,5,5,10
442598,Fracture of radius AND ulna,racial,Unknown,9,0,9
195453,"Colitis, enteritis and gastroenteritis presumed infectious",racial,Black or African American ,9,0,9
380707,Distortion of visual image,ethnic,Hispanic or Latino,9,0,9
79938,Closed fracture of scapula,racial,Unknown,9,0,9
433071,Contusion of multiple sites,racial,Other Race,7,2,9
79873,Urolith,racial,Other Race,7,2,9
138913,Second degree burn of two OR more fingers including thumb,racial,White,0,9,9
435959,Subarachnoid hemorrhage following injury without open intracranial wound,ethnic,Hispanic or Latino,5,5,10
435081,Abnormal findings on diagnostic imaging of heart and coronary circulation,racial,Unknown,2,7,9
433736,Obesity,racial,Alaska Native,2,7,9
40480431,Speech and language developmental delay due to hearing loss,racial,Asian,0,9,9
40389850,"Neoplasm of uncertain behaviour of stomach, intestines and rectum",racial,White,0,9,9
440853,Closed fracture of surgical neck of humerus,ethnic,Not Hispanic or Latino,9,0,9
78243,Congenital spondylolysis of lumbosacral region,racial,Unknown,0,9,9
437390,Hypoxaemia,racial,Other Race,5,5,10
136262,Open wound of forehead with complication,racial,White,0,9,9
377539,Syringomyelia and syringobulbia,ethnic,Hispanic or Latino,9,0,9
374941,Retained foreign body of eyelid,ethnic,Hispanic or Latino,9,0,9
194001,Abnormality of secretion of gastrin,ethnic,Hispanic or Latino,0,9,9
441049,Enamel caries,ethnic,Hispanic or Latino,7,2,9
434891,Hypersomnia disorder related to a known organic factor,ethnic,Hispanic or Latino,9,0,9
432345,Hypertrophy of tongue papillae,racial,White,7,2,9
4065355,Urticaria due to cold and heat,ethnic,Not Hispanic or Latino,9,0,9
74451,Palindromic rheumatism of the forearm,racial,Black or African American ,0,9,9
437828,Disorder of calcium metabolism,ethnic,Not Hispanic or Latino,2,7,9
259153,Throat soreness,racial,American Indian,9,0,9
442427,Cervical post-laminectomy syndrome,ethnic,Hispanic or Latino,0,9,9
315523,Hemoglobin S-F disease,ethnic,Hispanic or Latino,7,2,9
4058497,"Contusion, shoulder or upper arm",ethnic,Hispanic or Latino,9,0,9
196515,Congenital chordee,racial,White,0,9,9
4145004,Osteoarthritis of spine NOS,ethnic,Hispanic or Latino,5,5,10
434203,Late effect of contusion,ethnic,Hispanic or Latino,2,7,9
136262,Open wound of forehead with complication,ethnic,Hispanic or Latino,0,9,9
80552,Closed fracture of the scaphoid,racial,Other Race,0,9,9
433934,Accident caused by needle,racial,Unknown,7,2,9
441969,Radiology result abnormal,racial,Asian,7,2,9
434893,Selective IgM immunodeficiency,racial,Other Race,9,0,9
435783,Schizophrenia,racial,American Indian,0,9,9
30234,Cervical sprain,racial,Filipino,0,9,9
138239,Observation of limb structure,racial,Other Race,2,7,9
201072,Benign prostatic hypertrophy without outflow obstruction,racial,Asian,0,9,9
136915,Primary malignant neoplasm of skin of lip,racial,Unknown,0,9,9
443111,Tenosynovitis of foot,racial,Unknown,5,5,10
24978,Chronic adenotonsillitis,ethnic,Not Hispanic or Latino,0,9,9
438527,"Juvenile osteochondrosis of lower extremity, excluding foot",racial,Black or African American ,7,2,9
4060985,BMI 30+ - obesity,racial,Middle Eastern or North African,9,0,9
314059,Right bundle branch block,racial,American Indian or Alaska Native ,9,0,9
132573,Benign neoplasm of floor of mouth,racial,White,2,7,9
441408,Vomiting,racial,American Indian,9,0,9
80880,Open wound of foot except toes with tendon involvement,racial,White,7,2,9
436398,Glaucoma associated with ocular disorder,ethnic,Not Hispanic or Latino,9,0,9
193252,Diverticulosis of small intestine,racial,Unknown,9,0,9
441897,Chronic duodenal ileus,ethnic,Hispanic or Latino,9,0,9
138813,Early or threatened labour,racial,White,9,0,9
199958,Open wound of hip AND thigh without complication,racial,Unknown,5,5,10
193814,Chronic parametritis and pelvic cellulitis,racial,Unknown,9,0,9
442325,Furuncle of foot,racial,White,0,9,9
444258,Abrasion AND/OR friction burn of neck with infection,ethnic,Hispanic or Latino,5,5,10
77987,Respiratory observations of chest,racial,Black or African American ,2,7,9
138387,Thyrotoxicosis,racial,Unknown,9,0,9
196328,Enteric paratyphosis,racial,Unknown,2,7,9
441191,Poisoning by arthropod,racial,White,9,0,9
135615,Pityriasis,racial,Black or African American ,5,5,10
196214,Congenital disorder of gallbladder and biliary tract,ethnic,Hispanic or Latino,9,0,9
73843,Synovial cyst of popliteal space,racial,Asian,9,0,9
23799,Pharynx or nasopharynx oedema,ethnic,Hispanic or Latino,9,0,9
372424,Congenital anolmaly of eye,ethnic,Not Hispanic or Latino,2,7,9
4324124,Peritoneal dialysis,racial,White,7,2,9
381664,Algoneurodystrophy,ethnic,Hispanic or Latino,7,2,9
4108242,Atrial fibrillation and flutter NOS,racial,Unknown,7,2,9
432738,Iceland disease,racial,Other Race,7,2,9
432458,Closed fracture of C1-C4 level with spinal cord injury,ethnic,Hispanic or Latino,0,9,9
437992,Abnormal results of kidney function studies,racial,Asian,7,2,9
380834,Coma,ethnic,Not Hispanic or Latino,0,9,9
4146239,Pruritus of genital organs,racial,Asian,9,0,9
194703,Leucoplakia of vagina,ethnic,Hispanic or Latino,9,0,9
72434,Congenital hydrocele,ethnic,Hispanic or Latino,0,9,9
196523,Diarrhea,racial,Native Hawaiian or Other Pacific Islander ,7,2,9
4108055,Other forms of retinal detachment,ethnic,Hispanic or Latino,5,5,10
136497,Scar conditions and fibrosis of skin,racial,Unknown,7,2,9
80197,Poliomyelitis osteopathy of multiple sites,racial,Other Race,0,9,9
4143350,Other deficiency anaemias,ethnic,Hispanic or Latino,7,2,9
436659,Iron deficiency anaemia,racial,Filipino,9,0,9
439176,Closed traumatic dislocation of metacarpophalangeal joint of finger,racial,White,9,0,9
194996,Postoperative urethral stricture,racial,Unknown,0,9,9
443115,Closed fracture finger proximal phalanx,racial,Black or African American ,5,5,10
434887,Disorders of bilirubin excretion,racial,Other Race,5,5,10
436672,Disorder of copper metabolism,ethnic,Hispanic or Latino,9,0,9
433471,Retinal neovascularization,racial,White,2,7,9
74104,Fetal condition affecting obstetrical care of mother,racial,Unknown,9,0,9
312938,Hypertensive encephalopathy,racial,White,0,9,9
435522,Hypervitaminosis D,ethnic,Hispanic or Latino,9,0,9
312622,BVO - Branch retinal occlusion,racial,Unknown,5,5,10
440558,Closed dislocation of interphalangeal joint of finger,racial,White,0,9,9
193874,Bed wetting,racial,Asian,7,2,9
193251,Umbilical hernia without obstruction AND without gangrene,racial,American Indian or Alaska Native ,0,9,9
198289,Nonvenomous insect bite of hip without infection,ethnic,Not Hispanic or Latino,9,0,9
196175,Congenital OR acquired abnormality of cervix affecting pregnancy,ethnic,Hispanic or Latino,9,0,9
435570,Pulp and periapical tissue disease,racial,Asian,7,2,9
79109,Climacteric arthritis,racial,Unknown,9,0,9
4103679,Percutaneous transluminal angioscopy,ethnic,Hispanic or Latino,2,7,9
438047,Contusion of orbital tissues,ethnic,Hispanic or Latino,0,9,9
441963,Prader-Willi syndrome,racial,Other Race,5,5,10
192276,Chronic gouty nephropathy,racial,White,7,2,9
75099,Coccyx sprain,racial,Unknown,9,0,9
194412,Dysplasia of vagina,ethnic,Hispanic or Latino,9,0,9
435151,Physical child abuse,racial,Black or African American ,2,7,9
380375,Organic personality disorder,ethnic,Hispanic or Latino,2,7,9
438391,Amino acid transport disorder,ethnic,Hispanic or Latino,7,2,9
4062495,Glaucoma screening,racial,Native Hawaiian or Other Pacific Islander ,5,5,10
80571,Open wound of foot with complication,racial,White,5,5,10
193522,Acute prostatitis,racial,American Indian or Alaska Native ,0,9,9
380834,Coma,racial,Other Race,9,0,9
441962,Congenital bowing of tibia and/or fibula,racial,White,5,5,10
4149455,Baby birth weight 2.0-2.5kg,racial,White,0,9,9
136915,Primary malignant neoplasm of skin of lip,ethnic,Hispanic or Latino,0,9,9
75365,Oliguria and anuria,ethnic,Not Hispanic or Latino,7,2,9
441897,Chronic duodenal ileus,racial,White,9,0,9
76790,Familial ligamentous laxity,racial,White,5,5,10
40491340,Closed fracture of tibia,racial,Other Race,0,9,9
439707,Folie a deux,ethnic,Hispanic or Latino,9,0,9
376267,Superficial injury of conjunctiva,racial,White,7,2,9
198062,"Infectious colitis, enteritis and gastroenteritis",racial,Asian,7,2,9
141816,Acute lymphoid leukaemia in remission,racial,White,2,7,9
443865,Non-infective colitis,racial,American Indian or Alaska Native ,7,2,9
135033,Hair and hair follicle diseases,racial,American Indian or Alaska Native ,2,7,9
138821,Seborrhea,racial,Black or African American ,7,2,9
192360,Cyst and pseudocyst of pancreas,ethnic,Not Hispanic or Latino,9,0,9
4218420,Postinflammatory perforation of ear drum,ethnic,Hispanic or Latino,9,0,9
259043,Emphysematous bleb of lung,ethnic,Not Hispanic or Latino,9,0,9
443587,Diastolic heart failure,racial,Other Race,9,0,9
314754,Wheezing,racial,Filipino,7,2,9
434901,Subchronic paranoid schizophrenia with acute exacerbation,racial,Unknown,9,0,9
4157605,Infection due to resistant organism,racial,White,0,9,9
133002,Acute osteomyelitis,racial,White,0,9,9
440674,Gout,racial,American Indian,0,9,9
4029763,Check artificial pacemaker for electrode impedance,ethnic,Hispanic or Latino,0,9,9
440426,Vertigo as late effect of stroke,racial,Black or African American ,9,0,9
434663,Acute endocarditis,racial,Unknown,5,5,10
4100249,Presenile dementia NOS,racial,White,9,0,9
435642,Disturbance in speech,ethnic,Not Hispanic or Latino,2,7,9
432545,Bacterial disease,racial,Black or African American ,9,0,9
436391,Primary cerebellar degeneration,ethnic,Not Hispanic or Latino,0,9,9
75670,Sprain pelvic ligament,ethnic,Hispanic or Latino,7,2,9
141372,Contact dermatitis due to solvents,ethnic,Hispanic or Latino,5,5,10
4129342,Nephrectomy of remaining or solitary kidney,racial,Unknown,9,0,9
314463,Congenital anomaly of aorta,ethnic,Hispanic or Latino,2,7,9
255891,Lupus erythematosus,racial,Unknown,9,0,9
436996,Thoracoabdominal aortic aneurysm,ethnic,Not Hispanic or Latino,0,9,9
444093,Patient status finding,racial,Other Race,7,2,9
200449,Hepatitis in viral diseases EC,ethnic,Hispanic or Latino,5,5,10
436278,Superficial bruising of thigh,racial,American Indian or Alaska Native ,5,5,10
376979,Diabetic cataract,racial,Native Hawaiian or Other Pacific Islander ,9,0,9
75652,Congenital valgus deformity of foot,racial,White,0,9,9
138604,"Contusion of face, scalp and neck, excluding eye(s)",racial,Black or African American ,5,5,10
441241,Reticulosarcoma of lymph nodes of axilla and upper limb,racial,White,9,0,9
443293,Obstetric breast abscess with postnatal complication,ethnic,Hispanic or Latino,9,0,9
26441,Bleeding ulcer of esophagus,ethnic,Not Hispanic or Latino,0,9,9
4092896,Stool contents abnormal,racial,Filipino,5,5,10
4290927,Impairment level: low vision of both eyes,racial,Black or African American ,0,9,9
141095,Acne,racial,American Indian,7,2,9
4239975,Myocardial disease,racial,White,0,9,9
132449,Transient limb paralysis,ethnic,Hispanic or Latino,5,5,10
77646,Disorder of bone and articular cartilage,racial,Unknown,2,7,9
81379,Lateral epicondylitis,racial,Black or African American ,9,0,9
200780,Disease of uterus,racial,Unknown,9,0,9
435318,Complete spontaneous abortion with genital tract or pelvic infection,ethnic,Hispanic or Latino,9,0,9
375393,Laceration of skin of eyelid AND periocular area,ethnic,Hispanic or Latino,0,9,9
134735,Chronic osteomyelitis,ethnic,Not Hispanic or Latino,9,0,9
200660,Reticulosarcoma of lymph nodes of inguinal region and lower limb,racial,White,9,0,9
193242,Perforation of intestine,racial,Unknown,9,0,9
134305,Acute lymphoid leukaemia,racial,American Indian or Alaska Native ,9,0,9
138117,Benign tumour of spinal cord,racial,Black or African American ,0,9,9
436100,Narcolepsy,ethnic,Not Hispanic or Latino,0,9,9
439696,Hypertensive heart and renal disease with (congestive) heart failure,ethnic,Not Hispanic or Latino,0,9,9
201956,Congenital anomaly of lower limb,racial,White,9,0,9
381384,Congenital absence of external ear,ethnic,Hispanic or Latino,2,7,9
4211657,Closed fracture of lower leg,racial,White,0,9,9
74698,Breech presentation,racial,Unknown,9,0,9
437501,Primary malignant neoplasm of labia majora,ethnic,Hispanic or Latino,9,0,9
4100529,Misuse of drugs NOS,racial,White,7,2,9
140065,Pure red cell aplasia,racial,Black or African American ,9,0,9
434490,Shivering,racial,Other Race,9,0,9
372409,Sciatica neuralgia,racial,Native Hawaiian or Other Pacific Islander ,0,9,9
74855,Genital herpes simplex,racial,American Indian or Alaska Native ,9,0,9
433030,False-positive serological test for syphilis,racial,Unknown,7,2,9
315947,Thoracic back sprain,racial,Asian,5,5,10
434462,VSD - Ventricular septal defect,racial,Black or African American ,9,0,9
442589,Superficial foreign body of wrist without major open wound AND without infection,ethnic,Hispanic or Latino,2,7,9
436546,Strain of subscapularis muscle,racial,Other Race,9,0,9
4149353,"Attention deficit hyperactivity disorder, predominantly inattentive type",racial,Asian,7,2,9
198334,Campylobacter diarrhoea,racial,White,2,7,9
439082,Menopausal syndrome,racial,Native Hawaiian or Other Pacific Islander ,9,0,9
381017,Ametropic amblyopia,racial,Asian,5,5,10
435642,Disturbance in speech,racial,Unknown,0,9,9
435696,Early trauma complications,ethnic,Hispanic or Latino,5,5,10
4126282,Chlamydial urethritis,racial,Unknown,2,7,9
440532,Heavy-for-dates infant regardless of gestation period,racial,White,9,0,9
135611,Furuncle of hand,ethnic,Hispanic or Latino,9,0,9
317895,Hypertension due to renovascular disease,racial,Black or African American ,9,0,9
432620,Disorder of choroid of eye,racial,Unknown,9,0,9
73301,Synovitis/tenosynovitis - wrist,racial,Asian,9,0,9
79908,Muscle strength reduced,racial,Black or African American ,5,5,10
73754,Restless legs,racial,American Indian or Alaska Native ,9,0,9
441963,Prader-Willi syndrome,ethnic,Not Hispanic or Latino,5,5,10
313761,Central retinal vein occlusion,ethnic,Not Hispanic or Latino,0,9,9
373982,Benign tumour of conjunctiva,racial,Asian,9,0,9
40485064,Latent syphilis,racial,Other Race,0,9,9
78888,Open fracture of ankle,ethnic,Hispanic or Latino,9,0,9
193020,Incomplete emptying of bladder,racial,Unknown,5,5,10
436289,Non-medicinal agent causing toxic effects,ethnic,Hispanic or Latino,2,7,9
439653,Partial epilepsy without mention of impairment of consciousness,racial,White,2,7,9
133685,Salmonellosis,ethnic,Not Hispanic or Latino,9,0,9
442073,Malunion and nonunion of fracture,ethnic,Hispanic or Latino,7,2,9
4093309,Secondary syphilis of skin and mucous membrane,racial,White,0,9,9
4193570,Abnormal results of hearing screening test,ethnic,Not Hispanic or Latino,7,2,9
432250,Infective disorder,racial,Other Race,5,5,10
4147497,Nervous system and sense organ diseases,racial,Asian,0,9,9
438878,Abnormal results of liver function studies,racial,Black or African American ,7,2,9
439228,Adverse reaction to sulphonamides,ethnic,Hispanic or Latino,2,7,9
4016358,Staphylococcus carrier,racial,White,5,5,10
134159,Precordial pain,racial,Asian,2,7,9
443597,Chronic kidney disease stage 3,racial,American Indian,5,5,10
75860,Costiveness,racial,Asian Indian,2,7,9
259852,Staphylococcal pneumonia,ethnic,Hispanic or Latino,0,9,9
75620,Traumatic arthropathy of the ankle and/or foot,ethnic,Hispanic or Latino,9,0,9
77631,Secondary localized osteoarthrosis of shoulder region,racial,Unknown,9,0,9
4101068,Observation of ear discharge,racial,Unknown,7,2,9
439918,Poliomyelitis osteopathy of the ankle and/or foot,racial,Unknown,0,9,9
201211,Herpetic vulvovaginitis,racial,Unknown,9,0,9
4102808,Transsexuality with homosexual history,racial,Black or African American ,0,9,9
194306,Carcinoid tumor of stomach,racial,White,0,9,9
432586,Mental disorder,racial,Other Race,2,7,9
439666,Contracture of multiple joints,racial,Asian,9,0,9
381281,Degenerative progressive high myopia,racial,Unknown,7,2,9
372624,Cataract with neovascularization,ethnic,Hispanic or Latino,9,0,9
381114,Microcephalus,racial,Unknown,5,5,10
192372,Placenta praevia without haemorrhage - not delivered,ethnic,Not Hispanic or Latino,9,0,9
444420,Calculus of bile duct with chronic cholecystitis,ethnic,Hispanic or Latino,9,0,9
194685,Chronic non-obstructive atrophic pyelonephritis,ethnic,Hispanic or Latino,2,7,9
436747,Legal abortion without complication,ethnic,Hispanic or Latino,9,0,9
196214,Congenital disorder of gallbladder and biliary tract,racial,White,9,0,9
443747,Acute laryngotracheitis without obstruction,ethnic,Hispanic or Latino,5,5,10
437614,Early onset of delivery,ethnic,Hispanic or Latino,9,0,9
439924,Endocrine AND/OR metabolic disorder specific to the fetus OR newborn,ethnic,Hispanic or Latino,0,9,9
137111,"Closed fracture scapula, coracoid",racial,Unknown,0,9,9
4008566,Atypical schizophrenia,ethnic,Not Hispanic or Latino,2,7,9
4066724,Pilonidal sinus/cyst NOS,ethnic,Hispanic or Latino,0,9,9
4062795,Twin pregnancy unspecified,racial,White,9,0,9
4091532,Bowel observation,racial,Other Race,5,5,10
200784,Placental condition affecting management of mother,ethnic,Hispanic or Latino,9,0,9
432354,Chronic duodenal ulcer with perforation but without obstruction,racial,Unknown,0,9,9
30515,Oesophagostenosis,ethnic,Not Hispanic or Latino,0,9,9
196236,Septicaemic shock,ethnic,Hispanic or Latino,5,5,10
441126,Monosomy and deletion from autosome,racial,Other Race,9,0,9
79873,Urolith,racial,Asian,0,9,9
432554,Human immunodeficiency virus II infection,racial,Black or African American ,2,7,9
439224,Drug allergy,racial,Asian,7,2,9
372328,Otitis media,racial,American Indian,9,0,9
75373,Open fracture of head of radius,racial,Unknown,9,0,9
441691,Atypical squamous cells of undetermined significance on vaginal Papanicolaou smear,racial,American Indian or Alaska Native ,9,0,9
138825,Actinic keratosis,racial,Black or African American ,9,0,9
437428,Crushing injury - disorder,ethnic,Hispanic or Latino,2,7,9
433668,Burn of two OR more fingers including thumb,ethnic,Hispanic or Latino,7,2,9
80509,Bone cyst,racial,Black or African American ,2,7,9
79118,Deformity of calcaneum,ethnic,Hispanic or Latino,0,9,9
435781,Vitamin K deficiency,racial,White,9,0,9
316432,Right bundle branch block AND left anterior fascicular block,racial,White,5,5,10
440454,Abortion without complication,ethnic,Hispanic or Latino,9,0,9
443401,Congenital connective tissue disorder,ethnic,Hispanic or Latino,7,2,9
437093,Congenital ptosis of upper eyelid,ethnic,Not Hispanic or Latino,0,9,9
376961,Disturbance of consciousness,racial,American Indian or Alaska Native ,7,2,9
81938,Climacteric arthritis of the shoulder region,racial,Unknown,9,0,9
372914,Optic atrophy,racial,Black or African American ,7,2,9
433315,Feeding difficulties in newborn,racial,Other Race,2,7,9
443909,"Decreased level, laboratory test",racial,Black or African American ,9,0,9
436204,Subcutaneous hematoma,racial,White,2,7,9
380100,Glossopharyngeal neuralgia,racial,White,9,0,9
24977,Mucocele of salivary gland,racial,Unknown,7,2,9
140602,"Mechanical complication of internal orthopedic device, implant and graft",racial,Unknown,9,0,9
195259,Entrapment of lateral cutaneous nerve of thigh,racial,Black or African American ,2,7,9
200052,Primary malignant neoplasm of uterine adnexa,ethnic,Not Hispanic or Latino,9,0,9
201603,Disease of teeth AND/OR supporting structures,racial,American Indian or Alaska Native ,7,2,9
79106,Arthralgia of the pelvic region and thigh,racial,Filipino,9,0,9
4101068,Observation of ear discharge,ethnic,Not Hispanic or Latino,5,5,10
380706,Regular astigmatism,racial,Unknown,9,0,9
132703,Lichen planus,ethnic,Not Hispanic or Latino,7,2,9
77670,Chest pain,racial,Asian Indian,7,2,9
377085,Congenital anomaly of brain,racial,Asian,0,9,9
316822,Finding of heart murmur,racial,Native Hawaiian or Other Pacific Islander ,5,5,10
259852,Staphylococcal pneumonia,racial,White,0,9,9
434712,Varicose veins of legs in pregnancy and the puerperium with antenatal complication,ethnic,Hispanic or Latino,0,9,9
378165,Nystagmus,ethnic,Not Hispanic or Latino,5,5,10
436812,Tongue tie,racial,Unknown,2,7,9
440383,Depressive disorder,racial,Asian Indian,5,5,10
79173,Closed dislocation of jaw,ethnic,Not Hispanic or Latino,7,2,9
316427,Aneurysm of coronary vessels,racial,White,2,7,9
4145796,Family history: Musculoskeletal disease,racial,White,9,0,9
436522,Irregular sleep-wake pattern,ethnic,Not Hispanic or Latino,2,7,9
434872,Infection by Trichomonas,ethnic,Not Hispanic or Latino,9,0,9
4324124,Peritoneal dialysis,ethnic,Hispanic or Latino,7,2,9
201322,Internal hemorrhoids without complication,racial,Asian,5,5,10
201618,Disease of intestine,racial,Other Race,7,2,9
195926,Slowing of urinary stream,racial,Unknown,0,9,9
439348,Pregnancy complications,ethnic,Hispanic or Latino,9,0,9
440012,Fall from chair or bed,ethnic,Not Hispanic or Latino,0,9,9
377294,Exotropia,racial,Black or African American ,5,5,10
4148121,Tonsil and/or adenoid hypertrophy,racial,White,5,5,10
438204,Edema or excessive weight gain in pregnancy without mention of hypertension,ethnic,Hispanic or Latino,9,0,9
134735,Chronic osteomyelitis,racial,Asian,9,0,9
77146,Open wound of finger with tendon involvement,ethnic,Hispanic or Latino,2,7,9
434413,Incomplete spontaneous abortion with complication,ethnic,Hispanic or Latino,9,0,9
437839,Pica,racial,Unknown,9,0,9
435753,Malignant lymphoma of intrathoracic lymph nodes,ethnic,Hispanic or Latino,0,9,9
438111,Hematologic neoplasm of uncertain behavior,racial,White,0,9,9
4154623,Fit denture,racial,White,7,2,9
434046,Unilateral mixed conductive and sensorineural hearing loss with unrestricted hearing on the contralateral side,racial,White,0,9,9
138117,Benign tumour of spinal cord,ethnic,Not Hispanic or Latino,0,9,9
4051119,FH: Osteoporosis,racial,Unknown,9,0,9
256717,Bronchospasm,racial,Black or African American ,2,7,9
256722,Bronchopneumonia,racial,Unknown,5,5,10
432236,Tuberculosis of peripheral lymph nodes,ethnic,Not Hispanic or Latino,9,0,9
4016359,Streptococcus carrier,ethnic,Not Hispanic or Latino,9,0,9
433917,Burns of multiple sites,racial,White,0,9,9
433681,Late effect of accident due to natural and environmental factors,ethnic,Hispanic or Latino,9,0,9
4108374,Other specified peripheral vascular disease NOS,ethnic,Hispanic or Latino,5,5,10
197610,Ovarian cyst,racial,American Indian or Alaska Native ,9,0,9
139737,Pediculosis corporis,racial,White,7,2,9
80874,Open wound of multiple sites of one upper limb without complication,ethnic,Not Hispanic or Latino,5,5,10
440529,Abnormal findings on diagnostic imaging of urinary organs,racial,Other Race,2,7,9
374941,Retained foreign body of eyelid,racial,White,9,0,9
134671,Dental abscess without a sinus,racial,Black or African American ,5,5,10
373786,Abnormal vision,racial,Asian,9,0,9
376946,Senile delirium,racial,White,9,0,9
433881,Additional general conditions of patient,racial,Unknown,9,0,9
432529,"Motor vehicle traffic accident involving pedestrian dragged by motor vehicle, driver of motor vehicle injured",racial,Other Race,9,0,9
4264281,Open fracture,racial,White,7,2,9
4087420,Other specified miliary tuberculosis,racial,White,9,0,9
4180783,Malignant tumour of lingual tonsil,racial,White,9,0,9
432512,Foreign object left in body during procedure,ethnic,Hispanic or Latino,2,7,9
318186,Achalasia of esophagus,ethnic,Not Hispanic or Latino,7,2,9
192679,Renal disease in pregnancy AND/OR puerperium without hypertension,ethnic,Hispanic or Latino,9,0,9
139895,"Thyroid dysfunction during pregnancy, childbirth and the puerperium",racial,White,7,2,9
4059635,Work maladjustment problem,ethnic,Hispanic or Latino,7,2,9
317002,Hypopiesis,racial,Black or African American ,0,9,9
40483286,Critical illness myopathy,ethnic,Hispanic or Latino,0,9,9
73336,Closed traumatic dislocation ankle joint,racial,Other Race,9,0,9
376555,Open wound of ear drum without complication,ethnic,Hispanic or Latino,2,7,9
4272867,General well-being finding,racial,Native Hawaiian or Other Pacific Islander ,2,7,9
138176,Acute gingivitis,racial,Asian,5,5,10
192954,Acute gastric ulcer without hemorrhage AND without perforation but with obstruction,ethnic,Hispanic or Latino,5,5,10
4215909,Artificial pacemaker rate check,racial,White,7,2,9
77642,Arthralgia of the forearm,racial,American Indian or Alaska Native ,7,2,9
4288676,Acute and chronic cholecystitis,racial,Other Race,9,0,9
137682,Skin sensation disturbance,racial,Native Hawaiian or Other Pacific Islander ,9,0,9
73723,Benign tumour of epididymis,racial,White,0,9,9
77352,Pyogenic arthritis of the lower leg,racial,Unknown,9,0,9
140065,Pure red cell aplasia,ethnic,Not Hispanic or Latino,9,0,9
4176890,Male sterility,ethnic,Not Hispanic or Latino,0,9,9
381001,Subjective visual disturbance,ethnic,Not Hispanic or Latino,0,9,9
138841,Disorder of sacrum,racial,Unknown,5,5,10
141955,Pectus excavatum,ethnic,Not Hispanic or Latino,0,9,9
433894,Open fracture of phalanx of toe,ethnic,Hispanic or Latino,9,0,9
4018734,Sprain of costal cartilage,racial,Other Race,2,7,9
4037738,Visual alteration,racial,White,7,2,9
74723,Arthropathy associated with a neurological disorder,racial,Black or African American ,9,0,9
26823,Oral phase dysphagia,racial,White,0,9,9
318247,Apnea in the newborn,racial,White,7,2,9
436398,Glaucoma associated with ocular disorder,racial,White,7,2,9
135027,"Carbuncle of leg, except foot",racial,Unknown,2,7,9
436373,DSD - Developmental speech disorder,racial,Filipino,2,7,9
432586,Mental disorder,racial,Unknown,7,2,9
372425,Congenital abnormality of ear,ethnic,Not Hispanic or Latino,7,2,9
4064061,Other skin and subcutaneous tissue disorders,ethnic,Hispanic or Latino,5,5,10
441398,Anomaly of sex chromosome,racial,White,9,0,9
437579,Paroxysmal ventricular tachycardia,ethnic,Not Hispanic or Latino,2,7,9
4139915,Acute pyelitis,ethnic,Not Hispanic or Latino,5,5,10
24966,OV - Oesophageal varices,racial,American Indian or Alaska Native ,9,0,9
444200,Neoplasm of nervous system,racial,Unknown,9,0,9
138463,Oral aphthae,racial,American Indian or Alaska Native ,9,0,9
133713,Malignant melanoma of skin of face,racial,White,0,9,9
443783,Chronic disease,racial,American Indian,9,0,9
443545,Nonvenomous insect bite,racial,American Indian or Alaska Native ,9,0,9
26060,Benign tumor of tonsil,racial,White,9,0,9
441025,Stenosis of lacrimal canaliculi,ethnic,Not Hispanic or Latino,2,7,9
432546,Herpes zoster dermatitis of eyelids,racial,White,5,5,10
435244,Developmental disorder,racial,Asian,9,0,9
24978,Chronic adenotonsillitis,racial,Black or African American ,0,9,9
443776,Brachial radiculitis,racial,Black or African American ,7,2,9
434277,Hemophilus influenzae infection,ethnic,Hispanic or Latino,7,2,9
433000,Patellar tendonitis,racial,Black or African American ,0,9,9
374906,Cerebral lipidosis,racial,White,9,0,9
444375,"Contact dermatitis due to plants, except food",racial,Unknown,7,2,9
198475,Gallstone ileus,racial,Unknown,7,2,9
435521,Psychophysiologic disorder,ethnic,Not Hispanic or Latino,5,5,10
435951,"Closed fracture of tibia and fibula, shaft",racial,Unknown,5,5,10
381504,Post-herpetic trigeminal neuralgia,racial,White,9,0,9
436665,Manic-depressive psychosis,racial,Native Hawaiian or Other Pacific Islander ,9,0,9
4144876,Contact dermatitis and other eczemas,racial,Unknown,2,7,9
321037,Cholesterol embolisation syndrome,ethnic,Hispanic or Latino,9,0,9
380117,Oedema of conjunctiva,racial,White,5,5,10
4060434,Unstable lie unspecified,racial,White,9,0,9
312349,Venous varices,racial,Filipino,7,2,9
436375,Sodium and water depletion,racial,White,7,2,9
133586,Bilateral incomplete cleft palate with cleft lip,ethnic,Hispanic or Latino,0,9,9
4055208,Chronic hepatitis unspecified,ethnic,Not Hispanic or Latino,0,9,9
81175,Contusion of chest,racial,American Indian or Alaska Native ,5,5,10
4202322,Amputated big toe,ethnic,Not Hispanic or Latino,5,5,10
380421,Tympanic membrane marginal perforation,ethnic,Hispanic or Latino,0,9,9
441132,Laboratory finding abnormal,racial,Unknown,5,5,10
441751,Adverse reaction to salicylate,ethnic,Hispanic or Latino,0,9,9
443603,Adverse reaction to antidiabetic drug,ethnic,Hispanic or Latino,7,2,9
257004,Acute exacerbation of chronic obstructive airways disease,racial,Filipino,0,9,9
434547,Complication of surgical procedure,ethnic,Not Hispanic or Latino,9,0,9
138278,Sprains and strains of joints and adjacent muscles,racial,Filipino,7,2,9
4196960,Varicocele,racial,Black or African American ,0,9,9
4333977,Acquired anophthalmos,ethnic,Hispanic or Latino,5,5,10
439176,Closed traumatic dislocation of metacarpophalangeal joint of finger,ethnic,Hispanic or Latino,9,0,9
434311,Disorder of the urea cycle metabolism,racial,Black or African American ,0,9,9
4282316,Recurrent major depression,racial,Unknown,9,0,9
4028827,Manual examination of breast,ethnic,Hispanic or Latino,9,0,9
201461,Disorder affecting transplant,racial,White,9,0,9
443367,Antihypertensive adverse reaction,ethnic,Hispanic or Latino,9,0,9
441579,Acute inferoposterior infarction,ethnic,Hispanic or Latino,0,9,9
4317150,Sudden cardiac death,ethnic,Hispanic or Latino,5,5,10
255919,Finding of head and neck region,racial,Other Race,7,2,9
374882,Benign connective tissue neoplasm,ethnic,Not Hispanic or Latino,9,0,9
4331899,Child in family care,racial,Other Race,9,0,9
261782,Herpetic ulceration of vulva,racial,Other Race,9,0,9
4051114,FH: Diabetes mellitus,racial,Native Hawaiian or Other Pacific Islander ,7,2,9
4186238,Louse infestation,racial,Other Race,7,2,9
443767,Diabetic oculopathy,racial,Filipino,9,0,9
312950,IgE-mediated allergic asthma,racial,Alaska Native,0,9,9
438067,Malaria,ethnic,Hispanic or Latino,9,0,9
75865,Disorder of the urinary system,ethnic,Hispanic or Latino,5,5,10
435543,Primary angle-closure glaucoma,racial,White,7,2,9
77081,Tibialis tendinitis,racial,Unknown,9,0,9
77403,Closed fracture of vertebral column without spinal cord injury,racial,Asian,5,5,10
194091,Calculus in urethra,racial,Asian,9,0,9
315085,Enlargement of lymph nodes,racial,Filipino,7,2,9
77670,Chest pain,racial,American Indian,0,9,9
81247,Carcinoma in situ of urinary system,racial,Other Race,9,0,9
443541,Recurrent inguinal hernia with gangrene,ethnic,Hispanic or Latino,0,9,9
442584,Carbuncle of buttock,racial,Unknown,9,0,9
75121,Burn of lower leg,racial,Other Race,9,0,9
201901,Abscess of liver,ethnic,Hispanic or Latino,2,7,9
138340,Septicaemia due to Staphylococcus aureus,ethnic,Not Hispanic or Latino,0,9,9
254761,Cough,racial,Asian Indian,2,7,9
434500,Closed fracture of neck of femur,racial,American Indian or Alaska Native ,9,0,9
437093,Congenital ptosis of upper eyelid,racial,Unknown,9,0,9
432545,Bacterial disease,racial,Asian,9,0,9
193528,Third degree uterine prolapse,racial,Unknown,9,0,9
439975,Injury at C1-C4 level with spinal cord injury AND without bone injury,racial,Unknown,9,0,9
134386,Gingival recession,ethnic,Hispanic or Latino,5,5,10
72487,Crush injury of foot,racial,White,9,0,9
4111875,Varicose veins of the leg NOS,racial,Unknown,9,0,9
73302,Curvature of spine,racial,Unknown,0,9,9
4165091,Lack of exercise,racial,American Indian or Alaska Native ,0,9,9
435810,After-cataract,ethnic,Not Hispanic or Latino,7,2,9
436366,Benign tumour of testis,ethnic,Not Hispanic or Latino,0,9,9
433934,Accident caused by needle,racial,White,9,0,9
376901,"Acute paralytic poliomyelitis, bulbar",ethnic,Hispanic or Latino,9,0,9
4152045,Screening for malignant neoplasm of respiratory tract,racial,White,9,0,9
4149547,Fracture of vertebra without spinal cord lesion,racial,White,0,9,9
381551,Drug-related polyneuropathy,racial,White,0,9,9
76744,Azoospermia,ethnic,Hispanic or Latino,0,9,9
133303,Congenital anomaly of mouth,ethnic,Hispanic or Latino,0,9,9
31821,Endocrinopathy,racial,Asian,9,0,9
196738,Male genital organ disease,racial,American Indian or Alaska Native ,0,9,9
439719,Disseminated mycobacteriosis,ethnic,Hispanic or Latino,0,9,9
80232,Closed fracture of calcaneus,racial,Asian,0,9,9
443783,Chronic disease,racial,Filipino,5,5,10
4112534,Chronic laryngitis and laryngotracheitis,ethnic,Hispanic or Latino,0,9,9
200765,Chronic cholecystitis,racial,Unknown,5,5,10
433403,Viral meningitis,racial,Black or African American ,2,7,9
434752,Positive serological AND/OR viral culture findings for human immunodeficiency virus,racial,Asian,0,9,9
196064,Carcinoma in situ of digestive organ,ethnic,Hispanic or Latino,0,9,9
433197,PXF - Pseudoexfoliation of lens capsule,ethnic,Hispanic or Latino,0,9,9
4116861,Neuromyopathy,ethnic,Not Hispanic or Latino,9,0,9
437787,Secondary syphilis,racial,Black or African American ,0,9,9
435171,Allergic state,racial,Native Hawaiian or Other Pacific Islander ,5,5,10
254669,Disease of vocal cords,racial,White,2,7,9
436672,Disorder of copper metabolism,racial,White,9,0,9
4107655,Observations relating to psychosocial functioning,racial,Asian,5,5,10
26711,Chronic pharyngitis,racial,Other Race,9,0,9
377550,Compression of brain,ethnic,Not Hispanic or Latino,9,0,9
436265,Open wound of multiple sites of one lower limb AND thigh without complication,racial,Unknown,2,7,9
78272,Sprain of wrist,racial,Filipino,0,9,9
373404,Ophthalmic herpes simplex,racial,Unknown,9,0,9
78842,Acquired postural lordosis,racial,White,9,0,9
195500,Benign tumour of uterus,ethnic,Hispanic or Latino,9,0,9
138387,Thyrotoxicosis,ethnic,Hispanic or Latino,9,0,9
440389,MR - Mental retardation,racial,Filipino,7,2,9
444445,Benign neoplasm of skin of leg,racial,Unknown,2,7,9
436251,Closed fracture of proximal end of ulna,ethnic,Hispanic or Latino,2,7,9
201343,Acute alcoholic liver disease,ethnic,Not Hispanic or Latino,7,2,9
26060,Benign tumor of tonsil,ethnic,Hispanic or Latino,9,0,9
200779,Intrauterine polyp,racial,Black or African American ,9,0,9
440840,Neonatal candidiasis,ethnic,Not Hispanic or Latino,9,0,9
133566,Necrotizing fasciitis,racial,Unknown,9,0,9
201061,Diaphragmatic hernia,racial,Other Race,2,7,9
440649,Primary malignant neoplasm of head of pancreas,racial,White,0,9,9
4094448,Pregnancy test negative,racial,Asian,9,0,9
376337,Disease of nervous system,racial,American Indian or Alaska Native ,2,7,9
258780,Chronic obstructive bronchitis,racial,American Indian or Alaska Native ,0,9,9
73754,Restless legs,racial,Other Race,9,0,9
4051702,FH: Congenital anomaly,ethnic,Not Hispanic or Latino,9,0,9
375545,Lens opacity,racial,American Indian or Alaska Native ,5,5,10
441190,Injury of unknown intent due to fall from height,racial,White,9,0,9
199866,Acute gastritis,racial,American Indian or Alaska Native ,9,0,9
435781,Vitamin K deficiency,ethnic,Hispanic or Latino,9,0,9
200768,Inflammatory disease of vagina and/or vulva,racial,Unknown,9,0,9
200843,Observation of frequency of urination,racial,Filipino,2,7,9
196821,Observation of urethral discharge,ethnic,Not Hispanic or Latino,0,9,9
321052,Peripheral vascular disease,racial,Filipino,0,9,9
4206460,Problem,racial,Other Race,7,2,9
4116452,Generalized osteoarthritis NOS,racial,Black or African American ,9,0,9
433846,Ankylosis of joint of lower leg,racial,Unknown,9,0,9
444246,Cirrhosis of liver not due to alcohol,racial,American Indian or Alaska Native ,9,0,9
443539,Motor vehicle injury,ethnic,Not Hispanic or Latino,0,9,9
439924,Endocrine AND/OR metabolic disorder specific to the fetus OR newborn,racial,White,0,9,9
321876,Disease of capillaries,racial,Unknown,9,0,9
440525,Prematurity of fetus,racial,American Indian or Alaska Native ,0,9,9
4302979,Blepharorrhaphy,racial,Unknown,9,0,9
444243,Neurotic disorder,racial,Other Race,7,2,9
79126,Polysyndactyly,racial,White,0,9,9
434207,"Insect bite, nonvenomous, of hand, without mention of infection",racial,Unknown,5,5,10
380111,Acute atopic conjunctivitis,racial,Asian,5,5,10
80504,Acquired genu valgum,racial,Other Race,7,2,9
433257,Mesangiocapillary glomerulonephritis,racial,Unknown,5,5,10
432868,Hemoglobinopathy,racial,Unknown,0,9,9
133028,Scalp injuries due to birth trauma,racial,White,0,9,9
200528,Ascites,racial,American Indian or Alaska Native ,9,0,9
192667,Atrophic gastritis,racial,Black or African American ,0,9,9
77025,Diverticulitis of colon,racial,American Indian or Alaska Native ,2,7,9
132446,Congenital anomaly of skin,racial,Other Race,2,7,9
80861,Closed fracture of ischium,ethnic,Hispanic or Latino,9,0,9
432587,Polyclonal hypergammaglobulinemia,racial,Unknown,0,9,9
435889,Decubitus ulcer of ankle,ethnic,Not Hispanic or Latino,0,9,9
373175,Organic hallucinosis,racial,White,7,2,9
437038,Blood in urine,racial,American Indian or Alaska Native ,9,0,9
313005,Congenital stenosis of pulmonary valve,racial,Unknown,9,0,9
136661,Nodular goiter,ethnic,Not Hispanic or Latino,7,2,9
81984,Sprain of shoulder and upper arm,racial,American Indian or Alaska Native ,9,0,9
4008517,"Fracture of rib(s), sternum, larynx and trachea",racial,Unknown,0,9,9
440697,Nonaggressive unsocial conduct disorder,racial,Unknown,0,9,9
440786,Threatened premature labor,racial,White,9,0,9
372887,Disease of brain,ethnic,Not Hispanic or Latino,5,5,10
439025,Dacryocystitis,racial,White,9,0,9
437902,Teeth development and eruption disorders,racial,Filipino,5,5,10
4331070,Family history of polyp of colon,ethnic,Not Hispanic or Latino,7,2,9
197781,Shigella sonnei (group D),racial,White,2,7,9
377566,Palsy of conjugate gaze,racial,White,9,0,9
197304,Ulcer of lower limb,racial,Black or African American ,5,5,10
434712,Varicose veins of legs in pregnancy and the puerperium with antenatal complication,racial,Unknown,0,9,9
434822,Complication of internal prosthetic device,racial,White,5,5,10
254387,Upper respiratory tract hypersensitivity reaction,racial,Other Race,7,2,9
381316,CVA - Cerebrovascular accident,racial,American Indian or Alaska Native ,9,0,9
381562,"Impairment level: better eye: moderate impairment: lesser eye: blind, not further specified",racial,White,5,5,10
436546,Strain of subscapularis muscle,ethnic,Not Hispanic or Latino,2,7,9
199059,Ventral hernia with obstruction but no gangrene,ethnic,Hispanic or Latino,9,0,9
77963,Achilles tendinitis,racial,Asian,2,7,9
4108374,Other specified peripheral vascular disease NOS,racial,White,5,5,10
433168,Iron deficiency anaemia secondary to inadequate dietary iron intake,racial,Unknown,5,5,10
4057348,"Contusion, knee and lower leg NOS",ethnic,Hispanic or Latino,0,9,9
381028,Acute suppurative otitis media - tympanic membrane ruptured,racial,Other Race,5,5,10
436033,Syphilis,racial,Other Race,0,9,9
440760,Inflammatory disorder of jaw,racial,White,7,2,9
443789,Victim of trauma,racial,White,5,5,10
441593,Arteriovenous fistula of pulmonary vessels,ethnic,Hispanic or Latino,9,0,9
435790,Spurious polycythaemia,racial,Other Race,7,2,9
80182,Dermatomyositis,racial,Unknown,2,7,9
437217,Coccidioidomycosis,racial,Black or African American ,0,9,9
4164222,Tendon contracture,racial,Black or African American ,0,9,9
438792,Crowding of teeth,racial,White,2,7,9
380375,Organic personality disorder,racial,White,2,7,9
40481374,Allergic rhinitis due to food,racial,Unknown,5,5,10
441077,Stenosis of cervix,racial,Unknown,9,0,9
438209,Pregnancy care of habitual aborter,racial,White,9,0,9
73290,Contracture of joint,racial,White,0,9,9
434902,Autistic disorder of childhood onset,racial,American Indian or Alaska Native ,0,9,9
434277,Hemophilus influenzae infection,racial,White,7,2,9
441481,Adult victim of abuse,racial,Unknown,7,2,9
436996,Thoracoabdominal aortic aneurysm,racial,White,0,9,9
260034,Chronic pulmonary coccidioidomycosis,ethnic,Hispanic or Latino,0,9,9
4028716,Idiopathic thrombocythemia,racial,Other Race,7,2,9
76191,Disease of upper arm,racial,Asian,7,2,9
436314,Accidental puncture AND/OR laceration during a procedure,racial,Black or African American ,0,9,9
432289,Drug-induced neutropenia,racial,Unknown,2,7,9
442632,Abrasion AND/OR friction burn of wrist with infection,ethnic,Hispanic or Latino,7,2,9
197318,Cholesterolosis of gallbladder,racial,Asian,7,2,9
436353,Primary malignant neoplasm of upper outer quadrant of female breast,ethnic,Hispanic or Latino,9,0,9
375292,Perforation of tympanic membrane,racial,American Indian or Alaska Native ,0,9,9
133593,Transverse deficiency of upper limb,ethnic,Hispanic or Latino,0,9,9
4115379,"Localised, primary osteoarthritis of the pelvic region and thigh",racial,Other Race,9,0,9
432600,Stress reaction causing mixed disturbance of emotion and conduct,ethnic,Hispanic or Latino,7,2,9
436829,Closed fracture of angle of jaw,ethnic,Hispanic or Latino,0,9,9
80495,Palindromic rheumatism of the pelvic region and thigh,racial,Asian,9,0,9
434046,Unilateral mixed conductive and sensorineural hearing loss with unrestricted hearing on the contralateral side,racial,Unknown,9,0,9
195876,Hematometra,ethnic,Not Hispanic or Latino,0,9,9
4015842,Viral hepatitis carrier,ethnic,Not Hispanic or Latino,0,9,9
4091320,Meningococcal infection NOS,racial,White,9,0,9
436253,Sprain of foot,racial,Other Race,0,9,9
196325,Protozoal intestinal disease,ethnic,Hispanic or Latino,0,9,9
194306,Carcinoid tumor of stomach,ethnic,Hispanic or Latino,0,9,9
441836,Depressed bipolar I disorder,racial,Black or African American ,9,0,9
4010838,Increased body growth,ethnic,Hispanic or Latino,2,7,9
4304916,Gastrointestinal tract finding,ethnic,Not Hispanic or Latino,0,9,9
436285,Superficial foreign body without major open wound but with infection,ethnic,Hispanic or Latino,7,2,9
200040,Acute gonococcal endometritis,ethnic,Hispanic or Latino,9,0,9
380117,Oedema of conjunctiva,ethnic,Hispanic or Latino,5,5,10
439037,Aneurysm of artery of neck,racial,Unknown,9,0,9
443392,Malignant neoplastic disease,racial,White,9,0,9
432719,Panniculitis,ethnic,Hispanic or Latino,5,5,10
434219,Anaphylactic shock due to adverse food reaction,ethnic,Not Hispanic or Latino,7,2,9
443524,Mixed incontinence,racial,Other Race,9,0,9
4148404,Family history: Anemia,ethnic,Hispanic or Latino,5,5,10
140949,Scabies,racial,Filipino,2,7,9
261774,"Respiratory tuberculosis, not confirmed bacteriologically or histologically",ethnic,Not Hispanic or Latino,0,9,9
373654,Second degree burn of face AND/OR head,racial,White,2,7,9
4102808,Transsexuality with homosexual history,ethnic,Not Hispanic or Latino,0,9,9
372892,Metabolic encephalopathy,racial,White,5,5,10
312622,BVO - Branch retinal occlusion,ethnic,Not Hispanic or Latino,0,9,9
439183,Concussion,racial,Other Race,0,9,9
4012491,Difficulty chewing,racial,Black or African American ,5,5,10
195501,Polycystic ovaries,racial,American Indian,9,0,9
74806,Open wound of finger with complication,racial,White,0,9,9
374358,Dermatochalasis,racial,White,0,9,9
78907,Superficial injury of foot without infection,racial,Unknown,2,7,9
439672,Viral hepatitis C with coma,ethnic,Not Hispanic or Latino,9,0,9
440438,Anodontia,racial,Asian,9,0,9
80269,Mechanical complication of internal joint prosthesis,racial,Other Race,9,0,9
432461,"Closed fracture clavicle, shaft",racial,Black or African American ,0,9,9
4270866,Symptomatic dermographism,racial,Other Race,2,7,9
436246,Low libido,racial,Other Race,5,5,10
4116861,Neuromyopathy,racial,Asian,9,0,9
195769,Submucous uterine leiomyoma,ethnic,Not Hispanic or Latino,9,0,9
31884,Acquired diverticulum of esophagus,racial,White,9,0,9
318549,Cardiac septal defects,racial,White,9,0,9
77365,Disuse osteoporosis,ethnic,Not Hispanic or Latino,9,0,9
438731,Fat pad,racial,Unknown,7,2,9
195007,Female stress incontinence,racial,Black or African American ,9,0,9
432458,Closed fracture of C1-C4 level with spinal cord injury,racial,Unknown,0,9,9
4112819,Pneumonia due to other specified bacteria,racial,White,9,0,9
380533,Neonatal seizures,racial,White,9,0,9
437787,Secondary syphilis,racial,White,0,9,9
4096783,Total prostatectomy,racial,White,0,9,9
321318,Angina,racial,American Indian or Alaska Native ,7,2,9
4110022,Acute bronchitis and/or bronchiolitis,racial,White,0,9,9
443610,Prolapse of uterine cervical stump,ethnic,Hispanic or Latino,9,0,9
433315,Feeding difficulties in newborn,racial,Unknown,5,5,10
438567,Adult failure to thrive syndrome,racial,Asian,5,5,10
438398,Leukocytosis,racial,Native Hawaiian or Other Pacific Islander ,0,9,9
198985,Primary malignant neoplasm of kidney,racial,Asian,0,9,9
4067435,"Joint disorder NOS, of unspecified site",racial,White,9,0,9
25780,Lorain - Levi dwarfism,ethnic,Not Hispanic or Latino,0,9,9
439656,A/N care: grand multip,ethnic,Hispanic or Latino,9,0,9
439294,"Malignant neoplasm of head, neck and face",ethnic,Hispanic or Latino,7,2,9
432729,Crying infant,racial,Unknown,0,9,9
439183,Concussion,racial,Black or African American ,2,7,9
438871,Drug withdrawal syndrome in newborn,racial,White,7,2,9
81902,Urinary tract infectious disease,racial,American Indian,9,0,9
433837,Obstetric nipple infection with postnatal complication,ethnic,Not Hispanic or Latino,9,0,9
76194,Osteoarthrosis involving multiple sites but not designated as generalized,racial,Asian,7,2,9
373784,Acute allergic serous otitis media,racial,Unknown,7,2,9
376419,Haematoma of pinna,ethnic,Hispanic or Latino,7,2,9
436253,Sprain of foot,racial,Black or African American ,5,5,10
439298,Bronchitis and pneumonitis due to chemical fumes,racial,White,2,7,9
201322,Internal hemorrhoids without complication,racial,Black or African American ,0,9,9
433456,Acute pain,racial,American Indian or Alaska Native ,9,0,9
4053378,FH: Blood disorder,ethnic,Hispanic or Latino,5,5,10
312938,Hypertensive encephalopathy,ethnic,Hispanic or Latino,0,9,9
73720,Overlapping malignant neoplasm of urinary system,racial,White,9,0,9
76227,Leg oedema,ethnic,Hispanic or Latino,9,0,9
193277,Deliveries by caesarean,ethnic,Not Hispanic or Latino,9,0,9
438692,Primary malignant neoplasm of lateral wall of nasopharynx,racial,Unknown,0,9,9
440321,Helicobacter-associated disease,racial,American Indian or Alaska Native ,9,0,9
434626,Borderline personality disorder,ethnic,Not Hispanic or Latino,5,5,10
4170137,Non-suppurative otitis media,racial,Asian,7,2,9
432801,"Injury undetermined whether accidentally or purposely inflicted, fall from natural site",racial,Other Race,9,0,9
195977,Contusion of trunk,racial,Other Race,9,0,9
433911,Contusion of eye AND ocular adnexa,racial,Black or African American ,5,5,10
372924,Cerebral arterial occlusion,ethnic,Hispanic or Latino,9,0,9
199860,Hernia of abdominal cavity,racial,Other Race,2,7,9
4100249,Presenile dementia NOS,ethnic,Hispanic or Latino,9,0,9
435543,Primary angle-closure glaucoma,ethnic,Not Hispanic or Latino,9,0,9
439763,Benign tumour of trachea,ethnic,Hispanic or Latino,0,9,9
4113102,Amputated at hip,racial,White,9,0,9
78771,Labyrinthine dysfunction,racial,Unknown,0,9,9
438692,Primary malignant neoplasm of lateral wall of nasopharynx,ethnic,Not Hispanic or Latino,0,9,9
434089,Antepartum hemorrhage,ethnic,Hispanic or Latino,9,0,9
77673,Sign or symptom of the urinary system,racial,Other Race,2,7,9
436954,Drug abuse,racial,Other Race,0,9,9
377286,VFD - Visual field defect,racial,Asian,0,9,9
437470,Adverse reaction to benzodiazepine-based tranquilliser,racial,Unknown,9,0,9
433196,Chorioretinal scar,racial,Unknown,9,0,9
136368,Non-toxic multinodular goiter,racial,American Indian or Alaska Native ,9,0,9
438398,Leukocytosis,racial,Other Race,7,2,9
4317150,Sudden cardiac death,racial,White,5,5,10
377575,Tinnitus,racial,Filipino,0,9,9
194158,Perinatal gastrointestinal hemorrhage,racial,Filipino,0,9,9
380707,Distortion of visual image,racial,Unknown,9,0,9
441241,Reticulosarcoma of lymph nodes of axilla and upper limb,ethnic,Hispanic or Latino,9,0,9
194092,Uterine prolapse without vaginal wall prolapse,racial,Asian,9,0,9
192502,Contusion of multiple sites of trunk,racial,White,7,2,9
433881,Additional general conditions of patient,racial,Asian,7,2,9
4103640,Amputated foot,racial,Black or African American ,0,9,9
136497,Scar conditions and fibrosis of skin,racial,Black or African American ,2,7,9
134671,Dental abscess without a sinus,racial,Asian,9,0,9
376971,Retinal tear,racial,White,5,5,10
4192676,Born by caesarean section,racial,White,2,7,9
438111,Hematologic neoplasm of uncertain behavior,ethnic,Hispanic or Latino,0,9,9
4090255,Colloid bodies in retina,racial,Other Race,9,0,9
440735,Rheumatic fever without heart involvement,ethnic,Hispanic or Latino,0,9,9
438701,UKP - Disseminated malignancy of unknown primary,racial,Asian,9,0,9
4077382,Familial lipoprotein lipase deficiency,racial,White,2,7,9
195058,Nonallopathic lesion of abdomen,racial,White,9,0,9
4064382,Skin disease screening,ethnic,Not Hispanic or Latino,7,2,9
4028253,Neoplasm of digestive system,racial,Unknown,9,0,9
432611,Explosive personality disorder,ethnic,Not Hispanic or Latino,0,9,9
72711,Shoulder stiff,ethnic,Hispanic or Latino,9,0,9
4013457,"Closed fracture of proximal humerus, unspecified part",racial,Alaska Native,0,9,9
376525,Audiogram abnormal,racial,Other Race,5,5,10
77146,Open wound of finger with tendon involvement,racial,White,2,7,9
196156,Urethral diverticulum,racial,Unknown,9,0,9
439394,Congenital anomaly of face,racial,White,7,2,9
439221,"Adverse effect, due to correct medicinal substance properly administered",racial,Other Race,5,5,10
4091928,Chronic leukemia NOS,ethnic,Not Hispanic or Latino,9,0,9
440828,Renal pelvis and ureter obstructive defects,racial,Unknown,0,9,9
81936,Monoarthritis,racial,Unknown,7,2,9
197925,Haemorrhage of rectum and anus,racial,Black or African American ,5,5,10
259055,Extrinsic asthma with asthma attack,racial,Native Hawaiian or Other Pacific Islander ,0,9,9
374336,Infantile hemiplegia,ethnic,Hispanic or Latino,7,2,9
80509,Bone cyst,racial,Unknown,7,2,9
436075,Adjustment disorder with anxious mood,racial,Filipino,7,2,9
318736,Migraine,racial,Asian Indian,7,2,9
195289,Goodpasture's syndrome,ethnic,Not Hispanic or Latino,9,0,9
24134,Nonspecific pain in the neck region,racial,Filipino,2,7,9
435131,Victim of neglect,racial,Unknown,9,0,9
444112,Integumentary system finding,racial,Other Race,2,7,9
195012,Metrorrhagia,racial,Native Hawaiian or Other Pacific Islander ,9,0,9
198465,"Megacolon, not Hirschsprung's",racial,White,0,9,9
440088,Academic underachievement disorder,racial,Other Race,0,9,9
81711,Glenoid labrum detachment,racial,White,2,7,9
433644,Shellfish allergy,racial,White,5,5,10
435753,Malignant lymphoma of intrathoracic lymph nodes,racial,White,0,9,9
26727,Vomiting blood,racial,Other Race,2,7,9
318852,Congenital malformation of vitreous body,racial,Other Race,7,0,7
198892,Internal injury of abdominal organs without open wound into cavity,ethnic,Hispanic or Latino,5,2,7
200848,Dribbling of urine,racial,Unknown,0,7,7
134404,Anal spasm,racial,Unknown,5,2,7
195847,Gastroparesis syndrome,racial,Asian,7,0,7
443752,Ventricular hemorrhage,racial,White,7,0,7
137351,Epidermoid cyst of skin,racial,Filipino,0,7,7
443949,Disease type AND/OR category unknown,ethnic,Not Hispanic or Latino,0,7,7
28179,Polyp of vocal cord or larynx,ethnic,Not Hispanic or Latino,7,0,7
138388,Secondary hyperparathyroidism,ethnic,Not Hispanic or Latino,7,0,7
4087442,Acute poliomyelitis NOS,racial,Unknown,5,2,7
77358,Observation of hand region,racial,White,2,5,7
137829,Erythroid aplasia,racial,Asian,7,0,7
195301,Acute dilatation of stomach,ethnic,Hispanic or Latino,5,2,7
198192,Renal and perinephric abscess,racial,White,7,0,7
4109699,Unspecified chronic conjunctivitis,ethnic,Hispanic or Latino,2,5,7
201121,Malformation of urachus,ethnic,Hispanic or Latino,0,7,7
443357,Ankle joint observation,racial,White,2,5,7
321119,Coarctation of aorta,ethnic,Not Hispanic or Latino,5,2,7
321822,Peripheral circulatory disorder associated with diabetes mellitus,racial,White,0,7,7
192815,Intestinal infection due to E. coli,ethnic,Hispanic or Latino,5,2,7
376229,Abnormal involuntary movement,racial,Filipino,5,2,7
442623,Abrasion AND/OR friction burn of scalp without infection,racial,Asian,2,5,7
4264281,Open fracture,racial,Unknown,7,0,7
4152047,Lipid screening,racial,American Indian or Alaska Native ,7,0,7
253954,PTB - Pulmonary tuberculosis,racial,Other Race,5,2,7
438120,Opioid dependence,racial,American Indian or Alaska Native ,0,7,7
437165,Motor vehicle traffic accident,racial,Asian,2,5,7
432729,Crying infant,racial,Other Race,5,2,7
435755,Primary malignant neoplasm of skin of eyelid,ethnic,Hispanic or Latino,7,0,7
444031,Chronic heart failure,racial,Unknown,7,0,7
76161,Impotence of organic origin,racial,Filipino,0,7,7
443864,Multi-infarct dementia with depression,racial,Asian,7,0,7
435758,Burkitt's tumor of extranodal AND/OR solid organ site,ethnic,Hispanic or Latino,2,5,7
4152045,Screening for malignant neoplasm of respiratory tract,ethnic,Not Hispanic or Latino,7,0,7
135688,Abrasion AND/OR friction burn of foot with infection,racial,Unknown,7,0,7
436078,Malnutrition of moderate degree (Gomez: 60% to less than 75% of standard weight),racial,Other Race,7,0,7
79916,Acquired hallux rigidus,ethnic,Hispanic or Latino,7,0,7
79916,Acquired hallux rigidus,racial,White,7,0,7
434894,Acute post-hemorrhagic anemia,racial,Unknown,7,0,7
435243,Alcohol dependence,racial,American Indian,0,7,7
437838,"Cannabis dependence, episodic",racial,White,5,2,7
440360,Pure hyperglyceridemia,racial,Asian Indian,5,2,7
194682,Bilateral inguinal hernia with obstruction but no gangrene,ethnic,Not Hispanic or Latino,0,7,7
134144,Cleft palate with cleft lip,racial,Unknown,0,7,7
78473,Solitary cyst of breast,racial,American Indian or Alaska Native ,7,0,7
192676,Cervical intraepithelial neoplasia grade 1,racial,Black or African American ,7,0,7
197724,Unilateral traumatic amputation of foot without complication,racial,Unknown,0,7,7
434316,von Willebrand disorder,racial,Asian,7,0,7
439666,Contracture of multiple joints,racial,Unknown,5,2,7
4210151,HIV counseling,racial,Native Hawaiian or Other Pacific Islander ,7,0,7
198263,Right upper quadrant pain,racial,Native Hawaiian or Other Pacific Islander ,2,5,7
255919,Finding of head and neck region,racial,Asian,5,2,7
193242,Perforation of intestine,racial,Other Race,0,7,7
442601,Sedative abuse,ethnic,Not Hispanic or Latino,2,5,7
376419,Haematoma of pinna,racial,White,5,2,7
377910,Deviated nasal septum,racial,Other Race,0,7,7
4064359,Cholera screening,racial,White,0,7,7
381857,Impairment level: one eye: total impairment: other eye: not specified,racial,American Indian or Alaska Native ,7,0,7
443943,Herpes zoster,ethnic,Not Hispanic or Latino,2,5,7
374034,Visual disturbance,racial,Filipino,7,0,7
4330220,Family history of malignant neoplasm of genital structure,ethnic,Hispanic or Latino,7,0,7
79127,Congenital spondylolisthesis,racial,Asian,7,0,7
197607,Polymenorrhagia,racial,Filipino,7,0,7
80494,Arthropathy associated with another disorder,ethnic,Hispanic or Latino,2,5,7
74740,Accessory digit,ethnic,Hispanic or Latino,0,7,7
194686,Acquired renal cyst,racial,American Indian or Alaska Native ,7,0,7
375291,Bullous myringitis,racial,Unknown,2,5,7
438725,Disorder of magnesium metabolism,racial,Asian,7,0,7
75954,Sprain of interphalangeal joint of finger,ethnic,Not Hispanic or Latino,2,5,7
198313,Burn erythema of abdominal wall,ethnic,Hispanic or Latino,5,2,7
436072,Bipolar disorder in partial remission,racial,American Indian or Alaska Native ,7,0,7
433976,Primary malignant neoplasm of temporal lobe,ethnic,Hispanic or Latino,7,0,7
375828,Patulous eustachian tube,ethnic,Hispanic or Latino,2,5,7
200444,Post-cholecystectomy syndrome,racial,Unknown,5,2,7
440916,Burn to wrist/hand - blister,racial,Unknown,2,5,7
197601,Spermatocele,ethnic,Not Hispanic or Latino,0,7,7
434614,Disorder of iron metabolism,ethnic,Hispanic or Latino,5,2,7
432310,Meningitis due to cryptococcus,racial,Unknown,0,7,7
198645,Third degree burn of lower limb,racial,White,0,7,7
438130,Opioid abuse,ethnic,Hispanic or Latino,2,5,7
74187,Sprain of coracohumeral ligament,ethnic,Hispanic or Latino,0,7,7
73575,Deformity of toe,ethnic,Not Hispanic or Latino,2,5,7
4113683,Spontaneous abortion unspecified,ethnic,Hispanic or Latino,7,0,7
376105,Krampfe salaam attacks,racial,Asian,2,5,7
374372,Otogenic otalgia,ethnic,Not Hispanic or Latino,7,0,7
435299,Failure of dental prosthesis,racial,Asian,0,7,7
198101,Lipoma of skin and subcutaneous tissue (excluding face),racial,American Indian or Alaska Native ,7,0,7
137057,Paronychia,racial,American Indian or Alaska Native ,2,5,7
195223,Renal carnitine transport defect,racial,White,5,2,7
78193,Epididymo-orchitis,racial,Other Race,0,7,7
4318718,Limitation of movement of temporomandibular joint,ethnic,Hispanic or Latino,7,0,7
380731,OE - Otitis externa,racial,Black or African American ,0,7,7
192577,Carcinoma in situ of female genital organ,racial,White,7,0,7
437902,Teeth development and eruption disorders,racial,Other Race,5,2,7
374645,Phantom limb syndrome,racial,White,5,2,7
135722,Chronic infection of amputation stump,ethnic,Not Hispanic or Latino,0,7,7
443629,Generalised abdominal tenderness,ethnic,Hispanic or Latino,0,7,7
438067,Malaria,ethnic,Not Hispanic or Latino,2,5,7
259153,Throat soreness,racial,Native Hawaiian or Other Pacific Islander ,2,5,7
192885,Tarsal tunnel syndrome,ethnic,Not Hispanic or Latino,7,0,7
259848,Chronic rhinitis,racial,American Indian or Alaska Native ,5,2,7
253790,Pneumonia due to Klebsiella pneumoniae,racial,White,0,7,7
4100367,Simple schizophrenia NOS,racial,Asian,7,0,7
437523,Dependent personality disorder,racial,White,0,7,7
442110,Benign neoplasm of nasal sinus,ethnic,Hispanic or Latino,5,2,7
435023,Mild hyperemesis-not delivered,racial,Black or African American ,7,0,7
435633,Juvenile osteochondrosis of upper extremity,ethnic,Hispanic or Latino,7,0,7
81936,Monoarthritis,ethnic,Not Hispanic or Latino,5,2,7
436289,Non-medicinal agent causing toxic effects,racial,White,0,7,7
441262,"Amfetamine or psychostimulant dependence, episodic",racial,Asian,0,7,7
373449,Drug-induced delirium,ethnic,Hispanic or Latino,7,0,7
376969,Orofacial dyskinesia,racial,Unknown,7,0,7
317299,Disorder of vitreous body,racial,Unknown,5,2,7
437741,Accidental burning caused by caustic and corrosive substance,racial,White,0,7,7
193136,Acute gonococcal cervicitis,ethnic,Hispanic or Latino,7,0,7
4064061,Other skin and subcutaneous tissue disorders,racial,White,5,2,7
321483,Respiratory complication,ethnic,Hispanic or Latino,2,5,7
435849,Parietoalveolar pneumopathy,racial,Unknown,0,7,7
4167069,Aneurysm clipping,ethnic,Not Hispanic or Latino,7,0,7
31317,Can't get food down,racial,American Indian or Alaska Native ,7,0,7
375545,Lens opacity,racial,American Indian,7,0,7
4028827,Manual examination of breast,racial,Unknown,7,0,7
437643,Gait abnormality,racial,Alaska Native,7,0,7
77421,Open wound of hand except fingers without complication,racial,Asian,0,7,7
192367,Dysplasia of cervix,racial,Other Race,7,0,7
436140,Vulval varices,racial,Unknown,7,0,7
444433,Open wound of toe with complication,racial,White,2,5,7
201061,Diaphragmatic hernia,racial,Asian,7,0,7
373182,Amyotrophic lateral sclerosis,racial,White,5,2,7
440953,Cysticercosis,racial,Unknown,7,0,7
435786,Disorder of sleep-wake cycle,racial,White,5,2,7
376709,Discharge of eye,racial,Black or African American ,5,2,7
440085,Schizoid personality disorder,ethnic,Hispanic or Latino,5,2,7
433244,Tooth loss,racial,White,5,2,7
197332,Incomplete uterovaginal prolapse,racial,Other Race,7,0,7
73923,"Contusion, upper arm",racial,Other Race,7,0,7
443367,Antihypertensive adverse reaction,racial,White,5,2,7
437226,Malignant neoplasm of nasopharyngeal wall,ethnic,Hispanic or Latino,0,7,7
443452,Bleeding of unknown origin,ethnic,Not Hispanic or Latino,7,0,7
4149382,Endocrine/metabolic screening,racial,Other Race,0,7,7
194981,Bilateral femoral hernia without obstruction AND without gangrene,racial,Unknown,7,0,7
434782,Closed fracture of tibia AND fibula,racial,Other Race,7,0,7
4026149,Other cholecystitis,racial,White,7,0,7
441647,Continuing pregnancy after intrauterine death of twin fetus,ethnic,Hispanic or Latino,7,0,7
133147,Primary malignant neoplasm of skin of trunk,racial,Asian,0,7,7
443237,"Manic disorder, single episode",racial,Filipino,0,7,7
4224000,Transposition of pterygium,ethnic,Hispanic or Latino,7,0,7
4167075,Fusion of knee,ethnic,Not Hispanic or Latino,7,0,7
27321,Persistent vomiting,racial,Other Race,2,5,7
73026,Abnormal respiratory sounds,racial,Other Race,0,7,7
258482,Abscess of Bartholin's gland,ethnic,Not Hispanic or Latino,7,0,7
432311,Angle-closure glaucoma - borderline,ethnic,Not Hispanic or Latino,0,7,7
432296,Coagulation factor deficiency syndrome,ethnic,Hispanic or Latino,5,2,7
4018734,Sprain of costal cartilage,racial,Asian,7,0,7
4092669,Other viral exanthemata,racial,White,0,7,7
78835,Palindromic rheumatism of the lower leg,racial,Native Hawaiian or Other Pacific Islander ,0,7,7
196347,Intestinal parasitism,ethnic,Not Hispanic or Latino,5,2,7
437013,"Primary dental caries, pit and fissure origin",racial,Black or African American ,0,7,7
442752,Myalgia,racial,Filipino,2,5,7
4093460,Leptospirosis NOS,ethnic,Hispanic or Latino,5,2,7
440068,Psychosexual dysfunction,racial,Unknown,0,7,7
133367,Second degree burn of wrist,racial,White,7,0,7
377870,Heterotropia,ethnic,Hispanic or Latino,7,0,7
434165,Abnormal cervical smear,racial,Other Race,7,0,7
4056171,Prostatic hyperplasia NOS,ethnic,Not Hispanic or Latino,0,7,7
438329,Late effect of motor vehicle accident,racial,Other Race,7,0,7
433556,Derangement of posterior horn of lateral meniscus,racial,Unknown,0,7,7
437896,Disorder of language,racial,Unknown,7,0,7
254320,Cystic fibrosis of the lung,racial,White,7,0,7
4112954,Unspecified spontaneous abortion without mention of complication,racial,Unknown,7,0,7
4237140,Abnormal sexual function,racial,Unknown,0,7,7
138718,Thyrotoxicosis from ectopic thyroid nodule with no crisis,ethnic,Not Hispanic or Latino,5,2,7
313459,Sleep apnea,racial,Native Hawaiian or Other Pacific Islander ,0,7,7
314968,Varices,racial,Black or African American ,0,7,7
73557,Allergic arthritis of the pelvic region and thigh,racial,White,7,0,7
193402,Bacterial enteritis,ethnic,Hispanic or Latino,5,2,7
141932,Senile hyperkeratosis,racial,American Indian or Alaska Native ,7,0,7
4169658,No help available,racial,White,5,2,7
434073,Loss of teeth - acquired,racial,Asian,0,7,7
433894,Open fracture of phalanx of toe,racial,White,7,0,7
80852,Closed fracture of four ribs,ethnic,Hispanic or Latino,2,5,7
134681,Spasm of oesophagus,ethnic,Not Hispanic or Latino,7,0,7
441846,After-cataract not obscuring vision,racial,White,7,0,7
381865,Sensorimotor disorder of eyelid,racial,Unknown,5,2,7
73872,Congenital deformity of knee joint,racial,White,2,5,7
4062801,Threatened abortion NOS,ethnic,Hispanic or Latino,7,0,7
134304,Benign tumour of parathyroid gland,ethnic,Not Hispanic or Latino,7,0,7
197924,Bile duct calculus with acute cholecystitis and obstruction,racial,White,5,2,7
435796,Dehydration,racial,Filipino,7,0,7
4230975,Acquired deformity of the abdomen,racial,Asian,7,0,7
197324,Disease of peritoneum,racial,White,5,2,7
373204,Conjunctival xerosis,racial,Unknown,5,2,7
439273,"Single manic episode, mild",ethnic,Not Hispanic or Latino,7,0,7
444435,Superficial injury of elbow without infection,ethnic,Hispanic or Latino,2,5,7
440964,Hodgkin's paragranuloma of extranodal AND/OR solid organ site,racial,White,0,7,7
378439,Fourth nerve palsy,racial,White,5,2,7
4133029,Primigravida,racial,Filipino,7,0,7
4030270,Proliferative polycythemia,racial,Asian,2,5,7
40480002,Aphasia as late effect of cerebrovascular disease,racial,Other Race,0,7,7
320682,Finding of white blood cell number,racial,Asian,0,7,7
4024013,Sensory nervous system finding,ethnic,Not Hispanic or Latino,2,5,7
372925,Cholesteatoma,racial,Unknown,0,7,7
138538,Longitudinal deficiency of limb,racial,White,7,0,7
433773,Chronic orbital inflammation,racial,White,0,7,7
195363,Congenital anomaly of kidney,racial,Asian,7,0,7
440785,Vomiting of pregnancy,racial,Unknown,7,0,7
435011,Vulvar vestibulitis,ethnic,Hispanic or Latino,7,0,7
373786,Abnormal vision,racial,Black or African American ,7,0,7
438170,Acute myocardial infarction of inferior wall,racial,Unknown,7,0,7
437902,Teeth development and eruption disorders,racial,Black or African American ,0,7,7
374639,Chronic headache disorder,ethnic,Not Hispanic or Latino,7,0,7
4108358,Transient cerebral ischaemia NOS,ethnic,Hispanic or Latino,7,0,7
444132,Knee injury,racial,American Indian or Alaska Native ,5,2,7
133794,Chronic gingivitis,racial,Black or African American ,5,2,7
73036,Closed fracture of olecranon process of ulna,ethnic,Not Hispanic or Latino,0,7,7
30978,Hereditary leptocytosis,racial,Black or African American ,7,0,7
141056,Acute ethmoidal sinusitis,racial,Asian,5,2,7
40480435,Spastic hemiplegia of nondominant side,racial,White,0,7,7
194913,Idiopathic peripheral autonomic neuropathy,racial,White,5,2,7
436089,"Nondependent cocaine abuse, episodic",racial,White,2,5,7
134074,Oral soft tissue cellulitis,racial,Asian,2,5,7
373769,Nuclear cataract,racial,White,5,2,7
4202322,Amputated big toe,racial,Other Race,0,7,7
140352,AML - Acute myeloid leukemia,ethnic,Hispanic or Latino,5,2,7
80241,Closed fracture navicular,ethnic,Not Hispanic or Latino,7,0,7
134780,Closed dislocation of metatarsal joint,ethnic,Hispanic or Latino,2,5,7
141004,Lesion of radial nerve,ethnic,Not Hispanic or Latino,7,0,7
137658,Congenital pigmentary anomaly of skin,ethnic,Not Hispanic or Latino,5,2,7
441793,Infection due to Class Cestoda and/or Class Trematoda and/or Phylum Nemata,ethnic,Not Hispanic or Latino,2,5,7
436826,Closed fracture of shaft of radius,racial,White,2,5,7
4204967,Laryngismus,racial,White,2,5,7
440710,IRMA - Intraretinal microvascular abnormality,racial,Unknown,2,5,7
138994,MDS - Myelodysplastic syndrome,ethnic,Not Hispanic or Latino,7,0,7
439702,Residual infantile autism,racial,Unknown,0,7,7
138604,"Contusion of face, scalp and neck, excluding eye(s)",racial,Native Hawaiian or Other Pacific Islander ,2,5,7
434170,Atypical squamous cells of undetermined significance on cervical Papanicolaou smear,racial,American Indian or Alaska Native ,7,0,7
137750,Second degree burn of forehead AND/OR cheek,racial,Black or African American ,0,7,7
81148,Open Monteggia's fracture,ethnic,Not Hispanic or Latino,7,0,7
379009,Retinopathy of prematurity stage 3 - ridge with extraretinal fibrovascular proliferation,ethnic,Hispanic or Latino,7,0,7
443789,Victim of trauma,ethnic,Hispanic or Latino,7,0,7
75911,Acquired hallux valgus,racial,Asian,7,0,7
312437,Dyspnea,racial,Native Hawaiian or Other Pacific Islander ,7,0,7
441835,Chronic schizoaffective schizophrenia,racial,Black or African American ,7,0,7
196442,Chronic gastric ulcer with hemorrhage AND with perforation but without obstruction,racial,Other Race,7,0,7
200450,Disease of urethra,racial,Other Race,2,5,7
40484952,Retinal function study abnormal,ethnic,Hispanic or Latino,2,5,7
198978,Acute gonorrhea of lower genitourinary tract,racial,Black or African American ,5,2,7
200391,Peripheral autonomic neuropathy disease EC,racial,American Indian or Alaska Native ,0,7,7
376691,Delimited old retinal detachment,racial,White,2,5,7
372328,Otitis media,racial,Asian Indian,2,5,7
138592,Open wound of lip with complication,racial,Unknown,5,2,7
374640,Exudative retinal detachment,ethnic,Hispanic or Latino,7,0,7
439081,Premenstrual tension syndrome,racial,Asian,7,0,7
433909,Foreign body on external eye,ethnic,Not Hispanic or Latino,5,2,7
77638,Displacement of intervertebral disc without myelopathy,racial,Black or African American ,7,0,7
436421,"Mixed conductive and sensorineural hearing loss, bilateral",racial,White,2,5,7
75103,Sprain of jaw,racial,Asian,7,0,7
138676,Gram negative septicemia,ethnic,Hispanic or Latino,5,2,7
4178898,Economic problem,ethnic,Hispanic or Latino,5,2,7
136368,Non-toxic multinodular goiter,racial,Other Race,0,7,7
196821,Observation of urethral discharge,racial,Unknown,0,7,7
4114451,"Localized, primary osteoarthritis of unspecified site",ethnic,Hispanic or Latino,7,0,7
438668,Accidents due to travel and motion,ethnic,Hispanic or Latino,2,5,7
441615,Trigonitis,ethnic,Hispanic or Latino,7,0,7
30284,Motion sickness,racial,Asian,5,2,7
433456,Acute pain,racial,Filipino,2,5,7
194682,Bilateral inguinal hernia with obstruction but no gangrene,racial,Unknown,0,7,7
194081,Acute cystitis,racial,Native Hawaiian or Other Pacific Islander ,7,0,7
4030270,Proliferative polycythemia,racial,Other Race,0,7,7
435120,Blister of toe with infection,ethnic,Not Hispanic or Latino,5,2,7
193519,Impaired renal function disorder,racial,Unknown,2,5,7
372605,Spinal muscular atrophy,ethnic,Hispanic or Latino,0,7,7
441334,Glossodynia,ethnic,Not Hispanic or Latino,0,7,7
434143,Anophthalmos,racial,White,5,2,7
4222896,Chronic duodenal ulcer without haemorrhage AND without perforation,racial,Unknown,7,0,7
192357,Paralytic ileus,ethnic,Not Hispanic or Latino,5,2,7
434547,Complication of surgical procedure,racial,Unknown,7,0,7
72459,Closed fracture of two ribs,racial,Unknown,7,0,7
201072,Benign prostatic hypertrophy without outflow obstruction,racial,Other Race,0,7,7
4061214,Ulceration of vulva NOS,racial,White,7,0,7
137627,Prickly heat,racial,Asian,2,5,7
134741,Congenital anomaly of limb,ethnic,Hispanic or Latino,2,5,7
433949,Human bite,ethnic,Hispanic or Latino,0,7,7
376411,Central pterygium,racial,White,2,5,7
438977,"Primary malignant neoplasm of ribs, sternum and clavicle",ethnic,Not Hispanic or Latino,7,0,7
78472,Microscopic haematuria,racial,Black or African American ,0,7,7
381732,Nerve injury,racial,Unknown,7,0,7
80232,Closed fracture of calcaneus,racial,Unknown,0,7,7
133810,Secondary hyperparathyroidism of renal origin,racial,Black or African American ,2,5,7
138682,Herpes zoster auricularis,racial,White,5,2,7
196436,Internal haemorrhoid,racial,American Indian or Alaska Native ,0,7,7
254980,Intrinsic asthma with asthma attack,racial,Other Race,5,2,7
73065,"Contusion, genital organs",racial,White,7,0,7
442752,Myalgia,racial,Native Hawaiian or Other Pacific Islander ,2,5,7
4204904,Education about sexually transmitted disease prevention,racial,Native Hawaiian or Other Pacific Islander ,7,0,7
432596,Immune defect,ethnic,Hispanic or Latino,0,7,7
133278,Disorder of hair,racial,Asian,7,0,7
374948,Acute nonsuppurative otitis media,racial,Black or African American ,2,5,7
4194160,Thyroid function tests abnormal,racial,American Indian or Alaska Native ,7,0,7
440063,"Benign neoplasm of pancreas, excluding islets of Langerhans",ethnic,Hispanic or Latino,0,7,7
4129482,Ovary observations,racial,White,7,0,7
4109880,Varicose veins of the leg with ulcer,racial,Filipino,7,0,7
435754,Ca ascending colon,ethnic,Hispanic or Latino,0,7,7
435150,Effects of heat AND/OR light,racial,Unknown,7,0,7
443580,Systolic heart failure,racial,Black or African American ,5,2,7
377290,Legal blindness USA,racial,Asian,5,2,7
380839,TS - Tuberous sclerosis,racial,Other Race,0,7,7
78497,Cellulitis and abscess of toe,racial,Black or African American ,5,2,7
434822,Complication of internal prosthetic device,racial,Unknown,5,2,7
432311,Angle-closure glaucoma - borderline,racial,Asian,0,7,7
195603,Vulval and/or perineal noninflammatory disorders,racial,Other Race,7,0,7
197913,Disorder of function of stomach,racial,Native Hawaiian or Other Pacific Islander ,5,2,7
440751,Peritonsillar abscess,racial,Asian,0,7,7
439655,Symptom: generalized,racial,Black or African American ,0,7,7
317305,Stricture of artery,ethnic,Not Hispanic or Latino,0,7,7
194151,Congenital anomaly of stomach,ethnic,Hispanic or Latino,0,7,7
200319,Herpetic infection of penis,racial,White,0,7,7
441929,Varicose veins of perineum and vulva in pregnancy and the puerperium with antenatal complication,ethnic,Hispanic or Latino,7,0,7
4194056,"Simple partial seizure, consciousness not impaired",racial,Unknown,0,7,7
438559,Abnormal vaginal Papanicolaou smear,racial,Unknown,7,0,7
313005,Congenital stenosis of pulmonary valve,ethnic,Not Hispanic or Latino,7,0,7
436299,Fall from one level to another,racial,Unknown,2,5,7
137065,Nonstageable pressure ulcer,racial,White,7,0,7
137652,Specific bursitis often of occupational origin,racial,White,0,7,7
373198,Unqualified visual loss of both eyes,racial,Black or African American ,5,2,7
380038,Viral conjunctivitis,racial,Asian,0,7,7
437699,Strain of infraspinatus muscle AND/OR tendon,racial,White,0,7,7
372324,Eustachian tube disorder,racial,American Indian,5,2,7
377560,Internal hordeolum,racial,Black or African American ,7,0,7
380944,Adenoviral pharyngoconjunctivitis,ethnic,Hispanic or Latino,5,2,7
25844,Ulcer of esophagus,ethnic,Not Hispanic or Latino,7,0,7
132740,Positive skin test reaction,racial,Filipino,5,2,7
140821,Spasm,racial,Native Hawaiian or Other Pacific Islander ,2,5,7
4098297,Unspecified latent schizophrenia,racial,White,7,0,7
137856,Atypical facial pain,racial,Unknown,5,2,7
436027,Coxsackie virus disease,ethnic,Not Hispanic or Latino,2,5,7
440612,Toxic effect of tobacco and nicotine,racial,Unknown,7,0,7
374371,Stenosis of precerebral artery,racial,Unknown,0,7,7
434750,Feeding difficulties and mismanagement,racial,Native Hawaiian or Other Pacific Islander ,2,5,7
4138253,Malabsorption syndrome,racial,Unknown,5,2,7
138455,Stomatitis,ethnic,Not Hispanic or Latino,5,2,7
372912,Visual discomfort,racial,Asian,0,7,7
197444,Vascular complication of medical care,racial,Unknown,7,0,7
444445,Benign neoplasm of skin of leg,racial,Other Race,5,2,7
74464,Idiopathic scoliosis AND/OR kyphoscoliosis,racial,Filipino,7,0,7
376405,Binocular vision disorder,ethnic,Hispanic or Latino,0,7,7
80242,Current tear of medial cartilage AND/OR meniscus of knee,racial,Other Race,2,5,7
318222,Acute adenitis,racial,Black or African American ,5,2,7
436375,Sodium and water depletion,ethnic,Not Hispanic or Latino,0,7,7
4333977,Acquired anophthalmos,racial,Black or African American ,0,7,7
441838,Personality disorder,racial,Black or African American ,7,0,7
134681,Spasm of oesophagus,ethnic,Hispanic or Latino,0,7,7
436700,Eye displaced forwards,racial,Other Race,7,0,7
136057,Benign neoplasm of skin of trunk,racial,Black or African American ,5,2,7
4230642,Acquired deformity of chest,racial,Filipino,7,0,7
435928,Abnormal decrease in weight,racial,Native Hawaiian or Other Pacific Islander ,2,5,7
436089,"Nondependent cocaine abuse, episodic",racial,Unknown,0,7,7
440464,Complication following molar AND/OR ectopic pregnancy,racial,Unknown,7,0,7
313780,Mobitz type 2 second degree atrioventricular block,racial,Unknown,2,5,7
193070,Blister of trunk with infection,ethnic,Not Hispanic or Latino,7,0,7
134312,Iatrogenic hypothyroidism,racial,Other Race,7,0,7
199855,Acute gastric ulcer with hemorrhage AND with perforation but without obstruction,ethnic,Hispanic or Latino,0,7,7
444438,Leucoplakia of tongue,racial,Other Race,0,7,7
137648,Osteomyelitis of hand,ethnic,Hispanic or Latino,5,2,7
438350,Pneumocystosis,racial,Black or African American ,0,7,7
4092562,Reduction deformity of arm,ethnic,Hispanic or Latino,7,0,7
315564,Aortic valve regurgitation,racial,Unknown,5,2,7
194696,Menorrhalgia,racial,Native Hawaiian or Other Pacific Islander ,7,0,7
139202,"Burn involving 20-29 percent of body surface, with 10-19 percent of body surface with full thickness burn",ethnic,Hispanic or Latino,7,0,7
379822,Cyst of eyelid,ethnic,Not Hispanic or Latino,0,7,7
134870,Pityriasis versicolor,racial,American Indian or Alaska Native ,7,0,7
4062637,TB - Tuberculosis screening,racial,Asian Indian,2,5,7
4192676,Born by caesarean section,ethnic,Hispanic or Latino,0,7,7
73153,Malignant neoplasm of lateral wall of urinary bladder,ethnic,Hispanic or Latino,0,7,7
380402,Central corneal ulcer,ethnic,Hispanic or Latino,7,0,7
440142,Disease of mediastinum,racial,White,7,0,7
194981,Bilateral femoral hernia without obstruction AND without gangrene,racial,White,0,7,7
372646,"Peripheral pterygium, stationary",ethnic,Not Hispanic or Latino,2,5,7
443776,Brachial radiculitis,racial,Other Race,5,2,7
4088930,Confirmation of pregnancy,racial,American Indian or Alaska Native ,7,0,7
73019,Breast engorgement in newborn,ethnic,Hispanic or Latino,0,7,7
192385,"Tumour of uterine body complicating antenatal care, baby not yet delivered",racial,White,7,0,7
437175,"Fall on same level from slipping, tripping or stumbling",racial,Other Race,7,0,7
4104016,Ts and As - Tonsillectomy and adenoidectomy,racial,White,2,5,7
374350,Granuloma of conjunctiva,racial,White,7,0,7
436091,BM - Bacterial meningitis,racial,White,7,0,7
139902,Allergic urticaria,racial,American Indian or Alaska Native ,5,2,7
80204,IUGR - Intrauterine growth retardation,racial,White,5,2,7
4323962,"Electrocardiogram, rhythm",ethnic,Hispanic or Latino,0,7,7
440787,"Drug dependence in mother complicating pregnancy, childbirth AND/OR puerperium",racial,Unknown,7,0,7
381866,Degenerative disorder of eyelid,ethnic,Hispanic or Latino,5,2,7
379012,Monoplegia of upper limb,racial,Black or African American ,7,0,7
4161978,Patient on oxygen,racial,Asian,5,2,7
132483,"Insect bite, nonvenomous, of hand, infected",ethnic,Hispanic or Latino,0,7,7
443750,Nonvenomous insect bite of finger without infection,ethnic,Hispanic or Latino,5,2,7
80946,Tinea manus,racial,Other Race,0,7,7
436136,Dissection of thoracic aorta,ethnic,Hispanic or Latino,0,7,7
4150157,Other anemias,racial,Unknown,0,7,7
75311,Fibrosclerosis of breast,ethnic,Hispanic or Latino,7,0,7
133444,Thyroiditis,racial,Asian,2,5,7
4332993,Childhood schizophrenia NOS,racial,Unknown,0,7,7
72786,Burn of finger,ethnic,Hispanic or Latino,5,2,7
197605,Inflammatory disorder of male genital organ,racial,Unknown,0,7,7
315922,Patent ductus arteriosus,racial,American Indian or Alaska Native ,0,7,7
437689,Multiple closed fractures of cervical vertebrae,racial,White,0,7,7
435951,"Closed fracture of tibia and fibula, shaft",racial,White,0,7,7
433742,Latent schizophrenia,ethnic,Hispanic or Latino,0,7,7
138384,Acquired hypothyroidism,racial,Other Race,7,0,7
436446,Cracked tooth syndrome,racial,Other Race,0,7,7
77373,Congenital deformity of hip joint,racial,Unknown,0,7,7
444258,Abrasion AND/OR friction burn of neck with infection,ethnic,Not Hispanic or Latino,2,5,7
434156,Congenital anemia,racial,White,0,7,7
319845,Pulmonary valve disease,racial,Other Race,5,2,7
4243973,Laparoscopic appendectomy,racial,Unknown,7,0,7
440977,Megaloblastic anemia due to folate deficiency,ethnic,Not Hispanic or Latino,2,5,7
73045,Hand sprain,racial,Asian,2,5,7
201674,Congenital anomaly of pancreas,ethnic,Hispanic or Latino,2,5,7
26378,Hyperpituitarism,racial,Asian,7,0,7
192683,Uterovaginal prolapse,ethnic,Not Hispanic or Latino,7,0,7
72986,Disease of lower leg,racial,Asian,0,7,7
436635,Primary malignant neoplasm of sigmoid colon,ethnic,Hispanic or Latino,0,7,7
4129665,Hearing aid care,ethnic,Hispanic or Latino,7,0,7
80294,Foreign body in genitourinary tract,ethnic,Hispanic or Latino,7,0,7
443767,Diabetic oculopathy,racial,American Indian,7,0,7
376124,Pinguecula,racial,Black or African American ,2,5,7
381854,Disorder of conjunctiva,racial,Other Race,7,0,7
315078,Palpitations,racial,Asian Indian,2,5,7
74138,Pathological fracture of vertebra,racial,Asian,7,0,7
4104157,Genital observation,racial,Unknown,0,7,7
198810,Vulval intraepithelial neoplasia grade 2,racial,White,7,0,7
439197,Nonvenomous insect bite of neck with infection,racial,White,5,2,7
441680,Fetus OR newborn affected by multiple pregnancy,ethnic,Hispanic or Latino,7,0,7
199066,Female digestive-genital tract fistula,ethnic,Not Hispanic or Latino,7,0,7
201613,Chronic nonalcoholic liver disease,racial,American Indian or Alaska Native ,7,0,7
4152813,Family disruption,racial,Asian,2,5,7
375258,Photokeratitis,ethnic,Hispanic or Latino,5,2,7
256810,Choanal atresia,ethnic,Hispanic or Latino,0,7,7
314369,Malignant hypertensive heart disease without congestive heart failure,ethnic,Not Hispanic or Latino,2,5,7
440856,Open fracture of shaft of femur,ethnic,Hispanic or Latino,0,7,7
437920,Spontaneous abortion complicated by genital-pelvic infection,ethnic,Hispanic or Latino,7,0,7
199079,Hypertrophy of clitoris,racial,White,7,0,7
435799,Adjustment disorder with disturbance of conduct,racial,White,0,7,7
80497,Disorder of cervical spine,racial,Black or African American ,5,2,7
74127,Elbow joint contracture,racial,Unknown,0,7,7
443864,Multi-infarct dementia with depression,ethnic,Not Hispanic or Latino,7,0,7
435940,"Closed fracture of humerus, shaft",ethnic,Not Hispanic or Latino,0,7,7
194878,Nodular lymphoma of extranodal AND/OR solid organ site,racial,White,2,5,7
381865,Sensorimotor disorder of eyelid,racial,White,2,5,7
26638,Primary malignant neoplasm of oesophagus,racial,Unknown,7,0,7
140641,Verruca vulgaris,racial,American Indian,2,5,7
78831,Disease of ankle,racial,Asian,7,0,7
74635,Lumbosacral root lesion,racial,Asian,2,5,7
258458,Bacterial pleurisy with effusion,ethnic,Hispanic or Latino,7,0,7
439790,Psychalgia,ethnic,Hispanic or Latino,2,5,7
4179963,Family history of malignant neoplasm of breast,racial,Other Race,7,0,7
438306,Poisoning by psychodysleptic,ethnic,Hispanic or Latino,0,7,7
319041,Orthostatic hypotension,racial,American Indian or Alaska Native ,0,7,7
73231,Arthralgia of temporomandibular joint,racial,Asian,7,0,7
441947,Posttraumatic state,ethnic,Hispanic or Latino,7,0,7
321109,Congenital anomaly of coronary artery,racial,White,0,7,7
372425,Congenital abnormality of ear,racial,Black or African American ,7,0,7
140214,Eruption of skin,racial,Asian Indian,5,2,7
138667,Stoma observations,racial,White,0,7,7
434904,Persistent hypersomnia,racial,Unknown,7,0,7
132491,Contusion of scapular region,racial,White,7,0,7
434630,Sleep rhythm problem,ethnic,Hispanic or Latino,0,7,7
374498,Concussion with prolonged loss of consciousness AND return to pre-existing conscious level,ethnic,Hispanic or Latino,7,0,7
4100515,Cocaine type drug dependence,racial,White,0,7,7
433454,Adjustment disorder with mixed emotional features,racial,Other Race,7,0,7
321661,Spinal stenosis of thoracic region,racial,White,5,2,7
375393,Laceration of skin of eyelid AND periocular area,racial,White,2,5,7
80819,Acquired hallux varus,ethnic,Hispanic or Latino,7,0,7
372599,Severe mixed bipolar I disorder without psychotic features,ethnic,Not Hispanic or Latino,7,0,7
132449,Transient limb paralysis,racial,White,2,5,7
138616,Superficial burn of hand,racial,Unknown,2,5,7
433633,Late effect of superficial injury,racial,Unknown,7,0,7
437614,Early onset of delivery,ethnic,Not Hispanic or Latino,7,0,7
40490434,Abnormal arterial blood gas,racial,Unknown,5,2,7
73574,Nonunion of fracture,racial,White,7,0,7
378679,Acute poliomyelitis,racial,Other Race,0,7,7
433992,"Bipolar affective disorder, currently manic, moderate",racial,Unknown,7,0,7
198964,Chronic type C viral hepatitis,racial,Native Hawaiian or Other Pacific Islander ,0,7,7
24134,Nonspecific pain in the neck region,racial,Native Hawaiian or Other Pacific Islander ,0,7,7
260759,Malocclusion of teeth,racial,White,5,2,7
437892,Lown-Ganong-Levine syndrome,ethnic,Hispanic or Latino,7,0,7
22281,Sickle cell disease,racial,White,2,5,7
439080,Dyspareunia,racial,Black or African American ,7,0,7
432588,Megaloblastic anemia due to vitamin B>12< deficiency,racial,American Indian or Alaska Native ,7,0,7
201927,Cellulitis and abscess of leg,racial,Black or African American ,7,0,7
378425,Eyelid inflammation,racial,Black or African American ,5,2,7
438648,Vitamin poisoning,ethnic,Hispanic or Latino,7,0,7
80573,Contusion of ankle,racial,Other Race,2,5,7
315286,Chronic ischemic heart disease,racial,Filipino,0,7,7
4084229,Primary gout,racial,Native Hawaiian or Other Pacific Islander ,0,7,7
442167,Neoplasm of uncertain behaviour of craniopharyngeal duct,ethnic,Not Hispanic or Latino,7,0,7
433400,Emergency contraception,racial,Other Race,7,0,7
261116,Acquired nasal deformity,ethnic,Not Hispanic or Latino,2,5,7
4120610,Carrier of hereditary factor VIII deficiency disease,ethnic,Hispanic or Latino,0,7,7
4051114,FH: Diabetes mellitus,racial,American Indian or Alaska Native ,2,5,7
381664,Algoneurodystrophy,racial,White,7,0,7
441628,Menopausal and postmenopausal disorders,racial,Asian,7,0,7
314658,Cardiomegaly,racial,American Indian,0,7,7
199891,RI - Rhesus isoimmunisation,ethnic,Hispanic or Latino,7,0,7
433410,Primary syphilis,ethnic,Hispanic or Latino,0,7,7
201621,Chronic cystitis,racial,Asian,2,5,7
4171434,Immunization refused,racial,Black or African American ,2,5,7
4281232,Type B viral hepatitis,racial,Asian,0,7,7
434063,Jaw to cranial base anomaly,racial,Asian,0,7,7
442589,Superficial foreign body of wrist without major open wound AND without infection,racial,White,0,7,7
320536,Abnormal EKG finding,racial,American Indian,2,5,7
200445,Chronic prostatitis,racial,Black or African American ,0,7,7
136834,Closed intertrochanteric fracture,ethnic,Not Hispanic or Latino,7,0,7
4059173,Fracture of ankle,racial,White,5,2,7
4103915,Optic neuritis NOS,racial,Unknown,7,0,7
378001,Concussion with no loss of consciousness,racial,White,7,0,7
375827,Acute non-suppurative otitis media - serous,racial,American Indian or Alaska Native ,7,0,7
374342,Headache associated with sexual activity,ethnic,Hispanic or Latino,7,0,7
318247,Apnea in the newborn,ethnic,Not Hispanic or Latino,2,5,7
4269584,Finding relating to religious movement or belief,racial,Unknown,7,0,7
443360,Eye mass,ethnic,Not Hispanic or Latino,7,0,7
4319150,Pulled elbow,ethnic,Not Hispanic or Latino,7,0,7
321319,Cardiomyopathy,racial,Filipino,0,7,7
436682,Moderate mental handicap,racial,Black or African American ,7,0,7
436080,"Neoplasm of uncertain behaviour of lip, oral cavity and pharynx",racial,White,2,5,7
437342,Abnormality of forces of labor,racial,Unknown,7,0,7
4084229,Primary gout,racial,Black or African American ,2,5,7
192687,Vulvovaginitis associated with another disease,ethnic,Not Hispanic or Latino,7,0,7
443865,Non-infective colitis,racial,Native Hawaiian or Other Pacific Islander ,2,5,7
313500,Acute rheumatic heart disease,ethnic,Hispanic or Latino,5,2,7
75356,Congenital deformity of sternocleidomastoid muscle,ethnic,Hispanic or Latino,2,5,7
434953,Orbital granuloma,ethnic,Hispanic or Latino,5,2,7
377678,EEG abnormality,ethnic,Hispanic or Latino,2,5,7
440063,"Benign neoplasm of pancreas, excluding islets of Langerhans",racial,White,0,7,7
381854,Disorder of conjunctiva,ethnic,Not Hispanic or Latino,5,2,7
436077,Developmental delay,racial,Filipino,2,5,7
196751,Haemorrhage from placenta previa,racial,White,7,0,7
435553,Watery eye,racial,Other Race,7,0,7
4147494,Nonspecific mesenteric adenitis,ethnic,Hispanic or Latino,2,5,7
434610,Hyperkalemia,racial,Asian Indian,0,7,7
81721,Open wound of hand except fingers with tendon involvement,ethnic,Hispanic or Latino,5,2,7
440250,Subarachnoid hemorrhage following injury without open intracranial wound AND with concussion,racial,White,5,2,7
253321,Stridor,racial,Black or African American ,7,0,7
254387,Upper respiratory tract hypersensitivity reaction,racial,Native Hawaiian or Other Pacific Islander ,0,7,7
436446,Cracked tooth syndrome,ethnic,Not Hispanic or Latino,5,2,7
4311591,Cramp in limb,racial,Black or African American ,5,2,7
192376,Rhesus isoimmunization with antenatal problem,racial,Unknown,7,0,7
440547,Closed fracture of shaft of metacarpal bone,ethnic,Not Hispanic or Latino,7,0,7
4268980,Finding of general development,racial,Unknown,7,0,7
444413,Pyrexial convulsion,racial,Asian,5,2,7
444413,Pyrexial convulsion,racial,Filipino,0,7,7
4047937,Neonatal urinary tract infection,ethnic,Not Hispanic or Latino,2,5,7
192385,"Tumour of uterine body complicating antenatal care, baby not yet delivered",ethnic,Not Hispanic or Latino,7,0,7
375256,Anterior subcapsular polar senile cataract,racial,Unknown,0,7,7
380097,Diabetic macular edema,racial,Black or African American ,5,2,7
4326838,Decubitus ulcer of upper back,ethnic,Not Hispanic or Latino,0,7,7
376552,Cerebral laceration and contusion,ethnic,Hispanic or Latino,7,0,7
137991,Sick-euthyroid syndrome,ethnic,Hispanic or Latino,5,2,7
138825,Actinic keratosis,racial,Filipino,0,7,7
4103679,Percutaneous transluminal angioscopy,racial,White,0,7,7
436350,Schistosoma hematobium infection,racial,White,7,0,7
432461,"Closed fracture clavicle, shaft",racial,Unknown,0,7,7
4060813,Cystitis NOS,ethnic,Hispanic or Latino,5,2,7
79165,Closed Monteggia fracture,ethnic,Hispanic or Latino,5,2,7
197506,Malignant tumor of abdomen,ethnic,Hispanic or Latino,5,2,7
196324,Food poisoning due to Clostridium perfringens,ethnic,Not Hispanic or Latino,0,7,7
4239975,Myocardial disease,racial,Unknown,0,7,7
440081,Barbiturate dependence,racial,Black or African American ,7,0,7
433257,Mesangiocapillary glomerulonephritis,ethnic,Not Hispanic or Latino,0,7,7
437878,Persistent mydriasis,racial,White,5,2,7
377545,Episodic tension-type headache,ethnic,Hispanic or Latino,7,0,7
4005823,Tobacco user,racial,Native Hawaiian or Other Pacific Islander ,0,7,7
4318111,Traumatic amputation of leg,racial,Unknown,0,7,7
141004,Lesion of radial nerve,racial,Asian,7,0,7
253790,Pneumonia due to Klebsiella pneumoniae,ethnic,Hispanic or Latino,0,7,7
436799,Talipes cavus,ethnic,Hispanic or Latino,5,2,7
133414,Candidiasis of skin and nails,racial,American Indian or Alaska Native ,7,0,7
137213,Fungal dermatosis,racial,Other Race,5,2,7
81426,Closed fracture of clavicle,racial,Black or African American ,5,2,7
24660,Acute tonsillitis,racial,Native Hawaiian or Other Pacific Islander ,5,2,7
198374,Nodular lymphoma of spleen,ethnic,Hispanic or Latino,0,7,7
376120,"Keratoconjunctivitis sicca, not specified as Sjogren's",racial,American Indian or Alaska Native ,7,0,7
438066,Chlamydial infection,racial,Asian,7,0,7
313007,MR - Congenital mitral regurgitation,racial,White,0,7,7
4230975,Acquired deformity of the abdomen,ethnic,Not Hispanic or Latino,7,0,7
376525,Audiogram abnormal,racial,Black or African American ,5,2,7
435119,Sequela of injury,racial,White,2,5,7
4080568,Problem behaviour,racial,Black or African American ,2,5,7
439273,"Single manic episode, mild",racial,Asian,7,0,7
80187,Medial epicondylitis,racial,Asian,7,0,7
23865,Congenital abnormality of pharynx,ethnic,Hispanic or Latino,7,0,7
439137,Neonatal jaundice due to delayed conjugation,ethnic,Hispanic or Latino,0,7,7
443239,Precerebral arterial occlusion,racial,Unknown,7,0,7
435443,[X]Fall involving wheelchair,racial,Black or African American ,7,0,7
74728,Synovitis and tenosynovitis,racial,Asian,2,5,7
141816,Acute lymphoid leukaemia in remission,racial,Unknown,7,0,7
378416,Retinal disorder,racial,Asian,5,2,7
380103,Retinal detachment with retinal defect,racial,Unknown,7,0,7
257775,Post-tuberculous bronchiectasis,ethnic,Not Hispanic or Latino,0,7,7
4168213,Chest pain on breathing,racial,Native Hawaiian or Other Pacific Islander ,0,7,7
197484,Diarrhea of presumed infectious origin,racial,Asian,0,7,7
137054,Skin striae,ethnic,Not Hispanic or Latino,0,7,7
40480943,Lateral cystocele,racial,Unknown,7,0,7
138346,Erysipelas,racial,White,5,2,7
74189,Sprain of cruciate ligament of knee,racial,Other Race,0,7,7
318556,Nosebleed,racial,Native Hawaiian or Other Pacific Islander ,2,5,7
4124693,Hypertrophic cardiomyopathy,racial,Asian,0,7,7
439666,Contracture of multiple joints,racial,Filipino,7,0,7
201519,Ca liver - primary,ethnic,Not Hispanic or Latino,2,5,7
133384,Burn any degree involving less than 10 percent of body surface,racial,White,5,2,7
4201274,Anastomosis of small intestine to rectal stump,ethnic,Hispanic or Latino,7,0,7
4181328,CA - Cancer of adrenal gland,racial,Unknown,0,7,7
375826,Central hearing loss,racial,Asian,5,2,7
4144118,Gastrointestinal haemorrhage unspecified,ethnic,Hispanic or Latino,5,2,7
4057348,"Contusion, knee and lower leg NOS",racial,White,0,7,7
440829,Fetus and newborn affected by noxious influences transmitted via placenta or breast milk,racial,White,7,0,7
381301,Chronic serous otitis media,racial,Black or African American ,7,0,7
4124794,FH: - kidney disorder,racial,White,0,7,7
443747,Acute laryngotracheitis without obstruction,ethnic,Not Hispanic or Latino,0,7,7
25518,AS - Sickle cell trait,racial,Unknown,5,2,7
432966,Hypertrophy of vulva,racial,Unknown,7,0,7
195312,Functional voiding disorder,racial,Black or African American ,7,0,7
374362,Keratoconus,ethnic,Hispanic or Latino,5,2,7
438750,Old total retinal detachment,racial,Unknown,5,2,7
4333977,Acquired anophthalmos,racial,White,5,2,7
444202,Abscess,racial,Native Hawaiian or Other Pacific Islander ,0,7,7
195862,Urethritis,racial,Black or African American ,0,7,7
438208,Atrophy of vulva,racial,Unknown,7,0,7
432452,Anemia of prematurity,ethnic,Not Hispanic or Latino,2,5,7
142016,Nonvenomous insect bite of finger with infection,ethnic,Hispanic or Latino,7,0,7
380415,Acute swimmer's ear,racial,Other Race,2,5,7
195906,Disorder of lumbar spine,racial,Other Race,7,0,7
441262,"Amfetamine or psychostimulant dependence, episodic",racial,White,7,0,7
197911,Hernia of anterior abdominal wall without obstruction AND without gangrene,racial,American Indian or Alaska Native ,7,0,7
72501,Superficial foreign body of foot without major open wound AND without infection,racial,Unknown,7,0,7
140526,Congenital anomaly of endocrine gland,racial,Unknown,7,0,7
80578,Superficial injury of finger with infection,racial,White,5,2,7
75091,Closed fracture of carpal bone,racial,Other Race,0,7,7
197050,Abnormality of organs AND/OR soft tissues of pelvis affecting pregnancy,ethnic,Hispanic or Latino,7,0,7
435521,Psychophysiologic disorder,racial,Unknown,2,5,7
437496,Acute peripheral vestibulopathy,racial,Unknown,7,0,7
77600,Encysted hydrocele,ethnic,Hispanic or Latino,0,7,7
197223,Enterobiasis,racial,Black or African American ,0,7,7
442290,Varicose veins of legs complicating pregnancy AND/OR puerperium,racial,White,7,0,7
374350,Granuloma of conjunctiva,ethnic,Hispanic or Latino,7,0,7
434920,Hypochondriasis,ethnic,Hispanic or Latino,7,0,7
438304,Rat bite,racial,Unknown,0,7,7
4218420,Postinflammatory perforation of ear drum,ethnic,Not Hispanic or Latino,7,0,7
440005,Complication of medical care,ethnic,Not Hispanic or Latino,5,2,7
437969,Acquired pes planus,racial,American Indian,0,7,7
436386,Severe depressed bipolar I disorder with psychotic features,racial,Unknown,0,7,7
381574,External auditory canal exostosis,ethnic,Hispanic or Latino,2,5,7
315273,MS - Mitral stenosis,ethnic,Not Hispanic or Latino,7,0,7
4326838,Decubitus ulcer of upper back,racial,Unknown,7,0,7
441969,Radiology result abnormal,racial,Other Race,0,7,7
4113782,Cerebral artery occlusion NOS,ethnic,Hispanic or Latino,7,0,7
139099,Ingrowing nail,racial,Native Hawaiian or Other Pacific Islander ,2,5,7
201894,Acute intestinal vascular insufficiency,racial,Black or African American ,2,5,7
443446,Reflex sympathetic dystrophy of lower extremity,ethnic,Not Hispanic or Latino,2,5,7
4124693,Hypertrophic cardiomyopathy,ethnic,Not Hispanic or Latino,0,7,7
197043,Cervical observation during pregnancy and labor,racial,White,7,0,7
432512,Foreign object left in body during procedure,racial,Black or African American ,7,0,7
22274,Neoplasm of uncertain behaviour of larynx,racial,White,0,7,7
4242221,Rumination disorder,racial,White,0,7,7
193983,Disorder of pancreatic internal secretion,racial,Unknown,7,0,7
443458,Closed fracture of facial bone,racial,White,7,0,7
433595,Interstitial edema,racial,American Indian,7,0,7
434494,Closed fracture of the proximal humerus,racial,Alaska Native,0,7,7
132344,Gingival and periodontal disease,racial,Other Race,7,0,7
439053,Exostosis of jaw,ethnic,Hispanic or Latino,2,5,7
438106,"Reticulosarcoma of lymph nodes of head, face and neck",racial,White,2,5,7
141124,Congenital cardiovascular disorder,racial,White,0,7,7
4067537,Other disc disorders of unspecified site,ethnic,Hispanic or Latino,0,7,7
314963,Giant cell arteritis,racial,Unknown,0,7,7
4065991,Cellulitis and abscess of finger and toe,ethnic,Hispanic or Latino,7,0,7
316126,Crystalline deposits in vitreous,ethnic,Hispanic or Latino,2,5,7
372912,Visual discomfort,racial,Filipino,7,0,7
78097,Metastatic tumour of bone,racial,Other Race,7,0,7
75354,Osteochondropathy,racial,Black or African American ,7,0,7
4171434,Immunization refused,racial,Asian Indian,2,5,7
252658,Intrinsic asthma without status asthmaticus,racial,Asian,7,0,7
137441,"Insect bite, nonvenomous, of foot and toe, infected",ethnic,Hispanic or Latino,7,0,7
76790,Familial ligamentous laxity,racial,Unknown,2,5,7
23653,Foreign body in esophagus,racial,White,0,7,7
4062555,"Unspecified hypertension complicating pregnancy, childbirth and the puerperium NOS",ethnic,Not Hispanic or Latino,2,5,7
441276,Nondependent alcohol abuse in remission,racial,Native Hawaiian or Other Pacific Islander ,0,7,7
4059173,Fracture of ankle,ethnic,Hispanic or Latino,5,2,7
4109260,Other eyelid disorders,racial,Unknown,5,2,7
436855,Second degree burn of back of hand,ethnic,Hispanic or Latino,2,5,7
78015,Open wound of chest wall without complication,ethnic,Hispanic or Latino,2,5,7
437374,Neonatal aspiration of meconium,racial,White,7,0,7
138501,Cholinergic urticaria,racial,White,5,2,7
135033,Hair and hair follicle diseases,racial,Filipino,5,2,7
134305,Acute lymphoid leukaemia,racial,Other Race,0,7,7
441974,Closed fracture of forearm,racial,Black or African American ,0,7,7
198187,"Acute peptic ulcer without hemorrhage, without perforation AND without obstruction",ethnic,Not Hispanic or Latino,5,2,7
4108389,Generalized tuberculosis,racial,White,0,7,7
75614,Acrodermatitis continua,racial,American Indian,0,7,7
137520,Chronic thyroiditis,racial,Other Race,7,0,7
140582,Superficial burn of foot,ethnic,Hispanic or Latino,2,5,7
4233827,Biopsy of lymphatic structure,racial,White,2,5,7
193262,Inflammatory disorder of penis,racial,Unknown,0,7,7
376713,Cerebral hemorrhage,racial,Asian,7,0,7
199079,Hypertrophy of clitoris,ethnic,Hispanic or Latino,7,0,7
258458,Bacterial pleurisy with effusion,racial,White,7,0,7
200171,Carbuncle of skin AND/OR subcutaneous tissue,racial,Black or African American ,0,7,7
439940,Closed fracture of upper end of forearm,racial,White,5,2,7
320115,Mitral incompetence and aortic stenosis,ethnic,Hispanic or Latino,2,5,7
432284,Single major depressive episode,racial,American Indian or Alaska Native ,2,5,7
78233,Old disruption of medial collateral ligament,ethnic,Hispanic or Latino,5,2,7
433905,Open wound of vulva without complication,ethnic,Hispanic or Latino,7,0,7
77638,Displacement of intervertebral disc without myelopathy,racial,Asian,7,0,7
438749,Posterior subcapsular polar senile cataract,racial,White,0,7,7
442068,Cellulitis and abscess of forearm,racial,Asian,0,7,7
432598,Subchronic schizophrenia with acute exacerbations,racial,White,7,0,7
4326838,Decubitus ulcer of upper back,racial,White,0,7,7
253235,Pneumonia in pertussis,racial,Unknown,7,0,7
436245,Atypical glandular cells on vaginal Papanicolaou smear,racial,American Indian,7,0,7
436108,Acute closed-angle glaucoma,racial,Unknown,5,2,7
321882,Generalised atherosclerosis,racial,Asian,2,5,7
201338,Urethral fistula,racial,White,0,7,7
133848,Non-traumatic slipped upper femoral epiphysis,racial,Black or African American ,0,7,7
4140207,Nephrosclerosis,racial,Unknown,7,0,7
201355,Erosion and ectropion of the cervix,racial,Unknown,7,0,7
439796,"Nondependent cocaine abuse, continuous",racial,Unknown,7,0,7
440787,"Drug dependence in mother complicating pregnancy, childbirth AND/OR puerperium",racial,Black or African American ,7,0,7
313980,"Hodgkin disease, lymphocytic depletion of lymph nodes of multiple sites",ethnic,Hispanic or Latino,7,0,7
432730,Dysphonia,racial,Black or African American ,2,5,7
76548,Closed dislocation of hip,ethnic,Not Hispanic or Latino,5,2,7
377546,Chronic post-traumatic headache,ethnic,Not Hispanic or Latino,2,5,7
192858,Ovarian hyperfunction,ethnic,Hispanic or Latino,7,0,7
372613,Flaccid hemiplegia,ethnic,Not Hispanic or Latino,0,7,7
432738,Iceland disease,racial,Filipino,0,7,7
442139,Primary bronchial cancer,racial,Asian,5,2,7
317305,Stricture of artery,racial,White,0,7,7
438350,Pneumocystosis,racial,Unknown,0,7,7
257008,Abscess of parapharyngeal space,ethnic,Hispanic or Latino,5,2,7
134619,Toxic nodular goiter,racial,White,7,0,7
381308,Abscess of eyelid,racial,Other Race,2,5,7
75346,Disorder of meniscus of knee,racial,Asian,0,7,7
433837,Obstetric nipple infection with postnatal complication,racial,Unknown,7,0,7
4100091,Child attention deficit disorder NOS,ethnic,Not Hispanic or Latino,2,5,7
133384,Burn any degree involving less than 10 percent of body surface,racial,Unknown,5,2,7
379020,Entropion,racial,Unknown,7,0,7
4195231,Acute gastric ulcer without hemorrhage AND without perforation,ethnic,Hispanic or Latino,5,2,7
313224,Anomalous atrioventricular excitation,racial,Black or African American ,5,2,7
4024361,Paralysis of glottis,racial,Unknown,7,0,7
440878,Open wound of jaw without complication,racial,White,5,2,7
22856,Polyglandular dysfunction,racial,White,7,0,7
80815,Mucous cyst of skin,racial,Black or African American ,5,2,7
4108358,Transient cerebral ischaemia NOS,racial,White,7,0,7
374648,Monocular intermittent esotropia,ethnic,Hispanic or Latino,7,0,7
141411,Scalp injury,ethnic,Not Hispanic or Latino,0,7,7
74187,Sprain of coracohumeral ligament,racial,Other Race,0,7,7
440250,Subarachnoid hemorrhage following injury without open intracranial wound AND with concussion,ethnic,Hispanic or Latino,5,2,7
377560,Internal hordeolum,racial,Asian,2,5,7
75128,Injury of chest wall,racial,Other Race,5,2,7
437892,Lown-Ganong-Levine syndrome,racial,White,7,0,7
375557,Cerebral embolism,ethnic,Not Hispanic or Latino,2,5,7
197810,Malignant neoplasm of uterine adnexa,ethnic,Hispanic or Latino,7,0,7
436812,Tongue tie,racial,Black or African American ,0,7,7
76611,Injury of shoulder region,racial,Asian,7,0,7
200775,Endometrial hyperplasia,ethnic,Not Hispanic or Latino,7,0,7
193525,Abdominal pregnancy,racial,Other Race,7,0,7
443708,Cervical Papanicolaou smear positive for malignant neoplasm,racial,White,7,0,7
75004,Frank hematuria,racial,Other Race,0,7,7
258180,Pneumonia due to Gram negative bacteria,ethnic,Hispanic or Latino,7,0,7
443862,Complication of internal anastomosis,racial,Unknown,7,0,7
77068,Secondary localised osteoarthrosis of lower leg,racial,Other Race,0,7,7
197810,Malignant neoplasm of uterine adnexa,racial,Unknown,7,0,7
437937,Grand multiparity unspecified,ethnic,Hispanic or Latino,7,0,7
376106,Disorder of the central nervous system,ethnic,Not Hispanic or Latino,2,5,7
199063,"Hernia, with obstruction",ethnic,Hispanic or Latino,7,0,7
441946,Calcific tendinitis of shoulder,racial,Asian,7,0,7
433675,Toxic effect of chemical,ethnic,Not Hispanic or Latino,2,5,7
140570,Open wound of back without complication,ethnic,Hispanic or Latino,2,5,7
437966,Calcium deposits in tendon,racial,Asian,7,0,7
437501,Primary malignant neoplasm of labia majora,racial,Unknown,7,0,7
139955,Open wound of palate without complication,racial,White,7,0,7
436067,Schizophrenia simplex,racial,Alaska Native,7,0,7
200671,Benign tumour of renal pelvis,ethnic,Not Hispanic or Latino,2,5,7
439147,Amnesia,racial,American Indian or Alaska Native ,2,5,7
440228,Closed fracture of lower end of humerus,racial,Other Race,7,0,7
444082,False labor without delivery,ethnic,Hispanic or Latino,7,0,7
4179332,Parent-child problem,racial,Unknown,7,0,7
440788,Hyperemesis gravidarum with metabolic disturbance - not delivered,ethnic,Not Hispanic or Latino,7,0,7
73904,Open wound of buttock without complication,racial,White,2,5,7
372315,Anterior subcapsular polar cataract,racial,White,5,2,7
133637,Second degree burn of lower limb,racial,Unknown,7,0,7
195851,"Gastric ulcer without hemorrhage, without perforation AND without obstruction",racial,Black or African American ,7,0,7
194100,Obstructed labour due to foetal malposition,ethnic,Not Hispanic or Latino,0,7,7
374907,Tics of organic origin,racial,Unknown,2,5,7
439166,Closed fracture of radius,racial,Other Race,7,0,7
4331899,Child in family care,racial,Black or African American ,5,2,7
372828,Zoster ophthalmicus,racial,Unknown,5,2,7
443519,Retinopathy of prematurity stage 4 - subtotal retinal detachment,ethnic,Hispanic or Latino,7,0,7
135615,Pityriasis,racial,Other Race,5,2,7
314754,Wheezing,racial,Native Hawaiian or Other Pacific Islander ,5,2,7
201337,Disorder of bladder and bladder neck,racial,Asian,2,5,7
4240902,Allergy to peanuts,racial,Asian,0,7,7
4064362,Mycotic infection screening,ethnic,Not Hispanic or Latino,0,7,7
4149299,Follow-up orthopaedic assessment,ethnic,Hispanic or Latino,7,0,7
261738,Multiple burns of head and neck,racial,White,0,7,7
432582,Neoplastic disease of uncertain behavior,racial,Other Race,0,7,7
199151,Must strain to pass urine,ethnic,Hispanic or Latino,2,5,7
433069,Open wound of external genital organs with complication,racial,Filipino,7,0,7
4291005,VH - Viral hepatitis,racial,White,2,5,7
436882,[X]Fall involving bed,ethnic,Not Hispanic or Latino,2,5,7
441834,"Bipolar affective disorder, currently manic, mild",ethnic,Not Hispanic or Latino,5,2,7
439981,Wound dehiscence,racial,Unknown,7,0,7
73017,Congenital anomaly of toe,racial,White,7,0,7
81403,Osteopetrosis,ethnic,Not Hispanic or Latino,7,0,7
258375,Malignant neoplasm of overlapping lesion of bronchus and lung,ethnic,Hispanic or Latino,0,7,7
314423,"Benign essential hypertension complicating pregnancy, childbirth and the puerperium - not delivered",racial,Unknown,7,0,7
75924,Osteodystrophy,ethnic,Not Hispanic or Latino,5,2,7
440374,Obsessive compulsive disorder,racial,Other Race,2,5,7
440161,Indication for care AND/OR intervention in labor AND/OR delivery,ethnic,Hispanic or Latino,7,0,7
433813,Bladder neck obstruction,racial,Unknown,7,0,7
135287,Non-neoplastic naevus,racial,Black or African American ,5,2,7
4145479,Other specified candidiasis NOS,ethnic,Hispanic or Latino,7,0,7
4263325,Actinic cheilitis,racial,Black or African American ,7,0,7
193493,Benign hypertensive renal disease,racial,Unknown,7,0,7
134312,Iatrogenic hypothyroidism,racial,White,5,2,7
78162,Peripheral vertigo,ethnic,Not Hispanic or Latino,5,2,7
372318,Chronic follicular conjunctivitis,ethnic,Hispanic or Latino,2,5,7
140821,Spasm,racial,American Indian,5,2,7
75337,Cellulitis and abscess of buttock,racial,Other Race,5,2,7
377870,Heterotropia,racial,Other Race,7,0,7
381859,Infective OE,racial,American Indian,7,0,7
320347,Nodular lymphoma of lymph nodes of multiple sites,racial,White,0,7,7
442270,Disease of duodenum,racial,Black or African American ,0,7,7
137077,Chronic osteomyelitis of the ankle and/or foot,racial,Unknown,0,7,7
200783,Previous cesarean section,racial,Unknown,7,0,7
80819,Acquired hallux varus,racial,White,7,0,7
320739,Dissecting aortic aneurysm,ethnic,Hispanic or Latino,5,2,7
28457,Hypertrophy of tonsils,racial,Native Hawaiian or Other Pacific Islander ,2,5,7
199877,Mucous polyp of cervix,racial,Native Hawaiian or Other Pacific Islander ,7,0,7
133510,Rapidly progressive periodontitis,racial,Asian,5,2,7
77403,Closed fracture of vertebral column without spinal cord injury,racial,Other Race,7,0,7
444071,Furuncle of forearm,racial,American Indian,7,0,7
196217,Congenital malformation of diaphragm,racial,Asian,0,7,7
4103915,Optic neuritis NOS,ethnic,Not Hispanic or Latino,7,0,7
433856,Fracture of neck of femur,ethnic,Hispanic or Latino,0,7,7
194964,Aneurysm of splenic artery,racial,Asian,0,7,7
438532,Swan-neck deformity of finger,ethnic,Hispanic or Latino,5,2,7
139841,Chronic frontal sinusitis,racial,Asian,7,0,7
77139,Open wound of finger without complication,racial,Black or African American ,5,2,7
441641,FTND - Full term normal delivery,ethnic,Not Hispanic or Latino,5,2,7
4122116,Tooth eruption disturbances,racial,White,5,2,7
441261,Episodic acute alcoholic intoxication in alcoholism,racial,Unknown,0,7,7
4200655,Urostomy present,racial,White,2,5,7
4140233,"X-ray of ribs, sternum and clavicle",ethnic,Hispanic or Latino,5,2,7
74396,TMJ - Temporomandibular joint disorder,racial,Other Race,2,5,7
444429,Herpes simplex infection,ethnic,Not Hispanic or Latino,7,0,7
444121,"Primary dental caries, proximal smooth surface origin",ethnic,Hispanic or Latino,7,0,7
440925,Suicide,racial,White,5,2,7
4087442,Acute poliomyelitis NOS,ethnic,Hispanic or Latino,5,2,7
440385,Obstructive hydrocephalus,racial,Native Hawaiian or Other Pacific Islander ,2,5,7
4104561,Ptosis of eyelid NOS,ethnic,Not Hispanic or Latino,5,2,7
440329,Herpes zoster without complication,racial,Filipino,0,7,7
77070,Allergic arthritis of the hand,ethnic,Hispanic or Latino,5,2,7
196307,Lumbosacral plexus injury,ethnic,Hispanic or Latino,7,0,7
138501,Cholinergic urticaria,ethnic,Hispanic or Latino,5,2,7
437496,Acute peripheral vestibulopathy,ethnic,Not Hispanic or Latino,0,7,7
4064381,Nephropathy screening,racial,Asian,7,0,7
79833,Meniere's disease,racial,Unknown,5,2,7
4287544,Manic bipolar I disorder,racial,American Indian or Alaska Native ,0,7,7
201603,Disease of teeth AND/OR supporting structures,racial,American Indian,0,7,7
198289,Nonvenomous insect bite of hip without infection,racial,Other Race,5,2,7
435917,Fetus OR newborn affected by incompetent cervix,ethnic,Hispanic or Latino,7,0,7
195058,Nonallopathic lesion of abdomen,ethnic,Hispanic or Latino,7,0,7
192502,Contusion of multiple sites of trunk,ethnic,Hispanic or Latino,5,2,7
316432,Right bundle branch block AND left anterior fascicular block,ethnic,Not Hispanic or Latino,0,7,7
198446,Embolism and thrombosis of the abdominal aorta,ethnic,Hispanic or Latino,7,0,7
141933,Alopecia areata,racial,Other Race,5,2,7
4030398,Amputation of arm through shoulder,racial,White,2,5,7
138346,Erysipelas,racial,Unknown,7,0,7
435233,Disorders of fatty-acid metabolism,racial,White,5,2,7
4208970,History of physical abuse,racial,Black or African American ,7,0,7
4096215,"Hyperlipidemia, group A",racial,American Indian,0,7,7
76491,Obstetric non-purulent mastitis with antenatal complication,ethnic,Hispanic or Latino,7,0,7
81988,Sprain of sternum,ethnic,Hispanic or Latino,7,0,7
433773,Chronic orbital inflammation,ethnic,Hispanic or Latino,0,7,7
139734,Early yaws skin lesion,racial,White,5,2,7
433514,Abnormal hard tissue formation in pulp,ethnic,Hispanic or Latino,2,5,7
381581,Chalazion,racial,Asian,2,5,7
4227745,Infertility test,ethnic,Hispanic or Latino,5,2,7
4092562,Reduction deformity of arm,racial,White,7,0,7
381308,Abscess of eyelid,racial,Black or African American ,2,5,7
74717,Galactorrhoea in pregnancy and the puerperium - delivered with postnatal complication,ethnic,Hispanic or Latino,7,0,7
4067537,Other disc disorders of unspecified site,ethnic,Not Hispanic or Latino,7,0,7
374267,Tuberculosis of central nervous system,racial,Unknown,7,0,7
443417,Villonodular synovitis of lower limb,racial,Black or African American ,7,0,7
436741,Vulvodynia,racial,White,7,0,7
4094126,Family problems,ethnic,Hispanic or Latino,2,5,7
443344,Barrett esophagus,racial,Other Race,7,0,7
444028,Open wound of alveolar process without complication,racial,White,2,5,7
194989,Bilateral recurrent inguinal hernia with obstruction but no gangrene,ethnic,Hispanic or Latino,0,7,7
4116761,Lateral meniscus derangement unspecified,racial,White,5,2,7
78228,Joint derangement,racial,Black or African American ,2,5,7
378001,Concussion with no loss of consciousness,ethnic,Hispanic or Latino,7,0,7
318772,Disease of pericardium,racial,Other Race,5,2,7
435656,Neonatal jaundice,racial,Black or African American ,2,5,7
441919,Twin pregnancy,racial,Other Race,7,0,7
4242221,Rumination disorder,ethnic,Hispanic or Latino,0,7,7
197043,Cervical observation during pregnancy and labor,ethnic,Hispanic or Latino,7,0,7
77178,Contusion of multiple sites of upper limb,racial,Unknown,5,2,7
443716,Blister of shoulder without infection,racial,White,5,2,7
78512,Joint contracture of the ankle and/or foot,ethnic,Not Hispanic or Latino,7,0,7
141411,Scalp injury,racial,Asian,0,7,7
200219,Abdominal pain,racial,Asian Indian,5,2,7
74777,Closed fracture of astragalus,racial,Unknown,7,0,7
376578,Otitic barotrauma,racial,White,5,2,7
4116861,Neuromyopathy,racial,Unknown,0,7,7
79091,Unstable lie,racial,Unknown,7,0,7
436298,Adverse reaction to food,racial,Filipino,7,0,7
192956,Cholecystitis,racial,Other Race,7,0,7
434628,Separation anxiety,racial,Unknown,7,0,7
4302543,Insertion of prosthesis or prosthetic device of femoral head,racial,White,7,0,7
74125,Inflammatory polyarthropathy,racial,Asian,5,2,7
4113782,Cerebral artery occlusion NOS,racial,Unknown,7,0,7
378413,Partial recent retinal detachment with multiple defects,ethnic,Hispanic or Latino,5,2,7
438332,Disease of possible viral origin,racial,American Indian,5,2,7
193308,Congenital anomaly of spleen,ethnic,Not Hispanic or Latino,2,5,7
443582,Disorder of joint of hand,racial,Unknown,7,0,7
4305080,Abnormal breathing,racial,Black or African American ,5,2,7
74464,Idiopathic scoliosis AND/OR kyphoscoliosis,racial,Native Hawaiian or Other Pacific Islander ,5,2,7
40481920,Periumbilical pain,racial,Asian,7,0,7
438879,Closed bimalleolar fracture,ethnic,Not Hispanic or Latino,7,0,7
437295,Abnormal pupillary function,ethnic,Hispanic or Latino,7,0,7
133150,Malignant neoplasm of skin of lower limb and hip,racial,Unknown,0,7,7
438977,"Primary malignant neoplasm of ribs, sternum and clavicle",racial,White,7,0,7
4302252,High risk pregnancy care,racial,Native Hawaiian or Other Pacific Islander ,7,0,7
140821,Spasm,racial,Filipino,2,5,7
78236,Muscle wasting disorder,racial,Other Race,2,5,7
24909,Hereditary spherocytosis,ethnic,Hispanic or Latino,7,0,7
432660,Dentofacial anomaly,ethnic,Hispanic or Latino,5,2,7
435138,Injury of femoral nerve,racial,White,5,2,7
434697,Maternal tobacco abuse,racial,White,7,0,7
376400,Combined form of senile cataract,racial,Filipino,7,0,7
136497,Scar conditions and fibrosis of skin,racial,Other Race,0,7,7
4333977,Acquired anophthalmos,ethnic,Not Hispanic or Latino,0,7,7
439717,Active cochleovestibular Meniere's disease,ethnic,Hispanic or Latino,0,7,7
76685,MG - Myasthenia gravis,racial,Other Race,0,7,7
432513,Animal bite wound,racial,Unknown,7,0,7
436285,Superficial foreign body without major open wound but with infection,racial,White,7,0,7
432551,Parvovirus infection,ethnic,Hispanic or Latino,0,7,7
438005,Closed fracture shaft of fibula,ethnic,Not Hispanic or Latino,0,7,7
4168213,Chest pain on breathing,racial,Filipino,7,0,7
435866,Retrograde ejaculation,racial,White,0,7,7
436145,Pneumonia due to respiratory syncytial virus,racial,White,7,0,7
436096,Chronic pain,racial,Native Hawaiian or Other Pacific Islander ,5,2,7
440642,CSD - Cat scratch disease,ethnic,Hispanic or Latino,5,2,7
373461,Leukocoria,racial,White,7,0,7
78799,Chronic ulcerative ileocolitis,ethnic,Hispanic or Latino,7,0,7
379820,No colour perception,ethnic,Not Hispanic or Latino,2,5,7
195209,Benign neoplasm of liver and/or biliary ducts,ethnic,Not Hispanic or Latino,7,0,7
437409,Intracranial injury,racial,Other Race,0,7,7
77592,Articular crepitus of temporomandibular joint,ethnic,Not Hispanic or Latino,5,2,7
196152,Peritonitis,racial,Unknown,7,0,7
4210151,HIV counseling,racial,Black or African American ,0,7,7
28461,Hypertrophy of salivary gland,racial,Unknown,0,7,7
256531,Head and neck swelling,racial,American Indian or Alaska Native ,5,2,7
81151,Sprain of ankle joint,racial,American Indian or Alaska Native ,7,0,7
439294,"Malignant neoplasm of head, neck and face",racial,Unknown,7,0,7
321414,Hemoglobinuria,racial,Unknown,2,5,7
74150,"Congenital subluxation of hip, bilateral",ethnic,Hispanic or Latino,2,5,7
77354,Primary localised osteoarthrosis of lower leg,racial,Native Hawaiian or Other Pacific Islander ,2,5,7
136496,Cellulitis and abscess of face,racial,American Indian or Alaska Native ,5,2,7
81175,Contusion of chest,racial,Other Race,5,2,7
197339,"Congenital abnormality of uterus, affecting pregnancy",ethnic,Hispanic or Latino,5,2,7
74127,Elbow joint contracture,ethnic,Hispanic or Latino,0,7,7
201254,Insulin dependent diabetes mellitus,racial,American Indian,2,5,7
134453,Inflammation of bursa,racial,American Indian or Alaska Native ,7,0,7
372651,Chronic mastoiditis,ethnic,Hispanic or Latino,7,0,7
437839,Pica,racial,Black or African American ,0,7,7
443577,Asymmetric sensorineural hearing loss,racial,Other Race,5,2,7
372828,Zoster ophthalmicus,racial,White,5,2,7
196365,Neoplasm of uncertain behaviour of adrenal gland,racial,White,7,0,7
438791,Pulmonary congestion and hypostasis,racial,White,2,5,7
439705,Active disintegrative psychoses,ethnic,Hispanic or Latino,0,7,7
76150,Ulcer of rectum,ethnic,Not Hispanic or Latino,5,2,7
201313,Hypertensive renal disease,racial,Asian,7,0,7
4073526,Bilateral inguinal hernia repair,ethnic,Hispanic or Latino,0,7,7
443541,Recurrent inguinal hernia with gangrene,racial,Unknown,0,7,7
74809,Crushing injury of hand,racial,Asian,0,7,7
196738,Male genital organ disease,racial,Asian Indian,0,7,7
440424,Aphasia,racial,Native Hawaiian or Other Pacific Islander ,0,7,7
438350,Pneumocystosis,ethnic,Not Hispanic or Latino,0,7,7
23988,Hemolytic anemia due to glutathione metabolism disorder,ethnic,Hispanic or Latino,2,5,7
443629,Generalised abdominal tenderness,racial,Unknown,0,7,7
200764,Bile duct calculus without mention of cholecystitis and no obstruction,ethnic,Not Hispanic or Latino,7,0,7
432645,Necrotising scleritis without inflammation,ethnic,Hispanic or Latino,0,7,7
201773,Enteritis,racial,Unknown,0,7,7
132491,Contusion of scapular region,ethnic,Hispanic or Latino,7,0,7
4069400,Acquired genu valgum and varum,ethnic,Hispanic or Latino,0,7,7
318852,Congenital malformation of vitreous body,ethnic,Hispanic or Latino,7,0,7
78890,Sprain of elbow and forearm,racial,Other Race,5,2,7
132393,Pressure ulcer stage 1,racial,Asian,0,7,7
440543,Fracture of tibia,ethnic,Not Hispanic or Latino,7,0,7
381281,Degenerative progressive high myopia,racial,White,0,7,7
133280,Alopecia,racial,Black or African American ,7,0,7
4103897,Unspecified ectropion,ethnic,Hispanic or Latino,7,0,7
4102738,Screening for mental disorders,racial,White,5,2,7
74809,Crushing injury of hand,ethnic,Not Hispanic or Latino,0,7,7
4016359,Streptococcus carrier,racial,Unknown,7,0,7
81148,Open Monteggia's fracture,racial,White,7,0,7
138582,"Closed fracture scapula, acromion",racial,White,0,7,7
200762,Autoimmune hepatitis,ethnic,Not Hispanic or Latino,7,0,7
198683,Viral hepatitis B without hepatic coma,racial,Other Race,7,0,7
200052,Primary malignant neoplasm of uterine adnexa,racial,Unknown,7,0,7
375671,Concussion with loss of consciousness,racial,Unknown,7,0,7
73019,Breast engorgement in newborn,racial,White,0,7,7
81988,Sprain of sternum,racial,White,7,0,7
438535,Congenital abnormality of iris and ciliary body,ethnic,Hispanic or Latino,2,5,7
435522,Hypervitaminosis D,ethnic,Not Hispanic or Latino,5,2,7
28974,Candidiasis of oesophagus,racial,Unknown,5,2,7
141917,Balanitis xerotica obliterans,racial,Asian,0,7,7
134718,Hirsutism,racial,Black or African American ,7,0,7
4052931,Abandoned child,racial,Unknown,5,2,7
372624,Cataract with neovascularization,racial,White,7,0,7
372409,Sciatica neuralgia,racial,American Indian,7,0,7
433985,Hypercarotinemia,racial,Other Race,5,2,7
4263748,Recurrent major depression in complete remission,ethnic,Not Hispanic or Latino,5,2,7
443982,Traumatic amputation of thumb,racial,White,0,7,7
437891,PPHT - Primary pulmonary hypertension,racial,Other Race,7,0,7
441276,Nondependent alcohol abuse in remission,racial,Other Race,0,7,7
375538,"Degeneration of macula due to cyst, hole or pseudohole",ethnic,Not Hispanic or Latino,7,0,7
4064925,Hypertension screening,racial,Other Race,5,2,7
201397,Prune belly syndrome,ethnic,Hispanic or Latino,0,7,7
254387,Upper respiratory tract hypersensitivity reaction,racial,American Indian or Alaska Native ,2,5,7
438447,Acute myocardial infarction of inferolateral wall,ethnic,Not Hispanic or Latino,0,7,7
256810,Choanal atresia,racial,White,0,7,7
439298,Bronchitis and pneumonitis due to chemical fumes,racial,Unknown,7,0,7
435928,Abnormal decrease in weight,racial,American Indian or Alaska Native ,5,2,7
201340,Gastritis,racial,Asian,7,0,7
77600,Encysted hydrocele,racial,White,0,7,7
438112,Neoplastic disease,ethnic,Not Hispanic or Latino,5,2,7
435774,Disorder of amino acid metabolism,ethnic,Hispanic or Latino,2,5,7
380407,Chronic infective otitis externa,racial,White,7,0,7
443617,Conduct disorder,racial,Other Race,2,5,7
132483,"Insect bite, nonvenomous, of hand, infected",racial,White,0,7,7
444413,Pyrexial convulsion,racial,Black or African American ,0,7,7
4179332,Parent-child problem,racial,Other Race,2,5,7
436136,Dissection of thoracic aorta,racial,White,0,7,7
437544,Arterial retinal branch occlusion,ethnic,Not Hispanic or Latino,7,0,7
438306,Poisoning by psychodysleptic,racial,White,0,7,7
437202,Giardiasis,racial,White,2,5,7
315586,Priapism,ethnic,Not Hispanic or Latino,0,7,7
378421,Alcoholic peripheral neuropathy,racial,American Indian or Alaska Native ,0,7,7
319038,Postmyocardial infarction syndrome,racial,Unknown,2,5,7
4204966,Regurgitant esophagitis,ethnic,Not Hispanic or Latino,0,7,7
192759,Sequelae of fracture of spine,racial,White,2,5,7
256722,Bronchopneumonia,ethnic,Not Hispanic or Latino,0,7,7
381575,Disorder of external ear,racial,Black or African American ,7,0,7
258785,Pneumococcal pneumonia,racial,Black or African American ,0,7,7
381839,Habit disorder,racial,Asian,0,7,7
378547,Congenital anomaly of retina,racial,White,7,0,7
198803,Nodular hyperplasia of prostate gland,racial,American Indian,0,7,7
73843,Synovial cyst of popliteal space,racial,American Indian or Alaska Native ,0,7,7
4323155,Limited consultation,racial,White,5,2,7
4064362,Mycotic infection screening,ethnic,Hispanic or Latino,7,0,7
4222896,Chronic duodenal ulcer without haemorrhage AND without perforation,ethnic,Hispanic or Latino,7,0,7
440748,Interstitial emphysema of lung,racial,Other Race,0,7,7
381301,Chronic serous otitis media,racial,Asian,2,5,7
192496,Unilateral traumatic amputation of leg below knee with complication,ethnic,Hispanic or Latino,0,7,7
375838,Objective tinnitus,racial,Unknown,0,7,7
193955,TB - Renal tuberculosis,ethnic,Hispanic or Latino,7,0,7
4144118,Gastrointestinal haemorrhage unspecified,racial,White,5,2,7
432968,Anemia during pregnancy - baby delivered,racial,Other Race,7,0,7
437222,Respiratory syncytial virus infection,racial,Other Race,2,5,7
4103897,Unspecified ectropion,racial,White,7,0,7
192279,Diabetic nephropathy,racial,American Indian,7,0,7
438438,Acute myocardial infarction of anterolateral wall,ethnic,Not Hispanic or Latino,0,7,7
134452,Miners' elbow,racial,Other Race,0,7,7
439672,Viral hepatitis C with coma,racial,White,0,7,7
201354,Infertility due to extratesticular cause,ethnic,Not Hispanic or Latino,0,7,7
432441,Finding of length of gestation,racial,Asian,2,5,7
432512,Foreign object left in body during procedure,ethnic,Not Hispanic or Latino,7,0,7
76002,Mechanical complication due to breast prosthesis,racial,White,7,0,7
137591,Chronic apical periodontitis,ethnic,Hispanic or Latino,2,5,7
80502,Osteoporosis,racial,Native Hawaiian or Other Pacific Islander ,7,0,7
439935,Abnormal posture,ethnic,Hispanic or Latino,2,5,7
373205,Hemorrhage of eyelid,ethnic,Hispanic or Latino,5,2,7
78799,Chronic ulcerative ileocolitis,racial,Unknown,7,0,7
432867,Hyperlipidemia,racial,European,0,7,7
81426,Closed fracture of clavicle,racial,Asian,7,0,7
4100515,Cocaine type drug dependence,ethnic,Hispanic or Latino,0,7,7
72459,Closed fracture of two ribs,ethnic,Hispanic or Latino,7,0,7
196438,Acquired arteriovenous fistula of liver,racial,Other Race,5,2,7
443401,Congenital connective tissue disorder,racial,Unknown,7,0,7
79173,Closed dislocation of jaw,racial,American Indian,7,0,7
433846,Ankylosis of joint of lower leg,racial,White,5,2,7
78804,Schimmelbusch's disease,racial,American Indian or Alaska Native ,7,0,7
436667,Stammer,racial,Asian,0,7,7
135208,Benign tumor of lip,racial,Unknown,7,0,7
373474,Seeing double,racial,Black or African American ,7,0,7
4194160,Thyroid function tests abnormal,racial,Black or African American ,2,5,7
137016,Retained dental root,ethnic,Hispanic or Latino,5,2,7
196151,Functional disorder of intestine,racial,White,7,0,7
140176,Erythema nodosum,racial,Unknown,0,7,7
132494,Partial thickness burn of toe,racial,White,7,0,7
434842,Cause of overdose - accidental,ethnic,Hispanic or Latino,2,5,7
72374,Unstable lie with antenatal problem,ethnic,Not Hispanic or Latino,7,0,7
81721,Open wound of hand except fingers with tendon involvement,racial,White,5,2,7
4168213,Chest pain on breathing,racial,American Indian or Alaska Native ,7,0,7
201958,Perinatal dermatological disorders,racial,White,5,2,7
79898,Cellulitis and abscess of finger,racial,Other Race,5,2,7
440224,Closed dislocation of cervical vertebra,ethnic,Hispanic or Latino,7,0,7
4114451,"Localized, primary osteoarthritis of unspecified site",racial,Unknown,7,0,7
432525,Thyroid agent adverse reaction,ethnic,Not Hispanic or Latino,5,2,7
4167069,Aneurysm clipping,racial,Asian,7,0,7
80249,Sprain of acromioclavicular ligament,racial,White,0,7,7
133295,Inflammatory spondylopathy,ethnic,Not Hispanic or Latino,7,0,7
198810,Vulval intraepithelial neoplasia grade 2,ethnic,Hispanic or Latino,7,0,7
439197,Nonvenomous insect bite of neck with infection,ethnic,Hispanic or Latino,5,2,7
318448,"Incomplete atrioventricular block, second degree",ethnic,Not Hispanic or Latino,0,7,7
74114,Cellulitis and abscess of foot excluding toe,racial,Black or African American ,0,7,7
313867,Double outlet right ventricle,racial,Other Race,7,0,7
4129665,Hearing aid care,racial,White,5,2,7
433208,Disorder of pulmonary circulation,ethnic,Hispanic or Latino,2,5,7
378165,Nystagmus,racial,Unknown,7,0,7
438535,Congenital abnormality of iris and ciliary body,racial,White,2,5,7
79116,Disorder of tendon of shoulder region,racial,Asian,0,7,7
432725,Congenital anomaly of integument,racial,Unknown,7,0,7
374640,Exudative retinal detachment,racial,Unknown,7,0,7
200447,Gastrointestinal complication,racial,White,7,0,7
4062488,Thyroid disorder screening,racial,Black or African American ,2,5,7
141666,Acute osteomyelitis of lower leg,ethnic,Not Hispanic or Latino,0,7,7
4069400,Acquired genu valgum and varum,racial,White,0,7,7
372424,Congenital anolmaly of eye,racial,Unknown,2,5,7
4219346,Meatoplasty of urethra,racial,Unknown,0,7,7
374035,Keratitis,racial,White,7,0,7
377527,Presenile dementia with depression,racial,Asian,7,0,7
133278,Disorder of hair,racial,Unknown,7,0,7
81251,Neoplasm of breast,racial,White,7,0,7
378135,Facial nerve disorder,ethnic,Not Hispanic or Latino,0,7,7
436251,Closed fracture of proximal end of ulna,racial,White,2,5,7
440700,Communicating hydrocephalus,racial,White,7,0,7
4064362,Mycotic infection screening,racial,Asian,0,7,7
73889,Sprain of distal tibiofibular ligament,racial,White,5,2,7
441049,Enamel caries,ethnic,Not Hispanic or Latino,7,0,7
441190,Injury of unknown intent due to fall from height,racial,Asian,5,2,7
439222,Corticosteroids adverse reaction,ethnic,Hispanic or Latino,7,0,7
201995,"Contusion, lower limb, multiple sites",ethnic,Hispanic or Latino,7,0,7
136354,Dermal metastasis,racial,White,0,7,7
4323962,"Electrocardiogram, rhythm",racial,White,0,7,7
434675,Complication of gastrostomy,racial,Black or African American ,2,5,7
132494,Partial thickness burn of toe,ethnic,Hispanic or Latino,7,0,7
378849,Microtia,racial,Unknown,2,5,7
443788,Peritoneal adhesions with obstruction,racial,White,5,2,7
192954,Acute gastric ulcer without hemorrhage AND without perforation but with obstruction,ethnic,Not Hispanic or Latino,0,7,7
440422,Noise-induced hearing loss,ethnic,Hispanic or Latino,5,2,7
197324,Disease of peritoneum,ethnic,Not Hispanic or Latino,5,2,7
79903,Effusion of joint,ethnic,Not Hispanic or Latino,7,0,7
197032,Hyperplasia of prostate,racial,Black or African American ,0,7,7
439656,A/N care: grand multip,racial,Unknown,7,0,7
77630,Disease of shoulder,racial,Asian Indian,0,7,7
441647,Continuing pregnancy after intrauterine death of twin fetus,racial,White,7,0,7
4334644,Decubitus ulcer of lower back,ethnic,Not Hispanic or Latino,2,5,7
374364,Disorder of middle ear,ethnic,Not Hispanic or Latino,2,5,7
4026149,Other cholecystitis,ethnic,Hispanic or Latino,7,0,7
138973,Chancroid,racial,White,5,2,7
201449,Unilateral traumatic amputation of leg below knee without complication,racial,Unknown,7,0,7
441712,Open wound of ocular adnexa,racial,Unknown,2,5,7
433083,Opiate and narcotic poisoning,racial,White,7,0,7
377091,Fits - convulsions,racial,American Indian or Alaska Native ,0,7,7
193739,Ovarian failure,racial,Unknown,7,0,7
134780,Closed dislocation of metatarsal joint,racial,White,7,0,7
4092879,Absent kidney,racial,American Indian,0,7,7
4052837,Open wound of breast,racial,Unknown,7,0,7
200445,Chronic prostatitis,racial,Other Race,0,7,7
74194,Back sprain,racial,Other Race,5,2,7
438155,Optic disc glaucomatous atrophy,racial,Filipino,0,7,7
375256,Anterior subcapsular polar senile cataract,ethnic,Not Hispanic or Latino,7,0,7
75010,Fibroadenosis of breast,racial,Black or African American ,7,0,7
196734,Disease of prostate,racial,Asian,0,7,7
134461,Tietze disease,racial,Native Hawaiian or Other Pacific Islander ,2,5,7
435875,"Complications of pregnancy, childbirth and the puerperium",racial,Black or African American ,5,2,7
440098,Rubeosis iridis,ethnic,Hispanic or Latino,5,2,7
4196362,Genetic counselling,racial,Asian,7,0,7
439836,Atheromatous embolus of upper limb,racial,Unknown,7,0,7
24134,Nonspecific pain in the neck region,racial,American Indian,0,7,7
437259,Disruptive behavior disorder,racial,White,7,0,7
134324,Lipodystrophy,racial,Unknown,0,7,7
4107375,Somatoform pain disorder,ethnic,Hispanic or Latino,7,0,7
133848,Non-traumatic slipped upper femoral epiphysis,ethnic,Not Hispanic or Latino,0,7,7
254761,Cough,racial,Alaska Native,7,0,7
73841,Multiple stiff joints,ethnic,Hispanic or Latino,0,7,7
437409,Intracranial injury,racial,Black or African American ,0,7,7
201626,Mid-cycle pain,ethnic,Not Hispanic or Latino,2,5,7
440787,"Drug dependence in mother complicating pregnancy, childbirth AND/OR puerperium",ethnic,Not Hispanic or Latino,7,0,7
4056171,Prostatic hyperplasia NOS,ethnic,Hispanic or Latino,0,7,7
375838,Objective tinnitus,ethnic,Not Hispanic or Latino,0,7,7
379782,Gilles de la Tourette's syndrome,racial,Other Race,0,7,7
201899,Unilateral recurrent inguinal hernia,racial,Asian,7,0,7
441207,Drug reaction,racial,Black or African American ,5,2,7
4201412,Speech therapy,racial,White,2,5,7
380533,Neonatal seizures,racial,Other Race,7,0,7
435171,Allergic state,racial,American Indian or Alaska Native ,7,0,7
132416,Chronic haematoma of pinna,ethnic,Hispanic or Latino,2,5,7
4100091,Child attention deficit disorder NOS,racial,Unknown,2,5,7
438407,BN - Bulimia nervosa,racial,Unknown,7,0,7
258375,Malignant neoplasm of overlapping lesion of bronchus and lung,racial,White,0,7,7
75946,Sprain of proximal tibiofibular ligament,racial,Unknown,7,0,7
4176890,Male sterility,racial,Black or African American ,0,7,7
40484028,Dental caries extending into dentine,ethnic,Not Hispanic or Latino,2,5,7
440519,Premature - weight 1000g-2499g or gestation of 28-37weeks,racial,Asian,0,7,7
4149299,Follow-up orthopaedic assessment,racial,White,7,0,7
432612,Mild mental handicap,racial,Other Race,0,7,7
22274,Neoplasm of uncertain behaviour of larynx,ethnic,Not Hispanic or Latino,0,7,7
135496,Acute leukemia in remission,ethnic,Not Hispanic or Latino,7,0,7
315085,Enlargement of lymph nodes,racial,Native Hawaiian or Other Pacific Islander ,7,0,7
30163,Cellulitis and abscess of neck,racial,Asian,7,0,7
134304,Benign tumour of parathyroid gland,racial,Black or African American ,7,0,7
435374,Closed fracture of distal end of ulna,racial,White,0,7,7
4152838,Paralysis of vocal cords or larynx,ethnic,Hispanic or Latino,7,0,7
80294,Foreign body in genitourinary tract,racial,Unknown,7,0,7
434610,Hyperkalemia,racial,Filipino,7,0,7
4046500,Acute peptic ulcer with hemorrhage,racial,Asian,0,7,7
79938,Closed fracture of scapula,racial,White,7,0,7
4272867,General well-being finding,racial,Filipino,2,5,7
141666,Acute osteomyelitis of lower leg,racial,Black or African American ,0,7,7
4112816,Other respiratory system diseases,racial,Black or African American ,5,2,7
75354,Osteochondropathy,racial,Filipino,7,0,7
434145,Embryonal nuclear cataract,ethnic,Hispanic or Latino,7,0,7
81937,Traumatic arthropathy of the hand,racial,Unknown,7,0,7
443732,Disorder associated with type II diabetes melliltus,racial,Other Race,0,7,7
23988,Hemolytic anemia due to glutathione metabolism disorder,racial,White,0,7,7
140480,Impetigo,racial,American Indian or Alaska Native ,7,0,7
141411,Scalp injury,racial,Unknown,7,0,7
201617,Prostatic cyst,racial,White,0,7,7
24660,Acute tonsillitis,racial,Filipino,7,0,7
443862,Complication of internal anastomosis,racial,White,7,0,7
80880,Open wound of foot except toes with tendon involvement,ethnic,Hispanic or Latino,7,0,7
200319,Herpetic infection of penis,ethnic,Hispanic or Latino,0,7,7
72469,Closed dislocation of shoulder region,racial,Other Race,0,7,7
261687,Hemoptysis,racial,Asian,2,5,7
443519,Retinopathy of prematurity stage 4 - subtotal retinal detachment,racial,White,7,0,7
140027,Herpetic gingivostomatitis,racial,American Indian or Alaska Native ,5,2,7
136834,Closed intertrochanteric fracture,racial,Asian,7,0,7
135892,Erythematous condition,racial,Other Race,5,2,7
139734,Early yaws skin lesion,ethnic,Hispanic or Latino,5,2,7
199876,Prolapse of female genital organs,racial,Other Race,7,0,7
4073526,Bilateral inguinal hernia repair,racial,White,0,7,7
257775,Post-tuberculous bronchiectasis,racial,White,0,7,7
4062653,Gout screening,ethnic,Hispanic or Latino,5,2,7
199881,Endometriosis of ovary,ethnic,Hispanic or Latino,7,0,7
31610,Disorder of oesophagus,ethnic,Not Hispanic or Latino,5,2,7
4179925,Basic learning problem,racial,Asian,0,7,7
439025,Dacryocystitis,racial,Unknown,5,2,7
4227745,Infertility test,racial,White,5,2,7
4016675,"Sprain, ankle joint, medial",racial,Black or African American ,0,7,7
435023,Mild hyperemesis-not delivered,racial,Other Race,7,0,7
4219346,Meatoplasty of urethra,ethnic,Hispanic or Latino,0,7,7
381278,Cluster headache,racial,Unknown,0,7,7
135722,Chronic infection of amputation stump,racial,White,0,7,7
81378,Chondromalacia of patella,racial,Other Race,2,5,7
435231,Nondependent cannabis abuse in remission,ethnic,Hispanic or Latino,2,5,7
4185471,Disorder of pigmentation,racial,Other Race,7,0,7
434613,Generalized anxiety disorder,racial,Asian Indian,7,0,7
435325,Umbilical cord complication,ethnic,Not Hispanic or Latino,2,5,7
436391,Primary cerebellar degeneration,racial,Unknown,7,0,7
80478,Engorgement of breasts associated with childbirth,ethnic,Not Hispanic or Latino,7,0,7
437544,Arterial retinal branch occlusion,racial,Asian,7,0,7
4250023,Severe major depression with psychotic features,racial,Asian,7,0,7
435233,Disorders of fatty-acid metabolism,ethnic,Hispanic or Latino,5,2,7
136779,Disease of forearm,ethnic,Not Hispanic or Latino,7,0,7
439836,Atheromatous embolus of upper limb,ethnic,Hispanic or Latino,7,0,7
78267,Closed anterior dislocation of humerus,ethnic,Hispanic or Latino,2,5,7
437828,Disorder of calcium metabolism,racial,Black or African American ,0,7,7
321107,AR - Congenital aortic regurgitation,racial,Unknown,0,7,7
439224,Drug allergy,racial,Black or African American ,5,2,7
435517,Acidosis,racial,Unknown,2,5,7
200483,Disease of pelvis,racial,Other Race,2,5,7
139202,"Burn involving 20-29 percent of body surface, with 10-19 percent of body surface with full thickness burn",racial,Unknown,7,0,7
437896,Disorder of language,ethnic,Not Hispanic or Latino,5,2,7
442444,"Motor vehicle traffic accident involving pedestrian hit by motor vehicle, pedestrian injured",ethnic,Not Hispanic or Latino,7,0,7
133655,Burn of forearm,ethnic,Hispanic or Latino,2,5,7
4326838,Decubitus ulcer of upper back,ethnic,Hispanic or Latino,7,0,7
196324,Food poisoning due to Clostridium perfringens,racial,White,0,7,7
435492,Nodular lymphoma of intrathoracic lymph nodes,racial,Black or African American ,0,7,7
74892,Articular gout,racial,Black or African American ,7,0,7
437257,Continuous acute alcoholic intoxication in alcoholism,racial,Unknown,0,7,7
138346,Erysipelas,ethnic,Not Hispanic or Latino,5,2,7
439346,"Motor vehicle traffic accident involving pedestrian run over by motor vehicle, occupant of tram injured",ethnic,Hispanic or Latino,2,5,7
4064905,Venereal disease screening,racial,Filipino,5,2,7
440071,Gout associated problems,racial,White,0,7,7
194989,Bilateral recurrent inguinal hernia with obstruction but no gangrene,racial,White,0,7,7
4092879,Absent kidney,racial,Other Race,5,2,7
4175331,Congenital haemolytic anaemia,racial,White,5,2,7
438878,Abnormal results of liver function studies,racial,Filipino,7,0,7
4318111,Traumatic amputation of leg,ethnic,Hispanic or Latino,0,7,7
313980,"Hodgkin disease, lymphocytic depletion of lymph nodes of multiple sites",racial,White,7,0,7
4069541,Other acquired ankle and foot deformity,ethnic,Hispanic or Latino,5,2,7
377560,Internal hordeolum,racial,Other Race,5,2,7
78282,Closed dislocation of coccyx,ethnic,Hispanic or Latino,7,0,7
257683,Postnasal drip,racial,Filipino,7,0,7
137750,Second degree burn of forehead AND/OR cheek,ethnic,Not Hispanic or Latino,0,7,7
141124,Congenital cardiovascular disorder,ethnic,Not Hispanic or Latino,0,7,7
258981,Kaposi's sarcoma of skin,racial,Unknown,0,7,7
75946,Sprain of proximal tibiofibular ligament,racial,White,7,0,7
201354,Infertility due to extratesticular cause,racial,White,0,7,7
439935,Abnormal posture,racial,White,2,5,7
435792,Drug-induced sleep disorder,racial,Unknown,7,0,7
4061214,Ulceration of vulva NOS,ethnic,Hispanic or Latino,7,0,7
377280,Corneal disorder,racial,Unknown,5,2,7
437699,Strain of infraspinatus muscle AND/OR tendon,ethnic,Hispanic or Latino,0,7,7
134144,Cleft palate with cleft lip,racial,Black or African American ,0,7,7
378439,Fourth nerve palsy,ethnic,Hispanic or Latino,5,2,7
142032,Partial thickness burn of lower leg,racial,White,7,0,7
201894,Acute intestinal vascular insufficiency,racial,White,0,7,7
373962,Tabes dorsalis - neurosyphilis,racial,Unknown,7,0,7
373648,Superficial injury of eyelid AND/OR periocular area,racial,White,2,5,7
376709,Discharge of eye,racial,Other Race,0,7,7
26441,Bleeding ulcer of esophagus,racial,Other Race,7,0,7
4090114,Toxoplasmosis chorioretinitis,ethnic,Hispanic or Latino,5,2,7
374954,Optic neuritis,racial,Unknown,5,2,7
433025,Complication of vaccination,ethnic,Hispanic or Latino,2,5,7
436519,Perinatal intraventricular hemorrhage,ethnic,Not Hispanic or Latino,5,2,7
260123,Acute inflammation of sinus,racial,Asian Indian,0,7,7
139180,Open wound of multiple sites of face without complication,racial,White,0,7,7
4060689,Polyhydramnios unspecified,ethnic,Hispanic or Latino,7,0,7
4113351,Unspecified spontaneous abortion with complication NOS,ethnic,Hispanic or Latino,7,0,7
73923,"Contusion, upper arm",ethnic,Not Hispanic or Latino,7,0,7
197332,Incomplete uterovaginal prolapse,ethnic,Not Hispanic or Latino,7,0,7
442290,Varicose veins of legs complicating pregnancy AND/OR puerperium,ethnic,Hispanic or Latino,7,0,7
194151,Congenital anomaly of stomach,racial,White,0,7,7
435754,Ca ascending colon,racial,White,0,7,7
316427,Aneurysm of coronary vessels,ethnic,Not Hispanic or Latino,0,7,7
376686,Polyneuropathy associated with another disorder,racial,Other Race,0,7,7
440457,Threatened abortion,racial,Black or African American ,7,0,7
377853,Chronic tension-type headache,racial,Other Race,7,0,7
442901,"Motor vehicle traffic accident involving collision with another motor vehicle, stopped, occupant of tram injured",racial,Unknown,0,7,7
4031190,Swallowed foreign body,racial,Unknown,7,0,7
377254,"Multi-infarct dementia, uncomplicated",racial,Native Hawaiian or Other Pacific Islander ,0,7,7
74468,Congenital anomaly of rib,ethnic,Not Hispanic or Latino,0,7,7
196165,Cervical intraepithelial neoplasia grade 2,racial,Asian,7,0,7
436381,Gender identity disorder of childhood,racial,Black or African American ,2,5,7
436681,Insomnia disorder related to known organic factor,racial,Other Race,0,7,7
194100,Obstructed labour due to foetal malposition,racial,White,0,7,7
433946,Fall on same level due to impact against another person,racial,Other Race,2,5,7
133569,Fasciitis,racial,Asian,2,5,7
4167075,Fusion of knee,racial,Unknown,0,7,7
434156,Congenital anemia,ethnic,Not Hispanic or Latino,2,5,7
444258,Abrasion AND/OR friction burn of neck with infection,racial,White,2,5,7
4102739,Screening for cardiovascular system disease,racial,Unknown,0,7,7
196217,Congenital malformation of diaphragm,racial,Other Race,0,7,7
196347,Intestinal parasitism,racial,Unknown,0,7,7
435510,Hypocalcemia,racial,Other Race,5,2,7
442116,Allergy to eggs,racial,Black or African American ,0,7,7
79106,Arthralgia of the pelvic region and thigh,racial,American Indian,7,0,7
139099,Ingrowing nail,racial,Filipino,5,2,7
201958,Perinatal dermatological disorders,ethnic,Not Hispanic or Latino,2,5,7
440068,Psychosexual dysfunction,ethnic,Not Hispanic or Latino,0,7,7
141932,Senile hyperkeratosis,racial,Black or African American ,2,5,7
435866,Retrograde ejaculation,ethnic,Hispanic or Latino,0,7,7
441691,Atypical squamous cells of undetermined significance on vaginal Papanicolaou smear,racial,Other Race,7,0,7
374267,Tuberculosis of central nervous system,ethnic,Hispanic or Latino,7,0,7
376125,Disorder of eyelid,racial,Filipino,0,7,7
440589,Toxic effect of caustic substance,racial,White,5,2,7
441545,Somatisation disorder,ethnic,Not Hispanic or Latino,2,5,7
435308,Acute exudative glomerulonephritis,ethnic,Hispanic or Latino,0,7,7
194412,Dysplasia of vagina,racial,White,7,0,7
80805,Primary localized osteoarthrosis of forearm,racial,Other Race,7,0,7
375806,Idiopathic peripheral neuropathy,racial,Asian Indian,0,7,7
378547,Congenital anomaly of retina,ethnic,Hispanic or Latino,7,0,7
443933,Nicotiana tabacum poisoning,racial,Black or African American ,7,0,7
29735,Candidiasis of mouth,racial,Filipino,5,2,7
74322,Benign neoplasm of scrotum,racial,Unknown,0,7,7
136580,Dehiscence of surgical wound,ethnic,Not Hispanic or Latino,7,0,7
4201274,Anastomosis of small intestine to rectal stump,racial,White,7,0,7
132834,White piedra,racial,Unknown,7,0,7
437257,Continuous acute alcoholic intoxication in alcoholism,racial,White,7,0,7
438827,Foreign body granuloma of subcutaneous tissue,racial,Unknown,7,0,7
4049623,"Moderate major depression, single episode",racial,American Indian or Alaska Native ,7,0,7
259070,PGN - Acute proliferative glomerulonephritis,racial,Unknown,7,0,7
321689,Apneic,racial,Black or African American ,2,5,7
81983,Multiple dislocations,racial,White,7,0,7
438223,Sunburn of second degree,racial,White,2,5,7
443556,Primary focal hyperhidrosis,ethnic,Not Hispanic or Latino,2,5,7
135893,Decubitus ulcer of heel,racial,Black or African American ,0,7,7
73866,Congenital anomaly of breast,ethnic,Not Hispanic or Latino,7,0,7
80568,Traumatic amputation of finger without mention of complication,ethnic,Not Hispanic or Latino,5,2,7
80242,Current tear of medial cartilage AND/OR meniscus of knee,racial,Black or African American ,7,0,7
40482030,Dysplasia of prostate,ethnic,Hispanic or Latino,0,7,7
441579,Acute inferoposterior infarction,racial,Unknown,0,7,7
439251,"Bipolar affective disorder, currently depressed, in full remission",racial,Black or African American ,7,0,7
4034214,Open wound of ear,racial,White,2,5,7
74472,Congenital deformity of foot,racial,Black or African American ,2,5,7
432611,Explosive personality disorder,racial,Black or African American ,0,7,7
440964,Hodgkin's paragranuloma of extranodal AND/OR solid organ site,ethnic,Hispanic or Latino,0,7,7
432250,Infective disorder,ethnic,Not Hispanic or Latino,2,5,7
435374,Closed fracture of distal end of ulna,racial,Unknown,5,2,7
138667,Stoma observations,ethnic,Not Hispanic or Latino,0,7,7
4053045,Dog bite,racial,Black or African American ,0,7,7
437947,Complication of obstetrical surgical wound,racial,Unknown,7,0,7
373472,Pigmentary retinal dystrophy,racial,White,5,2,7
192858,Ovarian hyperfunction,racial,Unknown,7,0,7
196796,Congenital biliary atresia,racial,Unknown,0,7,7
194802,Foreign body in vulva and vagina,ethnic,Not Hispanic or Latino,7,0,7
443295,Maternal care for diminished foetal movements,ethnic,Not Hispanic or Latino,7,0,7
73557,Allergic arthritis of the pelvic region and thigh,ethnic,Hispanic or Latino,7,0,7
201606,Crohn's disease,racial,Asian,0,7,7
197440,Nonvenomous insect bite of trunk without infection,ethnic,Not Hispanic or Latino,7,0,7
381866,Degenerative disorder of eyelid,racial,White,2,5,7
440535,Abnormal radiographic examination,racial,Asian,5,2,7
443869,Nonvenomous insect bite of wrist without infection,ethnic,Not Hispanic or Latino,0,7,7
440233,Strain of supraspinatus muscle AND/OR tendon,racial,Unknown,7,0,7
140357,Neoplasm of uncertain behaviour of endocrine gland,racial,Unknown,7,0,7
443539,Motor vehicle injury,racial,White,2,5,7
436249,Closed fracture of femoral condyle of femur,ethnic,Not Hispanic or Latino,2,5,7
437046,Complete abortion,racial,Asian,7,0,7
437165,Motor vehicle traffic accident,racial,Other Race,2,5,7
374914,Quadriplegia,racial,Unknown,0,7,7
376337,Disease of nervous system,racial,Other Race,2,5,7
4103894,Hordeolum and other deep inflammation of eyelid NOS,ethnic,Not Hispanic or Latino,2,5,7
380733,Otalgia,racial,American Indian or Alaska Native ,5,2,7
73017,Congenital anomaly of toe,racial,Unknown,7,0,7
432453,General clinical state finding,racial,Black or African American ,2,5,7
442926,"Motor vehicle traffic accident involving collision with another motor vehicle, parked, driver of motor vehicle injured",racial,Unknown,5,2,7
435492,Nodular lymphoma of intrathoracic lymph nodes,ethnic,Not Hispanic or Latino,0,7,7
199913,Acquired deformity of ankle AND/OR foot,racial,Other Race,7,0,7
76002,Mechanical complication due to breast prosthesis,racial,Unknown,7,0,7
78232,Shoulder joint pain,racial,American Indian,7,0,7
141248,Benign neoplasm of skin of lip,racial,Unknown,7,0,7
433856,Fracture of neck of femur,racial,White,0,7,7
440989,Intermittent explosive disorder,ethnic,Hispanic or Latino,5,2,7
373488,Pupil-sparing third nerve palsy,ethnic,Not Hispanic or Latino,0,7,7
73576,Acquired chest and rib deformity,racial,Unknown,2,5,7
75095,Closed fracture of ankle,racial,Other Race,5,2,7
380103,Retinal detachment with retinal defect,ethnic,Not Hispanic or Latino,2,5,7
72710,Effusion of joint of forearm,racial,Asian,5,2,7
432660,Dentofacial anomaly,racial,White,2,5,7
4092669,Other viral exanthemata,ethnic,Hispanic or Latino,0,7,7
437247,Anaemia of chronic disease,racial,Filipino,0,7,7
435381,Closed fracture of base of thumb,racial,White,2,5,7
4276723,Finding of child weight centiles,racial,Native Hawaiian or Other Pacific Islander ,5,2,7
432525,Thyroid agent adverse reaction,ethnic,Hispanic or Latino,7,0,7
140435,Arrested dental caries,racial,Unknown,5,2,7
433759,Developmental reading disorder,racial,White,2,5,7
435224,Leukopenia,racial,Other Race,2,5,7
134248,Second degree burn of thumb,racial,White,2,5,7
134404,Anal spasm,racial,White,2,5,7
192357,Paralytic ileus,racial,Unknown,7,0,7
437013,"Primary dental caries, pit and fissure origin",ethnic,Not Hispanic or Latino,0,7,7
259849,Pneumonia with infectious diseases EC,ethnic,Not Hispanic or Latino,2,5,7
72715,Exostosis,racial,Unknown,7,0,7
4098297,Unspecified latent schizophrenia,ethnic,Not Hispanic or Latino,5,2,7
24230,Laryngeal FB - foreign body,racial,White,0,7,7
137652,Specific bursitis often of occupational origin,ethnic,Not Hispanic or Latino,0,7,7
373870,Neonatal dacryocystitis and conjunctivitis,ethnic,Hispanic or Latino,0,7,7
193402,Bacterial enteritis,racial,Unknown,5,2,7
380407,Chronic infective otitis externa,racial,Unknown,2,5,7
376104,Posttraumatic headache,racial,Asian,2,5,7
76255,Sprain of iliofemoral ligament,racial,White,5,2,7
376965,Hypertensive retinopathy,racial,Other Race,7,0,7
200470,Varicose veins of vulva AND/OR perineum complicating pregnancy AND/OR puerperium,ethnic,Hispanic or Latino,7,0,7
4096657,Toxic multinodular goitre NOS,racial,White,7,0,7
193308,Congenital anomaly of spleen,racial,Unknown,5,2,7
22856,Polyglandular dysfunction,ethnic,Hispanic or Latino,7,0,7
434890,Repetitive stereotyped movement,ethnic,Not Hispanic or Latino,0,7,7
75555,Viral labyrinthitis,ethnic,Hispanic or Latino,5,2,7
198374,Nodular lymphoma of spleen,racial,White,0,7,7
437226,Malignant neoplasm of nasopharyngeal wall,racial,Unknown,0,7,7
195856,Cholangitis,racial,Unknown,5,2,7
200845,Urinary precipitancy,racial,Other Race,2,5,7
321483,Respiratory complication,racial,White,2,5,7
437589,Pulpitis,ethnic,Hispanic or Latino,7,0,7
200144,Unilateral simple femoral hernia,racial,White,2,5,7
432967,Anemia during pregnancy - baby not yet delivered,racial,Black or African American ,7,0,7
381017,Ametropic amblyopia,racial,Other Race,7,0,7
4291005,VH - Viral hepatitis,ethnic,Hispanic or Latino,2,5,7
196431,Hypersensitivity angiitis,ethnic,Not Hispanic or Latino,7,0,7
140486,Ulcer of calf,racial,Asian,0,7,7
201265,Splenic disorder,racial,Asian,0,7,7
439654,Partial epilepsy with impairment of consciousness,racial,Asian,0,7,7
194149,Hirschsprung disease,racial,Native Hawaiian or Other Pacific Islander ,0,7,7
375278,Acquired stenosis of external ear canal secondary to inflammation,racial,White,2,5,7
73075,Contusion of upper limb,ethnic,Not Hispanic or Latino,5,2,7
192577,Carcinoma in situ of female genital organ,ethnic,Hispanic or Latino,7,0,7
135350,Acute osteomyelitis of the ankle and/or foot,racial,Unknown,2,5,7
373463,Benign cough headache,racial,Unknown,5,2,7
436859,"Insect bite, nonvenomous, of shoulder and upper arm, infected",ethnic,Hispanic or Latino,2,5,7
443913,Congenital anomaly of trachea,racial,Asian,0,7,7
372247,Candidal otomycosis,ethnic,Not Hispanic or Latino,5,2,7
194093,Postcoital bleeding,racial,Asian,7,0,7
436522,Irregular sleep-wake pattern,racial,Black or African American ,0,7,7
315947,Thoracic back sprain,racial,Filipino,5,2,7
432695,Post-term pregnancy,ethnic,Not Hispanic or Latino,5,2,7
439794,CSA - Central sleep apnoea,ethnic,Hispanic or Latino,2,5,7
4233827,Biopsy of lymphatic structure,ethnic,Hispanic or Latino,2,5,7
193136,Acute gonococcal cervicitis,racial,White,7,0,7
435633,Juvenile osteochondrosis of upper extremity,racial,White,7,0,7
444256,Polyp of labia,racial,Unknown,7,0,7
441351,Early onset of delivery - delivered,racial,White,5,2,7
78233,Old disruption of medial collateral ligament,racial,White,5,2,7
78236,Muscle wasting disorder,racial,Asian,5,2,7
373478,Presbyopia,racial,Filipino,5,2,7
443580,Systolic heart failure,racial,Asian,5,2,7
433595,Interstitial edema,racial,Native Hawaiian or Other Pacific Islander ,0,7,7
193809,Melena due to gastrointestinal hemorrhage,racial,Native Hawaiian or Other Pacific Islander ,2,5,7
23808,"Chronic peptic ulcer without hemorrhage, without perforation AND without obstruction",racial,White,2,5,7
441896,Plicated tongue,racial,White,7,0,7
78237,Bicipital tenosynovitis,racial,Other Race,7,0,7
442012,"Mechanical complication of genitourinary device, implant AND/OR graft",racial,Unknown,0,7,7
194964,Aneurysm of splenic artery,racial,Other Race,7,0,7
4175226,Screening for malignant neoplasm of colon,racial,Alaska Native,0,7,7
77335,Known OR suspected fetal abnormality affecting management of mother,racial,White,2,5,7
200671,Benign tumour of renal pelvis,racial,White,7,0,7
443442,Finding of vaginal vault smear result,racial,Asian,7,0,7
314171,Low blood pressure reading,ethnic,Not Hispanic or Latino,2,5,7
373775,Psychophysical visual disturbance,racial,Unknown,7,0,7
440820,Contracture of wrist joint,racial,White,7,0,7
4171556,Ankle ulcer,racial,Black or African American ,0,7,7
80004,Hand injury,racial,Black or African American ,2,5,7
140842,Changes in skin texture,racial,Filipino,5,2,7
77734,Contusion of lower leg,racial,Black or African American ,7,0,7
436353,Primary malignant neoplasm of upper outer quadrant of female breast,racial,White,7,0,7
376382,Tension-type headache,racial,Filipino,7,0,7
4110787,Other otitis externa,racial,Asian,0,7,7
136354,Dermal metastasis,ethnic,Not Hispanic or Latino,0,7,7
432893,Myasthenic syndrome due to another disorder,racial,White,2,5,7
440878,Open wound of jaw without complication,racial,Unknown,7,0,7
4047947,Complete parathyroidectomy,racial,Unknown,7,0,7
443577,Asymmetric sensorineural hearing loss,ethnic,Not Hispanic or Latino,7,0,7
435412,Second degree burn of breast,ethnic,Hispanic or Latino,7,0,7
73026,Abnormal respiratory sounds,racial,Black or African American ,2,5,7
437523,Dependent personality disorder,ethnic,Not Hispanic or Latino,0,7,7
4109564,Unspecified corneal ulcer,ethnic,Hispanic or Latino,7,0,7
441334,Glossodynia,racial,Other Race,7,0,7
77968,Hallux valgus AND bunion,racial,Filipino,7,0,7
197444,Vascular complication of medical care,ethnic,Not Hispanic or Latino,0,7,7
436919,Primary malignant neoplasm of unspecified site,racial,Other Race,5,2,7
444202,Abscess,racial,American Indian,7,0,7
4150481,"Traumatic blister of shoulder and upper arm, infected",ethnic,Hispanic or Latino,7,0,7
442270,Disease of duodenum,ethnic,Not Hispanic or Latino,0,7,7
4326681,Family history of malignant neoplasm of ovary,ethnic,Not Hispanic or Latino,7,0,7
139850,Acute frontal sinusitis,racial,Asian Indian,7,0,7
77129,Closed fracture of pelvis,ethnic,Not Hispanic or Latino,7,0,7
381035,Vertigo of central origin,racial,White,2,5,7
4194056,"Simple partial seizure, consciousness not impaired",ethnic,Hispanic or Latino,0,7,7
437342,Abnormality of forces of labor,ethnic,Hispanic or Latino,7,0,7
200775,Endometrial hyperplasia,racial,Unknown,7,0,7
200051,Primary malignant neoplasm of ovary,racial,Unknown,7,0,7
4120610,Carrier of hereditary factor VIII deficiency disease,racial,White,0,7,7
197724,Unilateral traumatic amputation of foot without complication,racial,White,0,7,7
78909,"Contusion, shoulder and upper arm, multiple sites",ethnic,Not Hispanic or Latino,5,2,7
23865,Congenital abnormality of pharynx,racial,White,7,0,7
197684,Dysuria,racial,Asian Indian,7,0,7
138718,Thyrotoxicosis from ectopic thyroid nodule with no crisis,racial,White,5,2,7
439926,Malaise and fatigue,racial,Asian Indian,0,7,7
440084,Aphemesthaesia,racial,White,2,5,7
440647,Sexually transmitted infectious disease,racial,Black or African American ,0,7,7
4088930,Confirmation of pregnancy,racial,Native Hawaiian or Other Pacific Islander ,7,0,7
435987,Peanut-induced anaphylaxis,ethnic,Hispanic or Latino,0,7,7
201900,Neurogenic bowel,ethnic,Hispanic or Latino,0,7,7
437741,Accidental burning caused by caustic and corrosive substance,racial,Unknown,0,7,7
438761,Acute dacryocystitis,ethnic,Hispanic or Latino,2,5,7
199767,Neoplasm of uncertain behaviour of liver and/or biliary passages,racial,White,7,0,7
381384,Congenital absence of external ear,ethnic,Not Hispanic or Latino,7,0,7
321882,Generalised atherosclerosis,racial,Native Hawaiian or Other Pacific Islander ,0,7,7
376415,Hypermetropia,racial,Black or African American ,7,0,7
200837,Congenital anomaly of fixation of intestine,racial,Asian,7,0,7
4124268,Faecal smear,racial,White,2,5,7
435242,Cerebellar ataxia,ethnic,Not Hispanic or Latino,0,7,7
374498,Concussion with prolonged loss of consciousness AND return to pre-existing conscious level,racial,White,7,0,7
74582,Primary malignant neoplasm of rectum,ethnic,Not Hispanic or Latino,7,0,7
432626,Glaucoma associated with vascular disorder,ethnic,Not Hispanic or Latino,0,7,7
314968,Varices,ethnic,Not Hispanic or Latino,0,7,7
375290,Chronic suppurative otitis media - tubotympanic,ethnic,Hispanic or Latino,5,2,7
434281,Aspergillosis,ethnic,Not Hispanic or Latino,0,7,7
77340,Genitourinary tract infection in pregnancy,racial,Other Race,7,0,7
139955,Open wound of palate without complication,ethnic,Hispanic or Latino,7,0,7
4047947,Complete parathyroidectomy,ethnic,Hispanic or Latino,7,0,7
4025663,Obstructed inguinal hernia,ethnic,Hispanic or Latino,0,7,7
433976,Primary malignant neoplasm of temporal lobe,racial,White,7,0,7
79118,Deformity of calcaneum,ethnic,Not Hispanic or Latino,7,0,7
437259,Disruptive behavior disorder,ethnic,Not Hispanic or Latino,7,0,7
434309,Sexual precocity,racial,Asian,5,2,7
381839,Habit disorder,racial,Other Race,0,7,7
198470,Unilateral inguinal hernia with obstruction but no gangrene,racial,White,0,7,7
133857,Acquired deformity of limb,ethnic,Not Hispanic or Latino,2,5,7
4064359,Cholera screening,ethnic,Hispanic or Latino,0,7,7
201792,Nongonococcal urethritis,ethnic,Hispanic or Latino,2,5,7
318521,Displacement of thoracic intervertebral disc without myelopathy,racial,White,5,2,7
433218,Superficial thrombophlebitis of arm,ethnic,Hispanic or Latino,5,2,7
440856,Open fracture of shaft of femur,racial,White,0,7,7
72404,Joint stiffness,racial,Unknown,5,2,7
378743,Mild nonproliferative retinopathy,racial,Black or African American ,7,0,7
443801,Exercise-induced asthma,racial,Native Hawaiian or Other Pacific Islander ,5,2,7
439655,Symptom: generalized,ethnic,Not Hispanic or Latino,0,7,7
441947,Posttraumatic state,racial,White,7,0,7
133351,Open wound of cheek without complication,racial,White,2,5,7
375258,Photokeratitis,racial,White,5,2,7
381031,Alternating esotropia,ethnic,Hispanic or Latino,7,0,7
441081,Maternal gonorrhoea during pregnancy - baby not yet delivered,ethnic,Hispanic or Latino,7,0,7
4066260,Galactorrhea in pregnancy and the puerperium,racial,Unknown,7,0,7
436350,Schistosoma hematobium infection,ethnic,Hispanic or Latino,7,0,7
74740,Accessory digit,racial,White,0,7,7
321320,Myocardial degeneration,ethnic,Hispanic or Latino,7,0,7
439790,Psychalgia,racial,White,2,5,7
377888,CHL - Conductive hearing loss,racial,Other Race,0,7,7
443421,Gallbladder and bile duct calculi,ethnic,Hispanic or Latino,7,0,7
439717,Active cochleovestibular Meniere's disease,racial,White,0,7,7
442012,"Mechanical complication of genitourinary device, implant AND/OR graft",ethnic,Hispanic or Latino,0,7,7
4062801,Threatened abortion NOS,racial,Unknown,7,0,7
198446,Embolism and thrombosis of the abdominal aorta,racial,Unknown,7,0,7
4148407,Family history: Cardiovascular disease,racial,Black or African American ,2,5,7
314962,Raynaud disease,racial,Other Race,5,2,7
376131,Tympanic membrane conductive hearing loss,racial,White,5,2,7
134718,Hirsutism,racial,Other Race,7,0,7
373179,Senile degeneration of brain,racial,Unknown,0,7,7
72786,Burn of finger,racial,White,7,0,7
4171594,Family history of cancer,racial,Unknown,7,0,7
436140,Vulval varices,ethnic,Not Hispanic or Latino,5,2,7
434316,von Willebrand disorder,ethnic,Not Hispanic or Latino,7,0,7
136916,Primary malignant neoplasm of skin of external auditory canal,racial,White,5,2,7
78605,Superficial bruising of elbow,racial,Other Race,7,0,7
437382,Urine observation,racial,Asian Indian,7,0,7
440142,Disease of mediastinum,ethnic,Hispanic or Latino,7,0,7
442286,Abscess of digit,racial,Asian Indian,7,0,7
80204,IUGR - Intrauterine growth retardation,ethnic,Hispanic or Latino,5,2,7
441025,Stenosis of lacrimal canaliculi,racial,Other Race,0,7,7
4034214,Open wound of ear,racial,Unknown,5,2,7
434752,Positive serological AND/OR viral culture findings for human immunodeficiency virus,racial,American Indian,0,7,7
444038,Psychoactive substance-induced organic mood disorder,racial,White,5,2,7
4177115,Malignant tumour of testis,ethnic,Not Hispanic or Latino,0,7,7
4038835,HD - Hodgkin's disease,ethnic,Hispanic or Latino,2,5,7
444419,Quadriparesis,ethnic,Not Hispanic or Latino,0,7,7
4188027,Food allergy,racial,Asian,2,5,7
440012,Fall from chair or bed,racial,Asian,0,7,7
75580,Chronic ulcerative proctitis,racial,Unknown,0,7,7
437262,Common peroneal nerve lesion,ethnic,Hispanic or Latino,7,0,7
437104,"Abnormal smear, noted, recall delete",ethnic,Not Hispanic or Latino,7,0,7
379012,Monoplegia of upper limb,ethnic,Not Hispanic or Latino,7,0,7
438039,Injury caused by animal,racial,Asian,0,7,7
432626,Glaucoma associated with vascular disorder,racial,Asian,0,7,7
435262,Primary open angle glaucoma,racial,Asian,5,2,7
444455,Benign tumour of soft tissue of head,racial,White,0,7,7
140823,Acquired musculoskeletal deformity,racial,White,5,2,7
441918,"Emotional AND/OR mental disease in mother complicating pregnancy, childbirth AND/OR puerperium",racial,Black or African American ,7,0,7
194083,Vaginitis and vulvovaginitis,racial,American Indian,7,0,7
198363,Candidiasis of vagina,racial,Filipino,7,0,7
435138,Injury of femoral nerve,ethnic,Hispanic or Latino,5,2,7
40483107,Inflamed seborrheic keratosis,ethnic,Not Hispanic or Latino,7,0,7
380733,Otalgia,racial,American Indian,5,2,7
434480,Syndrome of infant of diabetic mother,racial,Other Race,7,0,7
141917,Balanitis xerotica obliterans,racial,Other Race,0,7,7
201613,Chronic nonalcoholic liver disease,racial,Black or African American ,7,0,7
376984,Conjunctival cyst,ethnic,Hispanic or Latino,5,2,7
140020,Viral exanthem,racial,Asian,2,5,7
373488,Pupil-sparing third nerve palsy,racial,Other Race,0,7,7
440694,"Nondependent mixed drug abuse, episodic",racial,Unknown,7,0,7
432551,Parvovirus infection,racial,White,0,7,7
75865,Disorder of the urinary system,racial,Unknown,2,5,7
78619,"Contusion, knee",racial,Asian,5,2,7
438172,Atrial septal defect as current complication following acute myocardial infarction,racial,White,7,0,7
435758,Burkitt's tumor of extranodal AND/OR solid organ site,racial,White,2,5,7
4302543,Insertion of prosthesis or prosthetic device of femoral head,ethnic,Hispanic or Latino,7,0,7
77358,Observation of hand region,racial,Unknown,5,2,7
376405,Binocular vision disorder,racial,White,0,7,7
436228,Fetal death due to termination of pregnancy,ethnic,Hispanic or Latino,7,0,7
200772,Gastroenteritis due to radiation,racial,White,5,2,7
432587,Polyclonal hypergammaglobulinemia,racial,White,7,0,7
27017,Defective dental restoration,racial,Unknown,5,2,7
4119298,Late onset asthma,racial,American Indian or Alaska Native ,0,7,7
433656,Abnormal patient reaction,racial,Unknown,5,2,7
435018,Twin pregnancy - delivered,ethnic,Hispanic or Latino,7,0,7
435397,Seq of effects foreign body entering through natural orifice,ethnic,Hispanic or Latino,7,0,7
440202,Multiple congenital malformations,racial,Black or African American ,0,7,7
437088,Fetus OR newborn affected by oligohydramnios,ethnic,Hispanic or Latino,7,0,7
4062557,False labor,ethnic,Hispanic or Latino,7,0,7
200769,"Chronic gastric ulcer without hemorrhage, without perforation AND without obstruction",racial,Unknown,7,0,7
194847,Mechanical complication due to urethral indwelling catheter,racial,Unknown,0,7,7
74464,Idiopathic scoliosis AND/OR kyphoscoliosis,racial,American Indian or Alaska Native ,5,2,7
439907,Spontaneous tendon rupture,racial,Other Race,7,0,7
76545,Closed traumatic dislocation of patella,ethnic,Not Hispanic or Latino,2,5,7
444401,Delusions,racial,White,5,2,7
77317,Chronic ulcerative rectosigmoiditis,ethnic,Not Hispanic or Latino,7,0,7
434019,"Nondependent cannabis abuse, continuous",ethnic,Not Hispanic or Latino,5,2,7
4112816,Other respiratory system diseases,racial,American Indian,7,0,7
260315,Tuberculosis of lung with cavitation,racial,White,7,0,7
436485,Hyperemesis gravidarum with metabolic disturbance,ethnic,Hispanic or Latino,7,0,7
141213,Scarlet fever,racial,Black or African American ,2,5,7
201078,Senile atrophic vaginitis,racial,Asian,7,0,7
440697,Nonaggressive unsocial conduct disorder,ethnic,Not Hispanic or Latino,5,2,7
434143,Anophthalmos,ethnic,Hispanic or Latino,5,2,7
442425,Lumbar post-laminectomy syndrome,racial,Other Race,0,7,7
72993,Primary localised osteoarthrosis,racial,Other Race,7,0,7
372605,Spinal muscular atrophy,racial,White,0,7,7
4008089,Dysentery,ethnic,Not Hispanic or Latino,7,0,7
194149,Hirschsprung disease,ethnic,Not Hispanic or Latino,0,7,7
440085,Schizoid personality disorder,racial,White,0,7,7
74855,Genital herpes simplex,racial,Filipino,5,2,7
80951,Candidiasis of urogenital site,racial,Asian,5,2,7
374384,Cerebral ischemia,ethnic,Not Hispanic or Latino,0,7,7
437186,Hypothermia - accidental,racial,White,2,5,7
4169658,No help available,ethnic,Hispanic or Latino,2,5,7
73872,Congenital deformity of knee joint,ethnic,Hispanic or Latino,5,2,7
4024567,Respiratory observation,racial,Asian,7,0,7
74188,Closed fracture of rib,racial,Other Race,2,5,7
77960,Joint observation,racial,Asian,7,0,7
432860,Benign tumor of epipharynx,ethnic,Hispanic or Latino,7,0,7
134453,Inflammation of bursa,racial,Asian,0,7,7
435299,Failure of dental prosthesis,ethnic,Not Hispanic or Latino,0,7,7
134619,Toxic nodular goiter,ethnic,Not Hispanic or Latino,7,0,7
434073,Loss of teeth - acquired,racial,Other Race,7,0,7
435644,Metatarsal bone fracture,ethnic,Not Hispanic or Latino,0,7,7
200485,Decubitus ulcer of buttock,racial,Other Race,0,7,7
198645,Third degree burn of lower limb,ethnic,Hispanic or Latino,0,7,7
441321,Chronic nasopharyngitis,racial,Unknown,7,0,7
313502,Benign hypertensive heart disease without congestive heart failure,racial,Asian,7,0,7
79072,Inflammatory disorder of breast,racial,American Indian or Alaska Native ,7,0,7
72404,Joint stiffness,ethnic,Not Hispanic or Latino,7,0,7
435381,Closed fracture of base of thumb,ethnic,Hispanic or Latino,0,7,7
73673,Disorder of prosthetic joint,racial,White,7,0,7
139188,Open wound of scalp without complication,racial,American Indian or Alaska Native ,0,7,7
432672,Fissure of nipple,racial,White,5,2,7
442530,Broken tooth injury with complication,ethnic,Not Hispanic or Latino,5,2,7
4103574,Chronic depression,racial,Other Race,7,0,7
433985,Hypercarotinemia,racial,Asian,0,7,7
440009,Complication of implant,racial,Asian,7,0,7
319843,Mitral valve disorder,racial,Native Hawaiian or Other Pacific Islander ,0,7,7
72374,Unstable lie with antenatal problem,racial,Asian,7,0,7
200524,Perinatal digestive system disorders,ethnic,Hispanic or Latino,0,7,7
440083,Acute stress disorder,racial,Other Race,7,0,7
443752,Ventricular hemorrhage,ethnic,Hispanic or Latino,7,0,7
433227,Abnormal sensation,racial,Unknown,5,2,7
436098,Nondependent cocaine abuse in remission,ethnic,Not Hispanic or Latino,5,2,7
434033,Chorioretinitis,racial,White,0,7,7
380818,Acquired deformity of head,racial,Unknown,0,7,7
438106,"Reticulosarcoma of lymph nodes of head, face and neck",ethnic,Hispanic or Latino,2,5,7
4340380,Hepatitis C carrier,racial,Black or African American ,5,2,7
254662,Pulmonary infarction,racial,Black or African American ,7,0,7
4062921,Asymptomatic bacteriuria in pregnancy unspecified,racial,White,7,0,7
201820,Diabetes mellitus,racial,Filipino,0,7,7
435755,Primary malignant neoplasm of skin of eyelid,racial,White,7,0,7
199879,Fistula of the female genital organs,ethnic,Hispanic or Latino,7,0,7
381839,Habit disorder,racial,Black or African American ,0,7,7
254320,Cystic fibrosis of the lung,ethnic,Hispanic or Latino,7,0,7
196733,Urethral syndrome,ethnic,Not Hispanic or Latino,7,0,7
193517,Bile duct calculus with no mention of cholecystitis and with obstruction,racial,Unknown,2,5,7
78516,Arthralgia of the upper arm,racial,Native Hawaiian or Other Pacific Islander ,2,5,7
443677,Open wound of knee and/or leg and/or ankle,racial,Other Race,5,2,7
444124,Class III malocclusion,ethnic,Hispanic or Latino,2,5,7
377286,VFD - Visual field defect,racial,Other Race,0,7,7
196468,Acute salpingo-oophoritis,racial,White,5,0,5
4194056,"Simple partial seizure, consciousness not impaired",racial,White,5,0,5
74747,Acquired genu recurvatum,ethnic,Not Hispanic or Latino,0,5,5
30437,Gastroesophageal reflux disease with esophagitis,racial,Filipino,5,0,5
132397,Pilonidal cyst with no abscess,racial,Asian,0,5,5
76737,Hydrocele,racial,White,0,5,5
432795,Traumatic AND/OR non-traumatic injury,racial,Black or African American ,5,0,5
375274,Monocular exotropia,racial,Unknown,5,0,5
4053383,Family history of glaucoma,racial,White,2,2,4
4147635,Unspecified otorrhea,ethnic,Hispanic or Latino,0,5,5
4330220,Family history of malignant neoplasm of genital structure,racial,Unknown,5,0,5
133298,Musculoskeletal disorder of the neck,racial,Black or African American ,2,2,4
195392,Laceration of liver,racial,White,5,0,5
441564,Optic disc oedema associated with retinal disorder,ethnic,Hispanic or Latino,5,0,5
4062653,Gout screening,racial,Unknown,2,2,4
4051564,FH: Metabolic disorder,racial,Other Race,5,0,5
4153751,Ear - 2nd degree burn,ethnic,Hispanic or Latino,5,0,5
439297,Nuclear senile cataract,racial,Black or African American ,5,0,5
4310768,Fall on steps,racial,American Indian or Alaska Native ,5,0,5
438422,Primary iridocyclitis,ethnic,Not Hispanic or Latino,0,5,5
4103906,Lacrimal system disorder NOS,racial,Unknown,5,0,5
4242720,Intracranial hematoma following injury,racial,Unknown,0,5,5
4194895,Screening for disorder,racial,Filipino,5,0,5
4110499,Allergic rhinitis NOS,racial,American Indian or Alaska Native ,0,5,5
441906,Prolapse of urethra,ethnic,Hispanic or Latino,5,0,5
4108055,Other forms of retinal detachment,racial,White,2,2,4
133141,Tinea pedis,racial,American Indian,0,5,5
436936,Benign neoplasm of cranial nerve,ethnic,Hispanic or Latino,5,0,5
4302543,Insertion of prosthesis or prosthetic device of femoral head,ethnic,Not Hispanic or Latino,0,5,5
4147164,Hematologic malignancy,racial,Other Race,5,0,5
200215,Abdominal rigidity,racial,White,2,2,4
442558,"Gestation period, 32 weeks",racial,Black or African American ,0,5,5
4059635,Work maladjustment problem,racial,White,5,0,5
138384,Acquired hypothyroidism,racial,American Indian or Alaska Native ,5,0,5
440589,Toxic effect of caustic substance,ethnic,Hispanic or Latino,5,0,5
4169641,Developmental handicap screening,ethnic,Not Hispanic or Latino,2,2,4
434413,Incomplete spontaneous abortion with complication,racial,White,5,0,5
26441,Bleeding ulcer of esophagus,racial,Unknown,0,5,5
444285,Acquired equinovarus deformity,ethnic,Not Hispanic or Latino,5,0,5
4268980,Finding of general development,ethnic,Not Hispanic or Latino,5,0,5
4024013,Sensory nervous system finding,racial,Asian,0,5,5
438329,Late effect of motor vehicle accident,racial,Black or African American ,2,2,4
437838,"Cannabis dependence, episodic",ethnic,Not Hispanic or Latino,5,0,5
4064906,Bacterial conjunctivitis screening,racial,White,0,5,5
441947,Posttraumatic state,racial,Black or African American ,0,5,5
141934,Degenerative skin disorder,ethnic,Hispanic or Latino,2,2,4
80471,Disorder of lactation,racial,White,5,0,5
438788,Hypertrophy of adenoids,racial,Unknown,2,2,4
380126,Rheumatic chorea with heart involvement,racial,White,0,5,5
4206460,Problem,racial,Filipino,5,0,5
437643,Gait abnormality,racial,Filipino,5,0,5
381864,Subjective tinnitus,ethnic,Not Hispanic or Latino,5,0,5
313006,Congenital stenosis of mitral valve,ethnic,Hispanic or Latino,0,5,5
377877,Convergent squint,racial,Asian Indian,5,0,5
433092,Burn of multiple sites of wrist AND/OR hand,ethnic,Hispanic or Latino,5,0,5
4194056,"Simple partial seizure, consciousness not impaired",ethnic,Not Hispanic or Latino,5,0,5
374950,Oedema of eyelid,racial,Asian,5,0,5
197050,Abnormality of organs AND/OR soft tissues of pelvis affecting pregnancy,racial,White,5,0,5
80805,Primary localized osteoarthrosis of forearm,racial,American Indian or Alaska Native ,5,0,5
196341,Dermatophytosis of the perianal area,racial,American Indian,0,5,5
137488,E. coli septicemia,racial,Unknown,5,0,5
4145492,Other peripheral vascular disease,racial,White,2,2,4
379820,No colour perception,racial,Black or African American ,0,5,5
201674,Congenital anomaly of pancreas,racial,White,2,2,4
372646,"Peripheral pterygium, stationary",racial,Unknown,0,5,5
438398,Leukocytosis,racial,Asian Indian,5,0,5
4111255,Unspecified labyrinthitis,ethnic,Not Hispanic or Latino,0,5,5
378253,HA - Headache,racial,American Indian,2,2,4
4104857,Automatism petit mal,racial,White,5,0,5
4070671,"Middle ear anomaly, excluding ossicles",racial,White,5,0,5
4311591,Cramp in limb,racial,Filipino,0,5,5
254062,Acute chest syndrome,ethnic,Hispanic or Latino,2,2,4
253549,Connective tissue disease,ethnic,Not Hispanic or Latino,5,0,5
433752,Impulse control disorder,racial,White,5,0,5
4104050,Other specified strabismus NOS,ethnic,Hispanic or Latino,0,5,5
4064929,Genitourinary disease screening,ethnic,Hispanic or Latino,0,5,5
28060,Strept throat,racial,Native Hawaiian or Other Pacific Islander ,2,2,4
4030872,Hyperemesis of pregnancy,ethnic,Hispanic or Latino,5,0,5
375539,Haemophthalmos without current injury,racial,Unknown,5,0,5
134460,Plantar fascial fibromatosis,racial,Native Hawaiian or Other Pacific Islander ,5,0,5
440081,Barbiturate dependence,racial,Asian,5,0,5
76304,Burn of upper arm,ethnic,Hispanic or Latino,5,0,5
375077,Sensory inattention,racial,White,5,0,5
436173,Hyperemesis gravidarum with metabolic disturbance - delivered,ethnic,Hispanic or Latino,5,0,5
77642,Arthralgia of the forearm,racial,American Indian,5,0,5
432302,Cocaine dependence in remission,racial,Black or African American ,0,5,5
433095,Fall on or from steps,racial,Asian,0,5,5
373503,Intermittent cerebral ischaemia,racial,Filipino,5,0,5
432589,Neutropenia associated with infectious disease,racial,White,0,5,5
441737,Bruising,racial,Asian Indian,2,2,4
438410,[X]Psychogenic dysuria,ethnic,Hispanic or Latino,5,0,5
200962,Primary malignant neoplasm of prostate,racial,Asian Indian,0,5,5
133280,Alopecia,racial,American Indian or Alaska Native ,5,0,5
380103,Retinal detachment with retinal defect,racial,Other Race,5,0,5
40482203,Karyotype evaluation abnormal,ethnic,Not Hispanic or Latino,5,0,5
439654,Partial epilepsy with impairment of consciousness,racial,Unknown,5,0,5
432730,Dysphonia,racial,Filipino,0,5,5
374653,Neurologic disorder of eye movements,racial,White,2,2,4
138340,Septicaemia due to Staphylococcus aureus,racial,Unknown,0,5,5
374886,Benign neoplasm of ear,racial,White,2,2,4
200671,Benign tumour of renal pelvis,ethnic,Hispanic or Latino,5,0,5
376387,Spasmodic torticollis,racial,Unknown,0,5,5
201347,Pelvic pain syndrome,racial,Other Race,5,0,5
27516,Neoplasm of uncertain behaviour of paraganglion,ethnic,Hispanic or Latino,5,0,5
434303,Benign neoplasm of rectum and anal canal,ethnic,Not Hispanic or Latino,0,5,5
141941,Cervical spondylosis without myelopathy,racial,Other Race,5,0,5
317585,Aortic aneurysm,racial,Asian,0,5,5
442116,Allergy to eggs,racial,Asian,0,5,5
135424,Foreign body in mouth,racial,White,2,2,4
374375,Impacted cerumen,racial,American Indian,2,2,4
435088,Senility,racial,Other Race,2,2,4
77178,Contusion of multiple sites of upper limb,racial,White,5,0,5
440207,Hypoplastic left heart syndrome,racial,Unknown,5,0,5
134757,Ectodermal dysplasia,racial,White,0,5,5
315558,Atherosclerosis of arteries of the extremities,racial,Filipino,0,5,5
4168396,Dilation of cervix uteri and curettage for termination of pregnancy,ethnic,Hispanic or Latino,5,0,5
438879,Closed bimalleolar fracture,racial,Black or African American ,5,0,5
78888,Open fracture of ankle,ethnic,Not Hispanic or Latino,5,0,5
4182210,Dementia,ethnic,Not Hispanic or Latino,5,0,5
4173811,Congenital quadriplegia,racial,Other Race,5,0,5
439901,Chondrocalcinosis due to pyrophosphate crystals,ethnic,Hispanic or Latino,5,0,5
380038,Viral conjunctivitis,racial,Other Race,2,2,4
197717,Open wound of anterior abdominal wall without complication,ethnic,Not Hispanic or Latino,0,5,5
433946,Fall on same level due to impact against another person,racial,Black or African American ,0,5,5
141651,Stevens-Johnson syndrome,racial,Unknown,5,0,5
438120,Opioid dependence,racial,Asian,5,0,5
318556,Nosebleed,racial,American Indian or Alaska Native ,0,5,5
437477,[X]Fall involving playground equipment,racial,Unknown,2,2,4
135424,Foreign body in mouth,ethnic,Hispanic or Latino,2,2,4
436799,Talipes cavus,ethnic,Not Hispanic or Latino,2,2,4
318775,Venous embolism,racial,Asian,5,0,5
442764,Anal pain,racial,Black or African American ,0,5,5
434376,Acute myocardial infarction of anterior wall,racial,White,5,0,5
26727,Vomiting blood,racial,Black or African American ,0,5,5
436231,Abnormal findings diagnostic imaging of liver and biliary tract,ethnic,Not Hispanic or Latino,5,0,5
440972,Medulloadrenal hyperfunction,ethnic,Not Hispanic or Latino,0,5,5
76777,Arthropathy associated with infection,racial,Unknown,5,0,5
201998,Unilateral traumatic amputation of leg at OR above knee without complication,racial,Asian,5,0,5
4297975,Manual rupture of ovarian cyst,ethnic,Hispanic or Latino,5,0,5
200974,Carcinoma in situ of stomach,racial,Unknown,5,0,5
437483,Homicide or assault by unarmed fight or brawl,ethnic,Hispanic or Latino,5,0,5
375529,Infantile cerebral palsy,racial,Other Race,0,5,5
316084,Lymphadenitis,racial,Asian,2,2,4
195901,Osteomyelitis of pelvic region,ethnic,Hispanic or Latino,0,5,5
76786,Derangement of knee,racial,Native Hawaiian or Other Pacific Islander ,0,5,5
192674,Allergic gastroenteritis and colitis,racial,White,5,0,5
442793,Diabetic complication,racial,American Indian,5,0,5
198846,Enthesopathy of hip region,racial,Other Race,5,0,5
436147,Glossitis,ethnic,Not Hispanic or Latino,5,0,5
433949,Human bite,racial,Unknown,0,5,5
438052,Accident due to excessive cold,racial,White,2,2,4
373870,Neonatal dacryocystitis and conjunctivitis,racial,White,0,5,5
199991,Complication of transplanted kidney,racial,Asian,5,0,5
4109276,Other lacrimal system disorder,ethnic,Hispanic or Latino,5,0,5
73291,Palindromic rheumatism of the ankle and/or foot,racial,Filipino,0,5,5
72737,Microcalcifications of the breast,racial,Filipino,5,0,5
73036,Closed fracture of olecranon process of ulna,racial,Other Race,0,5,5
444405,Open multiple fractures of lower limb with ribs AND sternum,racial,White,5,0,5
4305080,Abnormal breathing,racial,Other Race,2,2,4
4109559,"Better eye: severe visual impairment, Lesser eye: severe visual impairment",racial,White,5,0,5
4204966,Regurgitant esophagitis,racial,Unknown,2,2,4
381118,Congenital vascular anomaly of eye,ethnic,Hispanic or Latino,2,2,4
442942,"Crush injury, toe(s)",ethnic,Not Hispanic or Latino,5,0,5
435792,Drug-induced sleep disorder,racial,White,2,2,4
441488,Adverse reaction to substance,racial,White,0,5,5
4204989,Disturbance in sleep behavior,ethnic,Hispanic or Latino,2,2,4
438731,Fat pad,ethnic,Not Hispanic or Latino,5,0,5
80778,Genitourinary tract infection in pregnancy - delivered with postnatal complication,ethnic,Hispanic or Latino,5,0,5
74582,Primary malignant neoplasm of rectum,racial,Other Race,5,0,5
260754,Haemophilus influenzae pneumonia,ethnic,Hispanic or Latino,0,5,5
433107,Injury of unknown intent by explosive,racial,White,0,5,5
135858,Disorder of lip,racial,Black or African American ,0,5,5
253234,Upper respiratory inflammation due to fumes AND/OR vapors,racial,Unknown,0,5,5
135061,Congenital anomaly of musculoskeletal system,racial,Asian,5,0,5
313500,Acute rheumatic heart disease,racial,Other Race,5,0,5
320798,Parapsoriasis,ethnic,Hispanic or Latino,5,0,5
4294569,Cervico-facial actinomycosis,ethnic,Hispanic or Latino,5,0,5
314965,Embolism and thrombosis of an arm or leg artery,racial,Unknown,5,0,5
75091,Closed fracture of carpal bone,racial,Asian,5,0,5
438052,Accident due to excessive cold,ethnic,Hispanic or Latino,2,2,4
4005743,Female sterility,racial,American Indian or Alaska Native ,5,0,5
432800,Assault by cutting and stabbing instruments,racial,White,0,5,5
439237,Assault,ethnic,Not Hispanic or Latino,5,0,5
321876,Disease of capillaries,racial,White,0,5,5
440760,Inflammatory disorder of jaw,racial,Other Race,0,5,5
4110806,Other peripheral vertigo NOS,ethnic,Hispanic or Latino,5,0,5
133714,Malignant melanoma of skin of trunk,ethnic,Hispanic or Latino,5,0,5
441764,Inhalation or ingestion of foreign body with respiratory obstruction or suffocation,ethnic,Hispanic or Latino,5,0,5
4112534,Chronic laryngitis and laryngotracheitis,racial,Asian,0,5,5
74505,Closed subtrochanteric fracture,racial,Unknown,0,5,5
192438,Abdominal mass,racial,Asian,5,0,5
197593,Impaction of intestine,racial,White,2,2,4
312950,IgE-mediated allergic asthma,racial,Filipino,2,2,4
4058422,H/O: asbestos exposure,ethnic,Hispanic or Latino,5,0,5
432574,Diffuse malignant lymphoma - histiocytic,racial,White,0,5,5
22492,Pharyngeal FB - foreign body,racial,White,5,0,5
4129665,Hearing aid care,ethnic,Not Hispanic or Latino,2,2,4
137977,Icteric,racial,Black or African American ,0,5,5
4305589,"Neoplasm, benign",racial,Asian,0,5,5
436839,Closed fracture of metacarpal bone,racial,American Indian or Alaska Native ,0,5,5
27918,Eosinophilic esophagitis,racial,Black or African American ,0,5,5
374139,Buphthalmos,ethnic,Hispanic or Latino,2,2,4
4295261,Postmenopausal state,racial,Black or African American ,5,0,5
4110505,Chest infection - other bacterial pneumonia,racial,Unknown,5,0,5
438028,Poisoning by drug AND/OR medicinal substance,ethnic,Not Hispanic or Latino,2,2,4
201347,Pelvic pain syndrome,ethnic,Not Hispanic or Latino,5,0,5
443723,Finding of cellular component of blood,racial,Unknown,5,0,5
4141481,"Hand, foot and mouth disease",racial,Asian,0,5,5
201254,Insulin dependent diabetes mellitus,racial,Native Hawaiian or Other Pacific Islander ,5,0,5
78508,Arthralgia of the ankle and/or foot,racial,Filipino,5,0,5
377889,Hearing loss,racial,American Indian,5,0,5
4283892,Placement of stents in coronary artery,ethnic,Hispanic or Latino,5,0,5
133547,Pyoderma,racial,White,2,2,4
4329847,MI - Myocardial infarction,ethnic,Not Hispanic or Latino,0,5,5
435394,Intracranial hemorrhage following injury,ethnic,Not Hispanic or Latino,0,5,5
24075,Esophageal stricture and stenosis,racial,Unknown,2,2,4
435935,Body substance analysis finding,ethnic,Not Hispanic or Latino,2,2,4
433243,Anomaly of tooth position,ethnic,Hispanic or Latino,2,2,4
378726,Alcoholic dementia,racial,White,0,5,5
378756,Conjunctival hemorrhage,racial,Filipino,5,0,5
200447,Gastrointestinal complication,ethnic,Not Hispanic or Latino,5,0,5
198192,Renal and perinephric abscess,ethnic,Not Hispanic or Latino,5,0,5
197417,Injury of ureter with open wound into abdominal cavity,racial,Native Hawaiian or Other Pacific Islander ,5,0,5
440989,Intermittent explosive disorder,racial,White,5,0,5
135360,Fainting,racial,Alaska Native,5,0,5
201350,Placental abruption - not delivered,racial,White,0,5,5
259070,PGN - Acute proliferative glomerulonephritis,racial,White,5,0,5
141771,"Injury undetermined whether accidentally or purposely inflicted, by crashing of motor vehicle",racial,White,0,5,5
434327,Cannabis abuse,racial,Black or African American ,0,5,5
78474,Hypertrophy of breast,racial,Other Race,5,0,5
432876,Bipolar I disorder,racial,Asian,2,2,4
319054,Thrombophlebitis of upper extremities,racial,Asian,5,0,5
441834,"Bipolar affective disorder, currently manic, mild",racial,Black or African American ,5,0,5
4303805,Allergic reaction to bite and/or sting,racial,Unknown,2,2,4
139980,Burn erythema of forearm,racial,Asian,5,0,5
197723,Open wound of lateral abdominal wall without complication,racial,White,0,5,5
4148076,Chronic neurogenic ulcer of lower limb,ethnic,Not Hispanic or Latino,5,0,5
435011,Vulvar vestibulitis,racial,Unknown,5,0,5
434089,Antepartum hemorrhage,racial,White,5,0,5
4252594,Subconjunctival injection,ethnic,Not Hispanic or Latino,2,2,4
4273391,Suicidal thoughts,racial,Asian,0,5,5
439348,Pregnancy complications,ethnic,Not Hispanic or Latino,5,0,5
195769,Submucous uterine leiomyoma,racial,Unknown,5,0,5
373347,Subdural hemorrhage following injury without open intracranial wound AND with concussion,racial,White,0,5,5
138176,Acute gingivitis,racial,Other Race,2,2,4
194439,Obstetric perineal wound disruption,ethnic,Hispanic or Latino,5,0,5
4056770,Breast signs and symptoms,racial,White,5,0,5
372320,Impairment level: one eye: total impairment: other eye: near-normal vision,ethnic,Hispanic or Latino,0,5,5
442565,Gestational edema without hypertension,racial,American Indian or Alaska Native ,5,0,5
438390,Benign tumour of vulva,ethnic,Not Hispanic or Latino,5,0,5
380097,Diabetic macular edema,racial,Other Race,2,2,4
372765,Open wound of head without complication,racial,Black or African American ,0,5,5
4060813,Cystitis NOS,racial,White,2,2,4
201344,Vesico-intestinal fistula,ethnic,Not Hispanic or Latino,0,5,5
433243,Anomaly of tooth position,racial,White,2,2,4
380500,Hypertrophy of fat pad of knee,racial,Unknown,0,5,5
77963,Achilles tendinitis,racial,Other Race,5,0,5
193308,Congenital anomaly of spleen,racial,Black or African American ,0,5,5
441922,Transient hypertension of pregnancy,ethnic,Hispanic or Latino,5,0,5
437839,Pica,ethnic,Not Hispanic or Latino,2,2,4
4109276,Other lacrimal system disorder,racial,White,5,0,5
80862,"Closed fractures of phalanx or phalanges, multiple sites",ethnic,Hispanic or Latino,5,0,5
194755,Abdominal tenderness of left lower quadrant,racial,Unknown,2,2,4
438767,Posterior staphyloma,ethnic,Hispanic or Latino,0,5,5
444112,Integumentary system finding,racial,Native Hawaiian or Other Pacific Islander ,5,0,5
441697,Open fracture of radius,racial,White,2,2,4
434782,Closed fracture of tibia AND fibula,ethnic,Not Hispanic or Latino,2,2,4
434613,Generalized anxiety disorder,racial,Filipino,2,2,4
200671,Benign tumour of renal pelvis,racial,Black or African American ,0,5,5
76491,Obstetric non-purulent mastitis with antenatal complication,racial,Unknown,5,0,5
74816,Contusion of toe,racial,Black or African American ,2,2,4
4001802,"Other muscle, ligament and fascia disorder",ethnic,Hispanic or Latino,0,5,5
437273,Glaucoma capsulare,racial,Unknown,5,0,5
377861,Disorder of refraction AND/OR accommodation,racial,American Indian,0,5,5
4066820,Ingestion dermatitis due to food,racial,American Indian or Alaska Native ,5,0,5
436485,Hyperemesis gravidarum with metabolic disturbance,racial,White,5,0,5
4108975,Borderline glaucoma NOS,ethnic,Not Hispanic or Latino,5,0,5
438284,Sprain of chondrosternal joint,racial,Unknown,2,2,4
4290927,Impairment level: low vision of both eyes,racial,Asian,2,2,4
194699,Liver disorder in pregnancy,ethnic,Not Hispanic or Latino,5,0,5
442170,Blister of neck with infection,ethnic,Hispanic or Latino,5,0,5
4147494,Nonspecific mesenteric adenitis,racial,White,2,2,4
4154616,Family history: Mental retardation,ethnic,Hispanic or Latino,5,0,5
440453,Incomplete legal abortion with delayed or excessive haemorrhage,ethnic,Hispanic or Latino,5,0,5
438557,Abnormal glucose level,racial,Asian Indian,2,2,4
444274,Massive parenchymal disruption of spleen without open wound into abdominal cavity,racial,White,0,5,5
441680,Fetus OR newborn affected by multiple pregnancy,ethnic,Not Hispanic or Latino,5,0,5
433195,Transient arterial retinal occlusion,ethnic,Not Hispanic or Latino,5,0,5
78842,Acquired postural lordosis,ethnic,Not Hispanic or Latino,5,0,5
4086928,IUCD status,racial,Black or African American ,5,0,5
377678,EEG abnormality,racial,White,0,5,5
77310,Deep vein phlebitis and thrombophlebitis of the leg,racial,Other Race,2,2,4
135699,Burn any degree involving 10-19 percent of body surface,racial,Unknown,2,2,4
136025,Gp B streptococcal septicemia,ethnic,Not Hispanic or Latino,5,0,5
133613,Closed traumatic dislocation of tarsometatarsal joint,racial,White,5,0,5
201519,Ca liver - primary,racial,Unknown,0,5,5
195464,Epidemic pleurodynia,ethnic,Hispanic or Latino,0,5,5
312723,Congenital heart disease,racial,Native Hawaiian or Other Pacific Islander ,5,0,5
135057,Nonallopathic lesion of sacral region,ethnic,Hispanic or Latino,5,0,5
433600,"Problem, abnormal test",ethnic,Not Hispanic or Latino,2,2,4
375393,Laceration of skin of eyelid AND periocular area,racial,Unknown,0,5,5
441266,Thiamin deficiency,racial,Unknown,0,5,5
77358,Observation of hand region,ethnic,Not Hispanic or Latino,2,2,4
374912,Leukodystrophy,ethnic,Not Hispanic or Latino,5,0,5
81144,Sprain of medial collateral ligament of knee,racial,Other Race,5,0,5
4015843,Gonorrhea carrier,ethnic,Not Hispanic or Latino,0,5,5
134276,Cutaneous actinomycosis,racial,White,2,2,4
77642,Arthralgia of the forearm,racial,Filipino,0,5,5
200831,Congenital anomaly of penis,ethnic,Not Hispanic or Latino,0,5,5
4062491,Anemia screening,ethnic,Not Hispanic or Latino,2,2,4
75924,Osteodystrophy,racial,Black or African American ,5,0,5
4004778,Other and unspecified congenital anomalies,ethnic,Hispanic or Latino,0,5,5
139888,Threatened premature labor - not delivered,racial,Black or African American ,5,0,5
255566,Acute tracheitis with obstruction,ethnic,Hispanic or Latino,5,0,5
198198,Vaginal polyp,ethnic,Not Hispanic or Latino,5,0,5
194995,Disorder of ureter,racial,Asian,5,0,5
4176874,Infantile melanodontia,racial,Filipino,0,5,5
378442,Conductive hearing loss of combined sites,racial,Asian,0,5,5
441073,Complete legal abortion,racial,Unknown,5,0,5
436230,Blood chemistry abnormal,racial,American Indian,2,2,4
27587,Disturbance of salivary secretion,racial,Other Race,2,2,4
255891,Lupus erythematosus,racial,Asian,0,5,5
436278,Superficial bruising of thigh,racial,Filipino,5,0,5
24818,Neck injury,racial,Other Race,2,2,4
317971,Respiratory system congenital anomalies,racial,White,5,0,5
443571,Cervicovaginal cytology: High grade squamous intraepithelial lesion or carcinoma,racial,Asian,5,0,5
439658,Gestosis,racial,Unknown,5,0,5
443728,Mass of chest wall,racial,American Indian or Alaska Native ,0,5,5
376121,Recurrent pterygium,racial,Unknown,0,5,5
440426,Vertigo as late effect of stroke,racial,Asian,5,0,5
75066,Nonallopathic lesion of cervical region,ethnic,Hispanic or Latino,0,5,5
435604,"Viral disease in mother complicating pregnancy, childbirth AND/OR puerperium",racial,Unknown,5,0,5
377546,Chronic post-traumatic headache,racial,Filipino,0,5,5
4067459,Heterotopic liver transplant,ethnic,Hispanic or Latino,0,5,5
198194,Female genital organ symptoms,racial,Native Hawaiian or Other Pacific Islander ,5,0,5
373766,Retinopathy of prematurity,racial,Unknown,2,2,4
194133,Low back pain,racial,Asian Indian,0,5,5
76939,Neoplasm of uncertain behaviour of bone and articular cartilage,racial,White,5,0,5
437184,"Poisoning of undetermined intent by corrosive, acid or caustic alkali",racial,White,5,0,5
434344,Accommodative spasm,racial,Unknown,0,5,5
438040,"Adverse reaction to analgesics, antipyretics and antirheumatics",racial,White,2,2,4
4016353,Meningococcus contact,ethnic,Hispanic or Latino,5,0,5
434944,Scleritis,ethnic,Not Hispanic or Latino,2,2,4
436145,Pneumonia due to respiratory syncytial virus,ethnic,Not Hispanic or Latino,5,0,5
4108961,Other chorioretinitis and retinochoroiditis,racial,White,5,0,5
135975,Blister of finger without infection,ethnic,Not Hispanic or Latino,2,2,4
72708,Traumatic arthropathy of the shoulder region,racial,Unknown,5,0,5
436086,Manic bipolar I disorder in full remission,ethnic,Hispanic or Latino,5,0,5
4108087,Other and unspecified rheumatic heart disease,ethnic,Hispanic or Latino,5,0,5
312383,Postpartum cardiomyopathy,ethnic,Not Hispanic or Latino,2,2,4
199065,Stricture of ureter,ethnic,Hispanic or Latino,0,5,5
73574,Nonunion of fracture,ethnic,Not Hispanic or Latino,5,0,5
439147,Amnesia,racial,American Indian,5,0,5
194686,Acquired renal cyst,racial,Other Race,2,2,4
75670,Sprain pelvic ligament,racial,White,2,2,4
196158,Disease of penis,racial,Black or African American ,0,5,5
194696,Menorrhalgia,racial,American Indian or Alaska Native ,5,0,5
434615,Cystic fibrosis without meconium ileus,ethnic,Not Hispanic or Latino,0,5,5
23789,Pharynx or nasopharynx cyst,racial,White,5,0,5
81943,Rupture of flexor tendons of hand AND/OR wrist,racial,White,0,5,5
135027,"Carbuncle of leg, except foot",racial,Other Race,5,0,5
4102738,Screening for mental disorders,racial,Unknown,0,5,5
79069,Disease of rectum,racial,Other Race,0,5,5
376961,Disturbance of consciousness,racial,Native Hawaiian or Other Pacific Islander ,5,0,5
444291,Cochlear hearing loss,racial,Native Hawaiian or Other Pacific Islander ,0,5,5
380944,Adenoviral pharyngoconjunctivitis,racial,White,2,2,4
4152045,Screening for malignant neoplasm of respiratory tract,racial,Unknown,5,0,5
377277,Impairment level: total impairment of both eyes,ethnic,Not Hispanic or Latino,0,5,5
73026,Abnormal respiratory sounds,racial,Unknown,5,0,5
253788,Nasal polyp,racial,Other Race,2,2,4
197237,Benign tumour of prostate,racial,Asian,0,5,5
438871,Drug withdrawal syndrome in newborn,ethnic,Hispanic or Latino,5,0,5
201773,Enteritis,racial,White,5,0,5
373770,"Infantile, juvenile and presenile cataracts",racial,Unknown,5,0,5
80156,Asymptomatic bacteriuria in pregnancy,racial,Other Race,5,0,5
4288028,Mural pregnancy,racial,White,5,0,5
433149,Cerebellar Ca,racial,American Indian or Alaska Native ,0,5,5
195316,Atypical endometrial hyperplasia,racial,Unknown,5,0,5
374631,Motor neurone disease,racial,White,5,0,5
376102,Partial recent retinal detachment with single defect,ethnic,Not Hispanic or Latino,5,0,5
435658,Atypical squamous cells on vaginal Papanicolaou smear cannot exclude high grade squamous intraepithelial lesion,racial,Unknown,5,0,5
433163,Deficiency of macronutrients,racial,Asian,5,0,5
201075,Noninflammatory disorder of cervix,racial,Asian,5,0,5
195877,Observation of gravid uterus,racial,White,5,0,5
198190,Gastric ulcer with perforation AND obstruction,ethnic,Hispanic or Latino,5,0,5
193522,Acute prostatitis,racial,Asian,0,5,5
440846,"Blood coagulation disorder, categorized by value of screening test",racial,Other Race,5,0,5
378901,Open wound of nasal septum without complication,ethnic,Hispanic or Latino,2,2,4
79104,Loose body in joint,ethnic,Hispanic or Latino,2,2,4
201909,Female infertility,racial,Asian,5,0,5
193422,Primary malignant neoplasm of body of stomach,ethnic,Not Hispanic or Latino,0,5,5
26514,Laryngeal web,ethnic,Hispanic or Latino,5,0,5
439815,Choroidal degeneration,ethnic,Hispanic or Latino,2,2,4
4093146,Herpes simplex with other specified complication,ethnic,Not Hispanic or Latino,2,2,4
195603,Vulval and/or perineal noninflammatory disorders,racial,Black or African American ,5,0,5
443392,Malignant neoplastic disease,racial,Unknown,5,0,5
75351,Adolescent postural kyphosis,racial,White,5,0,5
443674,Traumatic amputation of toe(s) with complication,racial,White,2,2,4
437406,Closed traumatic dislocation of joint of wrist,racial,White,0,5,5
28403,Acromegaly and gigantism,racial,Other Race,0,5,5
201927,Cellulitis and abscess of leg,racial,Native Hawaiian or Other Pacific Islander ,0,5,5
441202,Generalized anaphylaxis,racial,Unknown,5,0,5
193144,Suprarenal metastasis,racial,White,2,2,4
432893,Myasthenic syndrome due to another disorder,ethnic,Not Hispanic or Latino,0,5,5
437920,Spontaneous abortion complicated by genital-pelvic infection,racial,White,5,0,5
140489,Acquired acanthosis nigricans,racial,American Indian or Alaska Native ,0,5,5
433905,Open wound of vulva without complication,racial,White,5,0,5
134780,Closed dislocation of metatarsal joint,ethnic,Not Hispanic or Latino,5,0,5
373205,Hemorrhage of eyelid,racial,Unknown,5,0,5
436073,Psychotic disorder,racial,American Indian or Alaska Native ,5,0,5
433621,Sprain of sternoclavicular joint AND/OR ligament,ethnic,Not Hispanic or Latino,5,0,5
192858,Ovarian hyperfunction,ethnic,Not Hispanic or Latino,5,0,5
436517,Fetus OR newborn affected by narcotic transmitted via placenta AND/OR breast milk,racial,White,0,5,5
80914,Second degree burn of two OR more fingers not including thumb,racial,White,0,5,5
443174,"Splinter of neck, without major open wound, infected",racial,White,5,0,5
438546,Congenital anomaly of anterior chamber of eye,racial,White,0,5,5
441929,Varicose veins of perineum and vulva in pregnancy and the puerperium with antenatal complication,racial,White,5,0,5
201388,Congenital uterine anomaly,racial,Unknown,5,0,5
443869,Nonvenomous insect bite of wrist without infection,racial,Unknown,2,2,4
4036945,Consciousness disturbance NOS,ethnic,Hispanic or Latino,0,5,5
377885,Disorder of eye movements,racial,Other Race,2,2,4
381416,Brain injury without open intracranial wound AND with prolonged loss of consciousness (more than 24 hours) without return to pre-existing conscious level,ethnic,Hispanic or Latino,0,5,5
135287,Non-neoplastic naevus,racial,American Indian or Alaska Native ,0,5,5
4062636,Bacterial disease screening,racial,Native Hawaiian or Other Pacific Islander ,5,0,5
381290,Ocular hypertension,racial,Asian,5,0,5
198551,"Embryonic cyst of cervix, vagina and external female genitalia",ethnic,Not Hispanic or Latino,5,0,5
434319,Premature orgasm - male,racial,Black or African American ,0,5,5
440607,Accident caused by explosive material,racial,White,0,5,5
433486,Acute orbital inflammation,ethnic,Hispanic or Latino,2,2,4
443111,Tenosynovitis of foot,racial,Other Race,5,0,5
132703,Lichen planus,racial,Unknown,2,2,4
193242,Perforation of intestine,ethnic,Not Hispanic or Latino,2,2,4
376712,Purulent otitis media,ethnic,Not Hispanic or Latino,5,0,5
4326601,Anorectal abscess,racial,American Indian or Alaska Native ,5,0,5
438039,Injury caused by animal,racial,Unknown,5,0,5
73090,Superficial bruising of foot,racial,Native Hawaiian or Other Pacific Islander ,5,0,5
200588,Injury of abdomen,racial,White,2,2,4
140976,Toxic uninodular goiter,racial,White,5,0,5
200524,Perinatal digestive system disorders,ethnic,Not Hispanic or Latino,0,5,5
372925,Cholesteatoma,racial,White,5,0,5
432933,Aneurysm of artery of lower extremity,ethnic,Hispanic or Latino,2,2,4
135615,Pityriasis,racial,Asian,5,0,5
75629,"Stiff joint NEC, of the forearm",racial,White,0,5,5
434917,"Nondependent antidepressant type drug abuse, episodic",ethnic,Hispanic or Latino,5,0,5
4081756,Radiotherapy follow-up,ethnic,Hispanic or Latino,5,0,5
318566,Flushing,racial,Unknown,2,2,4
75620,Traumatic arthropathy of the ankle and/or foot,racial,White,5,0,5
133551,Vesicular eczema of hands and/or feet,racial,Filipino,5,0,5
4100857,Pickwickian syndrome,racial,Native Hawaiian or Other Pacific Islander ,5,0,5
4105181,Socialised childhood truancy,racial,White,0,5,5
140062,Iodine hypothyroidism,ethnic,Hispanic or Latino,5,0,5
4109253,Pterygium NOS,ethnic,Not Hispanic or Latino,5,0,5
137488,E. coli septicemia,ethnic,Hispanic or Latino,5,0,5
444268,Inhibited male orgasm,ethnic,Not Hispanic or Latino,0,5,5
4178898,Economic problem,racial,White,2,2,4
4265479,Acute duodenal ulcer with perforation,ethnic,Hispanic or Latino,0,5,5
440547,Closed fracture of shaft of metacarpal bone,racial,Unknown,5,0,5
4104016,Ts and As - Tonsillectomy and adenoidectomy,ethnic,Not Hispanic or Latino,0,5,5
79167,Open fracture finger distal phalanx,ethnic,Hispanic or Latino,0,5,5
440642,CSD - Cat scratch disease,racial,Unknown,5,0,5
441139,Instantaneous death,ethnic,Hispanic or Latino,5,0,5
443263,Obstetric breast abscess,ethnic,Hispanic or Latino,5,0,5
72715,Exostosis,racial,Other Race,2,2,4
433805,Abnormal jaw closure,racial,White,2,2,4
434488,Finding of basal metabolic rate,ethnic,Hispanic or Latino,5,0,5
315832,Angina decubitus,racial,White,2,2,4
201779,Tuberculosis of adrenal glands,ethnic,Hispanic or Latino,2,2,4
312728,Congenital tricuspid atresia and stenosis,racial,White,5,0,5
4243827,Drug addiction counseling,racial,White,2,2,4
441678,"Gestation period, 33 weeks",racial,Asian,0,5,5
440067,"Moderate bipolar I disorder, single manic episode",racial,White,2,2,4
4231580,Acute gastric ulcer with haemorrhage,ethnic,Hispanic or Latino,0,5,5
432512,Foreign object left in body during procedure,racial,Unknown,0,5,5
435315,Torsion of testis,racial,Black or African American ,0,5,5
378544,Subdural and cerebral hemorrhage due to birth trauma,racial,Unknown,0,5,5
75406,Crush injury of finger,ethnic,Not Hispanic or Latino,0,5,5
435521,Psychophysiologic disorder,racial,Other Race,5,0,5
139900,Urticaria,racial,American Indian or Alaska Native ,5,0,5
432612,Mild mental handicap,racial,Black or African American ,0,5,5
4064383,Rheumatoid arthritis screening,racial,Other Race,5,0,5
4225928,Heteronymous hemianopsia,racial,White,0,5,5
436238,Elevated levels of transaminase and lactic acid dehydrogenase,racial,Native Hawaiian or Other Pacific Islander ,2,2,4
438555,Cyanosis,racial,Other Race,5,0,5
373638,Superficial injury of cornea,racial,Other Race,5,0,5
4146239,Pruritus of genital organs,racial,Black or African American ,5,0,5
372309,Mononeuritis,racial,Native Hawaiian or Other Pacific Islander ,0,5,5
439105,Traumatic arthropathy of the forearm,racial,White,5,0,5
81636,Excessive foetal growth affecting management of mother,ethnic,Hispanic or Latino,5,0,5
380096,Proliferative diabetic retinopathy,racial,Black or African American ,5,0,5
441697,Open fracture of radius,ethnic,Hispanic or Latino,2,2,4
437828,Disorder of calcium metabolism,racial,Asian,5,0,5
435950,Closed Colles' fracture,racial,Asian,5,0,5
313459,Sleep apnea,racial,Filipino,0,5,5
22492,Pharyngeal FB - foreign body,ethnic,Hispanic or Latino,5,0,5
440787,"Drug dependence in mother complicating pregnancy, childbirth AND/OR puerperium",racial,White,2,2,4
442926,"Motor vehicle traffic accident involving collision with another motor vehicle, parked, driver of motor vehicle injured",racial,Native Hawaiian or Other Pacific Islander ,2,2,4
434615,Cystic fibrosis without meconium ileus,racial,Unknown,5,0,5
78818,Large fetus causing disproportion with antenatal problem,ethnic,Hispanic or Latino,5,0,5
140172,Erythematosquamous dermatosis,ethnic,Not Hispanic or Latino,5,0,5
141508,Dermatophytosis of scalp or beard,racial,American Indian or Alaska Native ,0,5,5
197304,Ulcer of lower limb,racial,Asian,5,0,5
138913,Second degree burn of two OR more fingers including thumb,ethnic,Not Hispanic or Latino,0,5,5
441482,Administrative reason for encounter,racial,Filipino,5,0,5
435788,Disorder of phosphorus metabolism,ethnic,Not Hispanic or Latino,2,2,4
4054908,Closed injury of kidney,racial,Asian,0,5,5
4001516,Endocervical biopsy,ethnic,Hispanic or Latino,5,0,5
4163865,Acute peptic ulcer without hemorrhage AND without perforation,racial,White,2,2,4
135858,Disorder of lip,racial,Other Race,0,5,5
4056770,Breast signs and symptoms,ethnic,Hispanic or Latino,5,0,5
314131,Degeneration of cervical intervertebral disc,racial,Filipino,5,0,5
432452,Anemia of prematurity,racial,Black or African American ,0,5,5
432898,Severe mental handicap,racial,Unknown,0,5,5
433149,Cerebellar Ca,ethnic,Not Hispanic or Latino,0,5,5
254058,Acute bronchiolitis due to respiratory syncytial virus,racial,Other Race,0,5,5
194856,Viral hepatitis A with hepatic coma,ethnic,Hispanic or Latino,2,2,4
198646,Full thickness burn of multiple sites of leg,racial,White,0,5,5
133420,Primary malignant neoplasm of endocrine gland,ethnic,Hispanic or Latino,5,0,5
137054,Skin striae,racial,Other Race,0,5,5
132446,Congenital anomaly of skin,racial,Asian,5,0,5
140489,Acquired acanthosis nigricans,racial,Black or African American ,2,2,4
4053470,Amblyopia ex anopsia,ethnic,Hispanic or Latino,2,2,4
137057,Paronychia,racial,Asian,5,0,5
314426,Congenital cardiovascular disorder during pregnancy - baby not yet delivered,racial,White,5,0,5
441259,Non-thrombocytopenic purpura,racial,Other Race,0,5,5
439391,Physical abuse of adult,ethnic,Not Hispanic or Latino,5,0,5
437262,Common peroneal nerve lesion,ethnic,Not Hispanic or Latino,5,0,5
440989,Intermittent explosive disorder,racial,Unknown,2,2,4
4218420,Postinflammatory perforation of ear drum,racial,Unknown,5,0,5
135303,Cyst of oral soft tissue,racial,Unknown,2,2,4
441830,Disorder of fluid AND/OR electrolyte,racial,Other Race,2,2,4
441077,Stenosis of cervix,racial,Other Race,5,0,5
73336,Closed traumatic dislocation ankle joint,racial,White,0,5,5
435788,Disorder of phosphorus metabolism,racial,White,2,2,4
201907,Oedema of male genital organs,racial,Black or African American ,0,5,5
313543,Venous complication in pregnancy AND/OR the puerperium,ethnic,Hispanic or Latino,5,0,5
75121,Burn of lower leg,racial,White,5,0,5
434793,Subdural hemorrhage following injury without open intracranial wound,racial,White,5,0,5
73649,Contusion of finger,racial,Black or African American ,0,5,5
4105589,Biopsy of peritoneum,racial,Unknown,5,0,5
80876,Unilateral traumatic amputation at OR above elbow without complication,racial,White,5,0,5
139180,Open wound of multiple sites of face without complication,racial,Unknown,5,0,5
23789,Pharynx or nasopharynx cyst,ethnic,Hispanic or Latino,5,0,5
376555,Open wound of ear drum without complication,ethnic,Not Hispanic or Latino,0,5,5
199878,Light and infrequent menstruation,racial,Asian,5,0,5
440023,St. Louis encephalitis virus infection,ethnic,Hispanic or Latino,5,0,5
197378,Overflow incontinence of urine,ethnic,Not Hispanic or Latino,5,0,5
432795,Traumatic AND/OR non-traumatic injury,racial,American Indian or Alaska Native ,2,2,4
141666,Acute osteomyelitis of lower leg,racial,Unknown,5,0,5
381864,Subjective tinnitus,racial,Other Race,2,2,4
432677,Habitual aborter-not pregnant,racial,White,5,0,5
443458,Closed fracture of facial bone,racial,Unknown,5,0,5
74513,Open wound of foot without mention of complication,racial,Black or African American ,5,0,5
4112534,Chronic laryngitis and laryngotracheitis,ethnic,Not Hispanic or Latino,0,5,5
199063,"Hernia, with obstruction",racial,White,5,0,5
436078,Malnutrition of moderate degree (Gomez: 60% to less than 75% of standard weight),racial,White,5,0,5
76725,Fissure in ano,racial,Other Race,0,5,5
438930,Accidental poisoning by drugs affecting blood constituents,ethnic,Hispanic or Latino,5,0,5
80767,Breast irregular nodularity,racial,Native Hawaiian or Other Pacific Islander ,5,0,5
441283,Recurrent iridocyclitis,racial,White,0,5,5
4195473,Temporary tracheostomy,ethnic,Hispanic or Latino,0,5,5
135027,"Carbuncle of leg, except foot",racial,Native Hawaiian or Other Pacific Islander ,0,5,5
377286,VFD - Visual field defect,racial,Black or African American ,2,2,4
78193,Epididymo-orchitis,racial,Asian,0,5,5
4173498,FH: Heart disorder,racial,American Indian or Alaska Native ,5,0,5
376578,Otitic barotrauma,ethnic,Hispanic or Latino,2,2,4
444274,Massive parenchymal disruption of spleen without open wound into abdominal cavity,ethnic,Hispanic or Latino,0,5,5
135287,Non-neoplastic naevus,racial,Asian,2,2,4
257778,Pertussis,ethnic,Not Hispanic or Latino,2,2,4
75053,Fracture of bone,racial,Black or African American ,0,5,5
4061706,"Disorder of lactation NOS, unspecified",racial,White,5,0,5
444405,Open multiple fractures of lower limb with ribs AND sternum,ethnic,Hispanic or Latino,5,0,5
320299,Complication of transplanted heart,ethnic,Hispanic or Latino,0,5,5
376103,Retinopathy,racial,Black or African American ,5,0,5
141648,Contact dermatitis due to cosmetics,racial,Unknown,5,0,5
4148260,Calculus of kidney with calculus of ureter,racial,White,0,5,5
4050572,Implantation of automatic cardiac defibrillator,racial,American Indian or Alaska Native ,5,0,5
436375,Sodium and water depletion,racial,Asian,0,5,5
374034,Visual disturbance,racial,American Indian,0,5,5
438867,Generalized body aches,racial,Asian Indian,5,0,5
4145479,Other specified candidiasis NOS,racial,White,5,0,5
321462,Cardiac complications of care,racial,Unknown,0,5,5
442287,Rest pain,ethnic,Not Hispanic or Latino,5,0,5
139970,Second degree burn of thigh,ethnic,Hispanic or Latino,5,0,5
442794,Poisoning by wasp sting,racial,Black or African American ,2,2,4
441874,Cerebral thrombosis,racial,Black or African American ,0,5,5
140570,Open wound of back without complication,racial,White,2,2,4
27017,Defective dental restoration,ethnic,Not Hispanic or Latino,2,2,4
137371,Neonatal septicaemia,ethnic,Hispanic or Latino,5,0,5
4108905,Congenital malformation of the urinary system,racial,Other Race,0,5,5
141253,Disease of thyroid gland,racial,Native Hawaiian or Other Pacific Islander ,2,2,4
321822,Peripheral circulatory disorder associated with diabetes mellitus,ethnic,Not Hispanic or Latino,5,0,5
443372,Lipid-lowering drug adverse reaction,racial,White,5,0,5
195593,Congenital hydrocele of canal of Nuck,racial,White,0,5,5
433745,"Amphetamine abuse, episodic",racial,Unknown,5,0,5
444082,False labor without delivery,racial,White,5,0,5
136264,Open wound of floor of mouth without complication,racial,Unknown,5,0,5
375801,Demyelinating disease of central nervous system,racial,White,5,0,5
139180,Open wound of multiple sites of face without complication,ethnic,Not Hispanic or Latino,0,5,5
78162,Peripheral vertigo,racial,Other Race,5,0,5
132321,Ichthyosis of eyelid,ethnic,Hispanic or Latino,0,5,5
4334644,Decubitus ulcer of lower back,racial,Asian,0,5,5
4164222,Tendon contracture,racial,Unknown,0,5,5
196163,Cervicitis and endocervicitis,racial,Other Race,5,0,5
439696,Hypertensive heart and renal disease with (congestive) heart failure,racial,Black or African American ,0,5,5
140489,Acquired acanthosis nigricans,racial,Asian,0,5,5
436826,Closed fracture of shaft of radius,racial,Unknown,5,0,5
444413,Pyrexial convulsion,racial,American Indian or Alaska Native ,5,0,5
198571,Cardiogenic shock,racial,White,0,5,5
201626,Mid-cycle pain,racial,Unknown,5,0,5
438532,Swan-neck deformity of finger,racial,White,2,2,4
373494,Cholesterin granuloma of middle ear,ethnic,Hispanic or Latino,0,5,5
4061056,Endometriosis NOS,ethnic,Not Hispanic or Latino,5,0,5
376425,Chronic non-suppurative otitis media,racial,Asian,2,2,4
193522,Acute prostatitis,racial,Black or African American ,0,5,5
440392,Retinal vascular occlusion,ethnic,Not Hispanic or Latino,0,5,5
438304,Rat bite,racial,White,5,0,5
4110815,"Sensorineural hearing loss, bilateral",racial,Asian Indian,5,0,5
434494,Closed fracture of the proximal humerus,racial,Asian,5,0,5
379010,Macular retinal puckering,ethnic,Not Hispanic or Latino,0,5,5
372921,Retained foreign body of middle ear,ethnic,Hispanic or Latino,2,2,4
439060,Atrophy of tongue papillae,ethnic,Hispanic or Latino,0,5,5
4204989,Disturbance in sleep behavior,racial,Black or African American ,5,0,5
444239,Postprocedural state finding,racial,American Indian or Alaska Native ,5,0,5
443887,Superficial foreign body of ankle without major open wound AND without infection,racial,White,2,2,4
200450,Disease of urethra,racial,Asian,2,2,4
380395,Retinal dystrophy,ethnic,Hispanic or Latino,5,0,5
443350,Lower urinary tract symptoms,racial,Native Hawaiian or Other Pacific Islander ,0,5,5
193733,Neoplasm of uncertain behavior of retroperitoneum and peritoneum,ethnic,Hispanic or Latino,5,0,5
435394,Intracranial hemorrhage following injury,racial,White,0,5,5
438367,Primary malignant neoplasm of nasal cavity,ethnic,Hispanic or Latino,2,2,4
435315,Torsion of testis,racial,Unknown,0,5,5
201355,Erosion and ectropion of the cervix,ethnic,Not Hispanic or Latino,2,2,4
378523,Residual foreign body in soft tissue,racial,Other Race,2,2,4
196157,Induratio penis plastica,racial,Other Race,0,5,5
4116770,"Localized, secondary osteoarthritis NOS",ethnic,Hispanic or Latino,5,0,5
443462,Enteritis due to Candida,racial,Unknown,5,0,5
194871,Trichomonal vulvovaginitis,racial,Black or African American ,5,0,5
377910,Deviated nasal septum,racial,Black or African American ,0,5,5
435950,Closed Colles' fracture,racial,Black or African American ,0,5,5
443207,Single organ dysfunction,ethnic,Hispanic or Latino,0,5,5
198558,Nycturia,racial,American Indian or Alaska Native ,5,0,5
141934,Degenerative skin disorder,racial,Asian,0,5,5
441751,Adverse reaction to salicylate,racial,White,0,5,5
443877,Nonvenomous insect bite of shoulder without infection,racial,Unknown,5,0,5
444268,Inhibited male orgasm,racial,White,0,5,5
435018,Twin pregnancy - delivered,racial,Unknown,5,0,5
441260,Drug withdrawal syndrome,racial,American Indian or Alaska Native ,0,5,5
194286,"Malignant neoplasm of corpus uteri, excluding isthmus",racial,Asian,5,0,5
380403,External hordeolum,racial,Filipino,2,2,4
80813,Lumbosacral spondylosis without myelopathy,racial,Black or African American ,5,0,5
74132,Degeneration of lumbosacral intervertebral disc,racial,American Indian,5,0,5
73008,Enthesopathy,racial,American Indian or Alaska Native ,0,5,5
135766,Leukaemia in remission,ethnic,Hispanic or Latino,2,2,4
375800,Dystonia,racial,Other Race,5,0,5
4088372,Herpes zoster with other specified complication,ethnic,Hispanic or Latino,0,5,5
256440,Disorder of paranasal sinuses,racial,Filipino,0,5,5
75996,Sacral spinal cord injury without bone injury,racial,Unknown,0,5,5
4104016,Ts and As - Tonsillectomy and adenoidectomy,racial,Black or African American ,0,5,5
4276723,Finding of child weight centiles,racial,American Indian or Alaska Native ,0,5,5
4024848,Chronic peptic ulcer without mention of complication,racial,White,5,0,5
444124,Class III malocclusion,racial,White,0,5,5
4147639,Cellulitis and abscess of toe NOS,racial,Unknown,2,2,4
378849,Microtia,ethnic,Not Hispanic or Latino,2,2,4
434279,Congenital syphilis,ethnic,Hispanic or Latino,0,5,5
4054908,Closed injury of kidney,ethnic,Hispanic or Latino,2,2,4
4065991,Cellulitis and abscess of finger and toe,racial,Unknown,5,0,5
433171,Selective IgA immunodeficiency,racial,White,0,5,5
442018,Foreign body accidentally left during a procedure,ethnic,Not Hispanic or Latino,5,0,5
137443,Mechanical complication due to skin graft failure AND/OR rejection,ethnic,Hispanic or Latino,0,5,5
195584,Acute peptic ulcer without hemorrhage AND without perforation but with obstruction,racial,White,0,5,5
436587,"Toxic effect of gas, fumes AND/OR vapors",racial,American Indian or Alaska Native ,5,0,5
4148260,Calculus of kidney with calculus of ureter,ethnic,Hispanic or Latino,0,5,5
379009,Retinopathy of prematurity stage 3 - ridge with extraretinal fibrovascular proliferation,ethnic,Not Hispanic or Latino,0,5,5
76611,Injury of shoulder region,racial,American Indian or Alaska Native ,0,5,5
434942,Postseptal orbital cellulitis,racial,Asian,0,5,5
436043,Malignant overlapping lesion of tongue,ethnic,Hispanic or Latino,0,5,5
372912,Visual discomfort,racial,Black or African American ,0,5,5
437382,Urine observation,racial,American Indian,5,0,5
376112,Diabetic polyneuropathy,racial,American Indian,5,0,5
442747,Contact dermatitis due to food in contact with skin,ethnic,Not Hispanic or Latino,2,2,4
439940,Closed fracture of upper end of forearm,racial,Unknown,0,5,5
4145004,Osteoarthritis of spine NOS,racial,White,2,2,4
314457,Congenital stenosis of aortic valve,racial,White,5,0,5
4048727,Neoplasm screening,racial,Black or African American ,2,2,4
200775,Endometrial hyperplasia,racial,Asian,5,0,5
320115,Mitral incompetence and aortic stenosis,racial,Unknown,0,5,5
313236,Cough variant asthma,racial,Asian Indian,0,5,5
437394,Closed fracture of lower end of forearm,racial,American Indian or Alaska Native ,0,5,5
374024,Reaction to spinal or lumbar puncture,ethnic,Not Hispanic or Latino,5,0,5
433048,Closed dislocation of fifth cervical vertebra,ethnic,Hispanic or Latino,5,0,5
378424,Astigmatism,racial,Other Race,5,0,5
195845,"Acute gastric ulcer with hemorrhage, with perforation AND with obstruction",ethnic,Hispanic or Latino,5,0,5
199718,Enteritis due to rotavirus,ethnic,Hispanic or Latino,0,5,5
435726,Mechanical complication of device,racial,Unknown,2,2,4
440053,Infestation by insect,racial,Unknown,5,0,5
440457,Threatened abortion,racial,Other Race,5,0,5
4104581,Esotropia with accommodative compensation,ethnic,Hispanic or Latino,5,0,5
4109256,Other conjunctival disorders,ethnic,Hispanic or Latino,5,0,5
436477,Abnormal products of conception,racial,Asian,5,0,5
74998,Pycocele,ethnic,Not Hispanic or Latino,0,5,5
79962,Crushing injury of elbow,ethnic,Not Hispanic or Latino,0,5,5
373347,Subdural hemorrhage following injury without open intracranial wound AND with concussion,ethnic,Hispanic or Latino,0,5,5
4144103,Influenza NOS,ethnic,Not Hispanic or Latino,0,5,5
436522,Irregular sleep-wake pattern,racial,White,2,2,4
314381,Kawasaki syndrome,ethnic,Not Hispanic or Latino,0,5,5
442770,Disorder of ciliary body,racial,White,5,0,5
444287,Carbuncle of neck,ethnic,Not Hispanic or Latino,0,5,5
4070671,"Middle ear anomaly, excluding ossicles",ethnic,Not Hispanic or Latino,5,0,5
80187,Medial epicondylitis,racial,Other Race,0,5,5
316432,Right bundle branch block AND left anterior fascicular block,racial,Asian,0,5,5
195906,Disorder of lumbar spine,racial,Black or African American ,0,5,5
441447,Open wound of external genital organs without complication,ethnic,Hispanic or Latino,5,0,5
201957,Necrotizing enterocolitis in fetus OR newborn,ethnic,Hispanic or Latino,0,5,5
372894,central serous retinopathy,racial,Other Race,0,5,5
4064206,O/E - tuning fork testing,racial,Asian,5,0,5
23034,Neonatal hypoglycemia,ethnic,Hispanic or Latino,2,2,4
141934,Degenerative skin disorder,ethnic,Not Hispanic or Latino,0,5,5
193825,"Congenital abnormality of uterus complicating antenatal care, baby not yet delivered",racial,White,5,0,5
374649,Strabismic amblyopia,ethnic,Not Hispanic or Latino,2,2,4
255677,Open wound of nose without complication,ethnic,Not Hispanic or Latino,2,2,4
432352,Idiopathic fibrosing alveolitis,ethnic,Not Hispanic or Latino,5,0,5
443421,Gallbladder and bile duct calculi,racial,White,5,0,5
195594,Spontaneous abortion complicated by delayed AND/OR excessive hemorrhage,ethnic,Hispanic or Latino,5,0,5
432672,Fissure of nipple,ethnic,Hispanic or Latino,5,0,5
432512,Foreign object left in body during procedure,racial,White,2,2,4
320744,Complete atrioventricular block,racial,Asian,5,0,5
432923,SAH - Subarachnoid haemorrhage,racial,Black or African American ,0,5,5
4109253,Pterygium NOS,racial,American Indian or Alaska Native ,0,5,5
4113683,Spontaneous abortion unspecified,racial,White,5,0,5
22274,Neoplasm of uncertain behaviour of larynx,ethnic,Hispanic or Latino,5,0,5
4089984,Congenital syphilis NOS,ethnic,Hispanic or Latino,2,2,4
194995,Disorder of ureter,racial,Black or African American ,2,2,4
198313,Burn erythema of abdominal wall,racial,White,2,2,4
200391,Peripheral autonomic neuropathy disease EC,racial,Filipino,5,0,5
139970,Second degree burn of thigh,racial,Unknown,5,0,5
194997,Prostatitis,racial,American Indian or Alaska Native ,0,5,5
377830,Alcohol withdrawal delirium,ethnic,Not Hispanic or Latino,0,5,5
138539,Shprintzen-Goldberg syndrome,racial,Black or African American ,0,5,5
377889,Hearing loss,racial,Filipino,0,5,5
437359,Osteochondritis dissecans,racial,Unknown,5,0,5
440325,Rubella without complication,ethnic,Hispanic or Latino,5,0,5
436171,"Syphilis in mother complicating pregnancy, childbirth AND/OR puerperium",ethnic,Hispanic or Latino,5,0,5
194081,Acute cystitis,racial,American Indian or Alaska Native ,5,0,5
440647,Sexually transmitted infectious disease,racial,Asian,2,2,4
195301,Acute dilatation of stomach,racial,White,5,0,5
437090,Hemolytic disease of fetus OR newborn due to ABO immunization,racial,White,0,5,5
4112525,Acute bronchiolitis NOS,racial,Asian,0,5,5
440519,Premature - weight 1000g-2499g or gestation of 28-37weeks,racial,Black or African American ,0,5,5
443375,Vitamin products adverse reaction,racial,Unknown,5,0,5
443081,Drowning and non-fatal immersion,ethnic,Hispanic or Latino,2,2,4
140949,Scabies,racial,American Indian or Alaska Native ,2,2,4
4148404,Family history: Anemia,ethnic,Not Hispanic or Latino,5,0,5
376555,Open wound of ear drum without complication,racial,White,0,5,5
201620,Calculus of kidney,racial,American Indian,5,0,5
315947,Thoracic back sprain,racial,American Indian or Alaska Native ,5,0,5
4062488,Thyroid disorder screening,racial,Asian,5,0,5
439162,"Closed fracture ankle, medial malleolus",racial,Asian,2,2,4
4109249,Other corneal disorders,ethnic,Hispanic or Latino,5,0,5
4201745,Disease of digestive system,ethnic,Not Hispanic or Latino,2,2,4
74717,Galactorrhoea in pregnancy and the puerperium - delivered with postnatal complication,racial,White,5,0,5
432335,Subclavian artery aneurysm,ethnic,Hispanic or Latino,5,0,5
316437,Cerebral atherosclerosis,racial,Other Race,5,0,5
81454,Injury of finger,racial,Filipino,5,0,5
4153751,Ear - 2nd degree burn,racial,Unknown,5,0,5
192359,RF - Renal failure,racial,Asian,0,5,5
375828,Patulous eustachian tube,racial,White,0,5,5
441692,Finding of serum tumour marker level,ethnic,Not Hispanic or Latino,0,5,5
133420,Primary malignant neoplasm of endocrine gland,racial,White,5,0,5
437041,Mother not delivered,racial,American Indian or Alaska Native ,5,0,5
434008,White blood cell disorder,racial,Other Race,0,5,5
442038,Anaphylactic shock due to serum,racial,Unknown,5,0,5
4091532,Bowel observation,racial,Native Hawaiian or Other Pacific Islander ,5,0,5
376116,Central loss of vision,ethnic,Not Hispanic or Latino,5,0,5
258354,Pulmonary African histoplasmosis,racial,Unknown,0,5,5
441259,Non-thrombocytopenic purpura,racial,Filipino,0,5,5
74739,Osteopathy from poliomyelitis,racial,Other Race,5,0,5
375738,Neurosyphilis,racial,White,0,5,5
74250,Burn of foot,racial,Other Race,5,0,5
4080568,Problem behaviour,racial,Other Race,5,0,5
199991,Complication of transplanted kidney,racial,Other Race,2,2,4
437273,Glaucoma capsulare,ethnic,Hispanic or Latino,5,0,5
439706,Psychosis with origin in childhood,racial,Asian,0,5,5
435532,Episodic chronic alcoholism,racial,Unknown,0,5,5
439700,Inhibited sexual desire,racial,Asian Indian,0,5,5
255566,Acute tracheitis with obstruction,racial,White,5,0,5
432962,Leukoplakia of cervix,racial,White,5,0,5
194403,Obstructed diaphragmatic hernia,ethnic,Not Hispanic or Latino,5,0,5
440382,LD - Learning difficulties,racial,Other Race,0,5,5
133510,Rapidly progressive periodontitis,racial,Unknown,2,2,4
439314,Thrombophlebitis of the femoral vein,ethnic,Not Hispanic or Latino,2,2,4
377274,Nonsenile cataract,racial,Unknown,2,2,4
440971,Neoplasm of uncertain behaviour of testis,ethnic,Hispanic or Latino,0,5,5
376125,Disorder of eyelid,ethnic,Not Hispanic or Latino,5,0,5
196454,Colostomy and enterostomy malfunction,racial,Asian,5,0,5
442775,Degeneration of thoracic intervertebral disc,racial,Filipino,5,0,5
4294569,Cervico-facial actinomycosis,racial,Unknown,5,0,5
78524,Acquired deformity of finger,racial,Other Race,2,2,4
4089994,Serological relapse after treatment of latent early syphilis,racial,White,0,5,5
441545,Somatisation disorder,racial,Other Race,0,5,5
138225,Disease of sebaceous glands,racial,Other Race,0,5,5
440829,Fetus and newborn affected by noxious influences transmitted via placenta or breast milk,ethnic,Hispanic or Latino,5,0,5
433909,Foreign body on external eye,racial,American Indian or Alaska Native ,2,2,4
201627,Abnormal vaginal bleeding,racial,Asian,5,0,5
200974,Carcinoma in situ of stomach,ethnic,Hispanic or Latino,5,0,5
441874,Cerebral thrombosis,racial,Asian,0,5,5
4139681,Allergy to dairy product,racial,Other Race,2,2,4
375525,Athetoid cerebral palsy,racial,Native Hawaiian or Other Pacific Islander ,5,0,5
193323,Neonatal diabetes mellitus,racial,White,5,0,5
4104860,Infantile spasms NOS,racial,White,0,5,5
74747,Acquired genu recurvatum,racial,Black or African American ,0,5,5
4233605,Cervical spinal cord injury without spinal bone injury,racial,Unknown,5,0,5
4108664,Hypertensive heart disease NOS,racial,White,2,2,4
443897,Disruption of perineal wound in the puerperium,ethnic,Not Hispanic or Latino,5,0,5
201914,Premenopausal menorrhagia,racial,American Indian or Alaska Native ,5,0,5
192759,Sequelae of fracture of spine,ethnic,Not Hispanic or Latino,0,5,5
260427,Common cold,racial,Filipino,0,5,5
137989,Abnormal results of cardiovascular function studies,racial,Filipino,0,5,5
138239,Observation of limb structure,racial,Black or African American ,0,5,5
4101431,Disorder of calcium metabolism NOS,racial,White,2,2,4
380126,Rheumatic chorea with heart involvement,ethnic,Hispanic or Latino,0,5,5
440607,Accident caused by explosive material,ethnic,Hispanic or Latino,0,5,5
198646,Full thickness burn of multiple sites of leg,ethnic,Not Hispanic or Latino,0,5,5
138864,Congenital anomaly of nail,ethnic,Not Hispanic or Latino,0,5,5
4110806,Other peripheral vertigo NOS,racial,Unknown,5,0,5
314171,Low blood pressure reading,racial,Other Race,0,5,5
432411,Acquired equinus foot deformity,ethnic,Hispanic or Latino,0,5,5
439615,Fall from stationary vehicle,racial,American Indian or Alaska Native ,0,5,5
439656,A/N care: grand multip,racial,Black or African American ,5,0,5
375827,Acute non-suppurative otitis media - serous,racial,Filipino,5,0,5
78804,Schimmelbusch's disease,racial,Asian,5,0,5
4101609,Ebstein anomaly of right atrioventricular valve,racial,Unknown,5,0,5
4103416,Drug dependence NOS,racial,Black or African American ,5,0,5
313833,Puerperal cerebrovascular disorder with postnatal complication,racial,White,5,0,5
4107528,Lermoyez syndrome,ethnic,Not Hispanic or Latino,5,0,5
314171,Low blood pressure reading,racial,Unknown,2,2,4
437657,Simple syndactyly of toes,racial,White,2,2,4
440905,Toxic effect of venom,racial,Black or African American ,2,2,4
80295,Burn of toe,racial,Unknown,5,0,5
438542,Gestation less than 24 weeks,racial,White,2,2,4
72710,Effusion of joint of forearm,racial,White,0,5,5
378125,Presenile dementia,ethnic,Hispanic or Latino,5,0,5
193261,Vaginospasm,racial,Unknown,5,0,5
75344,Intervertebral disc disorder,racial,Asian,5,0,5
439615,Fall from stationary vehicle,ethnic,Not Hispanic or Latino,0,5,5
4001138,Other soft tissue disorders,ethnic,Hispanic or Latino,5,0,5
4310682,Multiple open wounds with complication,racial,Black or African American ,0,5,5
377271,Parsonage-Turner syndrome,racial,White,0,5,5
200031,Viral hepatitis B with hepatic coma,ethnic,Hispanic or Latino,0,5,5
441171,Second degree burn of chest wall,ethnic,Hispanic or Latino,0,5,5
73065,"Contusion, genital organs",racial,Unknown,5,0,5
195392,Laceration of liver,ethnic,Hispanic or Latino,5,0,5
4145796,Family history: Musculoskeletal disease,racial,Other Race,0,5,5
433227,Abnormal sensation,ethnic,Not Hispanic or Latino,2,2,4
201826,Type 2 diabetes mellitus,racial,European,0,5,5
376102,Partial recent retinal detachment with single defect,racial,White,5,0,5
375281,Acute suppurative otitis media - tympanic membrane intact,racial,Native Hawaiian or Other Pacific Islander ,0,5,5
443716,Blister of shoulder without infection,ethnic,Hispanic or Latino,2,2,4
4113027,Dietary intake observations,racial,Native Hawaiian or Other Pacific Islander ,2,2,4
439901,Chondrocalcinosis due to pyrophosphate crystals,racial,Unknown,5,0,5
4273560,Premature labor,ethnic,Hispanic or Latino,5,0,5
439776,Pervasive developmental disorder,racial,White,0,5,5
201927,Cellulitis and abscess of leg,racial,Filipino,0,5,5
4066724,Pilonidal sinus/cyst NOS,racial,White,0,5,5
4140233,"X-ray of ribs, sternum and clavicle",racial,Other Race,5,0,5
135765,"Sezary's disease of lymph nodes of head, face AND/OR neck",racial,White,5,0,5
376411,Central pterygium,racial,Other Race,0,5,5
442601,Sedative abuse,ethnic,Hispanic or Latino,2,2,4
375290,Chronic suppurative otitis media - tubotympanic,racial,White,5,0,5
196338,Chronic gonococcal cystitis,racial,White,5,0,5
193807,Anorectal fistula,racial,Other Race,5,0,5
441481,Adult victim of abuse,ethnic,Not Hispanic or Latino,5,0,5
444093,Patient status finding,racial,Asian,2,2,4
4113027,Dietary intake observations,racial,American Indian,5,0,5
194412,Dysplasia of vagina,ethnic,Not Hispanic or Latino,5,0,5
372634,Nonphysiologic vision loss,racial,Native Hawaiian or Other Pacific Islander ,5,0,5
435613,Cellulitis,racial,American Indian,5,0,5
78011,Sprain of metacarpophalangeal joint,racial,Unknown,0,5,5
380701,SDLT - Senile dementia of the Lewy body type,racial,White,0,5,5
197950,Cellulitis and abscess of trunk,racial,American Indian or Alaska Native ,5,0,5
4165091,Lack of exercise,racial,Asian,0,5,5
438580,Closed fracture of C5-C7 level with spinal cord injury,racial,White,5,0,5
138463,Oral aphthae,racial,Black or African American ,2,2,4
433451,Aggressive unsocial conduct disorder,ethnic,Hispanic or Latino,2,2,4
4194396,Haemoglobinopathy screening test,ethnic,Hispanic or Latino,2,2,4
435935,Body substance analysis finding,racial,White,2,2,4
200145,Peritonitis in infectious diseases EC,ethnic,Hispanic or Latino,0,5,5
201627,Abnormal vaginal bleeding,racial,Filipino,5,0,5
140821,Spasm,racial,European,0,5,5
439248,"Mixed bipolar affective disorder, moderate",racial,White,0,5,5
437541,Glaucoma,racial,American Indian or Alaska Native ,5,0,5
380706,Regular astigmatism,racial,White,5,0,5
433942,Accident whilst engaged in household activity,racial,Asian,0,5,5
4151249,Malignant tumour of respiratory AND/OR intrathoracic organ,ethnic,Hispanic or Latino,0,5,5
442985,Male,racial,Other Race,0,5,5
133861,CL - Cleft lip,ethnic,Hispanic or Latino,5,0,5
441545,Somatisation disorder,racial,White,2,2,4
434689,Incomplete abortion,ethnic,Not Hispanic or Latino,5,0,5
197672,Urinary incontinence,racial,Native Hawaiian or Other Pacific Islander ,5,0,5
443535,Infection due to enterococcus,ethnic,Hispanic or Latino,2,2,4
434854,FP - Food poisoning,racial,Other Race,5,0,5
4295261,Postmenopausal state,racial,American Indian or Alaska Native ,5,0,5
30753,Esophagitis,racial,Filipino,5,0,5
136779,Disease of forearm,racial,Asian,5,0,5
4245252,Raised prostate specific antigen,racial,Filipino,0,5,5
377877,Convergent squint,racial,Other Race,2,2,4
74817,Crushing injury of buttock,racial,White,5,0,5
4145022,Traumatic arthritis NOS,racial,Unknown,5,0,5
74136,Muscle calcification and ossification,racial,White,0,5,5
381304,Impulsive acoustic trauma,racial,Unknown,2,2,4
436086,Manic bipolar I disorder in full remission,racial,White,0,5,5
442983,Nasal mucosa observation,racial,White,0,5,5
437841,Somatoform autonomic dysfunction - respiratory tract,ethnic,Hispanic or Latino,5,0,5
442310,Acute heart failure,ethnic,Not Hispanic or Latino,0,5,5
434657,Weakness of face muscles,racial,Black or African American ,2,2,4
198402,Neoplasm of uncertain behaviour of kidney,ethnic,Hispanic or Latino,0,5,5
440454,Abortion without complication,ethnic,Not Hispanic or Latino,5,0,5
434073,Loss of teeth - acquired,racial,Black or African American ,5,0,5
132835,Pediculosis capitis,racial,Black or African American ,5,0,5
132835,Pediculosis capitis,racial,Other Race,5,0,5
439871,Haemospermia,racial,Other Race,0,5,5
197803,"Malignant neoplasm, overlapping lesion of stomach",racial,White,0,5,5
141050,Disease of hard tissues of teeth,ethnic,Not Hispanic or Latino,0,5,5
4154616,Family history: Mental retardation,racial,Unknown,5,0,5
4151244,Fracture NOS,ethnic,Hispanic or Latino,0,5,5
4094126,Family problems,racial,White,2,2,4
77335,Known OR suspected fetal abnormality affecting management of mother,ethnic,Not Hispanic or Latino,0,5,5
136184,Pruritic disorder,racial,Filipino,2,2,4
194788,Open wound of anterior abdominal wall with complication,racial,White,5,0,5
437394,Closed fracture of lower end of forearm,racial,Other Race,0,5,5
4117739,Joint derangement NOS,racial,Unknown,5,0,5
434328,"Nondependent cannabis abuse, episodic",ethnic,Not Hispanic or Latino,0,5,5
316126,Crystalline deposits in vitreous,racial,Black or African American ,0,5,5
437993,Closed fracture of cervical spine,racial,Black or African American ,0,5,5
75629,"Stiff joint NEC, of the forearm",ethnic,Not Hispanic or Latino,0,5,5
4012258,Humoral immune defect,ethnic,Hispanic or Latino,5,0,5
78647,Peroneal nerve injury,ethnic,Hispanic or Latino,0,5,5
4093344,Prostate observation,racial,American Indian,0,5,5
436339,Bacterial infection due to Klebsiella pneumoniae,ethnic,Hispanic or Latino,5,0,5
4064927,Respiratory disease screening,racial,White,2,2,4
321042,Cardiac arrest,racial,Asian,0,5,5
75555,Viral labyrinthitis,racial,Unknown,2,2,4
4270866,Symptomatic dermographism,racial,Unknown,2,2,4
196436,Internal haemorrhoid,racial,Asian,2,2,4
74472,Congenital deformity of foot,racial,Native Hawaiian or Other Pacific Islander ,0,5,5
196338,Chronic gonococcal cystitis,ethnic,Hispanic or Latino,5,0,5
201473,Foreign body in intestine and colon,racial,White,0,5,5
381865,Sensorimotor disorder of eyelid,ethnic,Not Hispanic or Latino,0,5,5
441428,Closed fracture of lateral malleolus,racial,Other Race,5,0,5
377126,Concussion with brief loss of consciousness,racial,White,0,5,5
138384,Acquired hypothyroidism,racial,American Indian,5,0,5
199885,Acute female pelvic peritonitis,ethnic,Hispanic or Latino,5,0,5
440213,Consciousness and/or awareness finding,racial,White,2,2,4
4177966,Kaposi's sarcoma,racial,Asian,0,5,5
438398,Leukocytosis,racial,Filipino,0,5,5
439037,Aneurysm of artery of neck,ethnic,Not Hispanic or Latino,5,0,5
321109,Congenital anomaly of coronary artery,racial,Unknown,2,2,4
137974,Abnormal fetal heart beat noted before labor in liveborn infant,ethnic,Hispanic or Latino,5,0,5
432750,Closed dislocation of metatarsophalangeal joint,ethnic,Hispanic or Latino,5,0,5
75128,Injury of chest wall,racial,Asian,5,0,5
442985,Male,racial,White,5,0,5
80522,Congenital deformity of clavicle,racial,White,2,2,4
257008,Abscess of parapharyngeal space,racial,White,0,5,5
378163,Sounds seem unnaturally loud,racial,White,0,5,5
374347,Blepharoconjunctivitis,ethnic,Not Hispanic or Latino,2,2,4
435917,Fetus OR newborn affected by incompetent cervix,racial,White,5,0,5
434488,Finding of basal metabolic rate,racial,White,5,0,5
440161,Indication for care AND/OR intervention in labor AND/OR delivery,racial,White,5,0,5
78834,Effusion of joint of hand,racial,Unknown,2,2,4
433750,"Single major depressive episode, in full remission",racial,Black or African American ,5,0,5
81064,Pseudopolyposis of colon,racial,White,2,2,4
315558,Atherosclerosis of arteries of the extremities,racial,Black or African American ,5,0,5
441846,After-cataract not obscuring vision,racial,Unknown,5,0,5
77373,Congenital deformity of hip joint,racial,Other Race,5,0,5
199764,Benign ovarian tumour,racial,Unknown,5,0,5
77340,Genitourinary tract infection in pregnancy,racial,Native Hawaiian or Other Pacific Islander ,5,0,5
4010070,Closed fracture of lumbar spine with spinal cord lesion,racial,Unknown,5,0,5
379778,Multi-infarct dementia,racial,Asian,5,0,5
200528,Ascites,racial,Other Race,0,5,5
378161,Disorder of ear,racial,Other Race,2,2,4
4283892,Placement of stents in coronary artery,racial,Unknown,5,0,5
4302252,High risk pregnancy care,racial,Middle Eastern or North African,5,0,5
4058089,Mild hyperemesis gravidarum NOS,ethnic,Hispanic or Latino,5,0,5
132408,Back problem,racial,American Indian or Alaska Native ,2,2,4
27017,Defective dental restoration,racial,Asian,2,2,4
135745,Exanthema subitum,racial,Unknown,5,0,5
75899,Dislocation of shoulder region,racial,White,5,0,5
377868,Corneal pannus,racial,Unknown,0,5,5
40479606,Septic embolus of lung,racial,White,5,0,5
439105,Traumatic arthropathy of the forearm,ethnic,Hispanic or Latino,5,0,5
135765,"Sezary's disease of lymph nodes of head, face AND/OR neck",ethnic,Hispanic or Latino,5,0,5
75620,Traumatic arthropathy of the ankle and/or foot,racial,Unknown,5,0,5
436164,Corpus luteum cyst,ethnic,Hispanic or Latino,5,0,5
433218,Superficial thrombophlebitis of arm,racial,White,5,0,5
4145627,Biliary calculus,racial,Black or African American ,0,5,5
4056620,Other urethritis,racial,White,2,2,4
193312,Congenital anomaly of ureter,ethnic,Hispanic or Latino,2,2,4
437935,"Hemorrhage in early pregnancy, antepartum",racial,Unknown,5,0,5
442827,Fetus with central nervous system malformation with antenatal problem,racial,White,5,0,5
141232,MM - Malignant melanoma of skin,racial,Asian,2,2,4
4240103,Operation for bone injury on phalanges of foot,ethnic,Hispanic or Latino,2,2,4
257143,Open wound of multiple sites of nose without complication,ethnic,Hispanic or Latino,2,2,4
4093344,Prostate observation,racial,Native Hawaiian or Other Pacific Islander ,0,5,5
440158,"Venereal disease in mother complicating pregnancy, childbirth AND/OR puerperium",racial,White,5,0,5
24978,Chronic adenotonsillitis,racial,White,2,2,4
4064206,O/E - tuning fork testing,racial,Unknown,2,2,4
437092,Physiological development failure,racial,American Indian or Alaska Native ,0,5,5
441482,Administrative reason for encounter,racial,Asian Indian,0,5,5
4028641,Pregnancy and drug dependence,racial,Native Hawaiian or Other Pacific Islander ,5,0,5
433599,Abnormal biochemistry finding,racial,Black or African American ,0,5,5
138538,Longitudinal deficiency of limb,ethnic,Not Hispanic or Latino,2,2,4
80482,Suppurative arthritis,racial,Unknown,5,0,5
379778,Multi-infarct dementia,ethnic,Not Hispanic or Latino,5,0,5
75996,Sacral spinal cord injury without bone injury,ethnic,Hispanic or Latino,0,5,5
437390,Hypoxaemia,racial,American Indian or Alaska Native ,5,0,5
137275,Disorder of muscle,ethnic,Not Hispanic or Latino,2,2,4
440279,Accident,racial,Asian,2,2,4
4117862,Chronic rheumatic mitral valve,racial,White,5,0,5
433107,Injury of unknown intent by explosive,ethnic,Hispanic or Latino,0,5,5
437093,Congenital ptosis of upper eyelid,racial,Black or African American ,0,5,5
440085,Schizoid personality disorder,racial,Unknown,5,0,5
432352,Idiopathic fibrosing alveolitis,racial,White,5,0,5
77072,Joint effusion of ankle AND/OR foot,racial,Asian,0,5,5
78517,Arthralgia of multiple joints,racial,Native Hawaiian or Other Pacific Islander ,5,0,5
195007,Female stress incontinence,racial,Asian Indian,5,0,5
441788,Human papilloma virus infection,racial,Other Race,5,0,5
434541,Effects of heat,racial,Unknown,5,0,5
440921,Traumatic injury,racial,American Indian or Alaska Native ,2,2,4
381832,Presenile dementia with delirium,racial,Unknown,2,2,4
4145022,Traumatic arthritis NOS,ethnic,Not Hispanic or Latino,5,0,5
433548,Cracked nipple associated with childbirth,ethnic,Hispanic or Latino,5,0,5
4143968,Hypertensive renal disease NOS,ethnic,Hispanic or Latino,0,5,5
376382,Tension-type headache,racial,Native Hawaiian or Other Pacific Islander ,2,2,4
134618,Toxic diffuse goiter with thyrotoxic crisis,racial,Unknown,5,0,5
374049,Acute mucoid otitis media,ethnic,Not Hispanic or Latino,0,5,5
375393,Laceration of skin of eyelid AND periocular area,ethnic,Not Hispanic or Latino,2,2,4
198199,Pyelonephritis,racial,Asian,5,0,5
373432,Benign tumour of nervous system,ethnic,Hispanic or Latino,0,5,5
438725,Disorder of magnesium metabolism,racial,Unknown,5,0,5
375819,TM - Tympanic membrane disorder,racial,Unknown,2,2,4
438422,Primary iridocyclitis,racial,Unknown,0,5,5
4096666,Diabetes mellitus with hyperosmolar coma,racial,White,0,5,5
435810,After-cataract,racial,Asian,2,2,4
438178,Postmastectomy lymphedema syndrome,racial,Unknown,5,0,5
78025,Superficial injury of hand with infection,ethnic,Hispanic or Latino,0,5,5
372849,Overlapping malignant neoplasm of brain and other parts of the central nervous system,ethnic,Hispanic or Latino,5,0,5
433741,Hereditary pure erythrocytosis,racial,White,2,2,4
201899,Unilateral recurrent inguinal hernia,racial,Black or African American ,0,5,5
312940,Acute-on-chronic respiratory failure,racial,White,5,0,5
436334,Infection by Trypanosoma cruzi,ethnic,Hispanic or Latino,5,0,5
78581,Sprain of sacroiliac ligament,ethnic,Hispanic or Latino,5,0,5
132489,Partial thickness burn of finger,racial,White,2,2,4
372892,Metabolic encephalopathy,racial,Unknown,2,2,4
315922,Patent ductus arteriosus,racial,Unknown,0,5,5
77702,Multiple closed fractures of pelvis with disruption of pelvic circle,ethnic,Hispanic or Latino,5,0,5
133414,Candidiasis of skin and nails,racial,Black or African American ,2,2,4
440158,"Venereal disease in mother complicating pregnancy, childbirth AND/OR puerperium",ethnic,Hispanic or Latino,5,0,5
435244,Developmental disorder,racial,Black or African American ,0,5,5
196159,Old laceration of pelvic floor muscle,ethnic,Hispanic or Latino,5,0,5
4263370,R.I.N.D. syndrome,racial,Filipino,5,0,5
4006788,Percutaneous transluminal coronary balloon angioplasty,ethnic,Not Hispanic or Latino,0,5,5
434638,Macular focal chorioretinitis,ethnic,Hispanic or Latino,5,0,5
435516,Lipoprotein deficiency disorder,racial,Filipino,2,2,4
4092896,Stool contents abnormal,racial,American Indian or Alaska Native ,5,0,5
78593,Open wound of wrist without complication,racial,Asian,0,5,5
312336,Arterial aneurysm,racial,Asian,0,5,5
435790,Spurious polycythaemia,racial,Asian,0,5,5
376125,Disorder of eyelid,racial,Other Race,5,0,5
432739,Red blood cell disorder,racial,Asian,0,5,5
193317,Generalized abdominal rigidity,ethnic,Hispanic or Latino,5,0,5
433208,Disorder of pulmonary circulation,racial,White,0,5,5
320128,Essential hypertension,racial,Alaska Native,5,0,5
4109415,Secondary infected iridocyclitis,ethnic,Not Hispanic or Latino,5,0,5
194995,Disorder of ureter,racial,Other Race,0,5,5
195064,Perinatal jaundice due to hepatocellular damage,ethnic,Hispanic or Latino,0,5,5
437221,Chlamydia trachomatis infection,racial,Native Hawaiian or Other Pacific Islander ,5,0,5
376555,Open wound of ear drum without complication,racial,Other Race,0,5,5
132853,Lymphatic leukaemia,racial,White,0,5,5
4148076,Chronic neurogenic ulcer of lower limb,racial,Asian,5,0,5
312383,Postpartum cardiomyopathy,racial,White,2,2,4
199958,Open wound of hip AND thigh without complication,ethnic,Not Hispanic or Latino,5,0,5
133613,Closed traumatic dislocation of tarsometatarsal joint,ethnic,Hispanic or Latino,5,0,5
4167406,Eye disorder screening,racial,Asian Indian,5,0,5
201619,Diverticulum of stomach,racial,Unknown,0,5,5
374338,Nondiabetic proliferative retinopathy,ethnic,Not Hispanic or Latino,0,5,5
197006,Residual hemorrhoidal skin tags,ethnic,Not Hispanic or Latino,5,0,5
444112,Integumentary system finding,racial,Black or African American ,0,5,5
313878,Respiratory symptoms,racial,Asian Indian,0,5,5
4108087,Other and unspecified rheumatic heart disease,racial,White,5,0,5
4108389,Generalized tuberculosis,ethnic,Hispanic or Latino,0,5,5
436956,Evans syndrome,racial,Unknown,5,0,5
138790,Chronic periodontitis,racial,Unknown,0,5,5
4093165,Other specified viral hepatitis with hepatic coma NOS,ethnic,Not Hispanic or Latino,5,0,5
80184,Arthropathy due to parasitic infection,racial,Unknown,5,0,5
375791,Uncomplicated senile dementia,racial,Black or African American ,5,0,5
438205,Maternal syphilis during pregnancy - baby not yet delivered,racial,Unknown,5,0,5
192357,Paralytic ileus,racial,Asian,2,2,4
434872,Infection by Trichomonas,racial,Black or African American ,5,0,5
4141201,Beta lactam resistant bacterial infection,racial,White,5,0,5
4198960,Amputated above elbow,racial,White,5,0,5
138906,Superficial injury of face without infection,racial,Unknown,2,2,4
375825,Referred otalgia,racial,Unknown,2,2,4
440202,Multiple congenital malformations,racial,Unknown,0,5,5
443891,Cementum caries,racial,Unknown,5,0,5
375249,Traction detachment of retina,ethnic,Not Hispanic or Latino,5,0,5
74511,Open wound of knee and/or leg and/or ankle with complication,racial,White,5,0,5
380719,Impairment level: one eye: moderate impairment: other eye: normal vision,racial,White,2,2,4
4144395,Enlarged angioscotoma,ethnic,Hispanic or Latino,0,5,5
141508,Dermatophytosis of scalp or beard,racial,Asian,5,0,5
135762,Acute myeloid leukaemia in remission,racial,Other Race,0,5,5
440023,St. Louis encephalitis virus infection,racial,White,5,0,5
197339,"Congenital abnormality of uterus, affecting pregnancy",racial,White,2,2,4
434164,Glycosuria,racial,American Indian or Alaska Native ,5,0,5
434901,Subchronic paranoid schizophrenia with acute exacerbation,ethnic,Not Hispanic or Latino,5,0,5
77653,Traumatic myositis ossificans,racial,Black or African American ,0,5,5
198528,Acquired unequal leg length,racial,Asian,5,0,5
379020,Entropion,ethnic,Not Hispanic or Latino,5,0,5
4109564,Unspecified corneal ulcer,racial,White,5,0,5
257683,Postnasal drip,racial,Native Hawaiian or Other Pacific Islander ,2,2,4
438668,Accidents due to travel and motion,racial,White,2,2,4
4003982,Other specified skin anomalies,ethnic,Hispanic or Latino,5,0,5
4193570,Abnormal results of hearing screening test,racial,Black or African American ,5,0,5
201065,Acute and subacute liver necrosis,ethnic,Hispanic or Latino,5,0,5
441615,Trigonitis,racial,White,5,0,5
196523,Diarrhea,racial,American Indian,5,0,5
196151,Functional disorder of intestine,ethnic,Not Hispanic or Latino,0,5,5
442794,Poisoning by wasp sting,racial,Other Race,2,2,4
438478,Hemorrhage in early pregnancy,ethnic,Hispanic or Latino,5,0,5
444243,Neurotic disorder,racial,Black or African American ,5,0,5
4287844,alpha Thalassemia,ethnic,Hispanic or Latino,5,0,5
200528,Ascites,racial,Asian,2,2,4
436081,Immunosecretory disorder,racial,White,5,0,5
30968,Diabetes insipidus,racial,Other Race,0,5,5
79104,Loose body in joint,racial,White,2,2,4
79091,Unstable lie,racial,Asian,5,0,5
373461,Leukocoria,ethnic,Hispanic or Latino,5,0,5
74470,Congenital anomaly of upper limb,ethnic,Not Hispanic or Latino,0,5,5
72245,Chlamydial infection of lower genitourinary tract,ethnic,Not Hispanic or Latino,2,2,4
200970,CIS - Carcinoma in situ of prostate,racial,Asian,0,5,5
253482,Cortical blindness,ethnic,Not Hispanic or Latino,2,2,4
81936,Monoarthritis,racial,Asian,5,0,5
433745,"Amphetamine abuse, episodic",ethnic,Hispanic or Latino,5,0,5
441460,Late effect of sprain AND/OR strain without tendon injury,racial,Asian,0,5,5
443729,Peripheral circulatory disorder associated with type II diabetes mellitus,racial,Native Hawaiian or Other Pacific Islander ,0,5,5
137735,Second degree burn of forearm,racial,Unknown,5,0,5
437579,Paroxysmal ventricular tachycardia,racial,Filipino,0,5,5
135688,Abrasion AND/OR friction burn of foot with infection,ethnic,Not Hispanic or Latino,0,5,5
381832,Presenile dementia with delirium,ethnic,Hispanic or Latino,2,2,4
432302,Cocaine dependence in remission,ethnic,Not Hispanic or Latino,0,5,5
373999,Diabetic oculopathy associated with type I diabetes mellitus,racial,Black or African American ,5,0,5
4066724,Pilonidal sinus/cyst NOS,racial,Unknown,0,5,5
196433,Aneurysm of iliac artery,racial,White,0,5,5
314666,Healed coronary,racial,Filipino,0,5,5
376387,Spasmodic torticollis,ethnic,Not Hispanic or Latino,5,0,5
40480943,Lateral cystocele,ethnic,Not Hispanic or Latino,5,0,5
433903,"Abrasion AND/OR friction burn of multiple sites, infected",racial,White,5,0,5
141831,Branchial arch syndrome,racial,Unknown,0,5,5
4010070,Closed fracture of lumbar spine with spinal cord lesion,ethnic,Hispanic or Latino,5,0,5
375264,Impairment level: one eye: near-total impairment: other eye: normal vision,ethnic,Hispanic or Latino,0,5,5
79167,Open fracture finger distal phalanx,racial,Unknown,0,5,5
135057,Nonallopathic lesion of sacral region,racial,White,5,0,5
439219,Poisoning due to venomous spider,racial,Unknown,5,0,5
4053383,Family history of glaucoma,ethnic,Hispanic or Latino,2,2,4
74188,Closed fracture of rib,racial,Asian,2,2,4
75897,Polyarthropathy,racial,Black or African American ,2,2,4
373432,Benign tumour of nervous system,racial,Unknown,0,5,5
442170,Blister of neck with infection,racial,White,2,2,4
440085,Schizoid personality disorder,racial,Black or African American ,0,5,5
443460,Pathological fracture of femur,ethnic,Hispanic or Latino,5,0,5
435237,Reactive psychoses,ethnic,Hispanic or Latino,5,0,5
136184,Pruritic disorder,racial,American Indian or Alaska Native ,5,0,5
435651,Atypical squamous cells on cervical Papanicolaou smear cannot exclude high grade squamous intraepithelial lesion,racial,Black or African American ,5,0,5
201418,"Flatulence, eructation and gas pain",racial,American Indian,5,0,5
200164,Urine-induced contact dermatitis,racial,Filipino,2,2,4
4053470,Amblyopia ex anopsia,racial,White,2,2,4
376394,Menstrual migraine,racial,Unknown,5,0,5
436681,Insomnia disorder related to known organic factor,racial,Black or African American ,0,5,5
442714,"Splinter of finger, without major open wound, infected",racial,White,5,0,5
4290000,Mumps,racial,Unknown,5,0,5
440750,Thrombophlebitis of deep veins of upper extremities,racial,White,5,0,5
432742,Closed skull fracture without intracranial injury,racial,American Indian or Alaska Native ,0,5,5
258354,Pulmonary African histoplasmosis,ethnic,Hispanic or Latino,0,5,5
375246,Mononeuritis of upper limb,racial,American Indian,5,0,5
376117,Cataract in degenerative disorder,racial,Black or African American ,5,0,5
442040,Accidental poisoning by lead paints,ethnic,Hispanic or Latino,2,2,4
439372,"Motor vehicle traffic accident involving collision, on highway, between motor vehicle and fallen stone, traffic sign, tree or utility pole, pedestrian injured",racial,White,5,0,5
256723,Pneumonia and influenza,racial,Unknown,5,0,5
434926,Iridocyclitis,racial,Asian,2,2,4
436145,Pneumonia due to respiratory syncytial virus,ethnic,Hispanic or Latino,5,0,5
4288676,Acute and chronic cholecystitis,racial,Black or African American ,5,0,5
442749,Inhibited female orgasm,ethnic,Hispanic or Latino,5,0,5
438047,Contusion of orbital tissues,ethnic,Not Hispanic or Latino,5,0,5
442600,Manic bipolar I disorder in partial remission,racial,White,5,0,5
261393,Congenital polycystic lung,racial,White,5,0,5
439297,Nuclear senile cataract,racial,Asian,0,5,5
200338,Nodular lymphoma of intra-abdominal lymph nodes,ethnic,Hispanic or Latino,5,0,5
193520,Urinary bladder stone,racial,Other Race,5,0,5
381732,Nerve injury,racial,White,2,2,4
78524,Acquired deformity of finger,racial,Unknown,5,0,5
192359,RF - Renal failure,racial,Black or African American ,0,5,5
72714,Chronic polyarticular juvenile rheumatoid arthritis,racial,Unknown,5,0,5
4162218,Vaginal enterocele,racial,Unknown,5,0,5
4103735,"Better eye: near total visual impairment, Lesser eye: near total visual impairment",racial,Unknown,0,5,5
4147164,Hematologic malignancy,ethnic,Not Hispanic or Latino,5,0,5
4104857,Automatism petit mal,ethnic,Hispanic or Latino,5,0,5
4270866,Symptomatic dermographism,racial,Asian,5,0,5
259055,Extrinsic asthma with asthma attack,racial,American Indian or Alaska Native ,0,5,5
436541,Closed fracture of ulna,racial,Unknown,0,5,5
377279,"Profound impairment, one eye",racial,Asian,0,5,5
377678,EEG abnormality,ethnic,Not Hispanic or Latino,2,2,4
434638,Macular focal chorioretinitis,racial,Unknown,5,0,5
436246,Low libido,racial,Asian,0,5,5
4145627,Biliary calculus,ethnic,Not Hispanic or Latino,0,5,5
437222,Respiratory syncytial virus infection,racial,Black or African American ,0,5,5
4093165,Other specified viral hepatitis with hepatic coma NOS,racial,Asian,5,0,5
4273560,Premature labor,racial,White,5,0,5
379778,Multi-infarct dementia,racial,Unknown,0,5,5
77960,Joint observation,racial,Other Race,5,0,5
436173,Hyperemesis gravidarum with metabolic disturbance - delivered,racial,White,5,0,5
436588,Traumatic wound dehiscence,ethnic,Not Hispanic or Latino,5,0,5
141050,Disease of hard tissues of teeth,racial,White,0,5,5
133298,Musculoskeletal disorder of the neck,racial,Asian,2,2,4
433401,Coccidiosis,racial,White,2,2,4
200215,Abdominal rigidity,ethnic,Hispanic or Latino,2,2,4
444038,Psychoactive substance-induced organic mood disorder,ethnic,Hispanic or Latino,2,2,4
4141481,"Hand, foot and mouth disease",racial,Black or African American ,0,5,5
140602,"Mechanical complication of internal orthopedic device, implant and graft",racial,White,0,5,5
374631,Motor neurone disease,ethnic,Hispanic or Latino,5,0,5
440751,Peritonsillar abscess,racial,Unknown,5,0,5
201388,Congenital uterine anomaly,ethnic,Hispanic or Latino,5,0,5
72374,Unstable lie with antenatal problem,racial,Unknown,5,0,5
441155,Closed trimalleolar fracture,racial,White,5,0,5
432267,"Hodgkin's disease, lymphocytic depletion of extranodal AND/OR solid organ site",ethnic,Not Hispanic or Latino,0,5,5
432589,Neutropenia associated with infectious disease,ethnic,Hispanic or Latino,0,5,5
4070415,Fetus or neonate affected by chorioamnionitis,ethnic,Hispanic or Latino,5,0,5
443709,Atypical squamous cells of undetermined significance on anal Papanicolaou smear,ethnic,Not Hispanic or Latino,5,0,5
134398,Periodontal disease,racial,American Indian or Alaska Native ,5,0,5
4169009,FH: CVA,racial,Unknown,5,0,5
30968,Diabetes insipidus,racial,Unknown,5,0,5
433083,Opiate and narcotic poisoning,ethnic,Hispanic or Latino,5,0,5
261326,Viral pneumonia,racial,Black or African American ,2,2,4
440021,Herpes simplex without complication,racial,American Indian or Alaska Native ,2,2,4
4091320,Meningococcal infection NOS,racial,Unknown,5,0,5
442597,Meteorism,racial,Black or African American ,0,5,5
194831,Gastric foreign body,racial,White,0,5,5
378901,Open wound of nasal septum without complication,racial,White,2,2,4
433000,Patellar tendonitis,racial,Other Race,0,5,5
79962,Crushing injury of elbow,racial,White,0,5,5
381301,Chronic serous otitis media,racial,American Indian or Alaska Native ,5,0,5
436421,"Mixed conductive and sensorineural hearing loss, bilateral",racial,Unknown,2,2,4
313209,Left bundle branch hemiblock,racial,Black or African American ,2,2,4
379963,Open wound of external ear without complication,ethnic,Hispanic or Latino,2,2,4
74114,Cellulitis and abscess of foot excluding toe,racial,Native Hawaiian or Other Pacific Islander ,0,5,5
438391,Amino acid transport disorder,racial,White,2,2,4
376106,Disorder of the central nervous system,racial,Other Race,0,5,5
4243827,Drug addiction counseling,ethnic,Hispanic or Latino,5,0,5
436956,Evans syndrome,ethnic,Hispanic or Latino,5,0,5
443174,"Splinter of neck, without major open wound, infected",ethnic,Hispanic or Latino,5,0,5
73290,Contracture of joint,racial,Unknown,5,0,5
376699,Cicatricial ectropion,racial,Unknown,5,0,5
374886,Benign neoplasm of ear,ethnic,Not Hispanic or Latino,2,2,4
140214,Eruption of skin,racial,American Indian,2,2,4
378442,Conductive hearing loss of combined sites,ethnic,Not Hispanic or Latino,0,5,5
439669,Gonorrhoea of anus,ethnic,Not Hispanic or Latino,0,5,5
380941,Herpetic meningoencephalitis,racial,Native Hawaiian or Other Pacific Islander ,0,5,5
135333,Pressure sore,racial,Asian,0,5,5
4093468,Dermatomycosis NOS,ethnic,Hispanic or Latino,2,2,4
77673,Sign or symptom of the urinary system,racial,Asian,0,5,5
4103906,Lacrimal system disorder NOS,ethnic,Hispanic or Latino,5,0,5
28179,Polyp of vocal cord or larynx,racial,Black or African American ,5,0,5
76836,Sprain of knee and leg,racial,Filipino,5,0,5
443732,Disorder associated with type II diabetes melliltus,racial,Native Hawaiian or Other Pacific Islander ,0,5,5
440396,Glaucoma associated with ocular trauma,ethnic,Hispanic or Latino,2,2,4
4093146,Herpes simplex with other specified complication,racial,Black or African American ,2,2,4
441561,Low tension glaucoma,ethnic,Hispanic or Latino,2,2,4
30133,Acute laryngitis,racial,American Indian or Alaska Native ,5,0,5
442018,Foreign body accidentally left during a procedure,racial,Black or African American ,5,0,5
4304916,Gastrointestinal tract finding,racial,Unknown,5,0,5
436640,Primary malignant neoplasm of long bone of lower limb,ethnic,Hispanic or Latino,0,5,5
434901,Subchronic paranoid schizophrenia with acute exacerbation,racial,Black or African American ,5,0,5
376793,Congenital anomaly of ear with impairment of hearing,ethnic,Not Hispanic or Latino,2,2,4
200616,Complication of transplanted liver,ethnic,Hispanic or Latino,5,0,5
436254,Closed fractures of multiple bones of lower limb,ethnic,Not Hispanic or Latino,2,2,4
139841,Chronic frontal sinusitis,racial,American Indian or Alaska Native ,5,0,5
197018,Chronic gastric ulcer with hemorrhage but without obstruction,racial,Other Race,5,0,5
439139,Infections specific to perinatal period,ethnic,Hispanic or Latino,0,5,5
28060,Strept throat,racial,American Indian,5,0,5
442530,Broken tooth injury with complication,racial,Other Race,0,5,5
193517,Bile duct calculus with no mention of cholecystitis and with obstruction,racial,White,0,5,5
444382,Thoracic radiculitis,racial,American Indian,5,0,5
438156,Epiphora due to insufficient drainage,racial,White,0,5,5
80802,Secondary localized osteoarthrosis,racial,White,2,2,4
135350,Acute osteomyelitis of the ankle and/or foot,ethnic,Not Hispanic or Latino,2,2,4
195588,Cystitis,racial,American Indian or Alaska Native ,5,0,5
79917,Acquired deformity of toe,ethnic,Not Hispanic or Latino,2,2,4
136916,Primary malignant neoplasm of skin of external auditory canal,ethnic,Hispanic or Latino,2,2,4
80883,Nonvenomous insect bite of elbow with infection,racial,Unknown,0,5,5
4310768,Fall on steps,racial,Other Race,5,0,5
4145492,Other peripheral vascular disease,ethnic,Hispanic or Latino,2,2,4
136575,Nonvenomous insect bite with infection,racial,Other Race,0,5,5
194574,Chronic type B viral hepatitis,racial,Alaska Native,0,5,5
435543,Primary angle-closure glaucoma,racial,Asian,5,0,5
195590,Urethral stricture,racial,Asian,0,5,5
4195231,Acute gastric ulcer without hemorrhage AND without perforation,racial,Unknown,5,0,5
81097,Felty's syndrome,ethnic,Hispanic or Latino,5,0,5
81670,Congenital anomaly of spine,racial,Black or African American ,0,5,5
138826,Acne varioliformis,racial,Asian,2,2,4
200051,Primary malignant neoplasm of ovary,racial,Black or African American ,5,0,5
439245,"Mixed bipolar affective disorder, in full remission",racial,White,5,0,5
73558,Allergic arthritis of the lower leg,ethnic,Hispanic or Latino,5,0,5
4318408,Subdural haematoma,racial,Other Race,0,5,5
4201387,Tracheostomy in situ,racial,Other Race,5,0,5
72413,Non-traumatic rupture of muscle,ethnic,Hispanic or Latino,5,0,5
30515,Oesophagostenosis,racial,Unknown,0,5,5
434953,Orbital granuloma,racial,Unknown,5,0,5
135923,CP - Cleft palate,racial,Black or African American ,0,5,5
433163,Deficiency of macronutrients,racial,Black or African American ,2,2,4
4080568,Problem behaviour,racial,Filipino,5,0,5
433167,Lipoma of intrathoracic organs,ethnic,Hispanic or Latino,0,5,5
256146,Pneumoconiosis due to silicates,racial,Unknown,0,5,5
435101,Open fracture of foot,ethnic,Hispanic or Latino,2,2,4
316994,Malignant hypertensive heart disease with congestive cardiac failure,racial,Other Race,0,5,5
201350,Placental abruption - not delivered,ethnic,Hispanic or Latino,5,0,5
4107375,Somatoform pain disorder,racial,White,5,0,5
376119,Perforated corneal ulcer,ethnic,Hispanic or Latino,5,0,5
375249,Traction detachment of retina,racial,Unknown,0,5,5
436517,Fetus OR newborn affected by narcotic transmitted via placenta AND/OR breast milk,ethnic,Hispanic or Latino,0,5,5
438701,UKP - Disseminated malignancy of unknown primary,racial,Black or African American ,5,0,5
441692,Finding of serum tumour marker level,racial,White,5,0,5
75905,Pathological dislocation of upper arm,ethnic,Hispanic or Latino,0,5,5
320074,Lymphocytosis,ethnic,Not Hispanic or Latino,0,5,5
441202,Generalized anaphylaxis,racial,Other Race,2,2,4
437979,Macroglossia,ethnic,Hispanic or Latino,2,2,4
380111,Acute atopic conjunctivitis,racial,Other Race,2,2,4
73847,Observation of elbow joint,ethnic,Not Hispanic or Latino,0,5,5
440971,Neoplasm of uncertain behaviour of testis,racial,White,0,5,5
133835,Dermatitis,racial,Native Hawaiian or Other Pacific Islander ,5,0,5
434169,Abnormal findings on diagnostic imaging of breast,racial,Filipino,5,0,5
4024567,Respiratory observation,racial,Unknown,0,5,5
375519,Alcohol withdrawal syndrome,racial,Black or African American ,0,5,5
193518,Intestinal obstruction,racial,Asian,0,5,5
443772,Superficial injury of scalp with infection,ethnic,Hispanic or Latino,5,0,5
4053378,FH: Blood disorder,racial,Other Race,0,5,5
79904,Secondary localised osteoarthrosis of hand,ethnic,Hispanic or Latino,0,5,5
199855,Acute gastric ulcer with hemorrhage AND with perforation but without obstruction,racial,Unknown,0,5,5
439669,Gonorrhoea of anus,racial,Black or African American ,0,5,5
434502,Closed fracture of phalanx of toe,racial,Black or African American ,5,0,5
439246,"Mixed bipolar affective disorder, severe, with psychosis",ethnic,Not Hispanic or Latino,0,5,5
79804,Myotonic dystrophy,racial,Black or African American ,5,0,5
31821,Endocrinopathy,racial,Black or African American ,0,5,5
133414,Candidiasis of skin and nails,racial,Asian,0,5,5
441482,Administrative reason for encounter,racial,American Indian,5,0,5
199877,Mucous polyp of cervix,racial,Black or African American ,5,0,5
198197,Male infertility,racial,Black or African American ,0,5,5
434697,Maternal tobacco abuse,ethnic,Hispanic or Latino,5,0,5
195593,Congenital hydrocele of canal of Nuck,ethnic,Hispanic or Latino,0,5,5
4005439,Other lung anomaly NOS,ethnic,Hispanic or Latino,0,5,5
194993,Intestinal malabsorption,racial,Other Race,2,2,4
200670,Benign tumour of male genital organs,racial,White,0,5,5
4143292,Varicose veins of legs in the puerperium,racial,White,5,0,5
193733,Neoplasm of uncertain behavior of retroperitoneum and peritoneum,racial,White,5,0,5
77961,Disseminated idiopathic skeletal hyperostosis,ethnic,Hispanic or Latino,5,0,5
81454,Injury of finger,racial,American Indian or Alaska Native ,0,5,5
436859,"Insect bite, nonvenomous, of shoulder and upper arm, infected",racial,White,0,5,5
4297375,Victim of abuse,racial,White,5,0,5
4178537,Family history: nervous system disorder,ethnic,Hispanic or Latino,2,2,4
4222138,Allergic contact dermatitis of eyelid,ethnic,Not Hispanic or Latino,5,0,5
4112514,Unilateral total vocal cord paralysis,racial,Black or African American ,0,5,5
432456,Finding of alcohol intake,racial,Unknown,0,5,5
255302,Spontaneous pneumothorax,ethnic,Not Hispanic or Latino,0,5,5
135030,Discoloration of skin,racial,Other Race,5,0,5
137856,Atypical facial pain,ethnic,Not Hispanic or Latino,5,0,5
4109559,"Better eye: severe visual impairment, Lesser eye: severe visual impairment",ethnic,Hispanic or Latino,5,0,5
194133,Low back pain,racial,Alaska Native,5,0,5
139841,Chronic frontal sinusitis,racial,Black or African American ,5,0,5
432878,Drug abuse using speed,racial,American Indian or Alaska Native ,2,2,4
444391,Pain around eye,racial,Black or African American ,0,5,5
201527,Neoplasm of uncertain behaviour of prostate,ethnic,Not Hispanic or Latino,0,5,5
432725,Congenital anomaly of integument,racial,Asian,5,0,5
75708,Foreign body in anus and rectum,ethnic,Hispanic or Latino,0,5,5
444435,Superficial injury of elbow without infection,racial,White,0,5,5
377556,Sudden visual loss,racial,Asian,5,0,5
4204989,Disturbance in sleep behavior,ethnic,Not Hispanic or Latino,5,0,5
436098,Nondependent cocaine abuse in remission,racial,Black or African American ,2,2,4
4025176,Respiratory system diseases NOS,racial,Unknown,0,5,5
444071,Furuncle of forearm,racial,Other Race,5,0,5
437589,Pulpitis,racial,Unknown,2,2,4
4284118,Fall on escalator,racial,White,5,0,5
4273391,Suicidal thoughts,racial,Other Race,5,0,5
259048,Pneumonia in systemic mycosis,racial,White,0,5,5
27137,Open wound of mouth with complication,ethnic,Hispanic or Latino,5,0,5
434628,Separation anxiety,racial,Other Race,5,0,5
254068,Upper respiratory disease,racial,Asian,0,5,5
441896,Plicated tongue,racial,Unknown,5,0,5
377279,"Profound impairment, one eye",racial,Other Race,2,2,4
4148076,Chronic neurogenic ulcer of lower limb,racial,Unknown,5,0,5
442619,Fracture of humerus,racial,White,2,2,4
133468,Disease of extremity,ethnic,Not Hispanic or Latino,0,5,5
443378,Anabolic steroids adverse reaction,racial,White,0,5,5
372324,Eustachian tube disorder,racial,Asian,5,0,5
72459,Closed fracture of two ribs,racial,White,5,0,5
141933,Alopecia areata,racial,American Indian or Alaska Native ,0,5,5
193144,Suprarenal metastasis,ethnic,Hispanic or Latino,2,2,4
79889,Unstable lie - delivered,racial,White,5,0,5
4144395,Enlarged angioscotoma,racial,White,2,2,4
437935,"Hemorrhage in early pregnancy, antepartum",ethnic,Hispanic or Latino,5,0,5
193136,Acute gonococcal cervicitis,ethnic,Not Hispanic or Latino,5,0,5
435543,Primary angle-closure glaucoma,racial,Other Race,5,0,5
435063,Fetus OR newborn affected by ectopic pregnancy,ethnic,Hispanic or Latino,5,0,5
436176,Spontaneous abortion without complication,racial,Asian,5,0,5
433933,Plants - toxic effect,racial,White,2,2,4
374362,Keratoconus,racial,White,2,2,4
4022073,Dependance on wheel chair,racial,Asian,0,5,5
437689,Multiple closed fractures of cervical vertebrae,racial,Unknown,0,5,5
195289,Goodpasture's syndrome,ethnic,Hispanic or Latino,0,5,5
441680,Fetus OR newborn affected by multiple pregnancy,racial,Other Race,5,0,5
195482,Primary malignant neoplasm of intestinal tract,racial,White,5,0,5
376699,Cicatricial ectropion,ethnic,Hispanic or Latino,5,0,5
376394,Menstrual migraine,racial,White,5,0,5
439372,"Motor vehicle traffic accident involving collision, on highway, between motor vehicle and fallen stone, traffic sign, tree or utility pole, pedestrian injured",ethnic,Not Hispanic or Latino,5,0,5
439264,Acute suppurative otitis media,ethnic,Not Hispanic or Latino,5,0,5
4146248,Rheumatoid arthritis and other inflammatory polyarthropathies,ethnic,Not Hispanic or Latino,5,0,5
4140734,Amniocentesis for possible chromosomal abnormality,racial,Unknown,5,0,5
433768,Glaucoma with increased episcleral venous pressure,racial,Unknown,5,0,5
432803,[X]Fall on and from ladder,racial,Asian,0,5,5
439262,"Single manic episode, severe, with psychosis",racial,White,5,0,5
4154623,Fit denture,racial,Native Hawaiian or Other Pacific Islander ,5,0,5
442073,Malunion and nonunion of fracture,racial,Unknown,5,0,5
4055758,Temporomandibular joint disorder NOS,ethnic,Not Hispanic or Latino,2,2,4
73855,Arrest of bone development AND/OR growth,ethnic,Hispanic or Latino,0,5,5
4143968,Hypertensive renal disease NOS,racial,White,0,5,5
437334,Cervical incompetence with antenatal problem,ethnic,Not Hispanic or Latino,2,2,4
40422016,Suicide and selfinflicted injury by jumping or lying before moving object,racial,White,5,0,5
4108961,Other chorioretinitis and retinochoroiditis,ethnic,Hispanic or Latino,5,0,5
76791,Acquired deformity of hip,racial,Black or African American ,5,0,5
319927,Heart sounds abnormal,racial,Asian,0,5,5
434119,Hidradenitis,racial,Black or African American ,0,5,5
195926,Slowing of urinary stream,ethnic,Not Hispanic or Latino,0,5,5
319041,Orthostatic hypotension,racial,Other Race,5,0,5
40484028,Dental caries extending into dentine,racial,Black or African American ,2,2,4
193063,Blister of trunk without infection,ethnic,Hispanic or Latino,5,0,5
433930,Motor vehicle on road in collision with another motor vehicle,racial,Other Race,2,2,4
74817,Crushing injury of buttock,ethnic,Hispanic or Latino,5,0,5
377574,Presbycusis,racial,Other Race,2,2,4
193519,Impaired renal function disorder,racial,Other Race,5,0,5
437899,Acute and subacute bacterial endocarditis,ethnic,Not Hispanic or Latino,5,0,5
199837,Deep vein thrombosis of portal vein,ethnic,Hispanic or Latino,0,5,5
137977,Icteric,racial,American Indian or Alaska Native ,5,0,5
433903,"Abrasion AND/OR friction burn of multiple sites, infected",ethnic,Not Hispanic or Latino,5,0,5
80492,Knee joint contracture,racial,Unknown,5,0,5
4051770,"Contusion, ankle and foot, excluding toe(s)",ethnic,Hispanic or Latino,0,5,5
435649,Complication of hemodialysis,racial,Native Hawaiian or Other Pacific Islander ,0,5,5
379019,Inflammation of conjunctiva,racial,Native Hawaiian or Other Pacific Islander ,5,0,5
437536,Somatoform autonomic dysfunction - gastrointestinal tract,racial,Unknown,5,0,5
380395,Retinal dystrophy,racial,Unknown,0,5,5
442256,Disorder of bursae of shoulder region,racial,Filipino,5,0,5
195877,Observation of gravid uterus,ethnic,Hispanic or Latino,5,0,5
261687,Hemoptysis,racial,Black or African American ,2,2,4
443524,Mixed incontinence,racial,Native Hawaiian or Other Pacific Islander ,5,0,5
377551,Blind hypertensive eye,ethnic,Hispanic or Latino,5,0,5
313791,Bundle branch block,ethnic,Not Hispanic or Latino,0,5,5
375671,Concussion with loss of consciousness,ethnic,Not Hispanic or Latino,5,0,5
4159157,Disorder of tooth development,racial,White,5,0,5
377545,Episodic tension-type headache,racial,White,2,2,4
137350,Radiation dermatitis,ethnic,Hispanic or Latino,2,2,4
261880,Atelectasis,racial,Other Race,0,5,5
441564,Optic disc oedema associated with retinal disorder,racial,Unknown,5,0,5
80876,Unilateral traumatic amputation at OR above elbow without complication,ethnic,Not Hispanic or Latino,5,0,5
435119,Sequela of injury,ethnic,Not Hispanic or Latino,0,5,5
4093468,Dermatomycosis NOS,racial,White,2,2,4
133737,Acute thyroiditis,ethnic,Not Hispanic or Latino,5,0,5
196456,Cholecystolithiasis,racial,Native Hawaiian or Other Pacific Islander ,2,2,4
192684,"Renal hypertension complicating pregnancy, childbirth and the puerperium - not delivered",ethnic,Not Hispanic or Latino,0,5,5
132391,Furuncle of face,ethnic,Not Hispanic or Latino,0,5,5
200765,Chronic cholecystitis,ethnic,Not Hispanic or Latino,5,0,5
436254,Closed fractures of multiple bones of lower limb,racial,Unknown,5,0,5
375800,Dystonia,ethnic,Not Hispanic or Latino,0,5,5
442983,Nasal mucosa observation,ethnic,Hispanic or Latino,0,5,5
316994,Malignant hypertensive heart disease with congestive cardiac failure,ethnic,Not Hispanic or Latino,2,2,4
40421730,"Adverse reaction to mixed bacterial vaccines, excluding combinations with a pertussis component",ethnic,Hispanic or Latino,0,5,5
443603,Adverse reaction to antidiabetic drug,racial,White,2,2,4
4143292,Varicose veins of legs in the puerperium,ethnic,Hispanic or Latino,5,0,5
440696,Cyclothymia,ethnic,Hispanic or Latino,2,2,4
132704,Lichen nitidus,ethnic,Hispanic or Latino,2,2,4
372605,Spinal muscular atrophy,racial,Other Race,0,5,5
381028,Acute suppurative otitis media - tympanic membrane ruptured,racial,Asian,2,2,4
436936,Benign neoplasm of cranial nerve,racial,White,5,0,5
80852,Closed fracture of four ribs,racial,White,2,2,4
433759,Developmental reading disorder,ethnic,Not Hispanic or Latino,0,5,5
196162,Uterine inflammatory disease,ethnic,Hispanic or Latino,5,0,5
439406,Allergy to animal,racial,Black or African American ,5,0,5
442038,Anaphylactic shock due to serum,ethnic,Hispanic or Latino,5,0,5
193016,Cystic disease of kidney,racial,Black or African American ,2,2,4
380415,Acute swimmer's ear,racial,Native Hawaiian or Other Pacific Islander ,5,0,5
440703,Trigeminal nerve disorder,racial,Unknown,5,0,5
4005439,Other lung anomaly NOS,racial,White,0,5,5
196468,Acute salpingo-oophoritis,ethnic,Hispanic or Latino,5,0,5
442926,"Motor vehicle traffic accident involving collision with another motor vehicle, parked, driver of motor vehicle injured",ethnic,Not Hispanic or Latino,2,2,4
141094,Lichen,ethnic,Not Hispanic or Latino,2,2,4
437470,Adverse reaction to benzodiazepine-based tranquilliser,racial,White,0,5,5
442752,Myalgia,racial,American Indian or Alaska Native ,5,0,5
195064,Perinatal jaundice due to hepatocellular damage,racial,White,0,5,5
4116770,"Localized, secondary osteoarthritis NOS",racial,Unknown,5,0,5
81539,Mitochondrial disease,ethnic,Not Hispanic or Latino,0,5,5
432267,"Hodgkin's disease, lymphocytic depletion of extranodal AND/OR solid organ site",racial,White,0,5,5
439233,Poisoning by antidiabetic agent,ethnic,Hispanic or Latino,2,2,4
200687,Renal disorder associated with type I diabetes mellitus,racial,Filipino,5,0,5
373770,"Infantile, juvenile and presenile cataracts",ethnic,Hispanic or Latino,5,0,5
4232618,Gelastic seizure,racial,White,5,0,5
374653,Neurologic disorder of eye movements,ethnic,Hispanic or Latino,2,2,4
434339,Adolescent - emotional problem,racial,Black or African American ,2,2,4
436233,Delayed milestone,racial,Other Race,0,5,5
140435,Arrested dental caries,racial,White,5,0,5
374347,Blepharoconjunctivitis,racial,Asian,0,5,5
77987,Respiratory observations of chest,racial,Other Race,2,2,4
197239,Haemangioma of intra-abdominal structure,racial,Asian,5,0,5
137785,Verruca plantaris,racial,Black or African American ,0,5,5
319845,Pulmonary valve disease,racial,Black or African American ,5,0,5
381033,Aphakia,racial,Other Race,0,5,5
132583,Postablative hypothyroidism,racial,Unknown,5,0,5
257094,Congenital anomaly of lung,racial,White,0,5,5
375822,Neonatal obstruction of nasolacrimal duct,racial,Black or African American ,2,2,4
440029,Viral disease,racial,Alaska Native,0,5,5
80778,Genitourinary tract infection in pregnancy - delivered with postnatal complication,racial,White,5,0,5
439264,Acute suppurative otitis media,ethnic,Hispanic or Latino,2,2,4
4319325,Acquired deformity of trunk,racial,Asian,2,2,4
4200655,Urostomy present,ethnic,Not Hispanic or Latino,0,5,5
81097,Felty's syndrome,racial,White,5,0,5
4109415,Secondary infected iridocyclitis,racial,Black or African American ,5,0,5
440035,European cryptococcosis,ethnic,Not Hispanic or Latino,0,5,5
375538,"Degeneration of macula due to cyst, hole or pseudohole",racial,Other Race,5,0,5
201612,ALD - Alcoholic liver disease,ethnic,Not Hispanic or Latino,2,2,4
441132,Laboratory finding abnormal,racial,White,2,2,4
443417,Villonodular synovitis of lower limb,racial,White,2,2,4
442597,Meteorism,racial,Asian,0,5,5
201727,Superficial injury of trunk without infection,racial,White,5,0,5
443454,Cerebral infarction,racial,Filipino,5,0,5
4067459,Heterotopic liver transplant,racial,White,0,5,5
4054908,Closed injury of kidney,ethnic,Not Hispanic or Latino,0,5,5
437787,Secondary syphilis,ethnic,Hispanic or Latino,0,5,5
132416,Chronic haematoma of pinna,racial,White,2,2,4
4109699,Unspecified chronic conjunctivitis,racial,White,0,5,5
373216,Disorder of mastoid,ethnic,Hispanic or Latino,2,2,4
4051110,FH: leukaemia,racial,Other Race,2,2,4
74451,Palindromic rheumatism of the forearm,racial,Other Race,2,2,4
31609,Abscess of salivary gland,ethnic,Hispanic or Latino,5,0,5
435849,Parietoalveolar pneumopathy,ethnic,Not Hispanic or Latino,5,0,5
40481091,Partial edentulism,racial,White,2,2,4
442262,Blister of toe without infection,racial,Other Race,0,5,5
440865,Closed fracture of epiphysis of femur,racial,Unknown,5,0,5
138965,Myelitis,racial,White,2,2,4
436677,"Brief situational non-psychotic disorder, NOS",racial,Asian,5,0,5
432750,Closed dislocation of metatarsophalangeal joint,racial,Unknown,5,0,5
139188,Open wound of scalp without complication,racial,Other Race,0,5,5
4112514,Unilateral total vocal cord paralysis,ethnic,Not Hispanic or Latino,0,5,5
372921,Retained foreign body of middle ear,racial,White,2,2,4
4317122,Adverse reaction to drugs primarily affecting the gastrointestinal system NOS,ethnic,Hispanic or Latino,5,0,5
4012590,Fracture of one or more phalanges of foot NOS,ethnic,Hispanic or Latino,5,0,5
437428,Crushing injury - disorder,racial,Unknown,0,5,5
200349,Malignant lymphoma of intra-abdominal lymph nodes,racial,White,5,0,5
444211,Disease of thigh,racial,Asian,5,0,5
435227,Nutritional deficiency,racial,Native Hawaiian or Other Pacific Islander ,0,5,5
255302,Spontaneous pneumothorax,racial,Asian,0,5,5
443178,"Insect bite, nonvenomous, of face",ethnic,Not Hispanic or Latino,5,0,5
73560,Calcaneal spur,racial,Native Hawaiian or Other Pacific Islander ,2,2,4
24818,Neck injury,racial,Native Hawaiian or Other Pacific Islander ,0,5,5
377287,Phlyctenular keratoconjunctivitis,racial,White,2,2,4
80568,Traumatic amputation of finger without mention of complication,racial,Asian,5,0,5
75053,Fracture of bone,racial,Alaska Native,0,5,5
78228,Joint derangement,racial,Other Race,0,5,5
4028716,Idiopathic thrombocythemia,racial,Black or African American ,0,5,5
379820,No colour perception,racial,Unknown,0,5,5
380395,Retinal dystrophy,ethnic,Not Hispanic or Latino,0,5,5
261889,Simple chronic bronchitis,racial,American Indian,0,5,5
4215568,Sensory disturbance in limb,racial,Unknown,0,5,5
4206460,Problem,racial,Native Hawaiian or Other Pacific Islander ,2,2,4
76737,Hydrocele,ethnic,Hispanic or Latino,0,5,5
81088,Failed lactation,ethnic,Not Hispanic or Latino,0,5,5
435372,Underweight,racial,Filipino,0,5,5
75899,Dislocation of shoulder region,ethnic,Hispanic or Latino,5,0,5
4111411,Aortic valve disorders NOS,racial,White,0,5,5
138538,Longitudinal deficiency of limb,ethnic,Hispanic or Latino,5,0,5
139210,Superficial burn of back,ethnic,Hispanic or Latino,5,0,5
316447,Chronic hypotension,ethnic,Not Hispanic or Latino,0,5,5
438873,Closed fracture of base of skull with intracranial hemorrhage,racial,Black or African American ,0,5,5
192731,Digestive symptom,racial,Asian,5,0,5
4278672,Fracture of forearm,racial,White,2,2,4
135027,"Carbuncle of leg, except foot",ethnic,Not Hispanic or Latino,2,2,4
257143,Open wound of multiple sites of nose without complication,racial,White,2,2,4
4305841,Periodic limb movement disorder,racial,Unknown,5,0,5
137989,Abnormal results of cardiovascular function studies,ethnic,Not Hispanic or Latino,5,0,5
4156802,"Blister of finger, infected",ethnic,Hispanic or Latino,2,2,4
436876,Toxic effect of lead compound,racial,Unknown,5,0,5
435186,Disease due to Rhinovirus,ethnic,Hispanic or Latino,2,2,4
201473,Foreign body in intestine and colon,ethnic,Hispanic or Latino,0,5,5
375824,Abnormal auditory perception,racial,Black or African American ,2,2,4
141831,Branchial arch syndrome,racial,Black or African American ,0,5,5
80004,Hand injury,racial,Asian,0,5,5
4305303,Sleep deprivation,racial,Black or African American ,0,5,5
312733,"Abnormal foetal heart beat, not clear if noted before OR after onset of labour in liveborn infant",ethnic,Hispanic or Latino,5,0,5
196236,Septicaemic shock,racial,White,2,2,4
137666,Congenital ear lobe absence,racial,White,2,2,4
4064927,Respiratory disease screening,ethnic,Hispanic or Latino,2,2,4
197039,Male genital organ vascular diseases,racial,Unknown,0,5,5
4301700,Acute mastoiditis,racial,White,5,0,5
443409,On examination - left lower abdominal mass,racial,Asian,2,2,4
200169,Pruritus ani,racial,Asian,5,0,5
4051110,FH: leukaemia,ethnic,Hispanic or Latino,2,2,4
321689,Apneic,racial,Asian,2,2,4
373139,Syphilitic parkinsonism,racial,Unknown,0,5,5
440069,Drug dependence,racial,Asian,0,5,5
4105589,Biopsy of peritoneum,ethnic,Hispanic or Latino,5,0,5
439840,Inflammation of lymphatics,ethnic,Hispanic or Latino,5,0,5
4296611,Chronic gastric ulcer without hemorrhage AND without perforation,racial,White,5,0,5
440066,Disorder of purine and pyrimidine metabolism,ethnic,Hispanic or Latino,2,2,4
437251,Benign neoplasm of pituitary gland and craniopharyngeal duct,racial,Other Race,5,0,5
4094865,Ca intrahepatic bile ducts,ethnic,Not Hispanic or Latino,5,0,5
372888,Sciatic nerve lesion,racial,Unknown,2,2,4
437316,Fissural cyst of jaw,ethnic,Hispanic or Latino,5,0,5
433600,"Problem, abnormal test",racial,Unknown,5,0,5
4144103,Influenza NOS,racial,Unknown,2,2,4
4296611,Chronic gastric ulcer without hemorrhage AND without perforation,racial,Unknown,5,0,5
4166080,Decompression of median nerve,racial,Black or African American ,0,5,5
193518,Intestinal obstruction,racial,Black or African American ,5,0,5
74250,Burn of foot,ethnic,Not Hispanic or Latino,2,2,4
77156,Superficial foreign body of toe without major open wound but with infection,racial,Unknown,5,0,5
4056620,Other urethritis,ethnic,Not Hispanic or Latino,2,2,4
320299,Complication of transplanted heart,ethnic,Not Hispanic or Latino,0,5,5
434033,Chorioretinitis,racial,Unknown,5,0,5
132408,Back problem,racial,Filipino,5,0,5
78234,Arthralgia of the hand,racial,Asian Indian,5,0,5
433746,"Combined drug dependence, excluding opioid, continuous",ethnic,Hispanic or Latino,5,0,5
432600,Stress reaction causing mixed disturbance of emotion and conduct,racial,White,5,0,5
438873,Closed fracture of base of skull with intracranial hemorrhage,ethnic,Not Hispanic or Latino,0,5,5
256571,FB - Nasal foreign body,racial,Asian,5,0,5
4018734,Sprain of costal cartilage,racial,American Indian or Alaska Native ,5,0,5
72402,Traumatic arthropathy of the lower leg,ethnic,Hispanic or Latino,2,2,4
200146,Pancreatic steatorrhea,ethnic,Hispanic or Latino,5,0,5
439928,Gangrenous disorder,racial,Black or African American ,0,5,5
437973,Congenital chorioretinal degeneration,ethnic,Hispanic or Latino,0,5,5
138994,MDS - Myelodysplastic syndrome,racial,Unknown,0,5,5
4340379,Hepatitis B carrier,racial,Other Race,5,0,5
432303,Cocaine abuse,racial,Black or African American ,0,5,5
313833,Puerperal cerebrovascular disorder with postnatal complication,ethnic,Hispanic or Latino,5,0,5
141673,Aseptic necrosis of head of humerus,ethnic,Hispanic or Latino,2,2,4
4117739,Joint derangement NOS,ethnic,Hispanic or Latino,5,0,5
4242720,Intracranial hematoma following injury,ethnic,Hispanic or Latino,0,5,5
377277,Impairment level: total impairment of both eyes,racial,Other Race,0,5,5
201627,Abnormal vaginal bleeding,racial,American Indian or Alaska Native ,5,0,5
77819,Benign tumour of pleura,racial,White,5,0,5
443115,Closed fracture finger proximal phalanx,racial,Other Race,2,2,4
193252,Diverticulosis of small intestine,racial,White,2,2,4
437394,Closed fracture of lower end of forearm,racial,Filipino,5,0,5
441081,Maternal gonorrhoea during pregnancy - baby not yet delivered,ethnic,Not Hispanic or Latino,5,0,5
313223,Wegener granulomatosis,ethnic,Not Hispanic or Latino,2,2,4
435786,Disorder of sleep-wake cycle,ethnic,Hispanic or Latino,2,2,4
373475,Impairment level: one eye: moderate impairment: other eye: not specified,racial,Asian,5,0,5
437745,Victim of infant/child neglect,ethnic,Hispanic or Latino,5,0,5
4051114,FH: Diabetes mellitus,racial,Filipino,2,2,4
375671,Concussion with loss of consciousness,racial,White,2,2,4
200773,Stenosis of rectum and anus,racial,White,0,5,5
443709,Atypical squamous cells of undetermined significance on anal Papanicolaou smear,racial,White,2,2,4
4103735,"Better eye: near total visual impairment, Lesser eye: near total visual impairment",ethnic,Not Hispanic or Latino,0,5,5
196751,Haemorrhage from placenta previa,racial,Unknown,5,0,5
441407,Appetite loss - anorexia,racial,Filipino,5,0,5
4310768,Fall on steps,racial,Black or African American ,0,5,5
314426,Congenital cardiovascular disorder during pregnancy - baby not yet delivered,ethnic,Hispanic or Latino,5,0,5
4024000,Urinary system finding,racial,Black or African American ,0,5,5
443943,Herpes zoster,racial,Asian,0,5,5
435018,Twin pregnancy - delivered,racial,White,5,0,5
380095,Lesions of nerves plexuses and roots,racial,Unknown,5,0,5
443593,Ulcer of thigh,racial,White,0,5,5
194526,Injury of trunk,racial,Black or African American ,5,0,5
376267,Superficial injury of conjunctiva,ethnic,Not Hispanic or Latino,5,0,5
442286,Abscess of digit,racial,American Indian or Alaska Native ,0,5,5
197609,"Cervical, vaginal and vulval inflammatory diseases",racial,Unknown,5,0,5
380719,Impairment level: one eye: moderate impairment: other eye: normal vision,ethnic,Hispanic or Latino,2,2,4
196625,Viral hepatitis A without hepatic coma,ethnic,Not Hispanic or Latino,2,2,4
193250,Gastric hemorrhage,racial,Unknown,2,2,4
440330,Rochalimaea infection,racial,White,5,0,5
76835,Closed dislocation of elbow,racial,Unknown,0,5,5
81685,Fracture of clavicle due to birth trauma,ethnic,Not Hispanic or Latino,5,0,5
434279,Congenital syphilis,racial,White,0,5,5
435648,Testicular retraction,ethnic,Not Hispanic or Latino,0,5,5
4150614,Communication disorder,racial,Unknown,5,0,5
200169,Pruritus ani,racial,Other Race,0,5,5
436164,Corpus luteum cyst,racial,Unknown,5,0,5
438262,Chyluria,ethnic,Hispanic or Latino,5,0,5
30753,Esophagitis,racial,Asian,5,0,5
381308,Abscess of eyelid,racial,Native Hawaiian or Other Pacific Islander ,5,0,5
199065,Stricture of ureter,racial,White,0,5,5
434674,Atrophy of edentulous mandibular alveolar ridge,ethnic,Hispanic or Latino,5,0,5
376337,Disease of nervous system,racial,Unknown,2,2,4
26514,Laryngeal web,racial,Unknown,5,0,5
4162218,Vaginal enterocele,racial,Other Race,5,0,5
436804,Fetus OR newborn affected by premature rupture of membranes,ethnic,Hispanic or Latino,5,0,5
140842,Changes in skin texture,racial,American Indian or Alaska Native ,5,0,5
440750,Thrombophlebitis of deep veins of upper extremities,ethnic,Hispanic or Latino,5,0,5
379812,Exposure keratitis,ethnic,Hispanic or Latino,5,0,5
133570,Acute osteomyelitis of the pelvic region and/or thigh,ethnic,Hispanic or Latino,0,5,5
443421,Gallbladder and bile duct calculi,racial,Unknown,5,0,5
436741,Vulvodynia,racial,Other Race,5,0,5
140582,Superficial burn of foot,racial,White,0,5,5
81454,Injury of finger,racial,Asian,2,2,4
319927,Heart sounds abnormal,racial,Unknown,2,2,4
261393,Congenital polycystic lung,ethnic,Hispanic or Latino,5,0,5
76797,Congenital deformity of genital organ,ethnic,Not Hispanic or Latino,0,5,5
433025,Complication of vaccination,racial,White,0,5,5
4163865,Acute peptic ulcer without hemorrhage AND without perforation,ethnic,Hispanic or Latino,2,2,4
440380,"Combined drug dependence, excluding opioid, episodic",ethnic,Hispanic or Latino,5,0,5
4095302,Malignant tumour of cranial nerve,ethnic,Not Hispanic or Latino,0,5,5
4049623,"Moderate major depression, single episode",racial,Asian,5,0,5
138484,Thyroid dysfunction in the puerperium - baby delivered during previous episode of care,ethnic,Hispanic or Latino,5,0,5
437221,Chlamydia trachomatis infection,racial,Unknown,5,0,5
4100857,Pickwickian syndrome,racial,Alaska Native,0,5,5
440697,Nonaggressive unsocial conduct disorder,racial,Other Race,5,0,5
439346,"Motor vehicle traffic accident involving pedestrian run over by motor vehicle, occupant of tram injured",racial,Other Race,0,5,5
4117862,Chronic rheumatic mitral valve,racial,Native Hawaiian or Other Pacific Islander ,5,0,5
4097561,Burkitt lymphoma of lymph nodes of axilla and upper limb,racial,White,0,5,5
438733,Profound mental handicap,racial,Black or African American ,5,0,5
195588,Cystitis,racial,Other Race,2,2,4
256723,Pneumonia and influenza,racial,Asian,2,2,4
439037,Aneurysm of artery of neck,racial,Black or African American ,5,0,5
440972,Medulloadrenal hyperfunction,racial,White,0,5,5
373449,Drug-induced delirium,racial,White,2,2,4
200670,Benign tumour of male genital organs,ethnic,Hispanic or Latino,0,5,5
373182,Amyotrophic lateral sclerosis,ethnic,Not Hispanic or Latino,5,0,5
200765,Chronic cholecystitis,racial,American Indian or Alaska Native ,5,0,5
77354,Primary localised osteoarthrosis of lower leg,racial,Asian Indian,5,0,5
441401,Talipes valgus,racial,White,5,0,5
201121,Malformation of urachus,racial,White,0,5,5
133803,Periapical abscess with sinus tract,ethnic,Not Hispanic or Latino,5,0,5
432661,Stomatitis,racial,Other Race,0,5,5
137627,Prickly heat,racial,Black or African American ,5,0,5
4064918,Diabetes mellitus screening,racial,Alaska Native,5,0,5
436677,"Brief situational non-psychotic disorder, NOS",racial,Other Race,0,5,5
443350,Lower urinary tract symptoms,racial,Asian Indian,0,5,5
433257,Mesangiocapillary glomerulonephritis,racial,Asian,0,5,5
373769,Nuclear cataract,ethnic,Not Hispanic or Latino,5,0,5
4173657,Congenital malformation of the respiratory system,ethnic,Hispanic or Latino,2,2,4
79173,Closed dislocation of jaw,racial,Unknown,5,0,5
77702,Multiple closed fractures of pelvis with disruption of pelvic circle,racial,White,5,0,5
434012,Developmental dyslexia,ethnic,Hispanic or Latino,2,2,4
4160859,Methicillin resistant staphylococcus aureus carrier,racial,Black or African American ,2,2,4
435789,Megaloblastic anemia,ethnic,Not Hispanic or Latino,5,0,5
75044,"Stiff joint NEC, of the hand",racial,Other Race,0,5,5
444246,Cirrhosis of liver not due to alcohol,racial,Black or African American ,5,0,5
436855,Second degree burn of back of hand,racial,White,0,5,5
4109256,Other conjunctival disorders,racial,White,5,0,5
140489,Acquired acanthosis nigricans,racial,American Indian,5,0,5
80494,Arthropathy associated with another disorder,racial,White,2,2,4
198201,Chronic salpingo-oophoritis,racial,Asian,5,0,5
80295,Burn of toe,ethnic,Hispanic or Latino,5,0,5
195012,Metrorrhagia,racial,Asian,5,0,5
434630,Sleep rhythm problem,racial,Unknown,0,5,5
200616,Complication of transplanted liver,racial,White,5,0,5
194996,Postoperative urethral stricture,racial,White,5,0,5
4064905,Venereal disease screening,racial,American Indian,5,0,5
433514,Abnormal hard tissue formation in pulp,racial,Unknown,0,5,5
136025,Gp B streptococcal septicemia,racial,Unknown,5,0,5
4173811,Congenital quadriplegia,racial,Asian,0,5,5
435626,Tibial collateral ligament bursitis,racial,White,5,0,5
196625,Viral hepatitis A without hepatic coma,racial,Other Race,5,0,5
441202,Generalized anaphylaxis,racial,Black or African American ,0,5,5
193250,Gastric hemorrhage,ethnic,Not Hispanic or Latino,0,5,5
78633,Stokers' cramp,ethnic,Hispanic or Latino,2,2,4
193253,Nephritis,racial,Asian Indian,2,2,4
443360,Eye mass,racial,Black or African American ,5,0,5
440207,Hypoplastic left heart syndrome,ethnic,Not Hispanic or Latino,5,0,5
79740,Overlapping malignant neoplasm of colon,racial,White,5,0,5
321119,Coarctation of aorta,racial,Asian,5,0,5
4014296,Twins - both live born,racial,Unknown,5,0,5
432411,Acquired equinus foot deformity,racial,Unknown,0,5,5
140027,Herpetic gingivostomatitis,racial,Black or African American ,2,2,4
137792,Kaposi's varicelliform eruption,racial,Black or African American ,0,5,5
76498,Arthropathy associated with bacterial disease,ethnic,Hispanic or Latino,2,2,4
4282684,Impairment level: low vision of one eye,racial,Asian,5,0,5
80802,Secondary localized osteoarthrosis,ethnic,Hispanic or Latino,2,2,4
4297975,Manual rupture of ovarian cyst,racial,White,5,0,5
438156,Epiphora due to insufficient drainage,ethnic,Hispanic or Latino,0,5,5
434917,"Nondependent antidepressant type drug abuse, episodic",racial,Unknown,5,0,5
4102166,Multiparous,racial,Unknown,5,0,5
24974,Stenosis of larynx,ethnic,Hispanic or Latino,0,5,5
40479606,Septic embolus of lung,ethnic,Hispanic or Latino,5,0,5
141933,Alopecia areata,racial,Asian,2,2,4
440066,Disorder of purine and pyrimidine metabolism,racial,White,2,2,4
315078,Palpitations,racial,Filipino,5,0,5
433885,Closed supracondylar fracture of humerus,racial,Unknown,5,0,5
132724,Congenital anomaly of hair,ethnic,Hispanic or Latino,5,0,5
194418,Urethral caruncle,ethnic,Hispanic or Latino,5,0,5
433401,Coccidiosis,ethnic,Hispanic or Latino,2,2,4
4222138,Allergic contact dermatitis of eyelid,racial,Asian,5,0,5
72434,Congenital hydrocele,racial,Unknown,0,5,5
443462,Enteritis due to Candida,ethnic,Hispanic or Latino,5,0,5
4053600,Open wound of elbow,racial,White,0,5,5
317585,Aortic aneurysm,racial,Other Race,5,0,5
135852,Teething syndrome,racial,Black or African American ,0,5,5
433292,Inflammatory spondylopathy associated with another disease,ethnic,Hispanic or Latino,5,0,5
441947,Posttraumatic state,ethnic,Not Hispanic or Latino,0,5,5
438808,Mammary duct ectasia,ethnic,Hispanic or Latino,5,0,5
4141201,Beta lactam resistant bacterial infection,ethnic,Not Hispanic or Latino,5,0,5
136871,Burn any degree involving 20-29 percent of body surface,racial,White,5,0,5
193136,Acute gonococcal cervicitis,racial,Asian,5,0,5
375277,Non-infectious pinna disorders,racial,White,5,0,5
77070,Allergic arthritis of the hand,racial,Unknown,2,2,4
314423,"Benign essential hypertension complicating pregnancy, childbirth and the puerperium - not delivered",racial,Asian,5,0,5
30753,Esophagitis,racial,Black or African American ,0,5,5
375077,Sensory inattention,ethnic,Hispanic or Latino,5,0,5
439141,Abnormal increase in weight,racial,Native Hawaiian or Other Pacific Islander ,0,5,5
201619,Diverticulum of stomach,ethnic,Hispanic or Latino,0,5,5
441507,"Early latent syphilis, positive serology, negative cerebrospinal fluid, less than 2 years after infection",ethnic,Not Hispanic or Latino,0,5,5
437899,Acute and subacute bacterial endocarditis,racial,Asian,5,0,5
437088,Fetus OR newborn affected by oligohydramnios,racial,White,5,0,5
440380,"Combined drug dependence, excluding opioid, episodic",racial,White,5,0,5
375530,Migraine with prolonged aura,ethnic,Hispanic or Latino,5,0,5
76887,Disorders of urogenital prostheses or implants,racial,Asian,5,0,5
4181332,Malignant tumour of posterior third of tongue,racial,White,0,5,5
440828,Renal pelvis and ureter obstructive defects,racial,White,0,5,5
138826,Acne varioliformis,ethnic,Not Hispanic or Latino,2,2,4
440847,Neonatal jaundice associated with preterm delivery,racial,White,2,2,4
200773,Stenosis of rectum and anus,ethnic,Hispanic or Latino,0,5,5
432586,Mental disorder,racial,Asian,2,2,4
74505,Closed subtrochanteric fracture,racial,White,5,0,5
438699,Primary malignant neoplasm of rectosigmoid junction,racial,Unknown,0,5,5
437406,Closed traumatic dislocation of joint of wrist,ethnic,Hispanic or Latino,0,5,5
435648,Testicular retraction,racial,Other Race,0,5,5
439907,Spontaneous tendon rupture,racial,Unknown,2,2,4
444375,"Contact dermatitis due to plants, except food",racial,Filipino,0,5,5
200349,Malignant lymphoma of intra-abdominal lymph nodes,ethnic,Not Hispanic or Latino,5,0,5
40484010,Unilateral conductive hearing loss,ethnic,Not Hispanic or Latino,5,0,5
439654,Partial epilepsy with impairment of consciousness,racial,Other Race,5,0,5
442862,"Abrasion or friction burn of hand, without mention of infection",racial,Other Race,0,5,5
316457,Mallory-Weiss syndrome,ethnic,Hispanic or Latino,0,5,5
197506,Malignant tumor of abdomen,racial,Other Race,5,0,5
441334,Glossodynia,racial,Asian,0,5,5
437995,Closed ill-defined fractures of upper limb,racial,Black or African American ,0,5,5
254980,Intrinsic asthma with asthma attack,racial,Filipino,0,5,5
4057923,Burn involving less than 10% of body surface NOS,ethnic,Hispanic or Latino,5,0,5
381857,Impairment level: one eye: total impairment: other eye: not specified,racial,Black or African American ,2,2,4
200164,Urine-induced contact dermatitis,racial,American Indian or Alaska Native ,2,2,4
436588,Traumatic wound dehiscence,racial,White,5,0,5
441246,Hemangioma of intracranial structure,racial,Black or African American ,5,0,5
135930,Musculoskeletal system observation,racial,Black or African American ,5,0,5
4016960,Concussion NOS,ethnic,Hispanic or Latino,5,0,5
4177966,Kaposi's sarcoma,ethnic,Not Hispanic or Latino,0,5,5
441680,Fetus OR newborn affected by multiple pregnancy,racial,Asian,5,0,5
4104555,Other and unspecified conjunctivitis,racial,Unknown,5,0,5
72712,Synovial cyst,ethnic,Not Hispanic or Latino,0,5,5
138525,Pain in limb,racial,Asian Indian,5,0,5
320536,Abnormal EKG finding,racial,Filipino,5,0,5
441321,Chronic nasopharyngitis,ethnic,Not Hispanic or Latino,2,2,4
31317,Can't get food down,racial,Native Hawaiian or Other Pacific Islander ,2,2,4
73065,"Contusion, genital organs",ethnic,Not Hispanic or Latino,0,5,5
200174,Disease of skin AND/OR subcutaneous tissue,racial,Alaska Native,0,5,5
440432,Accretion on teeth,racial,White,0,5,5
80471,Disorder of lactation,ethnic,Hispanic or Latino,5,0,5
313219,Phlebitis and thrombophlebitis,racial,Black or African American ,2,2,4
436785,Spinal stenosis in cervical region,racial,Other Race,2,2,4
439166,Closed fracture of radius,racial,Asian,0,5,5
4185302,Chronic myocardial ischemia,racial,Asian,0,5,5
435928,Abnormal decrease in weight,racial,Filipino,2,2,4
194403,Obstructed diaphragmatic hernia,racial,Black or African American ,5,0,5
375264,Impairment level: one eye: near-total impairment: other eye: normal vision,racial,White,0,5,5
438477,Atrophy of testis,ethnic,Not Hispanic or Latino,0,5,5
435887,Antepartum deep phlebothrombosis,racial,White,2,2,4
201779,Tuberculosis of adrenal glands,racial,White,2,2,4
435651,Atypical squamous cells on cervical Papanicolaou smear cannot exclude high grade squamous intraepithelial lesion,racial,Other Race,5,0,5
81175,Contusion of chest,racial,Black or African American ,2,2,4
4305303,Sleep deprivation,racial,Asian,5,0,5
374221,Injury of brachial plexus,racial,Black or African American ,0,5,5
256896,Tuberculosis of bronchus,ethnic,Hispanic or Latino,5,0,5
381304,Impulsive acoustic trauma,racial,White,0,5,5
442619,Fracture of humerus,ethnic,Hispanic or Latino,2,2,4
316857,Brachial blood vessel injury,ethnic,Hispanic or Latino,0,5,5
28109,Carcinoma in situ of esophagus,racial,White,2,2,4
80883,Nonvenomous insect bite of elbow with infection,racial,White,2,2,4
4175028,Irritant gastritis,ethnic,Not Hispanic or Latino,5,0,5
443585,Abrasion AND/OR friction burn of multiple sites,racial,Asian,2,2,4
4230642,Acquired deformity of chest,racial,Asian,5,0,5
444453,Benign tumour of soft tissue of leg,racial,Unknown,2,2,4
4103641,Amputated at ankle,racial,Unknown,0,5,5
440755,"Acute duodenal ulcer without hemorrhage, without perforation AND without obstruction",racial,White,0,5,5
435226,"Bipolar affective disorder, current episode mixed",racial,Other Race,5,0,5
439262,"Single manic episode, severe, with psychosis",ethnic,Not Hispanic or Latino,5,0,5
4110499,Allergic rhinitis NOS,racial,Asian,2,2,4
380733,Otalgia,racial,Native Hawaiian or Other Pacific Islander ,2,2,4
79889,Unstable lie - delivered,ethnic,Hispanic or Latino,5,0,5
78237,Bicipital tenosynovitis,racial,Asian,5,0,5
440548,Closed fracture of lower end of femur,racial,Unknown,2,2,4
197417,Injury of ureter with open wound into abdominal cavity,ethnic,Not Hispanic or Latino,5,0,5
75066,Nonallopathic lesion of cervical region,racial,Unknown,0,5,5
437896,Disorder of language,racial,Black or African American ,5,0,5
198571,Cardiogenic shock,ethnic,Hispanic or Latino,0,5,5
196158,Disease of penis,racial,Asian,0,5,5
75385,"Closed fracture distal humerus, lateral epicondyle",racial,Unknown,5,0,5
254443,Sicca syndrome,racial,Filipino,5,0,5
132736,Bacteremia,racial,Native Hawaiian or Other Pacific Islander ,0,5,5
437120,Closed dislocation of foot,racial,White,0,5,5
320299,Complication of transplanted heart,racial,White,0,5,5
436682,Moderate mental handicap,racial,Filipino,0,5,5
81942,Enthesopathy of ankle AND/OR tarsus,racial,Filipino,5,0,5
4144149,Cared for by family,racial,Unknown,0,5,5
195867,Noninflammatory vaginal disorders,racial,American Indian or Alaska Native ,5,0,5
139210,Superficial burn of back,racial,Unknown,5,0,5
78581,Sprain of sacroiliac ligament,racial,White,5,0,5
4016358,Staphylococcus carrier,ethnic,Not Hispanic or Latino,0,5,5
440039,Specific viral infections,racial,Unknown,5,0,5
435839,Lymphatic oedema,racial,Black or African American ,2,2,4
435839,Lymphatic oedema,racial,Other Race,5,0,5
440035,European cryptococcosis,racial,Black or African American ,0,5,5
374375,Impacted cerumen,racial,Asian Indian,0,5,5
433881,Additional general conditions of patient,racial,Alaska Native,5,0,5
132575,Myeloid sarcoma in remission,racial,White,0,5,5
193493,Benign hypertensive renal disease,racial,Black or African American ,0,5,5
319844,Acute ischemic heart disease,racial,White,2,2,4
77965,Nodular tendinous disease of finger,racial,American Indian or Alaska Native ,2,2,4
4194895,Screening for disorder,racial,American Indian or Alaska Native ,5,0,5
195861,Small kidney,racial,Unknown,5,0,5
437489,Herpes zoster with complication,ethnic,Not Hispanic or Latino,0,5,5
4052804,FH: Allergy,ethnic,Hispanic or Latino,5,0,5
137379,Musculoskeletal symptom,racial,Native Hawaiian or Other Pacific Islander ,0,5,5
4252915,Hydrorhachis,ethnic,Hispanic or Latino,5,0,5
133726,Carcinoma in situ of skin of face,ethnic,Not Hispanic or Latino,2,2,4
441207,Drug reaction,racial,Asian Indian,5,0,5
196464,Rapidly progressive glomerulonephritis,ethnic,Hispanic or Latino,2,2,4
193020,Incomplete emptying of bladder,racial,Asian,5,0,5
73008,Enthesopathy,racial,Native Hawaiian or Other Pacific Islander ,2,2,4
438725,Disorder of magnesium metabolism,racial,Black or African American ,0,5,5
433030,False-positive serological test for syphilis,ethnic,Not Hispanic or Latino,0,5,5
439922,"Gestation period, 24 weeks",ethnic,Hispanic or Latino,5,0,5
438531,Chondromalacia,racial,Unknown,2,2,4
4088372,Herpes zoster with other specified complication,racial,Unknown,0,5,5
198860,Congenital anomaly of lower alimentary tract,ethnic,Not Hispanic or Latino,5,0,5
261738,Multiple burns of head and neck,ethnic,Not Hispanic or Latino,0,5,5
438129,"Severe manic bipolar I disorder with psychotic features, mood-congruent",ethnic,Hispanic or Latino,0,5,5
200338,Nodular lymphoma of intra-abdominal lymph nodes,racial,Unknown,5,0,5
194992,Coeliac disease,racial,Unknown,2,2,4
378413,Partial recent retinal detachment with multiple defects,racial,White,5,0,5
437478,Bite of nonvenomous arthropod,racial,American Indian or Alaska Native ,5,0,5
442119,Adhesions of temporomandibular joint,ethnic,Not Hispanic or Latino,5,0,5
376901,"Acute paralytic poliomyelitis, bulbar",racial,White,5,0,5
432296,Coagulation factor deficiency syndrome,racial,Unknown,0,5,5
374024,Reaction to spinal or lumbar puncture,racial,White,5,0,5
196431,Hypersensitivity angiitis,racial,Filipino,5,0,5
443237,"Manic disorder, single episode",racial,American Indian or Alaska Native ,5,0,5
441848,Cranial nerve disorder,racial,White,2,2,4
433768,Glaucoma with increased episcleral venous pressure,racial,White,5,0,5
433644,Shellfish allergy,ethnic,Not Hispanic or Latino,0,5,5
316135,AVB - Atrioventricular block,racial,Black or African American ,5,0,5
435381,Closed fracture of base of thumb,ethnic,Not Hispanic or Latino,2,2,4
433759,Developmental reading disorder,ethnic,Hispanic or Latino,5,0,5
80523,Congenital fusion of spine,ethnic,Not Hispanic or Latino,5,0,5
195223,Renal carnitine transport defect,ethnic,Hispanic or Latino,5,0,5
74136,Muscle calcification and ossification,ethnic,Hispanic or Latino,0,5,5
139036,Systolic dysfunction,ethnic,Not Hispanic or Latino,5,0,5
4273095,Acute tracheitis without obstruction,racial,Asian,5,0,5
133013,Congenital spinal cord anomaly,racial,Other Race,0,5,5
433987,Benign tumour of orbit,racial,White,5,0,5
433410,Primary syphilis,racial,White,0,5,5
440431,Pneumonia due to Mycoplasma pneumoniae,racial,Black or African American ,5,0,5
379006,Cerebral degeneration in childhood,racial,Unknown,0,5,5
441655,Disorder of sweat gland,ethnic,Not Hispanic or Latino,2,2,4
439871,Haemospermia,racial,Unknown,0,5,5
4268980,Finding of general development,racial,Other Race,5,0,5
4012590,Fracture of one or more phalanges of foot NOS,racial,White,5,0,5
381308,Abscess of eyelid,racial,Asian,0,5,5
4030872,Hyperemesis of pregnancy,racial,Unknown,5,0,5
437046,Complete abortion,racial,Other Race,5,0,5
81064,Pseudopolyposis of colon,racial,Unknown,5,0,5
4014230,Ankle sprain NOS,racial,Asian,5,0,5
4145823,Inadequate housing,ethnic,Hispanic or Latino,0,5,5
437394,Closed fracture of lower end of forearm,racial,Asian,5,0,5
133088,Late amputation stump complication,racial,Unknown,2,2,4
4284118,Fall on escalator,racial,Unknown,0,5,5
4016352,Tuberculosis contact,racial,Black or African American ,2,2,4
4147635,Unspecified otorrhea,racial,Unknown,0,5,5
80571,Open wound of foot with complication,racial,Other Race,0,5,5
441283,Recurrent iridocyclitis,ethnic,Hispanic or Latino,0,5,5
133570,Acute osteomyelitis of the pelvic region and/or thigh,racial,Other Race,0,5,5
438767,Posterior staphyloma,racial,Unknown,0,5,5
436480,Dystrophy of vulva,ethnic,Hispanic or Latino,5,0,5
432287,Immunodeficiency with IgM hypergammaglobulinaemia,ethnic,Not Hispanic or Latino,2,2,4
4139420,Foreign body in auditory canal,racial,Filipino,0,5,5
377868,Corneal pannus,ethnic,Hispanic or Latino,0,5,5
439264,Acute suppurative otitis media,racial,White,5,0,5
381562,"Impairment level: better eye: moderate impairment: lesser eye: blind, not further specified",racial,Other Race,5,0,5
136779,Disease of forearm,racial,Unknown,5,0,5
436043,Malignant overlapping lesion of tongue,racial,White,0,5,5
27674,N&V - Nausea and vomiting,racial,American Indian,5,0,5
440309,Adverse reaction to diphtheria vaccine,ethnic,Hispanic or Latino,2,2,4
198683,Viral hepatitis B without hepatic coma,racial,Unknown,2,2,4
375251,Retinopathy of prematurity stage 2 - intraretinal ridge,racial,White,5,0,5
435510,Hypocalcemia,racial,Black or African American ,0,5,5
81064,Pseudopolyposis of colon,racial,Other Race,0,5,5
140490,Anhidrosis,racial,Asian,0,5,5
137443,Mechanical complication due to skin graft failure AND/OR rejection,racial,White,0,5,5
78233,Old disruption of medial collateral ligament,ethnic,Not Hispanic or Latino,5,0,5
442766,Malignant hypertensive renal disease,ethnic,Hispanic or Latino,5,0,5
4101199,Hearing problem,racial,Filipino,0,5,5
443239,Precerebral arterial occlusion,racial,White,5,0,5
373202,Corneal ulcer,racial,White,5,0,5
256142,Dental arch relationship anomaly,ethnic,Hispanic or Latino,2,2,4
76503,Joint contracture of shoulder,racial,White,5,0,5
136368,Non-toxic multinodular goiter,racial,Black or African American ,5,0,5
372849,Overlapping malignant neoplasm of brain and other parts of the central nervous system,racial,Unknown,5,0,5
4057923,Burn involving less than 10% of body surface NOS,racial,White,5,0,5
434793,Subdural hemorrhage following injury without open intracranial wound,ethnic,Hispanic or Latino,5,0,5
136916,Primary malignant neoplasm of skin of external auditory canal,ethnic,Not Hispanic or Latino,5,0,5
443767,Diabetic oculopathy,racial,Native Hawaiian or Other Pacific Islander ,5,0,5
377559,Vernal conjunctivitis,ethnic,Not Hispanic or Latino,2,2,4
138455,Stomatitis,racial,Asian,2,2,4
438648,Vitamin poisoning,racial,White,5,0,5
433612,Closed fracture of upper end of fibula,racial,White,5,0,5
438407,BN - Bulimia nervosa,racial,Native Hawaiian or Other Pacific Islander ,5,0,5
4016353,Meningococcus contact,racial,White,5,0,5
4139420,Foreign body in auditory canal,racial,Other Race,5,0,5
26942,Hemoglobin SS disease with crisis,racial,White,0,5,5
381416,Brain injury without open intracranial wound AND with prolonged loss of consciousness (more than 24 hours) without return to pre-existing conscious level,racial,White,0,5,5
437394,Closed fracture of lower end of forearm,racial,Black or African American ,0,5,5
72465,Closed fracture of one or more phalanges of hand,racial,Other Race,2,2,4
192673,Vascular insufficiency of intestine,ethnic,Not Hispanic or Latino,5,0,5
4145821,Symptom of head and neck region,racial,White,2,2,4
4036945,Consciousness disturbance NOS,racial,Unknown,0,5,5
31967,Nausea,racial,American Indian or Alaska Native ,5,0,5
436222,Altered mental status,racial,Native Hawaiian or Other Pacific Islander ,2,2,4
436166,Mild hyperemesis gravidarum,racial,Asian,5,0,5
441192,Accidentally struck by or against objects or persons,racial,Other Race,0,5,5
192731,Digestive symptom,racial,Black or African American ,0,5,5
440330,Rochalimaea infection,ethnic,Hispanic or Latino,5,0,5
195603,Vulval and/or perineal noninflammatory disorders,racial,American Indian,5,0,5
4112366,Nasal polyp NOS,racial,White,5,0,5
201909,Female infertility,racial,Middle Eastern or North African,5,0,5
432962,Leukoplakia of cervix,ethnic,Hispanic or Latino,5,0,5
136282,"Burn erythema of single finger, not thumb",ethnic,Hispanic or Latino,2,2,4
4059611,Other disorders of bladder,racial,White,2,2,4
313007,MR - Congenital mitral regurgitation,ethnic,Hispanic or Latino,0,5,5
432878,Drug abuse using speed,racial,Asian,0,5,5
76227,Leg oedema,racial,White,5,0,5
372634,Nonphysiologic vision loss,racial,American Indian or Alaska Native ,5,0,5
140357,Neoplasm of uncertain behaviour of endocrine gland,racial,White,5,0,5
30683,Hemoglobin SS disease without crisis,racial,Black or African American ,2,2,4
197913,Disorder of function of stomach,racial,Asian Indian,0,5,5
74725,Displacement of cervical intervertebral disc without myelopathy,racial,Filipino,5,0,5
80184,Arthropathy due to parasitic infection,ethnic,Not Hispanic or Latino,5,0,5
4112366,Nasal polyp NOS,ethnic,Not Hispanic or Latino,5,0,5
434030,Glaucoma with lens disorder,racial,White,0,5,5
4064906,Bacterial conjunctivitis screening,ethnic,Hispanic or Latino,0,5,5
4160859,Methicillin resistant staphylococcus aureus carrier,racial,Other Race,5,0,5
4272867,General well-being finding,racial,American Indian or Alaska Native ,2,2,4
197033,Endometriosis of pelvic peritoneum,ethnic,Not Hispanic or Latino,5,0,5
437470,Adverse reaction to benzodiazepine-based tranquilliser,ethnic,Not Hispanic or Latino,0,5,5
312437,Dyspnea,racial,Asian Indian,0,5,5
75668,Sprain of sacroiliac region,racial,White,5,0,5
373784,Acute allergic serous otitis media,racial,Other Race,5,0,5
4093460,Leptospirosis NOS,racial,Unknown,2,2,4
4188027,Food allergy,racial,Filipino,0,5,5
201531,"Diabetes mellitus, juvenile type, with hyperosmolar coma",ethnic,Not Hispanic or Latino,0,5,5
432612,Mild mental handicap,racial,Asian,2,2,4
4101431,Disorder of calcium metabolism NOS,ethnic,Hispanic or Latino,2,2,4
4088777,Vagina observation,racial,Asian,5,0,5
4025663,Obstructed inguinal hernia,racial,Unknown,0,5,5
72786,Burn of finger,ethnic,Not Hispanic or Latino,5,0,5
432306,Gender identity disorder of adolescence,racial,Black or African American ,5,0,5
193240,Acute generalized peritonitis,ethnic,Hispanic or Latino,5,0,5
200449,Hepatitis in viral diseases EC,racial,Unknown,5,0,5
132706,Nail disease,racial,Asian,5,0,5
376120,"Keratoconjunctivitis sicca, not specified as Sjogren's",racial,Asian,5,0,5
138539,Shprintzen-Goldberg syndrome,ethnic,Not Hispanic or Latino,0,5,5
372613,Flaccid hemiplegia,racial,Asian,0,5,5
435516,Lipoprotein deficiency disorder,racial,American Indian or Alaska Native ,5,0,5
380111,Acute atopic conjunctivitis,racial,Black or African American ,5,0,5
4109249,Other corneal disorders,racial,White,5,0,5
4239721,Seafood allergy,racial,Other Race,2,2,4
444253,Blister of scalp without infection,racial,Unknown,5,0,5
373189,Encephalomyelitis,ethnic,Not Hispanic or Latino,2,2,4
77066,Derangement of medial meniscus,racial,Asian,0,5,5
4224000,Transposition of pterygium,racial,Unknown,5,0,5
441269,Autoimmune hemolytic anemia,racial,Alaska Native,5,0,5
192259,Ascariasis,ethnic,Hispanic or Latino,2,2,4
4062998,Infantile paralytic paralysis,racial,White,5,0,5
440098,Rubeosis iridis,racial,Unknown,2,2,4
196163,Cervicitis and endocervicitis,racial,Native Hawaiian or Other Pacific Islander ,5,0,5
435262,Primary open angle glaucoma,racial,Native Hawaiian or Other Pacific Islander ,5,0,5
193863,Congenital abnormality of lower limb AND/OR pelvic girdle,racial,White,0,5,5
442770,Disorder of ciliary body,ethnic,Hispanic or Latino,5,0,5
78025,Superficial injury of hand with infection,racial,Unknown,0,5,5
438392,Disorder of hyperalimentation,racial,White,0,5,5
199991,Complication of transplanted kidney,ethnic,Not Hispanic or Latino,5,0,5
433167,Lipoma of intrathoracic organs,racial,White,0,5,5
433246,"Chronic duodenal ulcer without hemorrhage, without perforation AND without obstruction",ethnic,Hispanic or Latino,5,0,5
434094,Spontaneous abortion with complication,racial,Unknown,5,0,5
24818,Neck injury,racial,American Indian,5,0,5
4141622,Asthma NOS,racial,Filipino,0,5,5
439262,"Single manic episode, severe, with psychosis",racial,Unknown,0,5,5
74211,Superficial injury of finger without infection,ethnic,Not Hispanic or Latino,5,0,5
4112525,Acute bronchiolitis NOS,racial,Black or African American ,5,0,5
4117862,Chronic rheumatic mitral valve,ethnic,Not Hispanic or Latino,5,0,5
315276,Vitreous hemorrhage,racial,Other Race,5,0,5
26662,Testicular hypofunction,racial,American Indian or Alaska Native ,0,5,5
199881,Endometriosis of ovary,racial,White,5,0,5
440129,Hypertrophy of nasal turbinates,racial,Black or African American ,2,2,4
436587,"Toxic effect of gas, fumes AND/OR vapors",ethnic,Not Hispanic or Latino,5,0,5
432746,"Open fracture of radius and ulna, shaft",ethnic,Hispanic or Latino,0,5,5
80522,Congenital deformity of clavicle,ethnic,Hispanic or Latino,2,2,4
4104581,Esotropia with accommodative compensation,racial,White,5,0,5
437184,"Poisoning of undetermined intent by corrosive, acid or caustic alkali",ethnic,Hispanic or Latino,5,0,5
199718,Enteritis due to rotavirus,racial,White,0,5,5
4181328,CA - Cancer of adrenal gland,racial,White,5,0,5
40482247,Organic sleep apnea,ethnic,Not Hispanic or Latino,2,2,4
193323,Neonatal diabetes mellitus,ethnic,Hispanic or Latino,5,0,5
28974,Candidiasis of oesophagus,racial,Black or African American ,0,5,5
433862,Congenital anomaly of tongue,racial,White,5,0,5
374655,Mastoiditis,ethnic,Not Hispanic or Latino,2,2,4
378414,Separation of retinal layers,racial,Asian,2,2,4
434689,Incomplete abortion,racial,Black or African American ,5,0,5
434502,Closed fracture of phalanx of toe,racial,American Indian or Alaska Native ,0,5,5
313989,Chronic lymphadenitis,racial,Unknown,0,5,5
376691,Delimited old retinal detachment,ethnic,Not Hispanic or Latino,0,5,5
133861,CL - Cleft lip,racial,White,5,0,5
4097561,Burkitt lymphoma of lymph nodes of axilla and upper limb,ethnic,Hispanic or Latino,0,5,5
4152813,Family disruption,racial,Black or African American ,5,0,5
432803,[X]Fall on and from ladder,racial,Black or African American ,0,5,5
440230,Closed fracture of anatomical neck of humerus,racial,White,2,2,4
141323,Acute maxillary sinusitis,racial,Other Race,2,2,4
4285417,Incision of pituitary gland,racial,White,2,2,4
435774,Disorder of amino acid metabolism,racial,White,0,5,5
198263,Right upper quadrant pain,racial,American Indian,5,0,5
75897,Polyarthropathy,racial,American Indian or Alaska Native ,5,0,5
137016,Retained dental root,racial,Unknown,5,0,5
76161,Impotence of organic origin,racial,Native Hawaiian or Other Pacific Islander ,0,5,5
193825,"Congenital abnormality of uterus complicating antenatal care, baby not yet delivered",ethnic,Hispanic or Latino,5,0,5
4303805,Allergic reaction to bite and/or sting,racial,Asian,5,0,5
4060318,Chest pain NOS,racial,Unknown,0,5,5
194265,Cryptosporidiasis,ethnic,Hispanic or Latino,0,5,5
4186238,Louse infestation,racial,American Indian or Alaska Native ,5,0,5
138713,Disease of parathyroid glands,racial,Unknown,5,0,5
81713,Carpal joint sprain,ethnic,Not Hispanic or Latino,0,5,5
4310085,Accidental poisoning by other drugs acting on central and autonomic nervous system,ethnic,Hispanic or Latino,0,5,5
439937,C-reactive protein abnormal,racial,Filipino,5,0,5
437038,Blood in urine,racial,Native Hawaiian or Other Pacific Islander ,5,0,5
313221,Rheumatic aortic stenosis,racial,White,5,0,5
434462,VSD - Ventricular septal defect,racial,Other Race,2,2,4
439002,Eating disorder,racial,Other Race,0,5,5
435023,Mild hyperemesis-not delivered,racial,Asian,5,0,5
439840,Inflammation of lymphatics,racial,White,5,0,5
318775,Venous embolism,racial,Black or African American ,5,0,5
375278,Acquired stenosis of external ear canal secondary to inflammation,ethnic,Not Hispanic or Latino,0,5,5
434541,Effects of heat,ethnic,Hispanic or Latino,5,0,5
76255,Sprain of iliofemoral ligament,ethnic,Hispanic or Latino,5,0,5
433881,Additional general conditions of patient,racial,Black or African American ,5,0,5
200784,Placental condition affecting management of mother,racial,White,5,0,5
193530,Follicular cyst of ovary,racial,Asian,5,0,5
4148412,Family history: Genitourinary disease,ethnic,Hispanic or Latino,5,0,5
77819,Benign tumour of pleura,ethnic,Hispanic or Latino,5,0,5
442901,"Motor vehicle traffic accident involving collision with another motor vehicle, stopped, occupant of tram injured",racial,White,5,0,5
77373,Congenital deformity of hip joint,racial,Black or African American ,0,5,5
196724,Disease of diaphragm,racial,Unknown,0,5,5
432800,Assault by cutting and stabbing instruments,ethnic,Hispanic or Latino,0,5,5
75010,Fibroadenosis of breast,racial,Asian,5,0,5
201901,Abscess of liver,racial,Unknown,0,5,5
435875,"Complications of pregnancy, childbirth and the puerperium",racial,Asian,5,0,5
439776,Pervasive developmental disorder,ethnic,Hispanic or Latino,0,5,5
72748,Strain of rotator cuff of shoulder,racial,American Indian or Alaska Native ,5,0,5
4196362,Genetic counselling,racial,Black or African American ,5,0,5
443603,Adverse reaction to antidiabetic drug,racial,Unknown,5,0,5
441171,Second degree burn of chest wall,racial,White,0,5,5
313780,Mobitz type 2 second degree atrioventricular block,ethnic,Not Hispanic or Latino,0,5,5
438580,Closed fracture of C5-C7 level with spinal cord injury,ethnic,Hispanic or Latino,5,0,5
193070,Blister of trunk with infection,racial,Unknown,5,0,5
4194396,Haemoglobinopathy screening test,racial,White,2,2,4
139882,Endometriosis in scar of skin,racial,Unknown,5,0,5
4149560,Hand sprain unspecified,ethnic,Not Hispanic or Latino,5,0,5
74582,Primary malignant neoplasm of rectum,racial,Unknown,5,0,5
201075,Noninflammatory disorder of cervix,ethnic,Not Hispanic or Latino,5,0,5
376102,Partial recent retinal detachment with single defect,racial,Unknown,0,5,5
81424,Closed dislocation of knee,ethnic,Hispanic or Latino,2,2,4
4061073,Male infertility NOS,ethnic,Hispanic or Latino,0,5,5
77734,Contusion of lower leg,racial,Native Hawaiian or Other Pacific Islander ,0,5,5
438410,[X]Psychogenic dysuria,racial,White,5,0,5
443257,Swellings and lumps,racial,American Indian or Alaska Native ,0,5,5
440638,Lyme disease,ethnic,Not Hispanic or Latino,5,0,5
199891,RI - Rhesus isoimmunisation,racial,White,5,0,5
134736,Backache,racial,Alaska Native,5,0,5
378741,Brachial plexus lesion,racial,Unknown,2,2,4
201129,Newborn swallowing maternal blood causing hematemesis or melena,ethnic,Not Hispanic or Latino,0,5,5
317109,Respiratory arrest,ethnic,Hispanic or Latino,5,0,5
260759,Malocclusion of teeth,racial,Unknown,5,0,5
444434,Schizophreniform disorder,ethnic,Not Hispanic or Latino,5,0,5
443587,Diastolic heart failure,racial,Filipino,0,5,5
4269719,Finding of growth of fungi,racial,Black or African American ,0,5,5
23164,Disease of anterior pituitary,racial,White,5,0,5
132659,Acute apical periodontitis,racial,Native Hawaiian or Other Pacific Islander ,2,2,4
197596,Toxic gastroenteritis,ethnic,Hispanic or Latino,0,5,5
372627,Transient visual loss,ethnic,Hispanic or Latino,5,0,5
81169,Superficial foreign body of finger without major open wound AND without infection,ethnic,Not Hispanic or Latino,5,0,5
28461,Hypertrophy of salivary gland,ethnic,Not Hispanic or Latino,0,5,5
4143350,Other deficiency anaemias,racial,Unknown,2,2,4
375552,Pterygium,racial,American Indian or Alaska Native ,5,0,5
135852,Teething syndrome,racial,Filipino,0,5,5
4143966,Essential hypertension NOS,racial,White,5,0,5
132853,Lymphatic leukaemia,ethnic,Hispanic or Latino,0,5,5
437233,Plasmacytic myeloma,racial,Other Race,0,5,5
379778,Multi-infarct dementia,ethnic,Hispanic or Latino,0,5,5
375738,Neurosyphilis,ethnic,Hispanic or Latino,0,5,5
4024848,Chronic peptic ulcer without mention of complication,ethnic,Hispanic or Latino,5,0,5
73373,Burn erythema of upper limb,ethnic,Not Hispanic or Latino,2,2,4
4232618,Gelastic seizure,ethnic,Hispanic or Latino,5,0,5
378424,Astigmatism,racial,Asian,2,2,4
140172,Erythematosquamous dermatosis,racial,White,5,0,5
4323155,Limited consultation,ethnic,Hispanic or Latino,2,2,4
318459,Respiratory insufficiency,ethnic,Not Hispanic or Latino,0,5,5
375274,Monocular exotropia,ethnic,Hispanic or Latino,5,0,5
377280,Corneal disorder,ethnic,Not Hispanic or Latino,5,0,5
4105181,Socialised childhood truancy,ethnic,Hispanic or Latino,0,5,5
433760,Dysreflexia,racial,Black or African American ,0,5,5
4243827,Drug addiction counseling,ethnic,Not Hispanic or Latino,2,2,4
134324,Lipodystrophy,racial,Black or African American ,0,5,5
313006,Congenital stenosis of mitral valve,racial,White,0,5,5
437428,Crushing injury - disorder,racial,White,2,2,4
438871,Drug withdrawal syndrome in newborn,ethnic,Not Hispanic or Latino,2,2,4
433015,Congenital anomaly of aortic arch,racial,Black or African American ,5,0,5
258453,Acute upper respiratory infection of multiple sites,racial,Other Race,5,0,5
435101,Open fracture of foot,racial,White,2,2,4
437557,Eczematous dermatitis of eyelid,racial,Black or African American ,5,0,5
4302543,Insertion of prosthesis or prosthetic device of femoral head,racial,Black or African American ,0,5,5
316447,Chronic hypotension,racial,Asian,0,5,5
139888,Threatened premature labor - not delivered,racial,Other Race,5,0,5
31609,Abscess of salivary gland,racial,White,5,0,5
377802,Late effects of poliomyelitis,racial,Asian,0,5,5
376555,Open wound of ear drum without complication,racial,Unknown,2,2,4
4159157,Disorder of tooth development,ethnic,Hispanic or Latino,5,0,5
73301,Synovitis/tenosynovitis - wrist,racial,Other Race,5,0,5
437202,Giardiasis,ethnic,Not Hispanic or Latino,0,5,5
196151,Functional disorder of intestine,racial,Black or African American ,0,5,5
436635,Primary malignant neoplasm of sigmoid colon,racial,White,0,5,5
320073,Neutrophil count below reference range,racial,Black or African American ,5,0,5
194087,Hepatitis due to infection,ethnic,Hispanic or Latino,0,5,5
436392,Carotid sinus syncope,racial,White,5,0,5
314457,Congenital stenosis of aortic valve,ethnic,Hispanic or Latino,5,0,5
316857,Brachial blood vessel injury,racial,White,0,5,5
380120,Strabismus in neuromuscular disorder,racial,Unknown,2,2,4
196431,Hypersensitivity angiitis,racial,Unknown,5,0,5
4307254,Closed fracture,racial,Filipino,5,0,5
4175331,Congenital haemolytic anaemia,ethnic,Hispanic or Latino,5,0,5
441512,Infection by Onchocerca volvulus,ethnic,Hispanic or Latino,5,0,5
77234,Benign tumour of colon,racial,Filipino,5,0,5
442558,"Gestation period, 32 weeks",racial,Asian,0,5,5
444112,Integumentary system finding,racial,American Indian or Alaska Native ,2,2,4
441868,Optic disc oedema,ethnic,Not Hispanic or Latino,5,0,5
439141,Abnormal increase in weight,racial,American Indian,5,0,5
443674,Traumatic amputation of toe(s) with complication,racial,Unknown,0,5,5
316822,Finding of heart murmur,racial,Asian Indian,0,5,5
199837,Deep vein thrombosis of portal vein,racial,White,0,5,5
134757,Ectodermal dysplasia,ethnic,Hispanic or Latino,0,5,5
256571,FB - Nasal foreign body,racial,Black or African American ,0,5,5
316139,HF - Heart failure,racial,American Indian,5,0,5
444445,Benign neoplasm of skin of leg,racial,Filipino,5,0,5
81379,Lateral epicondylitis,racial,American Indian,5,0,5
314054,Aortic valve disease,racial,American Indian,0,5,5
30683,Hemoglobin SS disease without crisis,ethnic,Not Hispanic or Latino,2,2,4
73840,Primary localised osteoarthrosis of shoulder region,racial,American Indian or Alaska Native ,5,0,5
378757,Hypotrichosis of eyelid,ethnic,Hispanic or Latino,2,2,4
196236,Septicaemic shock,racial,Unknown,2,2,4
197807,Primary malignant neoplasm of soft tissues of abdomen,racial,White,5,0,5
4103574,Chronic depression,racial,American Indian,5,0,5
378427,Tear film insufficiency,racial,Filipino,5,0,5
433633,Late effect of superficial injury,racial,White,5,0,5
440432,Accretion on teeth,ethnic,Hispanic or Latino,2,2,4
135032,Dermatitis due to substances taken internally,ethnic,Not Hispanic or Latino,2,2,4
441039,Phlebitis of lower limb vein,racial,Other Race,5,0,5
4036945,Consciousness disturbance NOS,ethnic,Not Hispanic or Latino,5,0,5
441225,Primary malignant neoplasm of ampulla of Vater,racial,White,0,5,5
380818,Acquired deformity of head,ethnic,Not Hispanic or Latino,5,0,5
201399,Congenital anomaly of adrenal gland,ethnic,Hispanic or Latino,0,5,5
141651,Stevens-Johnson syndrome,ethnic,Not Hispanic or Latino,5,0,5
378419,AD - Alzheimer's disease,racial,Filipino,5,0,5
432456,Finding of alcohol intake,ethnic,Hispanic or Latino,0,5,5
433862,Congenital anomaly of tongue,ethnic,Not Hispanic or Latino,2,2,4
192259,Ascariasis,racial,White,0,5,5
4269584,Finding relating to religious movement or belief,ethnic,Not Hispanic or Latino,5,0,5
437116,Closed fracture of distal end of radius,racial,Asian,0,5,5
380669,Benign neoplasm of eyelid including canthus,ethnic,Not Hispanic or Latino,2,2,4
4299535,Pregnancy confirmed,racial,Filipino,5,0,5
439060,Atrophy of tongue papillae,racial,White,0,5,5
75343,Contracture of hip joint,ethnic,Hispanic or Latino,5,0,5
320206,Congenital atresia of pulmonary valve,ethnic,Not Hispanic or Latino,0,5,5
443585,Abrasion AND/OR friction burn of multiple sites,racial,American Indian or Alaska Native ,5,0,5
435649,Complication of hemodialysis,ethnic,Not Hispanic or Latino,0,5,5
4110505,Chest infection - other bacterial pneumonia,ethnic,Hispanic or Latino,5,0,5
200527,Splenomegaly,racial,Other Race,5,0,5
40422016,Suicide and selfinflicted injury by jumping or lying before moving object,ethnic,Hispanic or Latino,5,0,5
75043,Hemarthrosis of knee,racial,White,0,5,5
4109260,Other eyelid disorders,racial,White,2,2,4
434298,Metastasis to upper limb lymph node,ethnic,Not Hispanic or Latino,5,0,5
437247,Anaemia of chronic disease,racial,American Indian,5,0,5
379032,Acute mastoiditis with complications,ethnic,Not Hispanic or Latino,0,5,5
438555,Cyanosis,racial,Unknown,5,0,5
199066,Female digestive-genital tract fistula,racial,Unknown,5,0,5
76545,Closed traumatic dislocation of patella,racial,Unknown,5,0,5
193312,Congenital anomaly of ureter,racial,White,2,2,4
440600,Assault by bite of human being,ethnic,Hispanic or Latino,2,2,4
375525,Athetoid cerebral palsy,ethnic,Not Hispanic or Latino,5,0,5
434207,"Insect bite, nonvenomous, of hand, without mention of infection",racial,Other Race,2,2,4
433092,Burn of multiple sites of wrist AND/OR hand,racial,White,5,0,5
377126,Concussion with brief loss of consciousness,ethnic,Hispanic or Latino,0,5,5
439183,Concussion,racial,Native Hawaiian or Other Pacific Islander ,0,5,5
252942,Asthmatic pulmonary eosinophilia,ethnic,Not Hispanic or Latino,0,5,5
444375,"Contact dermatitis due to plants, except food",racial,Other Race,2,2,4
321052,Peripheral vascular disease,racial,American Indian or Alaska Native ,5,0,5
22274,Neoplasm of uncertain behaviour of larynx,racial,Unknown,5,0,5
440979,Acquired hemolytic anemia,racial,Asian,5,0,5
435119,Sequela of injury,ethnic,Hispanic or Latino,2,2,4
377535,Sleep walking disorder,racial,Unknown,0,5,5
72618,Disorder of muscle,racial,Black or African American ,0,5,5
443610,Prolapse of uterine cervical stump,racial,White,5,0,5
75351,Adolescent postural kyphosis,ethnic,Not Hispanic or Latino,5,0,5
373404,Ophthalmic herpes simplex,racial,White,2,2,4
135030,Discoloration of skin,racial,Asian,5,0,5
442827,Fetus with central nervous system malformation with antenatal problem,ethnic,Hispanic or Latino,5,0,5
442444,"Motor vehicle traffic accident involving pedestrian hit by motor vehicle, pedestrian injured",racial,Asian,5,0,5
316998,Left bundle branch block,racial,Asian Indian,0,5,5
132466,Lumbar sprain,racial,American Indian,2,2,4
377283,Conjunctival injection,ethnic,Hispanic or Latino,2,2,4
81088,Failed lactation,racial,White,0,5,5
4089984,Congenital syphilis NOS,racial,White,2,2,4
138994,MDS - Myelodysplastic syndrome,racial,Asian,5,0,5
140490,Anhidrosis,ethnic,Not Hispanic or Latino,0,5,5
432451,Abnormal results of function studies of central nervous system,racial,White,5,0,5
437986,FTT - Failure to thrive,racial,Asian Indian,0,5,5
435521,Psychophysiologic disorder,racial,Black or African American ,2,2,4
194491,Tenderness of epigastrium,ethnic,Not Hispanic or Latino,2,2,4
4084229,Primary gout,racial,Filipino,2,2,4
373775,Psychophysical visual disturbance,racial,Other Race,5,0,5
439154,Abnormal findings on diagnostic imaging of skull and head,racial,Black or African American ,0,5,5
380395,Retinal dystrophy,racial,White,5,0,5
76002,Mechanical complication due to breast prosthesis,ethnic,Not Hispanic or Latino,5,0,5
40481920,Periumbilical pain,racial,American Indian or Alaska Native ,5,0,5
4024567,Respiratory observation,racial,American Indian or Alaska Native ,5,0,5
435799,Adjustment disorder with disturbance of conduct,ethnic,Hispanic or Latino,0,5,5
4196935,Unilateral repair of inguinal hernia with prosthesis or graft,racial,White,0,5,5
436086,Manic bipolar I disorder in full remission,ethnic,Not Hispanic or Latino,0,5,5
433933,Plants - toxic effect,ethnic,Hispanic or Latino,2,2,4
77653,Traumatic myositis ossificans,ethnic,Not Hispanic or Latino,0,5,5
437222,Respiratory syncytial virus infection,racial,Unknown,0,5,5
432310,Meningitis due to cryptococcus,ethnic,Not Hispanic or Latino,0,5,5
4169641,Developmental handicap screening,racial,Black or African American ,2,2,4
4171115,Low birth weight infant,racial,American Indian or Alaska Native ,0,5,5
256716,Asthma with status asthmaticus,racial,Asian,5,0,5
141475,Second degree burn of foot,ethnic,Not Hispanic or Latino,2,2,4
73904,Open wound of buttock without complication,racial,Unknown,2,2,4
4060985,BMI 30+ - obesity,racial,Alaska Native,5,0,5
4053045,Dog bite,racial,Asian,5,0,5
380415,Acute swimmer's ear,racial,Asian Indian,5,0,5
4147414,Varicose veins of legs in pregnancy,racial,Unknown,5,0,5
257581,Exacerbation of asthma,racial,Asian Indian,0,5,5
4148076,Chronic neurogenic ulcer of lower limb,ethnic,Hispanic or Latino,5,0,5
434657,Weakness of face muscles,ethnic,Not Hispanic or Latino,2,2,4
133655,Burn of forearm,ethnic,Not Hispanic or Latino,5,0,5
319054,Thrombophlebitis of upper extremities,ethnic,Not Hispanic or Latino,5,0,5
4104860,Infantile spasms NOS,ethnic,Hispanic or Latino,0,5,5
443913,Congenital anomaly of trachea,racial,Black or African American ,0,5,5
4071485,Foetus or neonate affected by caesarean section,ethnic,Not Hispanic or Latino,5,0,5
78097,Metastatic tumour of bone,racial,Black or African American ,5,0,5
197500,Primary malignant neoplasm of colon,racial,American Indian or Alaska Native ,5,0,5
78473,Solitary cyst of breast,racial,Black or African American ,5,0,5
75043,Hemarthrosis of knee,ethnic,Hispanic or Latino,0,5,5
201341,Incisional hernia with obstruction but no gangrene,racial,Unknown,5,0,5
434502,Closed fracture of phalanx of toe,racial,Asian,5,0,5
194831,Gastric foreign body,ethnic,Hispanic or Latino,0,5,5
4062637,TB - Tuberculosis screening,racial,Alaska Native,5,0,5
134398,Periodontal disease,racial,Black or African American ,0,5,5
376657,Lipoma of face,ethnic,Not Hispanic or Latino,2,2,4
434145,Embryonal nuclear cataract,racial,Unknown,5,0,5
444437,Congenital abnormality of cervix,racial,Unknown,5,0,5
436640,Primary malignant neoplasm of long bone of lower limb,racial,White,0,5,5
24818,Neck injury,racial,Black or African American ,0,5,5
432739,Red blood cell disorder,racial,Black or African American ,0,5,5
196341,Dermatophytosis of the perianal area,racial,Filipino,0,5,5
442766,Malignant hypertensive renal disease,racial,Unknown,5,0,5
441192,Accidentally struck by or against objects or persons,ethnic,Not Hispanic or Latino,5,0,5
192385,"Tumour of uterine body complicating antenatal care, baby not yet delivered",ethnic,Hispanic or Latino,5,0,5
433288,Derangement of anterior horn of lateral meniscus,racial,Unknown,5,0,5
379020,Entropion,racial,Asian,5,0,5
142026,Disorder of cardiovascular prostheses and implants,ethnic,Not Hispanic or Latino,5,0,5
315830,Variant angina,racial,Other Race,0,5,5
4164792,Hemophilus influenzae laryngitis,ethnic,Not Hispanic or Latino,2,2,4
201347,Pelvic pain syndrome,racial,Unknown,5,0,5
200483,Disease of pelvis,racial,Asian,0,5,5
432968,Anemia during pregnancy - baby delivered,racial,Unknown,5,0,5
193807,Anorectal fistula,racial,Asian,0,5,5
443545,Nonvenomous insect bite,racial,Native Hawaiian or Other Pacific Islander ,2,2,4
439987,"Accident caused by hot liquid and vapor, including steam",ethnic,Hispanic or Latino,2,2,4
440543,Fracture of tibia,racial,White,2,2,4
79091,Unstable lie,ethnic,Not Hispanic or Latino,5,0,5
40353121,"Accidental cut, puncture, perforation or haemorrhage during medical care",racial,White,2,2,4
373962,Tabes dorsalis - neurosyphilis,racial,White,2,2,4
438390,Benign tumour of vulva,racial,Asian,5,0,5
255302,Spontaneous pneumothorax,ethnic,Hispanic or Latino,0,5,5
4113650,Noninflammatory cervical disorder,racial,Unknown,5,0,5
381592,Chronic mucoid otitis media,racial,Asian,5,0,5
142016,Nonvenomous insect bite of finger with infection,racial,White,5,0,5
75905,Pathological dislocation of upper arm,racial,White,0,5,5
4061073,Male infertility NOS,racial,White,0,5,5
313543,Venous complication in pregnancy AND/OR the puerperium,racial,Unknown,5,0,5
4301700,Acute mastoiditis,ethnic,Hispanic or Latino,5,0,5
4195473,Temporary tracheostomy,racial,Unknown,0,5,5
437969,Acquired pes planus,racial,Other Race,2,2,4
377085,Congenital anomaly of brain,racial,Unknown,0,5,5
4017388,Closed dislocation lumbar spine,ethnic,Not Hispanic or Latino,5,0,5
436666,Psychosexual disorder,ethnic,Not Hispanic or Latino,0,5,5
199726,Granuloma inguinale,ethnic,Hispanic or Latino,5,0,5
373054,Open wound of auricle of ear without complication,racial,White,2,2,4
376961,Disturbance of consciousness,racial,Black or African American ,2,2,4
4240103,Operation for bone injury on phalanges of foot,racial,Unknown,2,2,4
444084,Extrinsic allergic alveolitis,racial,White,2,2,4
440058,Malignant lymphoma of extranodal AND/OR solid organ site,racial,White,2,2,4
434319,Premature orgasm - male,ethnic,Not Hispanic or Latino,0,5,5
136871,Burn any degree involving 20-29 percent of body surface,ethnic,Not Hispanic or Latino,5,0,5
196813,Simple renal cyst,ethnic,Not Hispanic or Latino,5,0,5
78073,Urogenital infection by Trichomonas vaginalis,racial,White,2,2,4
199879,Fistula of the female genital organs,ethnic,Not Hispanic or Latino,5,0,5
81636,Excessive foetal growth affecting management of mother,racial,White,5,0,5
4165091,Lack of exercise,racial,American Indian,5,0,5
30679,Benign tumour major salivary gland,ethnic,Not Hispanic or Latino,5,0,5
443375,Vitamin products adverse reaction,ethnic,Hispanic or Latino,5,0,5
4096666,Diabetes mellitus with hyperosmolar coma,ethnic,Not Hispanic or Latino,0,5,5
4062641,Malaria screening,racial,White,0,5,5
318800,GERD - Gastro-esophageal reflux disease,racial,Alaska Native,2,2,4
4319325,Acquired deformity of trunk,racial,Black or African American ,5,0,5
138913,Second degree burn of two OR more fingers including thumb,racial,Black or African American ,0,5,5
193240,Acute generalized peritonitis,racial,White,5,0,5
4112816,Other respiratory system diseases,racial,Asian,5,0,5
435522,Hypervitaminosis D,racial,Asian,2,2,4
444434,Schizophreniform disorder,racial,White,5,0,5
192679,Renal disease in pregnancy AND/OR puerperium without hypertension,racial,White,5,0,5
78619,"Contusion, knee",racial,American Indian or Alaska Native ,5,0,5
74396,TMJ - Temporomandibular joint disorder,racial,Black or African American ,2,2,4
4198960,Amputated above elbow,ethnic,Hispanic or Latino,5,0,5
434012,Developmental dyslexia,racial,White,2,2,4
317898,Malignant essential hypertension,racial,American Indian or Alaska Native ,5,0,5
4107375,Somatoform pain disorder,ethnic,Not Hispanic or Latino,5,0,5
78524,Acquired deformity of finger,racial,Black or African American ,5,0,5
441678,"Gestation period, 33 weeks",racial,Other Race,5,0,5
141650,Actinic porokeratosis,racial,White,5,0,5
4013526,ESR raised,ethnic,Not Hispanic or Latino,5,0,5
4340380,Hepatitis C carrier,racial,American Indian or Alaska Native ,0,5,5
440535,Abnormal radiographic examination,racial,Unknown,2,2,4
79917,Acquired deformity of toe,racial,American Indian or Alaska Native ,5,0,5
4182210,Dementia,racial,American Indian or Alaska Native ,5,0,5
437657,Simple syndactyly of toes,ethnic,Hispanic or Latino,2,2,4
4016675,"Sprain, ankle joint, medial",racial,Other Race,0,5,5
192691,Diabetes mellitus during pregnancy - baby not yet delivered,racial,Unknown,5,0,5
440694,"Nondependent mixed drug abuse, episodic",racial,Black or African American ,2,2,4
140190,Disorder of back,racial,Asian,0,5,5
436027,Coxsackie virus disease,racial,Other Race,2,2,4
195501,Polycystic ovaries,racial,Middle Eastern or North African,5,0,5
432335,Subclavian artery aneurysm,racial,Unknown,5,0,5
441274,Developmental expressive language disorder,racial,Other Race,0,5,5
138644,Burn erythema of lower limb,ethnic,Not Hispanic or Latino,2,2,4
81336,Rectal prolapse,racial,Asian,0,5,5
433823,"Infections of pregnancy, childbirth and the puerperium",racial,White,5,0,5
4061706,"Disorder of lactation NOS, unspecified",ethnic,Hispanic or Latino,5,0,5
438460,Edentulous alveolar ridge atrophy,ethnic,Not Hispanic or Latino,2,2,4
436826,Closed fracture of shaft of radius,ethnic,Not Hispanic or Latino,0,5,5
4239301,Unwanted pregnancy,racial,Black or African American ,5,0,5
4062921,Asymptomatic bacteriuria in pregnancy unspecified,ethnic,Hispanic or Latino,5,0,5
134074,Oral soft tissue cellulitis,racial,Other Race,5,0,5
443909,"Decreased level, laboratory test",racial,Unknown,5,0,5
4143350,Other deficiency anaemias,racial,White,5,0,5
4117862,Chronic rheumatic mitral valve,ethnic,Hispanic or Latino,5,0,5
31821,Endocrinopathy,racial,Unknown,5,0,5
135892,Erythematous condition,racial,Asian,2,2,4
141650,Actinic porokeratosis,ethnic,Hispanic or Latino,5,0,5
441401,Talipes valgus,ethnic,Hispanic or Latino,5,0,5
81250,Carcinoma in situ of breast,racial,Unknown,5,0,5
4051702,FH: Congenital anomaly,ethnic,Hispanic or Latino,5,0,5
4145823,Inadequate housing,racial,White,0,5,5
442306,Adjustment disorder with depressed mood,racial,Asian,0,5,5
441540,Reactive confusion,ethnic,Hispanic or Latino,2,2,4
4059611,Other disorders of bladder,ethnic,Hispanic or Latino,2,2,4
4094865,Ca intrahepatic bile ducts,racial,Black or African American ,5,0,5
73889,Sprain of distal tibiofibular ligament,ethnic,Hispanic or Latino,5,0,5
197795,Acute hepatitis B,racial,Black or African American ,2,2,4
4337542,Unilateral adrenalectomy,ethnic,Hispanic or Latino,5,0,5
434119,Hidradenitis,racial,Native Hawaiian or Other Pacific Islander ,5,0,5
435227,Nutritional deficiency,racial,Black or African American ,2,2,4
76304,Burn of upper arm,racial,White,5,0,5
254662,Pulmonary infarction,racial,American Indian or Alaska Native ,5,0,5
192496,Unilateral traumatic amputation of leg below knee with complication,racial,White,0,5,5
437382,Urine observation,racial,American Indian or Alaska Native ,5,0,5
443582,Disorder of joint of hand,racial,White,2,2,4
436466,Balanoposthitis,racial,American Indian or Alaska Native ,0,5,5
438250,Congenital talipes varus,ethnic,Not Hispanic or Latino,2,2,4
194408,Hydroureter,racial,White,2,2,4
373474,Seeing double,racial,Other Race,0,5,5
4119298,Late onset asthma,racial,White,5,0,5
438576,Open fracture of ulna,ethnic,Hispanic or Latino,5,0,5
376267,Superficial injury of conjunctiva,racial,Unknown,0,5,5
442598,Fracture of radius AND ulna,ethnic,Not Hispanic or Latino,2,2,4
377680,Facial nerve injury as birth trauma,racial,White,0,5,5
201603,Disease of teeth AND/OR supporting structures,racial,Filipino,5,0,5
193422,Primary malignant neoplasm of body of stomach,racial,Asian,0,5,5
436171,"Syphilis in mother complicating pregnancy, childbirth AND/OR puerperium",racial,White,5,0,5
139110,Intervertebral disc disorder of thoracic region with myelopathy,racial,White,0,5,5
4085075,At risk state,ethnic,Not Hispanic or Latino,2,2,4
316226,Complete TGA,racial,White,5,0,5
438990,Benign neuroendocrine tumor,ethnic,Not Hispanic or Latino,5,0,5
74505,Closed subtrochanteric fracture,ethnic,Hispanic or Latino,5,0,5
76611,Injury of shoulder region,racial,Other Race,5,0,5
193070,Blister of trunk with infection,ethnic,Hispanic or Latino,5,0,5
377545,Episodic tension-type headache,racial,Unknown,5,0,5
441786,Infection due to Bordetella parapertussis,ethnic,Hispanic or Latino,5,0,5
4145796,Family history: Musculoskeletal disease,ethnic,Hispanic or Latino,5,0,5
375539,Haemophthalmos without current injury,ethnic,Hispanic or Latino,5,0,5
435131,Victim of neglect,ethnic,Not Hispanic or Latino,0,5,5
197330,Finding of urethral sphincter function,ethnic,Not Hispanic or Latino,5,0,5
436155,Redundant prepuce and phimosis,racial,Native Hawaiian or Other Pacific Islander ,0,5,5
434183,"Closed fracture distal humerus, medial epicondyle",ethnic,Hispanic or Latino,2,2,4
317002,Hypopiesis,racial,Native Hawaiian or Other Pacific Islander ,2,2,4
440755,"Acute duodenal ulcer without hemorrhage, without perforation AND without obstruction",ethnic,Hispanic or Latino,0,5,5
4001516,Endocervical biopsy,racial,White,5,0,5
4237140,Abnormal sexual function,ethnic,Not Hispanic or Latino,0,5,5
432941,Disease of tongue,racial,American Indian or Alaska Native ,5,0,5
443263,Obstetric breast abscess,racial,White,5,0,5
4016960,Concussion NOS,racial,White,5,0,5
4265479,Acute duodenal ulcer with perforation,racial,White,0,5,5
26942,Hemoglobin SS disease with crisis,ethnic,Not Hispanic or Latino,0,5,5
443773,Damage to pelvic joints AND/OR ligaments during delivery,ethnic,Hispanic or Latino,5,0,5
444272,Contact dermatitis due to drugs AND/OR medicine,ethnic,Not Hispanic or Latino,5,0,5
440325,Rubella without complication,racial,White,5,0,5
140259,Open wound of face without complication,racial,Black or African American ,0,5,5
193807,Anorectal fistula,racial,Black or African American ,0,5,5
254591,Secondary malignant tumour of lung,racial,Other Race,0,5,5
24974,Stenosis of larynx,racial,White,0,5,5
200483,Disease of pelvis,racial,Black or African American ,5,0,5
433911,Contusion of eye AND ocular adnexa,racial,Asian,2,2,4
440653,Infection by toxoplasma gondii,ethnic,Not Hispanic or Latino,2,2,4
75911,Acquired hallux valgus,racial,Native Hawaiian or Other Pacific Islander ,5,0,5
438959,Amoebiasis,racial,Other Race,5,0,5
197494,Viral hepatitis C,racial,American Indian,5,0,5
437671,Abnormal feces,racial,Other Race,5,0,5
4200655,Urostomy present,ethnic,Hispanic or Latino,2,2,4
438808,Mammary duct ectasia,racial,White,5,0,5
74396,TMJ - Temporomandibular joint disorder,racial,Asian,5,0,5
135611,Furuncle of hand,ethnic,Not Hispanic or Latino,2,2,4
375415,Injury of head region,racial,Filipino,2,2,4
312437,Dyspnea,racial,Filipino,0,5,5
440696,Cyclothymia,racial,White,2,2,4
440388,[X]Developmental co - ordination disorder,racial,Unknown,0,5,5
374364,Disorder of middle ear,ethnic,Hispanic or Latino,0,5,5
374049,Acute mucoid otitis media,racial,Asian,0,5,5
78834,Effusion of joint of hand,ethnic,Not Hispanic or Latino,0,5,5
434207,"Insect bite, nonvenomous, of hand, without mention of infection",ethnic,Not Hispanic or Latino,2,2,4
374914,Quadriplegia,racial,Black or African American ,0,5,5
4104388,"Better eye: moderate visual impairment, Lesser eye: near total visual impairment",racial,White,0,5,5
75413,Burn of wrist,ethnic,Hispanic or Latino,2,2,4
4070287,Preauricular sinus and fistula,racial,Other Race,0,5,5
4102738,Screening for mental disorders,ethnic,Not Hispanic or Latino,2,2,4
4004778,Other and unspecified congenital anomalies,racial,White,0,5,5
4053045,Dog bite,racial,American Indian,5,0,5
4326601,Anorectal abscess,racial,Other Race,0,5,5
137548,Cervical root lesion,racial,Filipino,0,5,5
80493,Ankylosis of joint,ethnic,Hispanic or Latino,5,0,5
441488,Adverse reaction to substance,ethnic,Not Hispanic or Latino,0,5,5
77069,Old posterior cruciate ligament disruption,ethnic,Hispanic or Latino,0,5,5
440676,Neoplasm of uncertain behaviour of brain and spinal cord,racial,Unknown,5,0,5
442584,Carbuncle of buttock,racial,Asian,5,0,5
442013,Burn,racial,American Indian or Alaska Native ,0,5,5
196464,Rapidly progressive glomerulonephritis,racial,White,2,2,4
4103726,Subjective visual disturbance NOS,ethnic,Hispanic or Latino,5,0,5
438392,Disorder of hyperalimentation,ethnic,Not Hispanic or Latino,0,5,5
79145,Ehlers-Danlos syndrome,ethnic,Not Hispanic or Latino,0,5,5
442124,Orbital edema,ethnic,Hispanic or Latino,5,0,5
442110,Benign neoplasm of nasal sinus,racial,White,2,2,4
199866,Acute gastritis,racial,Native Hawaiian or Other Pacific Islander ,2,2,4
137991,Sick-euthyroid syndrome,racial,White,5,0,5
432870,Thrombocytopenia,racial,Native Hawaiian or Other Pacific Islander ,5,0,5
440083,Acute stress disorder,racial,American Indian or Alaska Native ,5,0,5
435726,Mechanical complication of device,racial,White,2,2,4
4154623,Fit denture,ethnic,Not Hispanic or Latino,5,0,5
135349,Compartment syndrome of upper limb,ethnic,Hispanic or Latino,5,0,5
79898,Cellulitis and abscess of finger,racial,American Indian or Alaska Native ,0,5,5
437474,Postoperative infection,racial,Black or African American ,5,0,5
443274,Psychostimulant dependence,ethnic,Not Hispanic or Latino,2,2,4
439799,Leg cramps,racial,Black or African American ,2,2,4
437241,Qualitative platelet defect,racial,Other Race,2,2,4
198216,Retroverted incarcerated gravid uterus - delivered,racial,Unknown,5,0,5
141216,MC - Molluscum contagiosum,racial,Native Hawaiian or Other Pacific Islander ,0,5,5
444239,Postprocedural state finding,racial,Filipino,0,5,5
76255,Sprain of iliofemoral ligament,ethnic,Not Hispanic or Latino,0,5,5
4114314,Screening for osteoporosis,racial,Native Hawaiian or Other Pacific Islander ,5,0,5
4196935,Unilateral repair of inguinal hernia with prosthesis or graft,ethnic,Hispanic or Latino,0,5,5
197603,Volvulus,ethnic,Hispanic or Latino,5,0,5
321590,Right bundle branch block AND left posterior fascicular block,racial,White,0,5,5
374044,Droopy eyelid,racial,Other Race,2,2,4
375827,Acute non-suppurative otitis media - serous,racial,Native Hawaiian or Other Pacific Islander ,5,0,5
134569,Erythema infectiosum,racial,Unknown,2,2,4
437316,Fissural cyst of jaw,racial,White,5,0,5
4269719,Finding of growth of fungi,racial,White,2,2,4
380941,Herpetic meningoencephalitis,racial,White,5,0,5
316139,HF - Heart failure,racial,Black or African American ,0,5,5
195977,Contusion of trunk,racial,Asian,5,0,5
433644,Shellfish allergy,ethnic,Hispanic or Latino,5,0,5
192964,Renal infection,racial,Unknown,5,0,5
435299,Failure of dental prosthesis,racial,Unknown,5,0,5
433451,Aggressive unsocial conduct disorder,racial,Unknown,5,0,5
439981,Wound dehiscence,ethnic,Not Hispanic or Latino,2,2,4
433540,Polyhydramnios with antenatal problem,ethnic,Not Hispanic or Latino,2,2,4
317576,Coronary arteriosclerosis,racial,European,0,5,5
439846,LVF - Left ventricular failure,racial,Black or African American ,0,5,5
4104561,Ptosis of eyelid NOS,racial,Asian,5,0,5
442441,Grand multiparity with antenatal problem,ethnic,Not Hispanic or Latino,5,0,5
433577,Hammer toe,racial,Black or African American ,0,5,5
4095302,Malignant tumour of cranial nerve,racial,White,0,5,5
443610,Prolapse of uterine cervical stump,racial,Unknown,5,0,5
139179,Open wound of lip without complication,racial,Black or African American ,0,5,5
376683,Non proliferative diabetic retinopathy,racial,Native Hawaiian or Other Pacific Islander ,5,0,5
442306,Adjustment disorder with depressed mood,racial,Black or African American ,2,2,4
200843,Observation of frequency of urination,racial,Native Hawaiian or Other Pacific Islander ,2,2,4
4062555,"Unspecified hypertension complicating pregnancy, childbirth and the puerperium NOS",racial,White,0,5,5
4174977,Diabetic retinopathy,racial,Filipino,0,5,5
436730,"Appendicitis, unqualified",racial,Other Race,5,0,5
321596,Peripheral venous insufficiency,racial,Filipino,5,0,5
4059157,Family circumstance NOS,racial,Black or African American ,0,5,5
444384,Nonvenomous insect bite of leg with infection,racial,White,2,2,4
317003,Compression of vein,ethnic,Hispanic or Latino,5,0,5
4196206,beta^+^ Thalassemia,ethnic,Not Hispanic or Latino,5,0,5
443372,Lipid-lowering drug adverse reaction,ethnic,Hispanic or Latino,2,2,4
444246,Cirrhosis of liver not due to alcohol,racial,Native Hawaiian or Other Pacific Islander ,0,5,5
432719,Panniculitis,ethnic,Not Hispanic or Latino,2,2,4
132575,Myeloid sarcoma in remission,ethnic,Hispanic or Latino,0,5,5
74127,Elbow joint contracture,racial,White,0,5,5
320752,Influenza with non-respiratory manifestation,racial,Filipino,0,5,5
436081,Immunosecretory disorder,ethnic,Hispanic or Latino,5,0,5
201313,Hypertensive renal disease,racial,Black or African American ,0,5,5
372605,Spinal muscular atrophy,ethnic,Not Hispanic or Latino,0,5,5
81496,Tuberculosis of vertebral column,racial,White,0,5,5
137371,Neonatal septicaemia,racial,White,5,0,5
374027,Lesion of ulnar nerve,racial,Asian,0,5,5
195079,Functional urinary incontinence,racial,Asian,0,5,5
74719,Foot ulcer,racial,American Indian or Alaska Native ,5,0,5
141090,PG - Pyogenic granuloma,racial,Asian,2,2,4
201958,Perinatal dermatological disorders,racial,Unknown,2,2,4
440438,Anodontia,racial,Other Race,2,2,4
373035,Closed fracture of malar AND/OR maxillary bones,ethnic,Hispanic or Latino,2,2,4
72407,Shoulder joint effusion,ethnic,Hispanic or Latino,5,0,5
72786,Burn of finger,racial,Unknown,2,2,4
79165,Closed Monteggia fracture,racial,Unknown,5,0,5
373139,Syphilitic parkinsonism,ethnic,Hispanic or Latino,0,5,5
253788,Nasal polyp,racial,Asian,0,5,5
435570,Pulp and periapical tissue disease,racial,White,2,2,4
194519,Open wound of vagina without complication,ethnic,Hispanic or Latino,5,0,5
440979,Acquired hemolytic anemia,ethnic,Not Hispanic or Latino,5,0,5
433741,Hereditary pure erythrocytosis,ethnic,Hispanic or Latino,2,2,4
200792,Retained placenta with no haemorrhage with postnatal problem,ethnic,Hispanic or Latino,5,0,5
194997,Prostatitis,racial,Asian,0,5,5
436701,Drusen of optic disc,ethnic,Hispanic or Latino,5,0,5
437175,"Fall on same level from slipping, tripping or stumbling",racial,American Indian or Alaska Native ,5,0,5
374139,Buphthalmos,racial,White,2,2,4
197724,Unilateral traumatic amputation of foot without complication,ethnic,Not Hispanic or Latino,0,5,5
199074,Acute pancreatitis,racial,Other Race,0,5,5
317003,Compression of vein,racial,White,5,0,5
434019,"Nondependent cannabis abuse, continuous",racial,Unknown,5,0,5
4148407,Family history: Cardiovascular disease,racial,Asian,0,5,5
315078,Palpitations,racial,Native Hawaiian or Other Pacific Islander ,2,2,4
374957,Acquired stenosis of external ear canal,ethnic,Not Hispanic or Latino,0,5,5
439228,Adverse reaction to sulphonamides,racial,Unknown,0,5,5
375291,Bullous myringitis,ethnic,Not Hispanic or Latino,5,0,5
4100912,Screening for rheumatoid conditions,racial,Other Race,5,0,5
78786,Pleurisy,racial,Other Race,5,0,5
141934,Degenerative skin disorder,racial,White,2,2,4
438261,Neonatal jaundice due to delayed conjugation associated with another disease,racial,Other Race,0,5,5
72434,Congenital hydrocele,racial,White,0,5,5
4016358,Staphylococcus carrier,ethnic,Hispanic or Latino,5,0,5
201061,Diaphragmatic hernia,racial,Native Hawaiian or Other Pacific Islander ,2,2,4
439014,Panuveitis,ethnic,Not Hispanic or Latino,5,0,5
24970,Chronic laryngitis,racial,Asian,2,2,4
441407,Appetite loss - anorexia,racial,American Indian or Alaska Native ,2,2,4
4233605,Cervical spinal cord injury without spinal bone injury,ethnic,Not Hispanic or Latino,5,0,5
378523,Residual foreign body in soft tissue,racial,Asian,0,5,5
197717,Open wound of anterior abdominal wall without complication,racial,Black or African American ,0,5,5
76611,Injury of shoulder region,racial,Black or African American ,2,2,4
440694,"Nondependent mixed drug abuse, episodic",racial,American Indian or Alaska Native ,0,5,5
378256,Abnormal reflex,racial,Unknown,2,2,4
440453,Incomplete legal abortion with delayed or excessive haemorrhage,racial,White,5,0,5
381574,External auditory canal exostosis,racial,White,0,5,5
4081756,Radiotherapy follow-up,racial,White,5,0,5
201350,Placental abruption - not delivered,ethnic,Not Hispanic or Latino,0,5,5
4310085,Accidental poisoning by other drugs acting on central and autonomic nervous system,racial,Unknown,0,5,5
132321,Ichthyosis of eyelid,racial,Unknown,0,5,5
4124299,Incision and evacuation of thrombosed hemorrhoid,racial,White,5,0,5
378256,Abnormal reflex,ethnic,Not Hispanic or Latino,2,2,4
376425,Chronic non-suppurative otitis media,racial,Unknown,0,5,5
379769,Benign brain tumour,racial,American Indian or Alaska Native ,0,5,5
200680,Tumour of urinary bladder,racial,Unknown,5,0,5
373205,Hemorrhage of eyelid,racial,White,0,5,5
194755,Abdominal tenderness of left lower quadrant,racial,White,2,2,4
74809,Crushing injury of hand,racial,White,5,0,5
440387,Cannabis dependence,racial,Unknown,0,5,5
373775,Psychophysical visual disturbance,racial,Black or African American ,0,5,5
439219,Poisoning due to venomous spider,ethnic,Not Hispanic or Latino,0,5,5
136580,Dehiscence of surgical wound,racial,Unknown,2,2,4
372318,Chronic follicular conjunctivitis,racial,Unknown,2,2,4
440543,Fracture of tibia,racial,Asian,5,0,5
200757,Abscess of peritoneum,racial,Unknown,5,0,5
315296,Preinfarction syndrome,racial,Black or African American ,0,5,5
73855,Arrest of bone development AND/OR growth,racial,White,0,5,5
440638,Lyme disease,ethnic,Hispanic or Latino,2,2,4
4064929,Genitourinary disease screening,racial,White,0,5,5
443772,Superficial injury of scalp with infection,racial,White,5,0,5
433885,Closed supracondylar fracture of humerus,racial,Black or African American ,2,2,4
440953,Cysticercosis,racial,Other Race,5,0,5
139753,Primary malignant neoplasm of parathyroid gland,racial,White,0,5,5
433131,Mumps without complication,racial,White,2,2,4
4305187,Control of epistaxis by packing of posterior and anterior nose,racial,White,2,2,4
201617,Prostatic cyst,ethnic,Not Hispanic or Latino,0,5,5
440084,Aphemesthaesia,racial,Black or African American ,0,5,5
434303,Benign neoplasm of rectum and anal canal,racial,Black or African American ,0,5,5
443428,Torus fracture of radius,ethnic,Not Hispanic or Latino,2,2,4
196162,Uterine inflammatory disease,racial,White,5,0,5
378726,Alcoholic dementia,racial,Black or African American ,0,5,5
201531,"Diabetes mellitus, juvenile type, with hyperosmolar coma",racial,White,0,5,5
444382,Thoracic radiculitis,racial,American Indian or Alaska Native ,2,2,4
442597,Meteorism,racial,American Indian or Alaska Native ,5,0,5
80914,Second degree burn of two OR more fingers not including thumb,ethnic,Hispanic or Latino,0,5,5
440069,Drug dependence,racial,American Indian or Alaska Native ,0,5,5
252942,Asthmatic pulmonary eosinophilia,racial,White,0,5,5
4181332,Malignant tumour of posterior third of tongue,ethnic,Hispanic or Latino,0,5,5
432417,Acquired hallux malleus,racial,Unknown,5,0,5
80593,Urinary complication,ethnic,Not Hispanic or Latino,2,2,4
444108,Finding related to sleep,racial,White,5,0,5
4154309,Severe recurrent major depression with psychotic features,racial,Filipino,5,0,5
4100857,Pickwickian syndrome,racial,American Indian,0,5,5
441922,Transient hypertension of pregnancy,racial,White,5,0,5
137063,Corns and callus,racial,Native Hawaiian or Other Pacific Islander ,0,5,5
138790,Chronic periodontitis,ethnic,Not Hispanic or Latino,5,0,5
73241,Anal and rectal polyp,racial,Other Race,0,5,5
442714,"Splinter of finger, without major open wound, infected",ethnic,Hispanic or Latino,5,0,5
377546,Chronic post-traumatic headache,racial,Unknown,5,0,5
435903,Juvenile osteochondrosis of foot,ethnic,Not Hispanic or Latino,0,5,5
440647,Sexually transmitted infectious disease,racial,Other Race,5,0,5
4104050,Other specified strabismus NOS,racial,White,0,5,5
192954,Acute gastric ulcer without hemorrhage AND without perforation but with obstruction,racial,Asian,0,5,5
197324,Disease of peritoneum,racial,Asian,5,0,5
75004,Frank hematuria,racial,Black or African American ,0,5,5
434674,Atrophy of edentulous mandibular alveolar ridge,racial,Unknown,5,0,5
135033,Hair and hair follicle diseases,racial,American Indian,2,2,4
377566,Palsy of conjugate gaze,racial,Unknown,5,0,5
201995,"Contusion, lower limb, multiple sites",racial,White,5,0,5
31057,Disorder of pharynx,ethnic,Not Hispanic or Latino,5,0,5
192502,Contusion of multiple sites of trunk,ethnic,Not Hispanic or Latino,5,0,5
380500,Hypertrophy of fat pad of knee,ethnic,Hispanic or Latino,0,5,5
438546,Congenital anomaly of anterior chamber of eye,racial,Black or African American ,5,0,5
196484,Retroverted incarcerated gravid uterus,ethnic,Hispanic or Latino,5,0,5
74998,Pycocele,racial,White,0,5,5
4144997,Osteoarthritis NOS,racial,American Indian or Alaska Native ,0,5,5
193863,Congenital abnormality of lower limb AND/OR pelvic girdle,ethnic,Not Hispanic or Latino,0,5,5
4098311,Borderline psychosis of childhood,racial,Unknown,5,0,5
81379,Lateral epicondylitis,racial,Asian Indian,0,5,5
436519,Perinatal intraventricular hemorrhage,racial,White,2,2,4
141663,Osteomyelitis,racial,American Indian or Alaska Native ,0,5,5
441258,Anemia in neoplastic disease,racial,White,0,5,5
437784,Pfeiffer's disease,racial,Unknown,5,0,5
378431,Impairment level: better eye: moderate impairment: lesser eye: not further specified,ethnic,Hispanic or Latino,2,2,4
4317122,Adverse reaction to drugs primarily affecting the gastrointestinal system NOS,racial,White,5,0,5
433246,"Chronic duodenal ulcer without hemorrhage, without perforation AND without obstruction",racial,Unknown,5,0,5
196471,Puberty bleeding,ethnic,Hispanic or Latino,5,0,5
192680,Portal hypertension,racial,Other Race,5,0,5
77335,Known OR suspected fetal abnormality affecting management of mother,ethnic,Hispanic or Latino,5,0,5
200485,Decubitus ulcer of buttock,racial,American Indian or Alaska Native ,5,0,5
441545,Somatisation disorder,ethnic,Hispanic or Latino,2,2,4
435216,Disorder associated with type I diabetes mellitus,racial,Black or African American ,0,5,5
377861,Disorder of refraction AND/OR accommodation,racial,Asian Indian,5,0,5
376525,Audiogram abnormal,racial,Asian,0,5,5
4146976,Crushed in between objects,ethnic,Not Hispanic or Latino,5,0,5
139980,Burn erythema of forearm,ethnic,Not Hispanic or Latino,5,0,5
193261,Vaginospasm,ethnic,Not Hispanic or Latino,5,0,5
74816,Contusion of toe,racial,Other Race,5,0,5
76227,Leg oedema,racial,Unknown,5,0,5
197807,Primary malignant neoplasm of soft tissues of abdomen,ethnic,Hispanic or Latino,5,0,5
443367,Antihypertensive adverse reaction,ethnic,Not Hispanic or Latino,2,2,4
377572,Noise effect on inner ear,racial,White,2,2,4
440558,Closed dislocation of interphalangeal joint of finger,racial,Unknown,0,5,5
138278,Sprains and strains of joints and adjacent muscles,racial,Native Hawaiian or Other Pacific Islander ,0,5,5
27516,Neoplasm of uncertain behaviour of paraganglion,racial,White,5,0,5
4145821,Symptom of head and neck region,ethnic,Hispanic or Latino,2,2,4
315505,Benign neoplasm of lymph node,racial,White,5,0,5
4124268,Faecal smear,racial,Unknown,2,0,2
201397,Prune belly syndrome,racial,Other Race,0,2,2
443375,Vitamin products adverse reaction,racial,White,2,0,2
4110029,Chronic pharyngitis and nasopharyngitis NOS,racial,White,0,2,2
81424,Closed dislocation of knee,racial,White,2,0,2
77965,Nodular tendinous disease of finger,racial,Asian Indian,0,2,2
4085104,Dermatosis due to mites,racial,Unknown,2,0,2
4223382,Comprehensive consultation,racial,Unknown,0,2,2
4290927,Impairment level: low vision of both eyes,racial,Filipino,0,2,2
76273,Open wound of shoulder region without complication,racial,Other Race,2,0,2
200164,Urine-induced contact dermatitis,racial,Native Hawaiian or Other Pacific Islander ,2,0,2
374940,Blepharophimosis syndrome,racial,Asian,2,0,2
435381,Closed fracture of base of thumb,racial,Black or African American ,0,2,2
443172,"Splinter of face, without major open wound",racial,White,0,2,2
40490405,Benign shuddering attacks,ethnic,Hispanic or Latino,2,0,2
196443,Gastric ulcer without hemorrhage AND without perforation but with obstruction,ethnic,Not Hispanic or Latino,0,2,2
441855,Epiphora due to excess lacrimation,racial,Unknown,2,0,2
377659,Spina bifida of lumbar region,ethnic,Hispanic or Latino,0,2,2
435563,Acute and subacute infective endocarditis associated with another disorder,racial,Unknown,2,0,2
441191,Poisoning by arthropod,ethnic,Not Hispanic or Latino,2,0,2
377279,"Profound impairment, one eye",racial,Native Hawaiian or Other Pacific Islander ,0,2,2
4025175,Tracheostomy complication NOS,ethnic,Hispanic or Latino,2,0,2
377535,Sleep walking disorder,racial,Black or African American ,0,2,2
440314,Injury of unknown intent by shotgun,racial,White,0,2,2
30361,Hypoglycemic disorder,racial,American Indian,2,0,2
435524,Sleep disorder,racial,Native Hawaiian or Other Pacific Islander ,2,0,2
4181604,Subcutaneous contraceptive implant,racial,Black or African American ,2,0,2
4288725,Lithium therapy,racial,Black or African American ,2,0,2
433606,Closed fracture of base of skull without intracranial injury,racial,White,2,0,2
438843,Non-traumatic rupture of patellar tendon,racial,White,2,0,2
196724,Disease of diaphragm,ethnic,Not Hispanic or Latino,2,0,2
318173,Vascular graft calcification,racial,Asian,2,0,2
442584,Carbuncle of buttock,racial,Other Race,2,0,2
435318,Complete spontaneous abortion with genital tract or pelvic infection,ethnic,Not Hispanic or Latino,2,0,2
4239721,Seafood allergy,racial,Black or African American ,2,0,2
73842,Enthesopathy of elbow region,ethnic,Not Hispanic or Latino,2,0,2
432436,Symbolic dysfunction,ethnic,Not Hispanic or Latino,2,0,2
76563,Late effect of burn of wrist AND/OR hand,ethnic,Hispanic or Latino,2,0,2
320752,Influenza with non-respiratory manifestation,racial,Asian Indian,2,0,2
193530,Follicular cyst of ovary,racial,Black or African American ,2,0,2
78193,Epididymo-orchitis,racial,Native Hawaiian or Other Pacific Islander ,0,2,2
77139,Open wound of finger without complication,racial,American Indian,2,0,2
198197,Male infertility,racial,American Indian or Alaska Native ,0,2,2
192568,Secondary malignant neoplasm of intra-abdominal lymph nodes,racial,Unknown,2,0,2
79957,Traumatic amputation of finger with complication,ethnic,Hispanic or Latino,0,2,2
442565,Gestational edema without hypertension,racial,Asian,2,0,2
434621,Autoimmune disease,ethnic,Hispanic or Latino,2,0,2
81713,Carpal joint sprain,racial,Unknown,0,2,2
4065991,Cellulitis and abscess of finger and toe,racial,White,2,0,2
442124,Orbital edema,racial,White,2,0,2
193863,Congenital abnormality of lower limb AND/OR pelvic girdle,ethnic,Hispanic or Latino,0,2,2
433881,Additional general conditions of patient,racial,Other Race,2,0,2
441541,Lymphocytopenia,racial,Unknown,2,0,2
4015717,Amebiasis carrier,ethnic,Hispanic or Latino,2,0,2
4275257,Detoxication therapy for alcoholism,ethnic,Not Hispanic or Latino,0,2,2
379805,Myopia,racial,American Indian or Alaska Native ,2,0,2
441974,Closed fracture of forearm,racial,Other Race,2,0,2
4140233,"X-ray of ribs, sternum and clavicle",racial,White,0,2,2
376564,Superficial injury of eye,racial,Unknown,0,2,2
444112,Integumentary system finding,racial,Asian,2,0,2
192275,Alpha-1-antitrypsin deficiency,racial,Unknown,0,2,2
444121,"Primary dental caries, proximal smooth surface origin",racial,White,2,0,2
81902,Urinary tract infectious disease,racial,African American,2,0,2
200149,Placenta previa with hemorrhage - not delivered,ethnic,Not Hispanic or Latino,2,0,2
439922,"Gestation period, 24 weeks",racial,White,0,2,2
435656,Neonatal jaundice,racial,American Indian or Alaska Native ,0,2,2
443253,Biological substance poisoning,racial,White,2,0,2
381444,Black eye,racial,Black or African American ,2,0,2
4196362,Genetic counselling,racial,Other Race,2,0,2
435411,Injury at C5-C7 level with spinal cord injury AND without bone injury,ethnic,Hispanic or Latino,0,2,2
138029,Second degree burn of palm,racial,Unknown,0,2,2
444243,Neurotic disorder,racial,Native Hawaiian or Other Pacific Islander ,2,0,2
321683,TTN - Transient tachypnoea of newborn,ethnic,Not Hispanic or Latino,2,0,2
435082,Closed fracture nasal bone,racial,Other Race,0,2,2
30361,Hypoglycemic disorder,ethnic,Not Hispanic or Latino,2,0,2
380120,Strabismus in neuromuscular disorder,racial,Asian Indian,0,2,2
381869,Intermitent squint,ethnic,Hispanic or Latino,2,0,2
256439,Allergic rhinitis due to pollen,racial,Filipino,2,0,2
316126,Crystalline deposits in vitreous,racial,White,2,0,2
75941,Closed fracture of one rib,ethnic,Not Hispanic or Latino,0,2,2
438021,Sequelae of fracture of arm,ethnic,Hispanic or Latino,0,2,2
434951,Lacrimal sac mucocele,ethnic,Hispanic or Latino,2,0,2
197236,Uterine fibroid,racial,Native Hawaiian or Other Pacific Islander ,2,0,2
257683,Postnasal drip,racial,American Indian,2,0,2
436544,Open fracture of distal end of ulna,ethnic,Not Hispanic or Latino,2,0,2
437758,Dependance on enabling machine or device,racial,Unknown,0,2,2
193262,Inflammatory disorder of penis,ethnic,Not Hispanic or Latino,0,2,2
133859,Preauricular cyst,ethnic,Not Hispanic or Latino,2,0,2
81186,Contusion of wrist,racial,Other Race,2,0,2
137951,Acquired keratoderma,racial,Other Race,2,0,2
4110738,Osteoarthritis deformans,ethnic,Not Hispanic or Latino,2,0,2
438268,Closed dislocation of finger,racial,Unknown,2,0,2
381551,Drug-related polyneuropathy,racial,American Indian or Alaska Native ,2,0,2
141370,Toxic erythema,ethnic,Not Hispanic or Latino,2,0,2
433288,Derangement of anterior horn of lateral meniscus,ethnic,Not Hispanic or Latino,2,0,2
435928,Abnormal decrease in weight,racial,American Indian,2,0,2
4062650,Malnutrition screening,racial,Unknown,0,2,2
80225,Sprain of ligament of lumbosacral joint,racial,Other Race,2,0,2
432968,Anemia during pregnancy - baby delivered,ethnic,Not Hispanic or Latino,2,0,2
443389,Cancer of ill-defined site,racial,Asian,2,0,2
433466,Childhood and adolescent relationship problem,racial,White,2,0,2
320425,Heart block,racial,White,2,0,2
138346,Erysipelas,racial,Asian,2,0,2
133551,Vesicular eczema of hands and/or feet,racial,Other Race,0,2,2
201399,Congenital anomaly of adrenal gland,racial,Unknown,0,2,2
432804,Fall from scaffold,racial,White,0,2,2
77880,Circumscribed labyrinthitis,racial,Unknown,2,0,2
4086928,IUCD status,racial,Asian,2,0,2
435647,Congenital folds and cysts of the posterior segment,ethnic,Hispanic or Latino,2,0,2
4305187,Control of epistaxis by packing of posterior and anterior nose,ethnic,Not Hispanic or Latino,2,0,2
435850,Cyst of jaw,racial,Black or African American ,2,0,2
319825,Rheumatic heart disease,racial,Other Race,2,0,2
318443,Arteriosclerotic vascular disease,racial,Other Race,0,2,2
442077,Anxiety disorder,racial,Asian,2,0,2
133294,Prepatellar bursitis,racial,Black or African American ,0,2,2
136937,Benign tumour of endocrine gland,ethnic,Hispanic or Latino,2,0,2
133327,Viremia,ethnic,Not Hispanic or Latino,2,0,2
432366,Hematoma of broad ligament,racial,White,2,0,2
138601,Open wound of face with complication,ethnic,Hispanic or Latino,2,0,2
444226,Dental restoration present,racial,White,0,2,2
376124,Pinguecula,racial,Asian,0,2,2
380403,External hordeolum,racial,American Indian or Alaska Native ,2,0,2
252348,Chronic pulmonary radiation disease,racial,White,2,0,2
258781,Pneumonopathy due to inhalation of dust,ethnic,Hispanic or Latino,2,0,2
4196206,beta^+^ Thalassemia,racial,Black or African American ,2,0,2
440195,Aniridia,ethnic,Not Hispanic or Latino,2,0,2
372930,Rheumatic chorea without heart involvement,racial,Asian,0,2,2
134671,Dental abscess without a sinus,racial,American Indian,2,0,2
439810,VKH syndrome,racial,Unknown,2,0,2
77642,Arthralgia of the forearm,racial,Native Hawaiian or Other Pacific Islander ,2,0,2
140208,Unilateral complete cleft palate with cleft lip,racial,Unknown,2,0,2
201624,Pyelitis associated with another disorder,racial,White,2,0,2
198194,Female genital organ symptoms,racial,Filipino,2,0,2
261782,Herpetic ulceration of vulva,racial,Filipino,2,0,2
433618,Open fracture of patella,racial,White,0,2,2
442281,Sprain of septal cartilage of nose,racial,White,2,0,2
196053,Metastatic tumour in kidney,racial,White,2,0,2
438066,Chlamydial infection,racial,Native Hawaiian or Other Pacific Islander ,2,0,2
197311,Pelvic varices,ethnic,Hispanic or Latino,0,2,2
436816,Vaginal vault smear abnormal,ethnic,Not Hispanic or Latino,2,0,2
444115,Disorder of bursa,racial,Asian,2,0,2
75042,Allergic arthritis of the shoulder region,racial,Black or African American ,0,2,2
432463,"Closed fracture clavicle, lateral end",ethnic,Not Hispanic or Latino,0,2,2
441417,Lack of coordination,racial,Other Race,2,0,2
198964,Chronic type C viral hepatitis,racial,Filipino,0,2,2
436101,Disorder of meninges,ethnic,Hispanic or Latino,0,2,2
201387,Doubling of uterus,racial,White,2,0,2
372627,Transient visual loss,racial,Unknown,2,0,2
433612,Closed fracture of upper end of fibula,ethnic,Hispanic or Latino,2,0,2
75686,Open wound of hand except fingers with complication,ethnic,Not Hispanic or Latino,0,2,2
381281,Degenerative progressive high myopia,racial,Other Race,0,2,2
74135,Disorder of synovium,racial,Asian,0,2,2
4297166,Closed reduction of fracture without internal fixation,racial,White,2,0,2
434833,Adverse reaction to anti-common cold drugs,ethnic,Hispanic or Latino,0,2,2
443708,Cervical Papanicolaou smear positive for malignant neoplasm,racial,Unknown,2,0,2
4016889,Other viral disease contact,ethnic,Hispanic or Latino,0,2,2
258540,Marfan syndrome,ethnic,Not Hispanic or Latino,2,0,2
195731,Shigella dysenteriae (group A),ethnic,Hispanic or Latino,0,2,2
377678,EEG abnormality,racial,Black or African American ,0,2,2
433279,Benign mucous membrane pemphigoid with no eye involvement,ethnic,Hispanic or Latino,0,2,2
436313,Shaken baby syndrome - non-accidental injury,ethnic,Not Hispanic or Latino,0,2,2
440990,Chorea,racial,Unknown,0,2,2
433997,Lymphangioma,ethnic,Hispanic or Latino,2,0,2
435205,Benign tumour of oropharynx,ethnic,Hispanic or Latino,2,0,2
441589,Endocarditis,racial,American Indian or Alaska Native ,0,2,2
72377,Shoulder girdle dystocia,racial,White,0,2,2
381686,PVS - Persistent vegetative state,ethnic,Not Hispanic or Latino,0,2,2
201530,"Diabetes mellitus, adult onset, with hyperosmolar coma",racial,Black or African American ,2,0,2
194081,Acute cystitis,racial,Filipino,2,0,2
138708,Acute leukemia,ethnic,Not Hispanic or Latino,0,2,2
433196,Chorioretinal scar,racial,White,2,0,2
434005,Morbid obesity,racial,Asian Indian,2,0,2
438962,Herpes simplex with complication,racial,Unknown,0,2,2
4086928,IUCD status,racial,American Indian,2,0,2
136025,Gp B streptococcal septicemia,racial,Other Race,2,0,2
201045,Thrombosed external haemorrhoids,racial,American Indian or Alaska Native ,2,0,2
437794,Juvenile syphilis,racial,White,0,2,2
197033,Endometriosis of pelvic peritoneum,racial,Unknown,2,0,2
73686,Tuberculosis of genitourinary system,ethnic,Not Hispanic or Latino,0,2,2
75637,Acquired postural kyphosis,racial,American Indian or Alaska Native ,2,0,2
436235,Taste sense altered,racial,Other Race,2,0,2
443389,Cancer of ill-defined site,ethnic,Not Hispanic or Latino,2,0,2
432347,Chronic disease of tonsils AND/OR adenoids,ethnic,Not Hispanic or Latino,0,2,2
4252234,Repair of gastroschisis,racial,White,0,2,2
194265,Cryptosporidiasis,racial,White,0,2,2
80880,Open wound of foot except toes with tendon involvement,ethnic,Not Hispanic or Latino,0,2,2
442764,Anal pain,racial,Asian,2,0,2
195294,Thrombosed hemorrhoids,racial,Unknown,0,2,2
376114,Severe nonproliferative diabetic retinopathy,ethnic,Not Hispanic or Latino,0,2,2
376712,Purulent otitis media,racial,Black or African American ,2,0,2
436944,Chronic paranoid schizophrenia,racial,Black or African American ,2,0,2
23034,Neonatal hypoglycemia,ethnic,Not Hispanic or Latino,0,2,2
137441,"Insect bite, nonvenomous, of foot and toe, infected",racial,Unknown,2,0,2
201957,Necrotizing enterocolitis in fetus OR newborn,ethnic,Not Hispanic or Latino,2,0,2
4310395,Open reduction of dislocation of elbow,ethnic,Hispanic or Latino,0,2,2
376793,Congenital anomaly of ear with impairment of hearing,racial,Black or African American ,0,2,2
196484,Retroverted incarcerated gravid uterus,racial,Unknown,2,0,2
372315,Anterior subcapsular polar cataract,ethnic,Not Hispanic or Latino,2,0,2
73904,Open wound of buttock without complication,ethnic,Not Hispanic or Latino,2,0,2
199718,Enteritis due to rotavirus,ethnic,Not Hispanic or Latino,0,2,2
435701,Injury of trigeminal nerve,racial,White,2,0,2
442008,Injury at T7-T12 level with spinal cord injury AND without bone injury,racial,Unknown,2,0,2
438411,Endophthalmitis,ethnic,Hispanic or Latino,0,2,2
141370,Toxic erythema,racial,Asian,2,0,2
436957,Functional disorders of polymorphonuclear neutrophils,racial,Black or African American ,0,2,2
79145,Ehlers-Danlos syndrome,racial,Unknown,2,0,2
437738,Motor vehicle accident off public road,racial,Unknown,2,0,2
439234,Poisoning by cardiotonic glycoside,racial,White,2,0,2
26052,Primary malignant neoplasm of larynx,ethnic,Not Hispanic or Latino,2,0,2
373463,Benign cough headache,racial,Other Race,2,0,2
440965,Hodgkin's disease of intrathoracic lymph nodes,ethnic,Hispanic or Latino,0,2,2
4051119,FH: Osteoporosis,racial,White,2,0,2
443858,Superficial injury of ankle with infection,racial,White,0,2,2
78786,Pleurisy,racial,Asian,0,2,2
198550,"Atresia and stenosis of large intestine, rectum and anal canal",ethnic,Not Hispanic or Latino,0,2,2
136710,Perichondritis of pinna,racial,Black or African American ,2,0,2
436876,Toxic effect of lead compound,racial,White,0,2,2
433987,Benign tumour of orbit,ethnic,Not Hispanic or Latino,2,0,2
4145947,Subnormal birth weight,ethnic,Not Hispanic or Latino,0,2,2
4161978,Patient on oxygen,racial,Native Hawaiian or Other Pacific Islander ,2,0,2
256440,Disorder of paranasal sinuses,racial,American Indian or Alaska Native ,2,0,2
4090206,Late effects of tuberculosis NOS,ethnic,Hispanic or Latino,0,2,2
436392,Carotid sinus syncope,ethnic,Hispanic or Latino,2,0,2
441833,Pathological drug intoxication,racial,White,2,0,2
4234990,Cardiac revascularisation with bypass aortocoronary anastomosis of two coronary vessels,racial,White,2,0,2
197330,Finding of urethral sphincter function,racial,Unknown,2,0,2
440374,Obsessive compulsive disorder,racial,Black or African American ,0,2,2
4062488,Thyroid disorder screening,racial,Native Hawaiian or Other Pacific Islander ,2,0,2
137813,Benign neoplasm of mouth region,racial,Unknown,2,0,2
198558,Nycturia,racial,Native Hawaiian or Other Pacific Islander ,0,2,2
196943,Red blood cell sequestration in spleen,racial,Black or African American ,0,2,2
378839,Spina bifida with hydrocephalus,racial,Unknown,2,0,2
133088,Late amputation stump complication,ethnic,Not Hispanic or Latino,0,2,2
439989,Insulin adverse reaction,racial,Unknown,0,2,2
134668,Chronic maxillary sinusitis,racial,Asian,2,0,2
201332,Alveolitis of jaw,ethnic,Hispanic or Latino,2,0,2
440431,Pneumonia due to Mycoplasma pneumoniae,racial,Other Race,2,0,2
372930,Rheumatic chorea without heart involvement,ethnic,Not Hispanic or Latino,0,2,2
197163,Burn of trunk,racial,White,0,2,2
375536,Organic writer's cramp,racial,White,2,0,2
4195231,Acute gastric ulcer without hemorrhage AND without perforation,racial,White,0,2,2
4016352,Tuberculosis contact,racial,Other Race,0,2,2
40485064,Latent syphilis,racial,Asian,0,2,2
436015,Accidental poisoning from foodstuffs and poisonous plants,racial,White,0,2,2
194382,External haemorrhoid,racial,American Indian or Alaska Native ,2,0,2
4069553,Acquired lordosis NOS,ethnic,Hispanic or Latino,2,0,2
194133,Low back pain,racial,African American,2,0,2
435230,Multiple personality disorder,ethnic,Not Hispanic or Latino,2,0,2
132822,Foot-and-mouth disease,ethnic,Not Hispanic or Latino,2,0,2
4101989,Closed fracture of shaft of bone of forearm,racial,Unknown,0,2,2
377885,Disorder of eye movements,racial,Native Hawaiian or Other Pacific Islander ,0,2,2
132466,Lumbar sprain,racial,Filipino,2,0,2
138876,Closed fracture of T1-T6 level with spinal cord injury,racial,White,2,0,2
436833,Open fracture of metacarpal bone,ethnic,Hispanic or Latino,2,0,2
134276,Cutaneous actinomycosis,ethnic,Not Hispanic or Latino,2,0,2
4310254,Mediastinal pneumogram,ethnic,Hispanic or Latino,0,2,2
199868,Incisional hernia with gangrene,ethnic,Hispanic or Latino,2,0,2
4010364,"Closed fracture of distal humerus, not otherwise specified",ethnic,Hispanic or Latino,0,2,2
75375,Closed fracture lunate,racial,Unknown,0,2,2
374053,Sudden hearing loss,ethnic,Hispanic or Latino,0,2,2
196726,Cholelithiasis AND acute cholecystitis without obstruction,racial,Other Race,2,0,2
4201412,Speech therapy,racial,Unknown,0,2,2
138255,Abnormal cardiovascular function,racial,Unknown,2,0,2
4056045,Other functional disorder of bladder,ethnic,Hispanic or Latino,2,0,2
377283,Conjunctival injection,racial,White,2,0,2
444424,Open wound of Eustachian tube with complication,ethnic,Not Hispanic or Latino,0,2,2
443728,Mass of chest wall,racial,Filipino,2,0,2
374940,Blepharophimosis syndrome,ethnic,Not Hispanic or Latino,2,0,2
201340,Gastritis,racial,Other Race,0,2,2
194611,CIN 3 - Cervical intraepithelial neoplasia grade 3,racial,Other Race,2,0,2
196443,Gastric ulcer without hemorrhage AND without perforation but with obstruction,racial,Asian,0,2,2
140960,Secondary malignant neoplasm of breast,ethnic,Hispanic or Latino,2,0,2
436118,After-cataract with vision obscured,racial,Black or African American ,2,0,2
200780,Disease of uterus,ethnic,Not Hispanic or Latino,2,0,2
4005603,Congenital cystic kidney disease NOS,racial,Unknown,0,2,2
432598,Subchronic schizophrenia with acute exacerbations,ethnic,Not Hispanic or Latino,2,0,2
443535,Infection due to enterococcus,racial,American Indian,2,0,2
379782,Gilles de la Tourette's syndrome,ethnic,Not Hispanic or Latino,0,2,2
443535,Infection due to enterococcus,ethnic,Not Hispanic or Latino,2,0,2
77139,Open wound of finger without complication,racial,Asian,2,0,2
441540,Reactive confusion,racial,White,0,2,2
134661,Chronic sphenoidal sinusitis,racial,White,0,2,2
440255,Open wound of axillary region without complication,ethnic,Hispanic or Latino,2,0,2
194265,Cryptosporidiasis,racial,Unknown,0,2,2
380397,Keratoconjunctivitis,racial,Unknown,2,0,2
4083043,Convalescence after surgery,racial,Unknown,0,2,2
373638,Superficial injury of cornea,racial,Asian,2,0,2
201338,Urethral fistula,ethnic,Not Hispanic or Latino,0,2,2
137441,"Insect bite, nonvenomous, of foot and toe, infected",racial,White,2,0,2
192502,Contusion of multiple sites of trunk,racial,Unknown,2,0,2
256142,Dental arch relationship anomaly,racial,Unknown,0,2,2
436747,Legal abortion without complication,ethnic,Not Hispanic or Latino,2,0,2
440788,Hyperemesis gravidarum with metabolic disturbance - not delivered,racial,Arab,2,0,2
435904,Derangement of anterior horn of medial meniscus,racial,Unknown,2,0,2
437985,Disturbance of temperature regulation of newborn,racial,White,2,0,2
136538,Closed fracture larynx and/or trachea,racial,Filipino,0,2,2
138896,Open wound of forehead without complication,racial,Black or African American ,2,0,2
440684,Simple paranoid state,racial,Asian,0,2,2
4099207,Thyroiditis NOS,ethnic,Hispanic or Latino,2,0,2
437557,Eczematous dermatitis of eyelid,racial,Other Race,2,0,2
4208970,History of physical abuse,racial,Other Race,2,0,2
74719,Foot ulcer,racial,Asian Indian,0,2,2
441408,Vomiting,racial,Alaska Native,0,2,2
139036,Systolic dysfunction,racial,Asian,2,0,2
139912,Spondylosis with myelopathy,racial,Unknown,0,2,2
80183,"Localised, secondary osteoarthritis of the ankle and/or foot",ethnic,Hispanic or Latino,2,0,2
432417,Acquired hallux malleus,ethnic,Not Hispanic or Latino,0,2,2
192581,Carcinoma in situ of uterus,ethnic,Hispanic or Latino,2,0,2
78586,Sprain of interphalangeal joint of toe,ethnic,Not Hispanic or Latino,2,0,2
439082,Menopausal syndrome,racial,Filipino,2,0,2
137054,Skin striae,racial,Unknown,2,0,2
437334,Cervical incompetence with antenatal problem,racial,Black or African American ,2,0,2
440431,Pneumonia due to Mycoplasma pneumoniae,racial,Filipino,0,2,2
438223,Sunburn of second degree,racial,Other Race,2,0,2
436027,Coxsackie virus disease,racial,American Indian,2,0,2
4180167,Joint infection,racial,White,0,2,2
78015,Open wound of chest wall without complication,racial,White,2,0,2
435119,Sequela of injury,racial,Black or African American ,0,2,2
200149,Placenta previa with hemorrhage - not delivered,racial,Asian,2,0,2
195313,Urethral abscess,ethnic,Hispanic or Latino,2,0,2
444028,Open wound of alveolar process without complication,ethnic,Not Hispanic or Latino,0,2,2
28974,Candidiasis of oesophagus,racial,Other Race,0,2,2
197135,Ureter injury without mention of open wound into cavity,ethnic,Hispanic or Latino,2,0,2
196858,Late effect of fracture of neck of femur,ethnic,Not Hispanic or Latino,0,2,2
375557,Cerebral embolism,racial,Other Race,0,2,2
140020,Viral exanthem,racial,Native Hawaiian or Other Pacific Islander ,0,2,2
432246,Leptospirosis,racial,White,2,0,2
193359,Open wound of multiple sites of one lower limb AND thigh with complication,ethnic,Hispanic or Latino,2,0,2
439665,Violent spouse,racial,Unknown,2,0,2
433706,Yaws gummata and ulcers,racial,Black or African American ,2,0,2
199839,External haemorrhoids without complication,racial,Filipino,0,2,2
196613,Neuroma of amputation stump,racial,White,2,0,2
381014,Conjunctival pigmentation,racial,Asian,2,0,2
30365,Panhypopituitarism,racial,Other Race,0,2,2
139888,Threatened premature labor - not delivered,racial,Native Hawaiian or Other Pacific Islander ,2,0,2
377680,Facial nerve injury as birth trauma,racial,Unknown,2,0,2
4201472,Varicella contact,racial,Other Race,0,2,2
199151,Must strain to pass urine,racial,Unknown,0,2,2
434374,Anisocoria,ethnic,Not Hispanic or Latino,2,0,2
433319,Fetus OR newborn affected by maternal complication of pregnancy,ethnic,Hispanic or Latino,2,0,2
138821,Seborrhea,racial,Filipino,2,0,2
432522,Transfusion reaction due to serum protein reaction,ethnic,Hispanic or Latino,2,0,2
4265600,Gastric ulcer,racial,Unknown,2,0,2
442325,Furuncle of foot,ethnic,Not Hispanic or Latino,0,2,2
436940,Insulin resistance syndrome,racial,Asian,2,0,2
192273,Benign tumour of adrenal gland,racial,Other Race,2,0,2
432941,Disease of tongue,racial,Black or African American ,0,2,2
79938,Closed fracture of scapula,racial,Other Race,0,2,2
137967,"Muscle, ligament and fascia disorders",racial,Black or African American ,0,2,2
444219,Osteitis deformans without bone tumor,racial,Black or African American ,0,2,2
4103886,Keratoconus NOS,ethnic,Hispanic or Latino,2,0,2
381252,Benign neoplasm of eye,racial,Native Hawaiian or Other Pacific Islander ,0,2,2
432789,Opioid analgesic adverse reaction,ethnic,Hispanic or Latino,2,0,2
433758,Childhood emotional disorder,racial,Black or African American ,0,2,2
380120,Strabismus in neuromuscular disorder,racial,Black or African American ,0,2,2
4222126,Removal of urethral stent,ethnic,Hispanic or Latino,2,0,2
197339,"Congenital abnormality of uterus, affecting pregnancy",racial,Unknown,2,0,2
4323155,Limited consultation,ethnic,Not Hispanic or Latino,2,0,2
4104583,Mechanical strabismus NOS,ethnic,Hispanic or Latino,2,0,2
440999,Choroidal rupture,racial,White,0,2,2
438836,Poliomyelitis osteopathy of the lower leg,racial,Other Race,0,2,2
139902,Allergic urticaria,racial,Filipino,0,2,2
4305187,Control of epistaxis by packing of posterior and anterior nose,ethnic,Hispanic or Latino,0,2,2
437663,Fever,racial,Native Hawaiian or Other Pacific Islander ,2,0,2
443743,Plasma cell neoplasm,ethnic,Hispanic or Latino,2,0,2
4066244,Caesarean wound disruption unspecified,racial,White,2,0,2
442553,Injury of bladder,ethnic,Hispanic or Latino,0,2,2
194702,PROM - Premature rupture of membranes,racial,White,2,0,2
194109,Delayed postpartum haemorrhage,racial,White,2,0,2
376113,Recent subtotal retinal detachment,racial,Unknown,0,2,2
442130,Open wound of tongue with complication,ethnic,Hispanic or Latino,0,2,2
73041,Closed fracture of five ribs,ethnic,Hispanic or Latino,0,2,2
441974,Closed fracture of forearm,racial,American Indian or Alaska Native ,0,2,2
441968,Acetonuria,racial,Native Hawaiian or Other Pacific Islander ,2,0,2
441032,Episcleritis periodica fugax,ethnic,Not Hispanic or Latino,0,2,2
74080,Orthostatic proteinuria,racial,Other Race,0,2,2
4096379,Hemangioma or lymphangioma NOS,racial,White,0,2,2
72737,Microcalcifications of the breast,racial,Native Hawaiian or Other Pacific Islander ,2,0,2
73291,Palindromic rheumatism of the ankle and/or foot,racial,Native Hawaiian or Other Pacific Islander ,0,2,2
434084,Abscess of vulva,racial,Asian,2,0,2
74469,Light-for-dates without mention of fetal malnutrition,racial,Asian,2,0,2
74129,Allergic arthritis of the ankle and/or foot,ethnic,Hispanic or Latino,2,0,2
316995,Coronary occlusion,racial,Filipino,0,2,2
436667,Stammer,racial,Other Race,0,2,2
376964,Partial recent retinal detachment with giant tear,racial,White,2,0,2
435866,Retrograde ejaculation,racial,Asian,0,2,2
196152,Peritonitis,racial,Other Race,0,2,2
433981,Benign neoplasm of short bone of upper limb,racial,White,0,2,2
441840,Clinical finding,racial,American Indian or Alaska Native ,2,0,2
436145,Pneumonia due to respiratory syncytial virus,racial,Asian,2,0,2
72992,Allergic arthritis,racial,White,2,0,2
434241,Accidental poisoning by soap products,ethnic,Hispanic or Latino,2,0,2
321320,Myocardial degeneration,ethnic,Not Hispanic or Latino,0,2,2
76273,Open wound of shoulder region without complication,ethnic,Not Hispanic or Latino,2,0,2
4164707,Canceled operative procedure,racial,American Indian,2,0,2
79915,Hemarthrosis of hand,ethnic,Not Hispanic or Latino,2,0,2
201625,Malposition of uterus,ethnic,Hispanic or Latino,2,0,2
4272341,Physical medicine evaluation and review for prosthetic program,ethnic,Hispanic or Latino,0,2,2
4337834,Hyperthyroidism due to ectopic thyroid nodule,racial,Unknown,0,2,2
253482,Cortical blindness,racial,Black or African American ,0,2,2
40484028,Dental caries extending into dentine,racial,American Indian or Alaska Native ,0,2,2
440059,Recurrent disease,ethnic,Hispanic or Latino,2,0,2
23988,Hemolytic anemia due to glutathione metabolism disorder,racial,Unknown,2,0,2
317299,Disorder of vitreous body,racial,White,0,2,2
201078,Senile atrophic vaginitis,racial,Black or African American ,2,0,2
4208388,Laryngotracheitis,ethnic,Hispanic or Latino,2,0,2
436256,Open fracture metatarsal,racial,White,2,0,2
4221619,Excision of vaginal lesion,ethnic,Hispanic or Latino,2,0,2
432287,Immunodeficiency with IgM hypergammaglobulinaemia,racial,White,0,2,2
433540,Polyhydramnios with antenatal problem,racial,Other Race,2,0,2
193983,Disorder of pancreatic internal secretion,racial,Asian,2,0,2
441961,Congenital pelviureteric junction obstruction,racial,White,0,2,2
438820,Postpartum deep phlebothrombosis,ethnic,Hispanic or Latino,2,0,2
373499,Disorder of eye region,racial,Black or African American ,0,2,2
380397,Keratoconjunctivitis,racial,Other Race,2,0,2
4092845,Candidiasis NOS,racial,Unknown,0,2,2
255841,Chronic bronchitis,racial,Filipino,2,0,2
194700,"Diabetes mellitus in mother complicating pregnancy, childbirth AND/OR puerperium",racial,American Indian or Alaska Native ,2,0,2
435522,Hypervitaminosis D,racial,American Indian or Alaska Native ,2,0,2
441770,Injury of unknown intent due to fall from high man-made structure,ethnic,Hispanic or Latino,2,0,2
442306,Adjustment disorder with depressed mood,racial,American Indian or Alaska Native ,2,0,2
254061,Pleural effusion,racial,Asian,0,2,2
320073,Neutrophil count below reference range,racial,Alaska Native,2,0,2
444287,Carbuncle of neck,racial,Asian,0,2,2
434329,Spinocerebellar disease,racial,Unknown,2,0,2
442073,Malunion and nonunion of fracture,racial,American Indian or Alaska Native ,0,2,2
134870,Pityriasis versicolor,racial,Native Hawaiian or Other Pacific Islander ,2,0,2
312327,Acute myocardial infarction,racial,Filipino,2,0,2
443260,Umbilical lump,racial,Unknown,0,2,2
138821,Seborrhea,racial,Other Race,0,2,2
444239,Postprocedural state finding,racial,American Indian,0,2,2
4239301,Unwanted pregnancy,racial,American Indian or Alaska Native ,2,0,2
433577,Hammer toe,racial,American Indian or Alaska Native ,2,0,2
4007913,Closed fracture mandible (site unspecified),racial,White,2,0,2
4105880,Contact of sexually transmissible disorder,racial,American Indian or Alaska Native ,0,2,2
26935,Disorder of endocrine testis,racial,Black or African American ,0,2,2
435533,"Hypnotic or anxiolytic dependence, continuous",racial,White,2,0,2
433695,Trypanosomiasis,ethnic,Hispanic or Latino,2,0,2
192279,Diabetic nephropathy,racial,Asian Indian,2,0,2
434272,Varicella infection,racial,Asian,0,2,2
194807,Injury of inferior vena cava,ethnic,Hispanic or Latino,0,2,2
432910,Disorder of lacrimal system,racial,Black or African American ,2,0,2
200171,Carbuncle of skin AND/OR subcutaneous tissue,racial,Filipino,0,2,2
4242962,Benign tumour of small intestine,racial,American Indian or Alaska Native ,2,0,2
432719,Panniculitis,racial,White,0,2,2
443438,Claw hand - acquired,racial,White,0,2,2
4109719,Other optic disc disorder NOS,racial,White,2,0,2
375256,Anterior subcapsular polar senile cataract,racial,Asian,2,0,2
4109253,Pterygium NOS,racial,Asian,2,0,2
193525,Abdominal pregnancy,racial,Black or African American ,2,0,2
375067,Microphthalmos associated with other anomalies of eye AND/OR adnexa,ethnic,Hispanic or Latino,2,0,2
133573,Acute osteomyelitis of shoulder region,racial,White,0,2,2
4237140,Abnormal sexual function,racial,Other Race,0,2,2
80165,Fetal disproportion,ethnic,Hispanic or Latino,2,0,2
77234,Benign tumour of colon,racial,Asian Indian,0,2,2
4215445,Arthroplasty of shoulder for recurrent dislocation,racial,White,2,0,2
435094,Open fracture of lower end of femur,ethnic,Hispanic or Latino,0,2,2
378765,TS - Tympanosclerosis,ethnic,Hispanic or Latino,0,2,2
4051568,Family history of mental disorder,racial,Other Race,2,0,2
4299535,Pregnancy confirmed,racial,Alaska Native,2,0,2
257011,Acute upper respiratory infection,racial,Alaska Native,2,0,2
193814,Chronic parametritis and pelvic cellulitis,racial,Other Race,2,0,2
75389,Current tear of lateral cartilage AND/OR meniscus of knee,racial,Other Race,2,0,2
440228,Closed fracture of lower end of humerus,racial,Black or African American ,2,0,2
196259,Injury of gastrointestinal tract without open wound into abdominal cavity,racial,White,0,2,2
433612,Closed fracture of upper end of fibula,ethnic,Not Hispanic or Latino,2,0,2
196569,Contusion of abdominal wall,ethnic,Not Hispanic or Latino,2,0,2
440370,Nutritional marasmus,ethnic,Not Hispanic or Latino,0,2,2
258458,Bacterial pleurisy with effusion,racial,Black or African American ,2,0,2
380688,Hypoglycaemic coma,racial,White,0,2,2
81983,Multiple dislocations,racial,Unknown,0,2,2
4153441,Fetus or neonate affected by breech delivery and extraction,ethnic,Hispanic or Latino,2,0,2
198291,Burn of abdominal wall,ethnic,Hispanic or Latino,2,0,2
77635,Disease of hand,racial,Black or African American ,2,0,2
434701,"Anemia in mother complicating pregnancy, childbirth AND/OR puerperium",racial,Asian,2,0,2
4100912,Screening for rheumatoid conditions,racial,Black or African American ,2,0,2
4012454,"Open fracture of tibia and/or fibula, shaft",racial,Unknown,0,2,2
374035,Keratitis,racial,Black or African American ,2,0,2
4096379,Hemangioma or lymphangioma NOS,ethnic,Hispanic or Latino,0,2,2
255175,Nodular tuberculosis of lung,ethnic,Hispanic or Latino,0,2,2
4147507,Retinal detachments and defects,racial,White,2,0,2
4094126,Family problems,racial,Unknown,2,0,2
78015,Open wound of chest wall without complication,racial,Black or African American ,2,0,2
81988,Sprain of sternum,ethnic,Not Hispanic or Latino,0,2,2
436245,Atypical glandular cells on vaginal Papanicolaou smear,racial,Black or African American ,2,0,2
196895,Viral gastroenteritis due to Norwalk-like agents,ethnic,Hispanic or Latino,2,0,2
4184816,Repair of prostate,ethnic,Hispanic or Latino,0,2,2
443883,Acute disease,racial,Asian,0,2,2
440329,Herpes zoster without complication,racial,American Indian or Alaska Native ,2,0,2
437954,Lateral meniscus derangement,racial,Unknown,2,0,2
74806,Open wound of finger with complication,racial,Unknown,0,2,2
4165091,Lack of exercise,racial,Black or African American ,0,2,2
198216,Retroverted incarcerated gravid uterus - delivered,ethnic,Not Hispanic or Latino,2,0,2
4318718,Limitation of movement of temporomandibular joint,racial,White,2,0,2
257581,Exacerbation of asthma,racial,Alaska Native,0,2,2
201221,Intestinal infection due to Class Cestoda and/or Class Trematoda and/or Phylum Nemata,ethnic,Not Hispanic or Latino,2,0,2
381859,Infective OE,racial,Filipino,0,2,2
193874,Bed wetting,racial,American Indian or Alaska Native ,2,0,2
81878,Benign paroxysmal positional vertigo,racial,Filipino,2,0,2
381118,Congenital vascular anomaly of eye,racial,White,2,0,2
4096347,Gouty arthropathy,racial,American Indian or Alaska Native ,2,0,2
442790,Growth and development,racial,Other Race,0,2,2
4105030,Other endophthalmitis,ethnic,Hispanic or Latino,2,0,2
198363,Candidiasis of vagina,racial,Native Hawaiian or Other Pacific Islander ,2,0,2
442282,Urinary casts,racial,Black or African American ,0,2,2
374377,Paralytic syndrome,ethnic,Not Hispanic or Latino,0,2,2
321314,Abdominal aortic aneurysm without rupture,racial,American Indian or Alaska Native ,0,2,2
313800,Thrombotic microangiopathy,racial,Unknown,2,0,2
40493424,Abdominal rigidity of right upper quadrant,ethnic,Hispanic or Latino,2,0,2
136030,Sweating fever,ethnic,Hispanic or Latino,0,2,2
4111259,Labyrinthine dysfunction NOS,racial,White,2,0,2
4228058,Unilateral mastectomy extended simple,racial,Unknown,2,0,2
441607,Mediastinal abscess,racial,Unknown,0,2,2
75637,Acquired postural kyphosis,racial,Other Race,2,0,2
81382,Tendon sheath giant cell tumor,racial,White,2,0,2
438477,Atrophy of testis,racial,Black or African American ,0,2,2
381285,Peroneal muscular atrophy,ethnic,Not Hispanic or Latino,0,2,2
376102,Partial recent retinal detachment with single defect,racial,Other Race,0,2,2
321726,Injury of blood vessels of lower extremity,ethnic,Hispanic or Latino,2,0,2
440684,Simple paranoid state,ethnic,Not Hispanic or Latino,0,2,2
440098,Rubeosis iridis,racial,White,2,0,2
433315,Feeding difficulties in newborn,racial,American Indian or Alaska Native ,0,2,2
73723,Benign tumour of epididymis,ethnic,Not Hispanic or Latino,0,2,2
140490,Anhidrosis,racial,White,0,2,2
318437,Accelerated secondary hypertension,ethnic,Hispanic or Latino,2,0,2
443012,Diabetes mellitus during pregnancy - baby delivered,racial,Other Race,2,0,2
81106,Acquired genu varum,racial,Other Race,0,2,2
438557,Abnormal glucose level,racial,European,0,2,2
373469,Symptomatic torsion dystonia,ethnic,Not Hispanic or Latino,2,0,2
4110052,Bronchiectasis NOS,ethnic,Hispanic or Latino,2,0,2
195594,Spontaneous abortion complicated by delayed AND/OR excessive hemorrhage,racial,White,2,0,2
436833,Open fracture of metacarpal bone,ethnic,Not Hispanic or Latino,0,2,2
4145479,Other specified candidiasis NOS,racial,Unknown,2,0,2
134276,Cutaneous actinomycosis,ethnic,Hispanic or Latino,0,2,2
192819,Typhoid fever,ethnic,Hispanic or Latino,2,0,2
444084,Extrinsic allergic alveolitis,ethnic,Not Hispanic or Latino,2,0,2
435661,Closed orbital blow-out fracture,racial,Black or African American ,2,0,2
253235,Pneumonia in pertussis,racial,White,0,2,2
373054,Open wound of auricle of ear without complication,ethnic,Not Hispanic or Latino,2,0,2
443782,Tremor,racial,Filipino,0,2,2
72693,Poor fetal growth affecting management,ethnic,Hispanic or Latino,2,0,2
4108389,Generalized tuberculosis,ethnic,Not Hispanic or Latino,0,2,2
4060433,Multiple pregnancy NOS,ethnic,Hispanic or Latino,2,0,2
140364,Disorder of thyrocalcitonin secretion,racial,White,2,0,2
439337,"Motor vehicle traffic accident involving collision, on highway, between motor vehicle and animal, passenger of motor vehicle injured",ethnic,Hispanic or Latino,2,0,2
196471,Puberty bleeding,racial,Unknown,2,0,2
192958,Floating kidney,racial,Unknown,0,2,2
440161,Indication for care AND/OR intervention in labor AND/OR delivery,racial,Unknown,2,0,2
379782,Gilles de la Tourette's syndrome,racial,Asian,0,2,2
201221,Intestinal infection due to Class Cestoda and/or Class Trematoda and/or Phylum Nemata,racial,Asian,2,0,2
315361,Orthopnea,racial,Black or African American ,2,0,2
72748,Strain of rotator cuff of shoulder,racial,Other Race,2,0,2
4087756,Late latent syphilis,racial,Asian,2,0,2
434953,Orbital granuloma,racial,White,0,2,2
4062652,Galactosaemia screening,racial,White,0,2,2
381028,Acute suppurative otitis media - tympanic membrane ruptured,racial,Filipino,0,2,2
433687,Botulism,racial,White,0,2,2
81988,Sprain of sternum,racial,Asian,0,2,2
435914,Metatarsus varus,ethnic,Not Hispanic or Latino,2,0,2
4184252,Observation of neck region,ethnic,Hispanic or Latino,0,2,2
4293175,"Mental state, behaviour and/or psychosocial function finding",racial,Alaska Native,0,2,2
377573,Pars tensa central perforation,racial,White,0,2,2
200769,"Chronic gastric ulcer without hemorrhage, without perforation AND without obstruction",racial,Other Race,2,0,2
436392,Carotid sinus syncope,ethnic,Not Hispanic or Latino,2,0,2
4042836,Disease of head,racial,Other Race,2,0,2
252341,Extrinsic asthma with status asthmaticus,racial,Unknown,2,0,2
437878,Persistent mydriasis,racial,Unknown,2,0,2
320752,Influenza with non-respiratory manifestation,racial,Asian,0,2,2
4273622,Operation on bone injury of carpals and metacarpals,ethnic,Hispanic or Latino,2,0,2
4307254,Closed fracture,racial,Asian,2,0,2
319041,Orthostatic hypotension,racial,Native Hawaiian or Other Pacific Islander ,0,2,2
444121,"Primary dental caries, proximal smooth surface origin",racial,Unknown,2,0,2
197795,Acute hepatitis B,racial,Other Race,0,2,2
193693,Viral hepatitis without hepatic coma,racial,Unknown,2,0,2
134214,Burn erythema of wrist,racial,Unknown,2,0,2
432860,Benign tumor of epipharynx,ethnic,Not Hispanic or Latino,2,0,2
40480943,Lateral cystocele,racial,Other Race,2,0,2
192259,Ascariasis,ethnic,Not Hispanic or Latino,0,2,2
436333,Orf virus disease,racial,Black or African American ,2,0,2
80815,Mucous cyst of skin,racial,Other Race,2,0,2
4036945,Consciousness disturbance NOS,racial,White,2,0,2
4201388,Gastrostomy present,racial,Native Hawaiian or Other Pacific Islander ,2,0,2
438040,"Adverse reaction to analgesics, antipyretics and antirheumatics",ethnic,Hispanic or Latino,2,0,2
4170747,Abnormal amniotic fluid,ethnic,Not Hispanic or Latino,2,0,2
438750,Old total retinal detachment,ethnic,Not Hispanic or Latino,0,2,2
436897,Transport fever,racial,Other Race,0,2,2
81169,Superficial foreign body of finger without major open wound AND without infection,racial,American Indian or Alaska Native ,2,0,2
79061,Colonic constipation,racial,Asian,0,2,2
135215,Hashimoto thyroiditis,racial,Unknown,2,0,2
373756,Exudative retinopathy,racial,Asian,0,2,2
198520,Lumbar spondylosis with myelopathy,racial,Other Race,0,2,2
196523,Diarrhea,racial,Asian Indian,0,2,2
377565,Optic atrophy associated with retinal dystrophy,ethnic,Hispanic or Latino,2,0,2
74864,Gonococcal joint infection,racial,White,0,2,2
199068,Vaginal hematoma,ethnic,Hispanic or Latino,2,0,2
433716,Primary malignant neoplasm of testis,ethnic,Not Hispanic or Latino,0,2,2
201069,"Peptic ulcer without hemorrhage, without perforation AND without obstruction",racial,Black or African American ,0,2,2
373216,Disorder of mastoid,ethnic,Not Hispanic or Latino,0,2,2
4105628,Facial nerve disorder NOS,ethnic,Hispanic or Latino,0,2,2
201332,Alveolitis of jaw,racial,Black or African American ,2,0,2
434164,Glycosuria,racial,Other Race,2,0,2
195500,Benign tumour of uterus,ethnic,Not Hispanic or Latino,0,2,2
443782,Tremor,racial,Other Race,0,2,2
24969,Laryngitis,racial,White,0,2,2
73383,Full thickness burn of foot,racial,White,2,0,2
133848,Non-traumatic slipped upper femoral epiphysis,racial,Unknown,0,2,2
4103726,Subjective visual disturbance NOS,racial,Unknown,2,0,2
4268973,Jaw-blinking,racial,White,2,0,2
374937,Impairment level: better eye: near-total impairment: lesser-eye: not further specified,racial,White,0,2,2
439222,Corticosteroids adverse reaction,racial,White,2,0,2
440071,Gout associated problems,racial,Filipino,0,2,2
4109880,Varicose veins of the leg with ulcer,racial,Alaska Native,2,0,2
4258683,Faeces - impacted,racial,Unknown,2,0,2
381014,Conjunctival pigmentation,ethnic,Not Hispanic or Latino,2,0,2
77067,Bucket handle tear of lateral meniscus,ethnic,Hispanic or Latino,2,0,2
198558,Nycturia,racial,European,0,2,2
438660,Toxic effect of nonpetroleum-based solvent,ethnic,Not Hispanic or Latino,0,2,2
313792,PT - Paroxysmal tachycardia,racial,Asian,2,0,2
4300419,Submammary mastitis associated with childbirth,racial,Unknown,2,0,2
442189,Blister of wrist without infection,racial,White,2,0,2
81943,Rupture of flexor tendons of hand AND/OR wrist,ethnic,Hispanic or Latino,0,2,2
316535,Closed fracture of dorsal vertebra without spinal cord injury,racial,Black or African American ,0,2,2
196455,Hepatorenal syndrome,racial,Unknown,2,0,2
436519,Perinatal intraventricular hemorrhage,racial,Unknown,2,0,2
4070287,Preauricular sinus and fistula,racial,White,2,0,2
373470,Polyneuropathy due to toxic agents,racial,Unknown,2,0,2
254796,Open wound of nose with complication,ethnic,Hispanic or Latino,0,2,2
197612,Abortion complicated by delayed AND/OR excessive hemorrhage,racial,Unknown,2,0,2
434328,"Nondependent cannabis abuse, episodic",racial,Unknown,0,2,2
438259,Umbilical hemorrhage after birth,racial,White,2,0,2
4050091,Open wound of penis,racial,Unknown,0,2,2
436166,Mild hyperemesis gravidarum,racial,American Indian or Alaska Native ,2,0,2
192450,Not passing urine,racial,Asian,0,2,2
435774,Disorder of amino acid metabolism,racial,Unknown,2,0,2
444028,Open wound of alveolar process without complication,racial,Unknown,2,0,2
312998,Pain in thoracic spine,racial,Filipino,0,2,2
432968,Anemia during pregnancy - baby delivered,racial,Black or African American ,2,0,2
432419,Encephalocele,ethnic,Hispanic or Latino,2,0,2
4146235,Other cellulitis and abscess,ethnic,Not Hispanic or Latino,2,0,2
376712,Purulent otitis media,racial,Asian,2,0,2
4104072,Purulent otitis media NOS,racial,White,2,0,2
77624,"Breast engorgement in pregnancy, the puerperium or lactation - delivered",racial,White,2,0,2
4098311,Borderline psychosis of childhood,ethnic,Not Hispanic or Latino,2,0,2
438105,Benign tumour of mediastinum,racial,White,0,2,2
443232,Eyelid and lacrimal drainage system laceration,racial,Unknown,0,2,2
192359,RF - Renal failure,racial,Asian Indian,0,2,2
259865,Cyst of Bartholin's gland duct,racial,American Indian or Alaska Native ,2,0,2
4070557,Incision of testis,racial,White,2,0,2
4029488,Hepatic encephalopathy,racial,Other Race,2,0,2
435925,Very premature - less than 1000g or less than 28 weeks,racial,Black or African American ,0,2,2
4113680,Ruptured tubal pregnancy,ethnic,Hispanic or Latino,2,0,2
78230,Rheumatoid arthritis with organ / system involvement,racial,Black or African American ,2,0,2
197593,Impaction of intestine,ethnic,Not Hispanic or Latino,0,2,2
376229,Abnormal involuntary movement,racial,Native Hawaiian or Other Pacific Islander ,0,2,2
4103737,"Better eye: low vision, Lesser eye: profound visual impairment",ethnic,Hispanic or Latino,2,0,2
197096,Urethra and bladder neck atresia and stenosis,ethnic,Hispanic or Latino,0,2,2
432451,Abnormal results of function studies of central nervous system,ethnic,Not Hispanic or Latino,0,2,2
79915,Hemarthrosis of hand,racial,Asian,2,0,2
440404,Stenosis of lacrimal punctum,racial,Unknown,2,0,2
378742,Blind hypotensive eye,ethnic,Not Hispanic or Latino,2,0,2
75608,Shoulder dystocia with antenatal problem,racial,White,2,0,2
435850,Cyst of jaw,ethnic,Not Hispanic or Latino,2,0,2
432609,"Acute alcoholic intoxication in remission, in alcoholism",racial,Unknown,0,2,2
312664,Influenza with respiratory manifestation other than pneumonia,racial,Native Hawaiian or Other Pacific Islander ,2,0,2
438460,Edentulous alveolar ridge atrophy,racial,Filipino,2,0,2
435866,Retrograde ejaculation,ethnic,Not Hispanic or Latino,0,2,2
4002318,Cleft palate with cleft lip NOS,ethnic,Hispanic or Latino,2,0,2
434183,"Closed fracture distal humerus, medial epicondyle",racial,Unknown,0,2,2
434501,"Open fracture ankle, trimalleolar",ethnic,Hispanic or Latino,2,0,2
4066882,Excision of anal skin tag,ethnic,Hispanic or Latino,2,0,2
4030398,Amputation of arm through shoulder,racial,Unknown,0,2,2
372894,central serous retinopathy,racial,White,0,2,2
80800,Polymyositis,ethnic,Not Hispanic or Latino,0,2,2
194093,Postcoital bleeding,racial,Black or African American ,2,0,2
441829,Hyperosmolality and or hypernatremia,racial,Native Hawaiian or Other Pacific Islander ,0,2,2
434193,Closed dislocation of distal radioulnar joint of wrist,ethnic,Hispanic or Latino,2,0,2
373127,Herpes simplex disciform keratitis,ethnic,Not Hispanic or Latino,0,2,2
78516,Arthralgia of the upper arm,racial,Filipino,2,0,2
4064377,Depression screening,racial,European,0,2,2
193693,Viral hepatitis without hepatic coma,racial,White,2,0,2
78509,Loose body in joint of ankle and/or foot,ethnic,Hispanic or Latino,2,0,2
4114314,Screening for osteoporosis,racial,Asian Indian,2,0,2
376793,Congenital anomaly of ear with impairment of hearing,racial,Asian,2,0,2
442334,Synovitis AND/OR tenosynovitis associated with another disease,ethnic,Hispanic or Latino,2,0,2
40353121,"Accidental cut, puncture, perforation or haemorrhage during medical care",ethnic,Hispanic or Latino,2,0,2
441139,Instantaneous death,racial,Unknown,2,0,2
81424,Closed dislocation of knee,racial,Other Race,0,2,2
197925,Haemorrhage of rectum and anus,racial,Native Hawaiian or Other Pacific Islander ,0,2,2
255841,Chronic bronchitis,racial,American Indian or Alaska Native ,2,0,2
316866,Hyperpiesis,racial,Unknown,2,0,2
436900,Mycoplasmosis,ethnic,Hispanic or Latino,0,2,2
432789,Opioid analgesic adverse reaction,racial,Black or African American ,0,2,2
4001802,"Other muscle, ligament and fascia disorder",racial,White,0,2,2
436446,Cracked tooth syndrome,racial,Black or African American ,0,2,2
442790,Growth and development,racial,Unknown,2,0,2
442073,Malunion and nonunion of fracture,racial,White,2,0,2
437175,"Fall on same level from slipping, tripping or stumbling",racial,Black or African American ,2,0,2
4288725,Lithium therapy,ethnic,Not Hispanic or Latino,2,0,2
432944,Major anomaly of jaw size,ethnic,Not Hispanic or Latino,0,2,2
4242435,Reifenstein syndrome,ethnic,Hispanic or Latino,0,2,2
434758,Exceptionally large baby,ethnic,Hispanic or Latino,2,0,2
30061,Neoplasm of uncertain behaviour of major salivary gland,racial,Asian,2,0,2
378352,Conjunctivitis due to adenovirus,ethnic,Hispanic or Latino,2,0,2
79915,Hemarthrosis of hand,ethnic,Hispanic or Latino,0,2,2
4062636,Bacterial disease screening,racial,Asian,2,0,2
433687,Botulism,racial,Unknown,0,2,2
437240,Carcinoma in situ of skin of upper limb and shoulder,ethnic,Hispanic or Latino,0,2,2
378439,Fourth nerve palsy,ethnic,Not Hispanic or Latino,2,0,2
4235140,Operation for bone injury of phalanges of hand,racial,Other Race,2,0,2
438947,Burning due to contact with hot water,ethnic,Hispanic or Latino,2,0,2
4112831,Extrinsic asthma NOS,racial,Black or African American ,0,2,2
442920,Mental disorder during pregnancy - baby delivered,ethnic,Not Hispanic or Latino,2,0,2
434348,Acute and subacute iridocyclitis,racial,Other Race,2,0,2
78786,Pleurisy,racial,Black or African American ,2,0,2
201958,Perinatal dermatological disorders,racial,Asian,2,0,2
377573,Pars tensa central perforation,racial,Unknown,2,0,2
435658,Atypical squamous cells on vaginal Papanicolaou smear cannot exclude high grade squamous intraepithelial lesion,ethnic,Not Hispanic or Latino,2,0,2
432571,Malignant lymphoma,racial,American Indian or Alaska Native ,2,0,2
4119298,Late onset asthma,racial,Native Hawaiian or Other Pacific Islander ,0,2,2
4249474,Generalized seborrheic dermatitis of infants,racial,Black or African American ,0,2,2
72618,Disorder of muscle,racial,Filipino,0,2,2
4177025,Fracture of patella,ethnic,Hispanic or Latino,0,2,2
195594,Spontaneous abortion complicated by delayed AND/OR excessive hemorrhage,racial,Unknown,2,0,2
201341,Incisional hernia with obstruction but no gangrene,ethnic,Hispanic or Latino,0,2,2
439987,"Accident caused by hot liquid and vapor, including steam",racial,Unknown,2,0,2
439799,Leg cramps,racial,American Indian or Alaska Native ,2,0,2
81636,Excessive foetal growth affecting management of mother,ethnic,Not Hispanic or Latino,2,0,2
73008,Enthesopathy,racial,Filipino,2,0,2
192387,Obstetric perineal wound disruption - delivered with postnatal complication,ethnic,Not Hispanic or Latino,2,0,2
437167,Accident caused by firearm missile,ethnic,Not Hispanic or Latino,0,2,2
134668,Chronic maxillary sinusitis,racial,Black or African American ,2,0,2
432593,Kwashiorkor,ethnic,Not Hispanic or Latino,2,0,2
197484,Diarrhea of presumed infectious origin,racial,Filipino,2,0,2
442604,Hypertensive heart disease,racial,Filipino,0,2,2
4148244,SN - Supernumerary tooth,racial,White,0,2,2
436118,After-cataract with vision obscured,racial,Asian,0,2,2
4179332,Parent-child problem,racial,Black or African American ,2,0,2
315831,Chronic pulmonary heart disease,racial,Native Hawaiian or Other Pacific Islander ,0,2,2
4090094,Unspecified histoplasmosis infection,racial,White,0,2,2
444413,Pyrexial convulsion,racial,Other Race,0,2,2
443219,Dental occlusion observation,ethnic,Hispanic or Latino,2,0,2
201341,Incisional hernia with obstruction but no gangrene,racial,White,0,2,2
139753,Primary malignant neoplasm of parathyroid gland,ethnic,Not Hispanic or Latino,0,2,2
4001965,Infection of multiple bones,racial,White,2,0,2
196471,Puberty bleeding,racial,White,2,0,2
194175,Left upper quadrant pain,racial,American Indian,2,0,2
195317,Incomplete spontaneous abortion with genital tract or pelvic infection,ethnic,Hispanic or Latino,2,0,2
194984,Hepatopathy,racial,Black or African American ,0,2,2
376981,Amblyopia,ethnic,Not Hispanic or Latino,0,2,2
198124,Disorder of kidney,racial,American Indian or Alaska Native ,0,2,2
141213,Scarlet fever,racial,Asian,2,0,2
40421730,"Adverse reaction to mixed bacterial vaccines, excluding combinations with a pertussis component",racial,White,0,2,2
135858,Disorder of lip,racial,Filipino,2,0,2
132579,Giant-cell thyroiditis,racial,Unknown,0,2,2
438460,Edentulous alveolar ridge atrophy,racial,Other Race,2,0,2
435553,Watery eye,racial,Black or African American ,2,0,2
196654,Lipoma of intra-abdominal organs,ethnic,Hispanic or Latino,2,0,2
73231,Arthralgia of temporomandibular joint,racial,Black or African American ,2,0,2
138641,Foreign body in tracheobronchial tree,ethnic,Hispanic or Latino,0,2,2
434810,Burn of genitalia,ethnic,Not Hispanic or Latino,2,0,2
434228,Passenger in vehicular AND/OR traffic accident,ethnic,Hispanic or Latino,0,2,2
4004785,Fetal alcohol syndrome,racial,Other Race,0,2,2
314059,Right bundle branch block,racial,American Indian,0,2,2
372828,Zoster ophthalmicus,ethnic,Not Hispanic or Latino,0,2,2
434327,Cannabis abuse,racial,Other Race,0,2,2
440858,Cortex contusion without open intracranial wound,racial,White,2,0,2
4086918,Viral screening,racial,Alaska Native,0,2,2
4064362,Mycotic infection screening,racial,Unknown,2,0,2
439847,Intracranial hemorrhage,ethnic,Not Hispanic or Latino,0,2,2
81878,Benign paroxysmal positional vertigo,racial,American Indian or Alaska Native ,2,0,2
201823,Benign tumour of penis,ethnic,Hispanic or Latino,0,2,2
314659,Arteritis,ethnic,Not Hispanic or Latino,0,2,2
435658,Atypical squamous cells on vaginal Papanicolaou smear cannot exclude high grade squamous intraepithelial lesion,racial,Asian,2,0,2
4240902,Allergy to peanuts,racial,Filipino,2,0,2
194408,Hydroureter,ethnic,Not Hispanic or Latino,0,2,2
4096347,Gouty arthropathy,racial,Filipino,0,2,2
442632,Abrasion AND/OR friction burn of wrist with infection,racial,Asian,0,2,2
381010,Intralenticular foreign body,ethnic,Hispanic or Latino,2,0,2
377535,Sleep walking disorder,ethnic,Not Hispanic or Latino,0,2,2
440690,Social phobia,racial,Black or African American ,0,2,2
76270,Superficial injury of foot with infection,ethnic,Hispanic or Latino,2,0,2
30061,Neoplasm of uncertain behaviour of major salivary gland,ethnic,Not Hispanic or Latino,2,0,2
442609,Friction blister without infection,racial,Asian,0,2,2
201221,Intestinal infection due to Class Cestoda and/or Class Trematoda and/or Phylum Nemata,ethnic,Hispanic or Latino,0,2,2
81705,Open dislocation of knee,ethnic,Hispanic or Latino,2,0,2
4102738,Screening for mental disorders,racial,Asian,2,0,2
317971,Respiratory system congenital anomalies,racial,Unknown,2,0,2
432441,Finding of length of gestation,racial,Unknown,0,2,2
4256640,Body mass index 40+ - severely obese,racial,American Indian or Alaska Native ,2,0,2
140586,Collapse - heat,racial,Unknown,0,2,2
133088,Late amputation stump complication,racial,Black or African American ,0,2,2
438259,Umbilical hemorrhage after birth,racial,Unknown,0,2,2
435230,Multiple personality disorder,racial,White,2,0,2
315558,Atherosclerosis of arteries of the extremities,racial,Alaska Native,2,0,2
437881,Malignant otitis externa,ethnic,Not Hispanic or Latino,2,0,2
436027,Coxsackie virus disease,racial,Black or African American ,0,2,2
4067061,Psoriasis and similar disorders NOS,ethnic,Hispanic or Latino,2,0,2
440921,Traumatic injury,racial,Other Race,2,0,2
432453,General clinical state finding,racial,Other Race,2,0,2
141022,Orbital tenonitis,racial,Unknown,2,0,2
4310682,Multiple open wounds with complication,racial,Asian,2,0,2
440851,Open fracture of forearm,ethnic,Hispanic or Latino,2,0,2
196433,Aneurysm of iliac artery,racial,Unknown,0,2,2
439303,Horseshoe retinal tear without detachment,ethnic,Hispanic or Latino,0,2,2
4112364,Other upper respiratory tract diseases,racial,Unknown,2,0,2
440370,Nutritional marasmus,ethnic,Hispanic or Latino,0,2,2
433822,Complication related to pregnancy,racial,Asian,2,0,2
435231,Nondependent cannabis abuse in remission,racial,White,0,2,2
438105,Benign tumour of mediastinum,racial,Unknown,2,0,2
378442,Conductive hearing loss of combined sites,racial,Unknown,0,2,2
132822,Foot-and-mouth disease,racial,Black or African American ,2,0,2
441085,Elderly primip,racial,Asian,2,0,2
376113,Recent subtotal retinal detachment,racial,Other Race,0,2,2
444236,Superficial foreign body of hand without major open wound but with infection,racial,Unknown,2,0,2
440422,Noise-induced hearing loss,racial,White,2,0,2
439968,Late effect of tendon injury,ethnic,Hispanic or Latino,0,2,2
81707,Closed fracture cuboid,racial,White,2,0,2
135489,Primary malignant neoplasm of male breast,ethnic,Hispanic or Latino,2,0,2
441274,Developmental expressive language disorder,racial,Asian,0,2,2
253788,Nasal polyp,racial,Filipino,0,2,2
22666,Vomiting after gastrointestinal tract surgery,racial,Unknown,2,0,2
4103726,Subjective visual disturbance NOS,racial,White,2,0,2
195501,Polycystic ovaries,racial,Black or African American ,2,0,2
442289,Death in less then 24 hours from onset of symptoms,ethnic,Hispanic or Latino,0,2,2
81670,Congenital anomaly of spine,racial,Other Race,2,0,2
444070,Tachycardia,racial,American Indian or Alaska Native ,2,0,2
4167069,Aneurysm clipping,racial,Unknown,0,2,2
439222,Corticosteroids adverse reaction,racial,Unknown,2,0,2
378087,Secondary malignant neoplasm of brain and spinal cord,racial,White,2,0,2
437854,Cataplexy and narcolepsy,racial,White,0,2,2
440855,Closed fracture of base of metacarpal bone other than first metacarpal,racial,Other Race,2,0,2
438090,"Overlapping malignant neoplasm of rectum, anus and anal canal",ethnic,Hispanic or Latino,0,2,2
433073,Superficial burn of back of hand,racial,Unknown,2,0,2
4106274,Neonatal cardiac arrest,racial,White,0,2,2
198289,Nonvenomous insect bite of hip without infection,racial,Black or African American ,2,0,2
198291,Burn of abdominal wall,racial,White,2,0,2
434820,Cold injury,ethnic,Hispanic or Latino,0,2,2
438727,Atypical depressive disorder,racial,Asian,2,0,2
73843,Synovial cyst of popliteal space,racial,Black or African American ,0,2,2
80493,Ankylosis of joint,racial,White,2,0,2
77355,Articular cartilage disorder of ankle AND/OR foot,racial,White,0,2,2
79936,Polyuria,racial,American Indian or Alaska Native ,2,0,2
317376,Tachypnoeic,racial,Other Race,0,2,2
4201472,Varicella contact,racial,American Indian or Alaska Native ,2,0,2
438952,Assault by striking with motor vehicle,ethnic,Hispanic or Latino,0,2,2
197044,Female infertility associated with anovulation,racial,Asian,2,0,2
441919,Twin pregnancy,racial,Unknown,2,0,2
437745,Victim of infant/child neglect,ethnic,Not Hispanic or Latino,2,0,2
4051564,FH: Metabolic disorder,racial,Asian,2,0,2
432463,"Closed fracture clavicle, lateral end",racial,Black or African American ,0,2,2
196236,Septicaemic shock,ethnic,Not Hispanic or Latino,0,2,2
77638,Displacement of intervertebral disc without myelopathy,racial,American Indian,0,2,2
436587,"Toxic effect of gas, fumes AND/OR vapors",racial,White,0,2,2
4140734,Amniocentesis for possible chromosomal abnormality,racial,White,2,0,2
373756,Exudative retinopathy,ethnic,Not Hispanic or Latino,0,2,2
432447,Atypical glandular cells on cervical Papanicolaou smear,racial,Black or African American ,2,0,2
443345,Antineoplastic adverse reaction,racial,Unknown,0,2,2
4282316,Recurrent major depression,ethnic,Not Hispanic or Latino,0,2,2
75042,Allergic arthritis of the shoulder region,ethnic,Not Hispanic or Latino,0,2,2
373995,Delirium,racial,Native Hawaiian or Other Pacific Islander ,0,2,2
434903,Ego-dystonic sexual orientation,ethnic,Hispanic or Latino,2,0,2
379032,Acute mastoiditis with complications,racial,Unknown,0,2,2
4299574,Factitious skin disease,racial,Black or African American ,0,2,2
432898,Severe mental handicap,racial,Asian,0,2,2
434246,Burn with deep necrosis of underlying tissues without loss of body part,ethnic,Hispanic or Latino,2,0,2
253009,Thoracogenic scoliosis,racial,White,2,0,2
4023168,Home alone,racial,Unknown,2,0,2
380859,Closed fracture of lower jaw bone,ethnic,Hispanic or Latino,0,2,2
436040,Infection by Strongyloides,ethnic,Not Hispanic or Latino,0,2,2
4055742,Acute pericementitis,ethnic,Not Hispanic or Latino,0,2,2
314965,Embolism and thrombosis of an arm or leg artery,ethnic,Not Hispanic or Latino,0,2,2
4194160,Thyroid function tests abnormal,racial,Filipino,0,2,2
438204,Edema or excessive weight gain in pregnancy without mention of hypertension,ethnic,Not Hispanic or Latino,2,0,2
435320,Acute glomerulonephritis associated with another disorder,racial,Unknown,0,2,2
434584,Epidemic Kaposi's sarcoma,racial,White,0,2,2
444098,"Gestation period, 40 weeks",ethnic,Not Hispanic or Latino,0,2,2
135030,Discoloration of skin,racial,Black or African American ,2,0,2
443404,Postpartum disorder,ethnic,Hispanic or Latino,2,0,2
438438,Acute myocardial infarction of anterolateral wall,racial,Unknown,2,0,2
4273622,Operation on bone injury of carpals and metacarpals,ethnic,Not Hispanic or Latino,0,2,2
442077,Anxiety disorder,racial,Black or African American ,0,2,2
373461,Leukocoria,ethnic,Not Hispanic or Latino,2,0,2
381866,Degenerative disorder of eyelid,racial,Unknown,2,0,2
4172146,Proctostomy,ethnic,Hispanic or Latino,0,2,2
4105030,Other endophthalmitis,racial,White,2,0,2
136865,Injury of radial nerve,ethnic,Hispanic or Latino,0,2,2
4144123,Other kidney and ureter disorders,racial,White,2,0,2
440129,Hypertrophy of nasal turbinates,racial,Other Race,2,0,2
28083,Primary malignant neoplasm of pharynx,ethnic,Not Hispanic or Latino,0,2,2
433752,Impulse control disorder,racial,Black or African American ,0,2,2
435509,Intracranial abscess,ethnic,Hispanic or Latino,0,2,2
438722,Non megaloblastic anemia associated with nutritional deficiency,racial,Black or African American ,2,0,2
435797,Selective immunoglobulin dysfunction,ethnic,Hispanic or Latino,2,0,2
75908,Kissing spine,racial,White,0,2,2
4153727,Closed fracture of other tarsal and metatarsal bones,ethnic,Hispanic or Latino,0,2,2
4314713,Abusive parenting,racial,White,2,0,2
372613,Flaccid hemiplegia,racial,Other Race,0,2,2
197981,Abdominal tenderness,racial,American Indian or Alaska Native ,0,2,2
432598,Subchronic schizophrenia with acute exacerbations,racial,Black or African American ,2,0,2
135030,Discoloration of skin,racial,Filipino,2,0,2
4063304,Rhesus isoimmunization unspecified,ethnic,Hispanic or Latino,2,0,2
432821,Leprosy,ethnic,Hispanic or Latino,0,2,2
4146239,Pruritus of genital organs,racial,Other Race,2,0,2
377545,Episodic tension-type headache,ethnic,Not Hispanic or Latino,0,2,2
442632,Abrasion AND/OR friction burn of wrist with infection,ethnic,Not Hispanic or Latino,0,2,2
437483,Homicide or assault by unarmed fight or brawl,racial,White,2,0,2
440985,Phobia,racial,American Indian or Alaska Native ,0,2,2
4268980,Finding of general development,racial,Black or African American ,2,0,2
4064917,Urinary neoplasm screening,ethnic,Hispanic or Latino,0,2,2
201238,Primary malignant neoplasm of female genital organ,ethnic,Not Hispanic or Latino,0,2,2
139980,Burn erythema of forearm,racial,White,0,2,2
4104054,Vitreous disorders NOS,ethnic,Hispanic or Latino,2,0,2
132736,Bacteremia,racial,Other Race,2,0,2
4311159,Midline cystocele,racial,Black or African American ,2,0,2
443782,Tremor,racial,American Indian or Alaska Native ,2,0,2
438480,"Abnormal glucose tolerance in mother complicating pregnancy, childbirth AND/OR puerperium",racial,Other Race,2,0,2
197593,Impaction of intestine,ethnic,Hispanic or Latino,2,0,2
435875,"Complications of pregnancy, childbirth and the puerperium",racial,Other Race,2,0,2
440422,Noise-induced hearing loss,racial,Unknown,2,0,2
437745,Victim of infant/child neglect,racial,Asian,2,0,2
196236,Septicaemic shock,racial,Asian,0,2,2
433860,IAA - Interrupted aortic arch,racial,White,2,0,2
4056196,Other breast disorders,ethnic,Hispanic or Latino,2,0,2
195007,Female stress incontinence,racial,Filipino,2,0,2
80141,Functional diarrhea,racial,Other Race,0,2,2
193525,Abdominal pregnancy,racial,Asian,2,0,2
440276,"Infection AND/OR inflammatory reaction due to internal prosthetic device, implant AND/OR graft",racial,Native Hawaiian or Other Pacific Islander ,0,2,2
192759,Sequelae of fracture of spine,ethnic,Hispanic or Latino,2,0,2
372651,Chronic mastoiditis,racial,White,2,0,2
74216,Injury of nerves at shoulder and upper arm level,racial,White,2,0,2
196813,Simple renal cyst,racial,Unknown,2,0,2
433706,Yaws gummata and ulcers,ethnic,Not Hispanic or Latino,2,0,2
197911,Hernia of anterior abdominal wall without obstruction AND without gangrene,racial,Asian,2,0,2
314383,Myocarditis,racial,White,2,0,2
77880,Circumscribed labyrinthitis,ethnic,Hispanic or Latino,2,0,2
433886,Closed fracture of trapezium bone of wrist,racial,Unknown,2,0,2
193530,Follicular cyst of ovary,racial,Other Race,2,0,2
4116761,Lateral meniscus derangement unspecified,racial,Unknown,2,0,2
432875,Anemia due to chronic blood loss,racial,Black or African American ,2,0,2
381574,External auditory canal exostosis,racial,Unknown,2,0,2
314426,Congenital cardiovascular disorder during pregnancy - baby not yet delivered,ethnic,Not Hispanic or Latino,2,0,2
443982,Traumatic amputation of thumb,racial,Unknown,0,2,2
432881,Pancytopenia,racial,Black or African American ,2,0,2
374037,Night blindness,ethnic,Hispanic or Latino,2,0,2
195209,Benign neoplasm of liver and/or biliary ducts,racial,Asian,2,0,2
4050929,FH: Skin disease,racial,White,2,0,2
195583,Chronic gastric ulcer without hemorrhage AND without perforation but with obstruction,racial,White,2,0,2
4088083,Tuberculosis of other organs,ethnic,Hispanic or Latino,0,2,2
74124,Traumatic arthropathy,racial,Other Race,0,2,2
373356,Open wound of multiple sites of ear with complication,racial,White,2,0,2
201905,Constipation by outlet obstruction,ethnic,Hispanic or Latino,2,0,2
435231,Nondependent cannabis abuse in remission,racial,Unknown,2,0,2
195588,Cystitis,racial,Filipino,2,0,2
4064362,Mycotic infection screening,racial,White,2,0,2
76255,Sprain of iliofemoral ligament,racial,American Indian or Alaska Native ,0,2,2
4088777,Vagina observation,racial,Other Race,2,0,2
4082086,No home medical services,racial,White,2,0,2
440005,Complication of medical care,racial,Asian,0,2,2
4196206,beta^+^ Thalassemia,racial,Asian,2,0,2
435207,"Nodular lymphoma of lymph nodes of head, face and neck",racial,White,0,2,2
381559,Sensory disorder of eyelid,racial,Unknown,2,0,2
434697,Maternal tobacco abuse,ethnic,Not Hispanic or Latino,2,0,2
80249,Sprain of acromioclavicular ligament,ethnic,Not Hispanic or Latino,0,2,2
4103737,"Better eye: low vision, Lesser eye: profound visual impairment",ethnic,Not Hispanic or Latino,0,2,2
141022,Orbital tenonitis,ethnic,Hispanic or Latino,2,0,2
380421,Tympanic membrane marginal perforation,ethnic,Not Hispanic or Latino,2,0,2
4146239,Pruritus of genital organs,racial,Filipino,0,2,2
376412,Acute follicular conjunctivitis,racial,Unknown,2,0,2
439002,Eating disorder,racial,Native Hawaiian or Other Pacific Islander ,0,2,2
73904,Open wound of buttock without complication,racial,Black or African American ,2,0,2
433751,Prolonged depressive adjustment reaction,racial,Black or African American ,2,0,2
4293175,"Mental state, behaviour and/or psychosocial function finding",racial,American Indian or Alaska Native ,0,2,2
135858,Disorder of lip,racial,American Indian or Alaska Native ,0,2,2
138825,Actinic keratosis,racial,American Indian,2,0,2
433452,"Cannabis dependence, continuous",ethnic,Hispanic or Latino,0,2,2
316478,"Heart disease in mother complicating pregnancy, childbirth AND/OR puerperium",racial,White,2,0,2
196654,Lipoma of intra-abdominal organs,ethnic,Not Hispanic or Latino,2,0,2
140318,"Septicemia due to streptococcus, group A",ethnic,Not Hispanic or Latino,2,0,2
4152047,Lipid screening,racial,Native Hawaiian or Other Pacific Islander ,2,0,2
439968,Late effect of tendon injury,racial,Asian,0,2,2
376416,Chronic dacryoadenitis,racial,Unknown,0,2,2
439025,Dacryocystitis,racial,Other Race,2,0,2
440642,CSD - Cat scratch disease,racial,White,0,2,2
137900,Acute sphenoidal sinusitis,ethnic,Hispanic or Latino,0,2,2
4252735,Mourning,racial,Other Race,2,0,2
139757,Malignant melanoma of skin of lower limb,ethnic,Not Hispanic or Latino,2,0,2
438792,Crowding of teeth,racial,Unknown,2,0,2
433919,Heroin poisoning,ethnic,Hispanic or Latino,0,2,2
4317960,Neonatal respiratory failure,racial,White,2,0,2
133725,Carcinoma in situ of skin of lip,ethnic,Hispanic or Latino,2,0,2
139912,Spondylosis with myelopathy,ethnic,Hispanic or Latino,0,2,2
253797,Post-inflammatory pulmonary fibrosis,racial,Asian Indian,0,2,2
376111,Unqualified visual loss of one eye,racial,Asian,2,0,2
4065992,Cellulitis and abscess of finger unspecified,racial,Unknown,0,2,2
4121123,Haemophagocytic lymphohistiocytosis,racial,White,2,0,2
77357,Intrapelvic protrusion of acetabulum,ethnic,Hispanic or Latino,2,0,2
4299535,Pregnancy confirmed,racial,American Indian or Alaska Native ,2,0,2
139753,Primary malignant neoplasm of parathyroid gland,ethnic,Hispanic or Latino,0,2,2
373101,Injury of ulnar nerve,racial,Other Race,0,2,2
435649,Complication of hemodialysis,ethnic,Hispanic or Latino,0,2,2
81723,Contusion of hand,racial,American Indian or Alaska Native ,2,0,2
377559,Vernal conjunctivitis,racial,Other Race,2,0,2
81943,Rupture of flexor tendons of hand AND/OR wrist,ethnic,Not Hispanic or Latino,0,2,2
317895,Hypertension due to renovascular disease,ethnic,Not Hispanic or Latino,2,0,2
443387,Cancer of stomach,ethnic,Hispanic or Latino,0,2,2
381014,Conjunctival pigmentation,ethnic,Hispanic or Latino,0,2,2
135360,Fainting,racial,Asian Indian,0,2,2
80811,Rupture of extensor tendons of hand AND/OR wrist,racial,White,0,2,2
194087,Hepatitis due to infection,racial,White,0,2,2
321887,Disorder of artery,racial,Black or African American ,2,0,2
435155,Injury of unknown intent by firearms and explosives,ethnic,Hispanic or Latino,0,2,2
4088930,Confirmation of pregnancy,racial,Filipino,2,0,2
132253,Mixed pediculosis,racial,Unknown,2,0,2
313504,Osler hemorrhagic telangiectasia syndrome,racial,White,2,0,2
138225,Disease of sebaceous glands,racial,Filipino,0,2,2
435802,Blepharospasm,racial,Unknown,0,2,2
4128540,Partial excision of pituitary gland by transsphenoidal approach,racial,White,2,0,2
137441,"Insect bite, nonvenomous, of foot and toe, infected",racial,Other Race,2,0,2
258955,Whooping cough due to organism other than Bordetella pertussis,racial,Unknown,2,0,2
318397,Chronic idiopathic thrombocytopenic purpura,ethnic,Not Hispanic or Latino,0,2,2
433243,Anomaly of tooth position,racial,Unknown,2,0,2
4006436,Other congenital musculoskeletal anomalies,racial,White,0,2,2
435795,Fugue,racial,Unknown,2,0,2
438480,"Abnormal glucose tolerance in mother complicating pregnancy, childbirth AND/OR puerperium",racial,Filipino,2,0,2
376807,Congenital macular changes,racial,White,2,0,2
4021168,Natural contraception,racial,Other Race,2,0,2
380669,Benign neoplasm of eyelid including canthus,racial,Asian,0,2,2
138973,Chancroid,racial,Asian,2,0,2
134596,Lymphoid leukemia in remission,ethnic,Hispanic or Latino,2,0,2
197095,Embryonic cyst of fallopian tube and broad ligament,ethnic,Hispanic or Latino,2,0,2
442031,Accidentally struck by or against stationary object,ethnic,Hispanic or Latino,0,2,2
443274,Psychostimulant dependence,racial,Unknown,0,2,2
200579,Superficial injury of hip without infection,racial,Asian,0,2,2
436926,Primary malignant neoplasm of cerebral meninges,ethnic,Hispanic or Latino,0,2,2
4307254,Closed fracture,racial,Black or African American ,0,2,2
195873,Leukorrhagia,racial,American Indian or Alaska Native ,2,0,2
442558,"Gestation period, 32 weeks",racial,Other Race,0,2,2
76201,Non-traumatic rupture of biceps brachii tendon,ethnic,Not Hispanic or Latino,2,0,2
196943,Red blood cell sequestration in spleen,ethnic,Not Hispanic or Latino,0,2,2
4147837,Generalized metabolic disorder,ethnic,Not Hispanic or Latino,0,2,2
73282,"Breast engorgement in pregnancy, the puerperium or lactation with antenatal complication",racial,White,2,0,2
77698,Sprain of coracoclavicular ligament,ethnic,Hispanic or Latino,2,0,2
4211231,Panic disorder without agoraphobia,racial,Black or African American ,0,2,2
437240,Carcinoma in situ of skin of upper limb and shoulder,ethnic,Not Hispanic or Latino,2,0,2
373463,Benign cough headache,racial,White,2,0,2
4065363,Dyschromia NOS,ethnic,Hispanic or Latino,2,0,2
433758,Childhood emotional disorder,ethnic,Not Hispanic or Latino,0,2,2
40479849,Sexual abuse of adult,ethnic,Not Hispanic or Latino,2,0,2
438040,"Adverse reaction to analgesics, antipyretics and antirheumatics",ethnic,Not Hispanic or Latino,0,2,2
252658,Intrinsic asthma without status asthmaticus,racial,American Indian or Alaska Native ,0,2,2
443674,Traumatic amputation of toe(s) with complication,ethnic,Not Hispanic or Latino,2,0,2
444247,Venous thrombosis,racial,Other Race,2,0,2
4124299,Incision and evacuation of thrombosed hemorrhoid,ethnic,Hispanic or Latino,2,0,2
197823,Lipoma of spermatic cord,racial,White,0,2,2
4048191,Enlargement of tonsil or adenoid,racial,Alaska Native,0,2,2
434527,Poisoning by primarily systemic agent,racial,White,2,0,2
4088777,Vagina observation,racial,Filipino,2,0,2
438338,Epidemic meningitis,ethnic,Hispanic or Latino,0,2,2
434254,Heat stroke and sunstroke,racial,White,0,2,2
4175226,Screening for malignant neoplasm of colon,racial,European,0,2,2
380378,Epilepsy,racial,Native Hawaiian or Other Pacific Islander ,2,0,2
442325,Furuncle of foot,racial,Black or African American ,0,2,2
254677,Adenoviral pneumonia,racial,Unknown,2,0,2
139766,Carcinoma in situ of scalp and skin of neck,ethnic,Not Hispanic or Latino,2,0,2
4107655,Observations relating to psychosocial functioning,racial,American Indian or Alaska Native ,2,0,2
376712,Purulent otitis media,racial,Unknown,2,0,2
381285,Peroneal muscular atrophy,racial,Black or African American ,0,2,2
80205,Perinatal condition,racial,Unknown,0,2,2
138896,Open wound of forehead without complication,racial,Asian,0,2,2
4148407,Family history: Cardiovascular disease,racial,Native Hawaiian or Other Pacific Islander ,0,2,2
133737,Acute thyroiditis,racial,Asian,2,0,2
4264281,Open fracture,ethnic,Not Hispanic or Latino,0,2,2
201117,Nonallopathic lesion of pelvic region,racial,Unknown,2,0,2
4177243,Cancer of pharynx,racial,White,0,2,2
438760,Chronic dacryocystitis,racial,Unknown,2,0,2
138973,Chancroid,ethnic,Not Hispanic or Latino,2,0,2
434183,"Closed fracture distal humerus, medial epicondyle",racial,White,2,0,2
436941,Hypervitaminosis A,racial,Unknown,0,2,2
256531,Head and neck swelling,racial,Filipino,2,0,2
79898,Cellulitis and abscess of finger,racial,Native Hawaiian or Other Pacific Islander ,2,0,2
436403,Retinal vasculitis,ethnic,Hispanic or Latino,2,0,2
132412,Failed back syndrome,ethnic,Not Hispanic or Latino,0,2,2
436541,Closed fracture of ulna,racial,Black or African American ,2,0,2
437744,Heat exhaustion,racial,Unknown,2,0,2
261393,Congenital polycystic lung,ethnic,Not Hispanic or Latino,0,2,2
373182,Amyotrophic lateral sclerosis,ethnic,Hispanic or Latino,0,2,2
4012570,High risk sexual behavior,racial,Native Hawaiian or Other Pacific Islander ,2,0,2
443081,Drowning and non-fatal immersion,racial,Other Race,0,2,2
4059178,Gastrojejunal ulcer,ethnic,Not Hispanic or Latino,2,0,2
40484952,Retinal function study abnormal,ethnic,Not Hispanic or Latino,2,0,2
198678,Intestinal infectious disease,racial,Native Hawaiian or Other Pacific Islander ,2,0,2
443012,Diabetes mellitus during pregnancy - baby delivered,racial,White,2,0,2
137944,Bullous dermatosis,racial,Asian,2,0,2
23245,Hemorrhage of esophagus,racial,White,0,2,2
134898,Non-toxic single thyroid nodule,racial,Native Hawaiian or Other Pacific Islander ,2,0,2
255848,Pneumonia,racial,Native Hawaiian or Other Pacific Islander ,2,0,2
436098,Nondependent cocaine abuse in remission,racial,Unknown,2,0,2
381551,Drug-related polyneuropathy,ethnic,Not Hispanic or Latino,2,0,2
4166776,Dupuytren contracture,racial,Other Race,0,2,2
436833,Open fracture of metacarpal bone,racial,Black or African American ,0,2,2
78504,"Arthropathy associated with mycoses, of the hand",racial,White,2,0,2
439968,Late effect of tendon injury,ethnic,Not Hispanic or Latino,0,2,2
72996,"Stiff joint NEC, of the lower leg",racial,Unknown,2,0,2
256716,Asthma with status asthmaticus,racial,Filipino,2,0,2
196654,Lipoma of intra-abdominal organs,racial,Asian,2,0,2
439941,Closed fracture of condyle of humerus,racial,White,0,2,2
435661,Closed orbital blow-out fracture,ethnic,Not Hispanic or Latino,2,0,2
314409,Vascular disorder of penis,ethnic,Hispanic or Latino,0,2,2
261904,Class III buccal segment relationship,ethnic,Not Hispanic or Latino,2,0,2
434821,SIRS - System inflammatory response syndrome,racial,Black or African American ,2,0,2
436097,"Nondependent mixed drug abuse, continuous",racial,Unknown,2,0,2
312939,Thromboangiitis obliterans,ethnic,Hispanic or Latino,2,0,2
319038,Postmyocardial infarction syndrome,ethnic,Not Hispanic or Latino,0,2,2
78518,Observation of shoulder joint,racial,Black or African American ,2,0,2
437116,Closed fracture of distal end of radius,racial,Black or African American ,0,2,2
435028,Puerperal pyrexia of unknown origin,ethnic,Hispanic or Latino,2,0,2
435410,Burn of palm,ethnic,Not Hispanic or Latino,2,0,2
442189,Blister of wrist without infection,racial,Unknown,2,0,2
320073,Neutrophil count below reference range,racial,American Indian or Alaska Native ,2,0,2
4085075,At risk state,racial,Unknown,2,0,2
4179235,Family history of malignant neoplasm of lung,ethnic,Hispanic or Latino,2,0,2
374360,Disorder of optic nerve,racial,Other Race,0,2,2
195771,Secondary diabetes mellitus,racial,Native Hawaiian or Other Pacific Islander ,0,2,2
4179214,Family history of malignant neoplasm of gastrointestinal tract,racial,Asian Indian,0,2,2
40479849,Sexual abuse of adult,racial,Asian,2,0,2
196442,Chronic gastric ulcer with hemorrhage AND with perforation but without obstruction,racial,White,2,0,2
136775,Contact dermatitis due to solar radiation,racial,Asian,2,0,2
74768,Closed fracture of triquetral bone of wrist,ethnic,Hispanic or Latino,2,0,2
74513,Open wound of foot without mention of complication,racial,Other Race,0,2,2
133283,Pyoderma gangrenosum,racial,White,2,0,2
201613,Chronic nonalcoholic liver disease,racial,Filipino,2,0,2
24609,Hypoglycaemia,racial,Filipino,2,0,2
437537,Shyness disorder of childhood,racial,White,0,2,2
4064381,Nephropathy screening,racial,Black or African American ,2,0,2
314090,PET - Mild pre-eclamptic toxaemia,racial,Unknown,2,0,2
444212,Injury of descending left colon without open wound into abdominal cavity,racial,White,0,2,2
4108517,Eustachian tube obstruction NOS,ethnic,Not Hispanic or Latino,0,2,2
439228,Adverse reaction to sulphonamides,racial,White,0,2,2
434891,Hypersomnia disorder related to a known organic factor,racial,Unknown,2,0,2
442023,Poisoning of undetermined intent,ethnic,Not Hispanic or Latino,2,0,2
193306,Situs inversus,racial,Unknown,2,0,2
320136,Disease of respiratory system,racial,Filipino,2,0,2
194408,Hydroureter,ethnic,Hispanic or Latino,2,0,2
432864,Acute schizophrenic episode,racial,Asian,2,0,2
4211527,Operation on globus pallidus,ethnic,Hispanic or Latino,2,0,2
200579,Superficial injury of hip without infection,ethnic,Not Hispanic or Latino,0,2,2
438329,Late effect of motor vehicle accident,racial,Asian,0,2,2
435840,Acute epiglottitis without obstruction,ethnic,Hispanic or Latino,0,2,2
197751,Burn of lower limb,ethnic,Hispanic or Latino,2,0,2
192364,Nephrotic syndrome associated with another disorder,racial,Asian,0,2,2
196158,Disease of penis,racial,Filipino,0,2,2
440692,"Cocaine dependence, episodic",ethnic,Hispanic or Latino,2,0,2
4145010,Knee enthesopathy NOS,ethnic,Hispanic or Latino,0,2,2
4101199,Hearing problem,racial,Asian,0,2,2
444361,Nonvenomous insect bite of toe without infection,ethnic,Not Hispanic or Latino,0,2,2
4097586,Myeloid leukaemia NOS,ethnic,Hispanic or Latino,0,2,2
377788,General paresis,ethnic,Hispanic or Latino,2,0,2
196654,Lipoma of intra-abdominal organs,racial,White,2,0,2
4141622,Asthma NOS,racial,Asian,2,0,2
441482,Administrative reason for encounter,racial,Native Hawaiian or Other Pacific Islander ,2,0,2
194475,Singultus,racial,Other Race,0,2,2
442530,Broken tooth injury with complication,racial,Unknown,2,0,2
4061587,Obstetric pulmonary embolism NOS,racial,White,0,2,2
24970,Chronic laryngitis,racial,Black or African American ,2,0,2
440387,Cannabis dependence,ethnic,Not Hispanic or Latino,0,2,2
4110501,Bilateral total vocal cord paralysis,racial,Unknown,0,2,2
434824,Injury of cranial nerve,ethnic,Hispanic or Latino,2,0,2
28083,Primary malignant neoplasm of pharynx,racial,Unknown,2,0,2
441077,Stenosis of cervix,racial,Black or African American ,2,0,2
441181,Effects of high altitude,ethnic,Not Hispanic or Latino,2,0,2
377888,CHL - Conductive hearing loss,racial,Black or African American ,0,2,2
318521,Displacement of thoracic intervertebral disc without myelopathy,ethnic,Not Hispanic or Latino,0,2,2
377555,Solar retinitis,ethnic,Hispanic or Latino,2,0,2
260125,Acute bronchiolitis,racial,Native Hawaiian or Other Pacific Islander ,0,2,2
4110945,Benign hypertensive heart disease NOS,racial,Unknown,2,0,2
441739,Burn erythema of axilla,racial,Unknown,2,0,2
199886,Simple endometrial hyperplasia,racial,Unknown,2,0,2
4089994,Serological relapse after treatment of latent early syphilis,ethnic,Not Hispanic or Latino,0,2,2
256716,Asthma with status asthmaticus,racial,Other Race,2,0,2
438542,Gestation less than 24 weeks,ethnic,Not Hispanic or Latino,0,2,2
439987,"Accident caused by hot liquid and vapor, including steam",racial,White,0,2,2
444038,Psychoactive substance-induced organic mood disorder,ethnic,Not Hispanic or Latino,2,0,2
30968,Diabetes insipidus,racial,Native Hawaiian or Other Pacific Islander ,2,0,2
441385,Corrected transposition of great vessels,ethnic,Not Hispanic or Latino,2,0,2
378420,Carcinomatous neuropathy,ethnic,Hispanic or Latino,2,0,2
432741,Abnormal immunology finding,racial,Filipino,2,0,2
4164707,Canceled operative procedure,racial,Asian,0,2,2
374384,Cerebral ischemia,racial,Unknown,0,2,2
380421,Tympanic membrane marginal perforation,racial,Asian,2,0,2
442864,"Splinter of elbow, without major open wound, infected",ethnic,Not Hispanic or Latino,2,0,2
139888,Threatened premature labor - not delivered,racial,Asian,2,0,2
373756,Exudative retinopathy,ethnic,Hispanic or Latino,2,0,2
4273630,Patch repair of arteriovenous fistula,racial,Other Race,0,2,2
444375,"Contact dermatitis due to plants, except food",racial,Asian,0,2,2
192698,Hypertonic uterine dysfunction,ethnic,Hispanic or Latino,0,2,2
377869,Conjunctival deposit,racial,White,0,2,2
4136219,Open reduction of dislocation of knee,ethnic,Hispanic or Latino,2,0,2
136237,Cardiovascular system problem,racial,Asian,2,0,2
4103752,Limited eye examination,ethnic,Hispanic or Latino,2,0,2
433678,Infection of central venous catheter,racial,White,2,0,2
436489,Complication of obstetrical surgery AND/OR procedure,ethnic,Not Hispanic or Latino,2,0,2
440556,Closed transcervical fracture of femur,racial,White,0,2,2
254676,Lung involvement associated with another disorder,ethnic,Not Hispanic or Latino,2,0,2
78605,Superficial bruising of elbow,racial,Black or African American ,0,2,2
4062686,Diabetes mellitus in the pueperium - baby delivered during previous episode of care,ethnic,Not Hispanic or Latino,0,2,2
24909,Hereditary spherocytosis,racial,White,2,0,2
432601,Childhood and adolescent disturbance with elective mutism,ethnic,Hispanic or Latino,0,2,2
75337,Cellulitis and abscess of buttock,racial,American Indian or Alaska Native ,2,0,2
79069,Disease of rectum,racial,Black or African American ,0,2,2
138845,Rheumatism,ethnic,Not Hispanic or Latino,2,0,2
140961,Infestation by Phthirus pubis,ethnic,Hispanic or Latino,0,2,2
433507,Loss of teeth due to local periodontal disease,racial,Unknown,0,2,2
78769,Acute petrositis,ethnic,Not Hispanic or Latino,2,0,2
433505,Subclavian steal syndrome,racial,White,0,2,2
444388,Blister of leg without infection,racial,Other Race,0,2,2
437833,Hypokalaemia,racial,Native Hawaiian or Other Pacific Islander ,2,0,2
81403,Osteopetrosis,racial,Other Race,2,0,2
74396,TMJ - Temporomandibular joint disorder,racial,American Indian or Alaska Native ,2,0,2
135766,Leukaemia in remission,racial,Asian,0,2,2
192433,Congenital hypertrophic pyloric stenosis,racial,Unknown,2,0,2
201093,Infection of skin AND/OR subcutaneous tissue,racial,American Indian or Alaska Native ,2,0,2
433032,Pyrexia postprocedure,racial,Other Race,0,2,2
432541,Primary tuberculosis,ethnic,Hispanic or Latino,0,2,2
4060011,Burn: 20-29% of body surface NOS,racial,Unknown,0,2,2
136661,Nodular goiter,racial,Asian,0,2,2
4052931,Abandoned child,ethnic,Not Hispanic or Latino,2,0,2
40481367,Chronic left-sided ulcerative colitis,racial,White,0,2,2
258482,Abscess of Bartholin's gland,racial,Other Race,2,0,2
440865,Closed fracture of epiphysis of femur,racial,White,0,2,2
76548,Closed dislocation of hip,racial,Native Hawaiian or Other Pacific Islander ,0,2,2
373489,Congenital nystagmus,racial,Black or African American ,2,0,2
4001802,"Other muscle, ligament and fascia disorder",racial,Unknown,0,2,2
81539,Mitochondrial disease,racial,Black or African American ,0,2,2
4171115,Low birth weight infant,racial,Unknown,2,0,2
4066163,Ureteric colic,racial,Asian,0,2,2
432864,Acute schizophrenic episode,ethnic,Not Hispanic or Latino,2,0,2
440371,Disorder of immune function,racial,Unknown,2,0,2
75605,Intrauterine death affecting management of mother,racial,Unknown,2,0,2
372309,Mononeuritis,racial,Filipino,0,2,2
4064924,Ear disorder screening,racial,Unknown,2,0,2
79914,Polydactyly of toes,racial,Other Race,0,2,2
434311,Disorder of the urea cycle metabolism,racial,Unknown,2,0,2
31057,Disorder of pharynx,racial,Native Hawaiian or Other Pacific Islander ,2,0,2
4095592,Malignant melanoma of scalp and/or neck,ethnic,Hispanic or Latino,2,0,2
441026,Orbital deformity due to trauma,racial,Unknown,2,0,2
192364,Nephrotic syndrome associated with another disorder,ethnic,Not Hispanic or Latino,0,2,2
436209,Fracture of fibula,racial,Other Race,2,0,2
200459,Endometrial cystic hyperplasia,racial,White,2,0,2
138708,Acute leukemia,racial,Native Hawaiian or Other Pacific Islander ,0,2,2
376415,Hypermetropia,racial,Other Race,2,0,2
381783,Viral disease of central nervous system,ethnic,Hispanic or Latino,0,2,2
79115,"Spondylopathy, NOS",racial,Other Race,2,0,2
374040,Ill-defined disorder of eye,racial,Other Race,2,0,2
434012,Developmental dyslexia,racial,Unknown,0,2,2
194092,Uterine prolapse without vaginal wall prolapse,racial,American Indian or Alaska Native ,2,0,2
4070523,Massive epicranial subaponeurotic haemorrhage due to birth trauma,ethnic,Hispanic or Latino,0,2,2
4003982,Other specified skin anomalies,racial,Unknown,2,0,2
133284,Impetigo herpetiformis,ethnic,Not Hispanic or Latino,2,0,2
196284,Burn of mouth and pharynx,ethnic,Hispanic or Latino,2,0,2
201635,Female infertility of uterine origin,racial,Unknown,2,0,2
436588,Traumatic wound dehiscence,racial,Unknown,2,0,2
442018,Foreign body accidentally left during a procedure,ethnic,Hispanic or Latino,0,2,2
138176,Acute gingivitis,racial,American Indian or Alaska Native ,2,0,2
434301,Benign neoplasm of ribs and/or sternum and/or clavicle,racial,White,2,0,2
73534,Disproportion between fetus and pelvis,ethnic,Hispanic or Latino,2,0,2
318450,Cardiac tamponade,ethnic,Hispanic or Latino,0,2,2
377558,Irregular astigmatism,racial,White,2,0,2
441126,Monosomy and deletion from autosome,racial,Unknown,2,0,2
138965,Myelitis,ethnic,Hispanic or Latino,0,2,2
432585,Blood coagulation disorder,racial,Asian,0,2,2
435574,Abnormal form of root of tooth,ethnic,Not Hispanic or Latino,0,2,2
375806,Idiopathic peripheral neuropathy,racial,American Indian,2,0,2
4063026,Herpes gestationis NOS,racial,White,2,0,2
257423,"Late effect of burns of eye, face, head AND/OR neck",ethnic,Hispanic or Latino,0,2,2
261327,Empyema of pleura without fistula,racial,Unknown,2,0,2
4103722,Cataract NOS,ethnic,Not Hispanic or Latino,2,0,2
318448,"Incomplete atrioventricular block, second degree",racial,Black or African American ,0,2,2
438261,Neonatal jaundice due to delayed conjugation associated with another disease,racial,Asian,0,2,2
135618,Prurigo,racial,Native Hawaiian or Other Pacific Islander ,0,2,2
381275,Anterior horn cell disease,racial,White,2,0,2
318382,Malignant mast cell tumor of extranodal AND/OR solid organ site,ethnic,Hispanic or Latino,0,2,2
81358,Transverse OR oblique presentation of fetus,ethnic,Hispanic or Latino,2,0,2
433596,Abnormal sputum,racial,Asian,2,0,2
375530,Migraine with prolonged aura,racial,Unknown,2,0,2
73819,Painful breasts,racial,American Indian,2,0,2
4196250,Hyperbaric chamber therapy,ethnic,Hispanic or Latino,2,0,2
437505,Nodular lymphoma of lymph nodes of axilla and upper limb,ethnic,Hispanic or Latino,2,0,2
441741,"Motor vehicle accident, passenger",ethnic,Not Hispanic or Latino,2,0,2
444297,Vertiginous syndrome,racial,Filipino,2,0,2
192735,Malignant ascites,racial,Asian,2,0,2
375527,Headache disorder,racial,Black or African American ,0,2,2
434111,Oligohydramnios,racial,White,2,0,2
4147650,"Muscular calcification and ossification, unspecified",ethnic,Not Hispanic or Latino,0,2,2
140966,Benign neoplasm of skin of face,racial,Asian,2,0,2
40484952,Retinal function study abnormal,racial,Asian,2,0,2
75667,Sprain of calcaneofibular ligament,racial,Unknown,0,2,2
374915,Localisation-related epilepsy,racial,Unknown,0,2,2
4191387,Infertility care,racial,White,0,2,2
381677,SBO - Spina bifida occulta,racial,Other Race,0,2,2
138312,Burn of scalp,ethnic,Hispanic or Latino,2,0,2
137322,Oral submucosal fibrosis,ethnic,Hispanic or Latino,2,0,2
439894,Post-term pregnancy - delivered,ethnic,Hispanic or Latino,2,0,2
75954,Sprain of interphalangeal joint of finger,racial,Unknown,0,2,2
432637,Scleritis with corneal involvement,ethnic,Hispanic or Latino,2,0,2
435610,Varicose veins of perineum and vulva in pregnancy and the puerperium - delivered,racial,Black or African American ,2,0,2
75103,Sprain of jaw,racial,Other Race,2,0,2
437986,FTT - Failure to thrive,racial,Native Hawaiian or Other Pacific Islander ,0,2,2
197601,Spermatocele,racial,Unknown,0,2,2
376422,Mucopurulent conjunctivitis,racial,Filipino,0,2,2
436357,Primary malignant neoplasm of soft tissues of upper limb,ethnic,Hispanic or Latino,0,2,2
436972,Glaucoma associated with systemic syndromes,racial,Alaska Native,0,2,2
432878,Drug abuse using speed,racial,Black or African American ,0,2,2
137497,Dermatophytosis of the body,racial,Native Hawaiian or Other Pacific Islander ,0,2,2
76725,Fissure in ano,racial,American Indian or Alaska Native ,2,0,2
199925,Perinatal intestinal perforation,racial,White,0,2,2
436785,Spinal stenosis in cervical region,racial,Black or African American ,2,0,2
200444,Post-cholecystectomy syndrome,ethnic,Not Hispanic or Latino,2,0,2
444382,Thoracic radiculitis,racial,Filipino,2,0,2
79911,Effusion of joint of upper arm,ethnic,Not Hispanic or Latino,0,2,2
443604,Factitious disorder with predominantly psychological signs and symptoms,racial,Unknown,2,0,2
4120666,Conjunctival biopsy,ethnic,Hispanic or Latino,2,0,2
75863,Chronic interstitial cystitis,racial,Black or African American ,2,0,2
79106,Arthralgia of the pelvic region and thigh,racial,Asian Indian,2,0,2
77734,Contusion of lower leg,racial,Other Race,2,0,2
374040,Ill-defined disorder of eye,racial,Filipino,0,2,2
198809,Acute cholecystitis,racial,Asian,2,0,2
436826,Closed fracture of shaft of radius,racial,Black or African American ,0,2,2
4343127,Evans operation,ethnic,Hispanic or Latino,0,2,2
442075,Chronic glomerulonephritis associated with another disorder,racial,White,0,2,2
441979,Open fracture of upper end of tibia,racial,Native Hawaiian or Other Pacific Islander ,0,2,2
4066244,Caesarean wound disruption unspecified,ethnic,Hispanic or Latino,2,0,2
4137583,Interruption of vena cava,ethnic,Hispanic or Latino,2,0,2
198189,Suppurative peritonitis,racial,White,0,2,2
73318,Polydactyly of fingers,racial,Other Race,0,2,2
76565,Shoulder bruise,ethnic,Not Hispanic or Latino,0,2,2
78228,Joint derangement,racial,Asian,0,2,2
439002,Eating disorder,racial,Black or African American ,2,0,2
443801,Exercise-induced asthma,racial,Asian Indian,2,0,2
4089998,Other venereal diseases,racial,White,2,0,2
132703,Lichen planus,racial,Asian,2,0,2
261889,Simple chronic bronchitis,racial,American Indian or Alaska Native ,2,0,2
76819,Congenital unilateral subluxation of hip,ethnic,Not Hispanic or Latino,0,2,2
252663,Pneumonitis due to inhalation of food or vomitus,racial,Alaska Native,2,0,2
4343820,Diagnostic arthroscopy of hip joint,ethnic,Hispanic or Latino,2,0,2
444052,"Bone AND/OR joint disorder of back in mother complicating pregnancy, childbirth AND/OR puerperium",racial,White,2,0,2
258866,Respiratory distress syndrome in the newborn,racial,White,0,2,2
321638,"Benign essential hypertension complicating pregnancy, childbirth and the puerperium",ethnic,Not Hispanic or Latino,2,0,2
442926,"Motor vehicle traffic accident involving collision with another motor vehicle, parked, driver of motor vehicle injured",racial,Other Race,0,2,2
77815,"Benign neoplasm of vertebral column, excluding sacrum and coccyx",racial,White,2,0,2
4296205,Second degree burn,racial,Other Race,2,0,2
4104558,Unspecified blepharitis,ethnic,Not Hispanic or Latino,0,2,2
73851,Effusion of joint of multiple sites,racial,White,2,0,2
433516,Duodenitis,racial,White,0,2,2
200171,Carbuncle of skin AND/OR subcutaneous tissue,racial,Asian,0,2,2
381304,Impulsive acoustic trauma,racial,Asian,2,0,2
434323,Disorder of sulphur-bearing amino acid metabolism,racial,Unknown,2,0,2
257010,Abscess of lung,racial,Black or African American ,2,0,2
4173657,Congenital malformation of the respiratory system,racial,White,2,0,2
80951,Candidiasis of urogenital site,racial,Native Hawaiian or Other Pacific Islander ,0,2,2
253815,Ulceration of vulva,racial,American Indian or Alaska Native ,2,0,2
435271,Mooren ulcer,ethnic,Hispanic or Latino,0,2,2
81695,Sprain of radiocarpal ligament,ethnic,Not Hispanic or Latino,2,0,2
439700,Inhibited sexual desire,racial,American Indian or Alaska Native ,0,2,2
75121,Burn of lower leg,racial,Unknown,2,0,2
4110501,Bilateral total vocal cord paralysis,ethnic,Hispanic or Latino,0,2,2
4073865,Construction of penis,ethnic,Hispanic or Latino,0,2,2
201792,Nongonococcal urethritis,racial,Unknown,0,2,2
440994,Psychic factor associated with another disorder,racial,White,2,0,2
260936,Infiltrative tuberculosis of lung,racial,White,0,2,2
373201,Acute eustachian tube salpingitis,racial,Black or African American ,2,0,2
201595,Thrombosed internal hemorrhoids,racial,Unknown,2,0,2
79911,Effusion of joint of upper arm,racial,Asian,0,2,2
380731,OE - Otitis externa,racial,Other Race,0,2,2
437127,Closed dislocation of acromioclavicular joint,racial,Other Race,0,2,2
140273,"Contusion, forearm area",racial,Asian,2,0,2
73575,Deformity of toe,racial,Other Race,2,0,2
432795,Traumatic AND/OR non-traumatic injury,racial,Native Hawaiian or Other Pacific Islander ,2,0,2
437169,Disorder of transplanted bone marrow,ethnic,Hispanic or Latino,0,2,2
4098582,Hyperemesis gravidarum before end of 22 week gestation with carbohydrate depletion,ethnic,Hispanic or Latino,2,0,2
132704,Lichen nitidus,racial,White,0,2,2
435726,Mechanical complication of device,racial,Asian,2,0,2
4054550,Open wound of scrotum and testes,ethnic,Hispanic or Latino,0,2,2
73925,Burn of upper limb,ethnic,Not Hispanic or Latino,0,2,2
197227,Overlapping malignant neoplasm of gastrointestinal tract,ethnic,Hispanic or Latino,0,2,2
441918,"Emotional AND/OR mental disease in mother complicating pregnancy, childbirth AND/OR puerperium",racial,American Indian or Alaska Native ,2,0,2
30284,Motion sickness,racial,Other Race,2,0,2
199978,Contusion of lower limb,racial,American Indian or Alaska Native ,2,0,2
4261613,Educational problem,racial,American Indian or Alaska Native ,2,0,2
138519,Spondylosis without myelopathy,racial,American Indian or Alaska Native ,2,0,2
4303359,Acute septal infarction,racial,White,2,0,2
4112365,Woakes' ethmoiditis,ethnic,Hispanic or Latino,0,2,2
381304,Impulsive acoustic trauma,ethnic,Not Hispanic or Latino,2,0,2
433125,Infection due to Staphylocccus aureus,racial,Filipino,0,2,2
137666,Congenital ear lobe absence,ethnic,Hispanic or Latino,0,2,2
372913,Impairment level: one eye: near-total impairment: other eye: not specified,ethnic,Not Hispanic or Latino,2,0,2
195223,Renal carnitine transport defect,ethnic,Not Hispanic or Latino,0,2,2
373724,Neoplasm of brain,racial,Black or African American ,2,0,2
4118958,Unilateral total thyroid lobectomy,ethnic,Not Hispanic or Latino,2,0,2
439053,Exostosis of jaw,ethnic,Not Hispanic or Latino,2,0,2
440751,Peritonsillar abscess,racial,Other Race,0,2,2
440988,Antisocial personality disorder,ethnic,Hispanic or Latino,0,2,2
140489,Acquired acanthosis nigricans,racial,Native Hawaiian or Other Pacific Islander ,2,0,2
73866,Congenital anomaly of breast,racial,Native Hawaiian or Other Pacific Islander ,2,0,2
440758,Posteruptive color change of tooth,racial,Unknown,2,0,2
439233,Poisoning by antidiabetic agent,racial,White,0,2,2
4158567,Post percutaneous transluminal coronary angioplasty,racial,American Indian,2,0,2
438912,Chemical burn of eyelid AND/OR periocular area,ethnic,Not Hispanic or Latino,0,2,2
374649,Strabismic amblyopia,racial,Other Race,0,2,2
442068,Cellulitis and abscess of forearm,racial,Native Hawaiian or Other Pacific Islander ,0,2,2
140018,Tuberculous abscess of spinal cord,ethnic,Hispanic or Latino,0,2,2
4104401,Unspecified corneal oedema,ethnic,Hispanic or Latino,2,0,2
4171556,Ankle ulcer,racial,Other Race,0,2,2
441266,Thiamin deficiency,ethnic,Not Hispanic or Latino,2,0,2
375393,Laceration of skin of eyelid AND periocular area,racial,Black or African American ,0,2,2
438737,Acute paranoid reaction,racial,White,0,2,2
432507,Suicide - hanging,ethnic,Not Hispanic or Latino,0,2,2
196462,Unilateral recurrent femoral hernia without obstruction AND without gangrene,racial,Unknown,2,0,2
375817,Conjunctivochalasis,ethnic,Hispanic or Latino,2,0,2
433701,Mycosis,racial,American Indian or Alaska Native ,2,0,2
193239,Diverticulitis of small intestine,racial,Black or African American ,0,2,2
436246,Low libido,racial,Black or African American ,2,0,2
26378,Hyperpituitarism,racial,Other Race,0,2,2
433486,Acute orbital inflammation,racial,Unknown,2,0,2
258079,Histoplasmosis with pneumonia,racial,White,2,0,2
443397,Malignant tumour of small bowel,ethnic,Hispanic or Latino,0,2,2
138239,Observation of limb structure,racial,American Indian or Alaska Native ,2,0,2
436289,Non-medicinal agent causing toxic effects,ethnic,Not Hispanic or Latino,2,0,2
40484010,Unilateral conductive hearing loss,racial,White,2,0,2
198797,Umbilical hernia with gangrene,ethnic,Hispanic or Latino,2,0,2
194871,Trichomonal vulvovaginitis,racial,American Indian or Alaska Native ,2,0,2
440603,Blood transfusion reaction,racial,White,2,0,2
134404,Anal spasm,ethnic,Not Hispanic or Latino,2,0,2
381569,Myogenic ptosis,racial,White,0,2,2
254561,Pneumonic plague,ethnic,Hispanic or Latino,2,0,2
198700,Liver secondary cancer,racial,White,2,0,2
259874,Ulceration of vulva associated with another disorder,racial,White,2,0,2
196735,Acute pyelonephritis without medullary necrosis,racial,Other Race,2,0,2
195793,Neoplasm of uncertain behavior of uterus,racial,Unknown,2,0,2
433260,Mother delivered,racial,Unknown,2,0,2
198892,Internal injury of abdominal organs without open wound into cavity,racial,Unknown,0,2,2
77070,Allergic arthritis of the hand,ethnic,Not Hispanic or Latino,0,2,2
314664,Long Q-T syndrome,racial,Other Race,2,0,2
4109544,"Total, mature senile cataract",ethnic,Not Hispanic or Latino,2,0,2
432611,Explosive personality disorder,racial,Asian,0,2,2
4078366,Repair of syndactyly,ethnic,Hispanic or Latino,0,2,2
436078,Malnutrition of moderate degree (Gomez: 60% to less than 75% of standard weight),racial,Black or African American ,2,0,2
441321,Chronic nasopharyngitis,racial,Asian,2,0,2
4111255,Unspecified labyrinthitis,racial,Black or African American ,0,2,2
434572,"Pinta, intermediate lesion",racial,White,2,0,2
4112831,Extrinsic asthma NOS,racial,Native Hawaiian or Other Pacific Islander ,0,2,2
379010,Macular retinal puckering,racial,Other Race,2,0,2
80591,Superficial injury of hand without infection,ethnic,Hispanic or Latino,0,2,2
4052804,FH: Allergy,ethnic,Not Hispanic or Latino,0,2,2
373870,Neonatal dacryocystitis and conjunctivitis,racial,Black or African American ,2,0,2
433978,Benign tumour of laryngopharynx,ethnic,Hispanic or Latino,0,2,2
4111411,Aortic valve disorders NOS,ethnic,Not Hispanic or Latino,0,2,2
73373,Burn erythema of upper limb,racial,Asian,2,0,2
4169658,No help available,racial,Unknown,0,2,2
438837,Boutonniere deformity,ethnic,Hispanic or Latino,2,0,2
313543,Venous complication in pregnancy AND/OR the puerperium,racial,White,2,0,2
194861,Syphilis of liver,ethnic,Not Hispanic or Latino,0,2,2
260630,"Tuberculosis of lung, bacteriological and histological examination not done",ethnic,Hispanic or Latino,0,2,2
259153,Throat soreness,racial,Asian Indian,0,2,2
434155,"Intraventricular (nontraumatic) haemorrhage, grade 3, of foetus and newborn",ethnic,Hispanic or Latino,0,2,2
80541,Closed fracture of eight OR more ribs,racial,White,2,0,2
4028827,Manual examination of breast,racial,White,2,0,2
133150,Malignant neoplasm of skin of lower limb and hip,racial,White,2,0,2
442864,"Splinter of elbow, without major open wound, infected",ethnic,Hispanic or Latino,0,2,2
434673,Soft tissue impingement on teeth,ethnic,Not Hispanic or Latino,0,2,2
444125,Satisfactory for evaluation but limited by absence of an endocervical/transformation zone component from a patient with a cervix,racial,American Indian or Alaska Native ,2,0,2
4102739,Screening for cardiovascular system disease,racial,Other Race,0,2,2
320299,Complication of transplanted heart,racial,Native Hawaiian or Other Pacific Islander ,0,2,2
4133967,Meckel's diverticulum,ethnic,Hispanic or Latino,0,2,2
73043,Open traumatic dislocation of shoulder,racial,White,0,2,2
435170,Effects of thirst,racial,Unknown,2,0,2
139900,Urticaria,racial,Asian Indian,0,2,2
195213,Aldosteronism,racial,White,0,2,2
76508,Infectious myositis,ethnic,Hispanic or Latino,2,0,2
436485,Hyperemesis gravidarum with metabolic disturbance,racial,Unknown,2,0,2
79903,Effusion of joint,racial,Black or African American ,2,0,2
438171,Rupture of chordae tendineae,ethnic,Hispanic or Latino,2,0,2
193242,Perforation of intestine,racial,Black or African American ,0,2,2
196625,Viral hepatitis A without hepatic coma,racial,Asian,0,2,2
192735,Malignant ascites,ethnic,Not Hispanic or Latino,2,0,2
441015,Pigmentary iris degeneration,ethnic,Not Hispanic or Latino,2,0,2
438542,Gestation less than 24 weeks,ethnic,Hispanic or Latino,2,0,2
80242,Current tear of medial cartilage AND/OR meniscus of knee,racial,Asian,0,2,2
196044,Primary malignant neoplasm of stomach,racial,Asian,2,0,2
25189,Malignant tumour of mouth,racial,White,0,2,2
4089994,Serological relapse after treatment of latent early syphilis,ethnic,Hispanic or Latino,0,2,2
436298,Adverse reaction to food,racial,Native Hawaiian or Other Pacific Islander ,0,2,2
377277,Impairment level: total impairment of both eyes,racial,Black or African American ,0,2,2
438261,Neonatal jaundice due to delayed conjugation associated with another disease,ethnic,Not Hispanic or Latino,0,2,2
373200,Chronic fungal otitis externa,racial,Other Race,2,0,2
4064360,Leprosy screening,ethnic,Hispanic or Latino,0,2,2
440129,Hypertrophy of nasal turbinates,racial,Native Hawaiian or Other Pacific Islander ,0,2,2
378163,Sounds seem unnaturally loud,racial,Unknown,0,2,2
435574,Abnormal form of root of tooth,racial,Asian,0,2,2
136264,Open wound of floor of mouth without complication,racial,Black or African American ,0,2,2
40479583,Iatrogenic pneumothorax,racial,White,0,2,2
138826,Acne varioliformis,racial,Unknown,2,0,2
135975,Blister of finger without infection,racial,Asian,2,0,2
4064061,Other skin and subcutaneous tissue disorders,racial,Unknown,0,2,2
378768,Acute sanguinous otitis media,ethnic,Hispanic or Latino,2,0,2
4283229,Excision of lesion of spleen,ethnic,Hispanic or Latino,0,2,2
194393,CACS - Coeliac axis compression syndrome,ethnic,Hispanic or Latino,2,0,2
436445,Abrasion of teeth,racial,Filipino,0,2,2
435305,Duodenal ulcer without hemorrhage AND without perforation but with obstruction,ethnic,Hispanic or Latino,2,0,2
197751,Burn of lower limb,ethnic,Not Hispanic or Latino,0,2,2
442941,"Nontraffic accident involving being trapped by door of motor vehicle whilst boarding or alighting from motor vehicle, except off-road vehicle, not on highway, driver of motor vehicle injured",racial,Unknown,0,2,2
75052,Enthesopathy of wrist AND/OR carpus,racial,Asian,2,0,2
136575,Nonvenomous insect bite with infection,racial,Asian,2,0,2
437015,Congenital alveolar hyperplasia of mandible,racial,Unknown,2,0,2
441480,Poisoning by androgen AND/OR anabolic congener,ethnic,Hispanic or Latino,0,2,2
138841,Disorder of sacrum,racial,Asian,2,0,2
193238,Acute appendicitis with peritoneal abscess,racial,White,0,2,2
4111998,Esophageal varices associated with another disorder,racial,White,0,2,2
4216906,Suture of laceration of external ear,ethnic,Hispanic or Latino,0,2,2
378429,Rosacea conjunctivitis,ethnic,Hispanic or Latino,0,2,2
4085922,Infection screening,racial,Black or African American ,0,2,2
441628,Menopausal and postmenopausal disorders,racial,Other Race,2,0,2
440647,Sexually transmitted infectious disease,racial,American Indian or Alaska Native ,2,0,2
194856,Viral hepatitis A with hepatic coma,racial,White,0,2,2
438737,Acute paranoid reaction,racial,Unknown,2,0,2
443522,Neonatal bradycardia,ethnic,Hispanic or Latino,0,2,2
442110,Benign neoplasm of nasal sinus,racial,Unknown,2,0,2
140487,Dermatitis herpetiformis,racial,Unknown,0,2,2
194807,Injury of inferior vena cava,racial,White,0,2,2
372324,Eustachian tube disorder,racial,Filipino,2,0,2
433486,Acute orbital inflammation,racial,White,0,2,2
194152,Renal agenesis and dysgenesis,racial,Other Race,2,0,2
435511,Hypercalcemia,racial,Native Hawaiian or Other Pacific Islander ,2,0,2
132659,Acute apical periodontitis,racial,Asian Indian,0,2,2
254662,Pulmonary infarction,racial,Other Race,2,0,2
141104,Intervertebral disc disorder of lumbar region with myelopathy,racial,Native Hawaiian or Other Pacific Islander ,2,0,2
314369,Malignant hypertensive heart disease without congestive heart failure,racial,Other Race,0,2,2
253815,Ulceration of vulva,racial,Other Race,2,0,2
381504,Post-herpetic trigeminal neuralgia,racial,Asian,2,0,2
440577,Late effect of radiation,racial,Unknown,2,0,2
433985,Hypercarotinemia,racial,Native Hawaiian or Other Pacific Islander ,2,0,2
433000,Patellar tendonitis,racial,Asian,2,0,2
377889,Hearing loss,racial,Asian Indian,2,0,2
4214763,Repair of brain,racial,Other Race,0,2,2
4308543,Postoperative infection NOS,ethnic,Hispanic or Latino,2,0,2
138965,Myelitis,ethnic,Not Hispanic or Latino,2,0,2
381580,Conjunctival degeneration,ethnic,Hispanic or Latino,0,2,2
75050,Coxa valga - acquired,ethnic,Not Hispanic or Latino,0,2,2
193523,Broad ligament laceration syndrome,ethnic,Not Hispanic or Latino,2,0,2
77644,Adhesive capsulitis of shoulder,racial,Asian Indian,2,0,2
440758,Posteruptive color change of tooth,racial,White,2,0,2
197926,Female genital tract-skin fistula,ethnic,Hispanic or Latino,2,0,2
439120,Aseptic necrosis of head AND/OR neck of femur,racial,Asian,2,0,2
442573,Nonpurulent mastitis associated with childbirth,ethnic,Hispanic or Latino,2,0,2
373216,Disorder of mastoid,racial,Unknown,0,2,2
192963,Disease of pancreas,racial,Other Race,0,2,2
72996,"Stiff joint NEC, of the lower leg",racial,White,0,2,2
380728,Filamentary keratitis,racial,White,2,0,2
4109544,"Total, mature senile cataract",racial,Asian,2,0,2
260430,Pneumonia due to E. coli,racial,White,0,2,2
312358,CGN - Chronic glomerulonephritis,racial,Black or African American ,0,2,2
133278,Disorder of hair,racial,American Indian or Alaska Native ,2,0,2
435805,Cerebrospinal rhinorrhoea,ethnic,Not Hispanic or Latino,2,0,2
432262,Primary malignant neoplasm of trachea,ethnic,Hispanic or Latino,2,0,2
378081,Overlapping malignant neoplasm of connective and other soft tissues,racial,Unknown,0,2,2
196284,Burn of mouth and pharynx,ethnic,Not Hispanic or Latino,2,0,2
192815,Intestinal infection due to E. coli,ethnic,Not Hispanic or Latino,0,2,2
256450,Pulmonary asbestosis,racial,White,0,2,2
432537,Assault by handgun,racial,White,0,2,2
373472,Pigmentary retinal dystrophy,racial,Other Race,2,0,2
444256,Polyp of labia,racial,White,2,0,2
437249,Recurrent manic episodes,ethnic,Not Hispanic or Latino,2,0,2
373982,Benign tumour of conjunctiva,racial,White,0,2,2
192357,Paralytic ileus,racial,American Indian or Alaska Native ,2,0,2
4012320,Autotransplantation of thyroid tissue,racial,Other Race,2,0,2
375824,Abnormal auditory perception,racial,Asian,0,2,2
439093,Traumatic lesion during delivery,ethnic,Hispanic or Latino,2,0,2
315831,Chronic pulmonary heart disease,racial,Black or African American ,2,0,2
435141,Haemorrhage AND/OR haematoma complicating procedure,racial,Other Race,2,0,2
4154309,Severe recurrent major depression with psychotic features,racial,Other Race,2,0,2
133803,Periapical abscess with sinus tract,racial,Unknown,2,0,2
372247,Candidal otomycosis,racial,Asian Indian,2,0,2
137351,Epidermoid cyst of skin,racial,American Indian or Alaska Native ,2,0,2
379021,Impairment level: one eye: moderate impairment: other eye: near-normal vision,racial,White,0,2,2
4104391,"Better eye: moderate visual impairment, Lesser eye: moderate visual impairment",racial,White,2,0,2
197440,Nonvenomous insect bite of trunk without infection,racial,Black or African American ,2,0,2
201792,Nongonococcal urethritis,racial,White,2,0,2
440516,Congenital ureterovesical obstruction,ethnic,Hispanic or Latino,0,2,2
432814,Device withdrawn and / or removed,ethnic,Hispanic or Latino,0,2,2
81247,Carcinoma in situ of urinary system,racial,White,2,0,2
138102,Benign tumour of skin,racial,Filipino,2,0,2
81696,Closed fracture of acetabulum,racial,White,2,0,2
4147961,Screening for malignant neoplasm of breast,racial,Asian Indian,2,0,2
436238,Elevated levels of transaminase and lactic acid dehydrogenase,racial,Asian Indian,0,2,2
4151727,Back disorders - other,ethnic,Hispanic or Latino,0,2,2
4104386,"Better eye: profound visual impairment, Lesser eye: profound visual impairment",ethnic,Hispanic or Latino,0,2,2
372309,Mononeuritis,racial,American Indian or Alaska Native ,2,0,2
375292,Perforation of tympanic membrane,racial,American Indian,0,2,2
137111,"Closed fracture scapula, coracoid",racial,White,0,2,2
4097704,Other specified leukaemia,racial,White,2,0,2
443539,Motor vehicle injury,racial,Other Race,0,2,2
316994,Malignant hypertensive heart disease with congestive cardiac failure,racial,Black or African American ,0,2,2
440637,Relapsing fever,ethnic,Not Hispanic or Latino,0,2,2
443752,Ventricular hemorrhage,ethnic,Not Hispanic or Latino,2,0,2
193666,Hip injury,racial,Other Race,2,0,2
438761,Acute dacryocystitis,racial,White,2,0,2
135157,Observation of cardiovascular device,racial,Unknown,0,2,2
440977,Megaloblastic anemia due to folate deficiency,racial,Asian,0,2,2
4064925,Hypertension screening,racial,Native Hawaiian or Other Pacific Islander ,0,2,2
4097567,Nodular lymphoma of unspecified site,ethnic,Hispanic or Latino,2,0,2
376989,Duane's syndrome,racial,White,2,0,2
312723,Congenital heart disease,racial,American Indian or Alaska Native ,2,0,2
4062921,Asymptomatic bacteriuria in pregnancy unspecified,ethnic,Not Hispanic or Latino,2,0,2
201093,Infection of skin AND/OR subcutaneous tissue,racial,Filipino,2,0,2
4210149,Substance abuse counseling,racial,American Indian,0,2,2
4008517,"Fracture of rib(s), sternum, larynx and trachea",racial,White,0,2,2
435243,Alcohol dependence,racial,Asian,0,2,2
373449,Drug-induced delirium,racial,Unknown,2,0,2
440927,High risk drug monitoring status,racial,Other Race,0,2,2
4147630,Other disorders of binocular eye movements,racial,White,2,0,2
4064908,Trypanosomiasis screening,racial,Unknown,2,0,2
4008566,Atypical schizophrenia,racial,Unknown,2,0,2
441259,Non-thrombocytopenic purpura,racial,Asian,2,0,2
442425,Lumbar post-laminectomy syndrome,racial,Black or African American ,0,2,2
443545,Nonvenomous insect bite,racial,American Indian,0,2,2
72995,Joint contracture of hand,racial,Native Hawaiian or Other Pacific Islander ,0,2,2
201820,Diabetes mellitus,racial,Black or African American ,0,2,2
4094448,Pregnancy test negative,racial,Filipino,2,0,2
4058984,Small kidneys unspecified,ethnic,Hispanic or Latino,2,0,2
437186,Hypothermia - accidental,ethnic,Not Hispanic or Latino,2,0,2
434156,Congenital anemia,racial,Black or African American ,2,0,2
444421,Congenital malformation of liver,racial,White,2,0,2
141371,PR - Pityriasis rosea,racial,Asian,2,0,2
378419,AD - Alzheimer's disease,racial,Alaska Native,2,0,2
22426,Congenital macrostomia,racial,White,0,2,2
435726,Mechanical complication of device,ethnic,Not Hispanic or Latino,2,0,2
141673,Aseptic necrosis of head of humerus,racial,Asian,2,0,2
4104558,Unspecified blepharitis,ethnic,Hispanic or Latino,2,0,2
140633,Vaccinia,ethnic,Hispanic or Latino,2,0,2
4051241,FH: Asthma,racial,White,0,2,2
4238737,Offending behavior,ethnic,Hispanic or Latino,0,2,2
436134,Disorder of sclera,racial,Unknown,2,0,2
437464,"Injury undetermined whether accidentally or purposely inflicted, fall from residential premises",ethnic,Not Hispanic or Latino,0,2,2
195581,Peritoneal adhesion,ethnic,Hispanic or Latino,2,0,2
74722,Secondary localized osteoarthrosis of pelvic region,ethnic,Hispanic or Latino,0,2,2
28457,Hypertrophy of tonsils,racial,American Indian,2,0,2
432919,Discoid lupus erythematosus eyelid,racial,White,2,0,2
141248,Benign neoplasm of skin of lip,ethnic,Not Hispanic or Latino,2,0,2
374040,Ill-defined disorder of eye,racial,American Indian or Alaska Native ,2,0,2
435368,Congenital pigeon chest,racial,Other Race,0,2,2
261116,Acquired nasal deformity,racial,Other Race,0,2,2
4179963,Family history of malignant neoplasm of breast,racial,Asian,2,0,2
373692,West Nile encephalitis,ethnic,Hispanic or Latino,2,0,2
78593,Open wound of wrist without complication,racial,Filipino,0,2,2
432729,Crying infant,racial,American Indian or Alaska Native ,0,2,2
316084,Lymphadenitis,racial,American Indian or Alaska Native ,2,0,2
4053387,Family history of polycystic kidney,ethnic,Hispanic or Latino,2,0,2
316457,Mallory-Weiss syndrome,racial,White,0,2,2
380513,Congenital cataract,racial,Black or African American ,2,0,2
440105,Aqueous humour misdirect,racial,White,2,0,2
258441,Cholesteatoma of attic,ethnic,Hispanic or Latino,2,0,2
373179,Senile degeneration of brain,racial,White,0,2,2
4113683,Spontaneous abortion unspecified,racial,Unknown,2,0,2
137520,Chronic thyroiditis,racial,Unknown,2,0,2
253954,PTB - Pulmonary tuberculosis,racial,Black or African American ,0,2,2
433659,Delayed healing of surgical wound,ethnic,Not Hispanic or Latino,2,0,2
193597,Visible peristalsis,ethnic,Hispanic or Latino,0,2,2
141094,Lichen,racial,Asian,2,0,2
4148115,Ectopic beats unspecified,ethnic,Hispanic or Latino,0,2,2
137652,Specific bursitis often of occupational origin,racial,Unknown,0,2,2
137721,Abrasion AND/OR friction burn of finger with infection,ethnic,Hispanic or Latino,2,0,2
313324,Cheyne-Stokes respiration,racial,White,2,0,2
443774,"Disease condition determination, uncontrolled",racial,Other Race,2,0,2
373747,Extrapyramidal disease,racial,Asian,2,0,2
81902,Urinary tract infectious disease,racial,Asian Indian,2,0,2
4015842,Viral hepatitis carrier,racial,Unknown,2,0,2
443235,Ankle and/or foot joint stiffness,racial,Unknown,0,2,2
434203,Late effect of contusion,racial,Other Race,2,0,2
4307254,Closed fracture,racial,Other Race,0,2,2
195867,Noninflammatory vaginal disorders,racial,Other Race,2,0,2
320116,Acute pericarditis,racial,Unknown,0,2,2
437384,Raised laboratory findings,ethnic,Not Hispanic or Latino,2,0,2
31339,Dental restoration esthetically inadequate or displeasing,ethnic,Hispanic or Latino,2,0,2
4088072,Pulmonary tuberculosis NOS,ethnic,Hispanic or Latino,2,0,2
374044,Droopy eyelid,racial,Native Hawaiian or Other Pacific Islander ,0,2,2
4220063,"Repair of knee, five-in-one",racial,Unknown,2,0,2
432816,Tuberculosis of limb bones,ethnic,Hispanic or Latino,0,2,2
4173811,Congenital quadriplegia,racial,Native Hawaiian or Other Pacific Islander ,2,0,2
375530,Migraine with prolonged aura,racial,White,2,0,2
435795,Fugue,ethnic,Hispanic or Latino,2,0,2
4194895,Screening for disorder,racial,Native Hawaiian or Other Pacific Islander ,0,2,2
4087763,Gonococcal infection of other specified sites,racial,White,0,2,2
435810,After-cataract,racial,Black or African American ,2,0,2
441398,Anomaly of sex chromosome,racial,Black or African American ,0,2,2
137057,Paronychia,racial,Filipino,0,2,2
133351,Open wound of cheek without complication,racial,Unknown,2,0,2
380510,Congenital abnormality of eyelid,racial,Black or African American ,0,2,2
438912,Chemical burn of eyelid AND/OR periocular area,ethnic,Hispanic or Latino,2,0,2
196364,Benign tumour of cervix,racial,Unknown,2,0,2
4060011,Burn: 20-29% of body surface NOS,ethnic,Hispanic or Latino,0,2,2
439382,Disorder of hypothalamus,racial,Unknown,2,0,2
4143490,Blindness or low vision NOS,racial,Unknown,0,2,2
381007,Impairment level: better eye: profound impairment: lesser eye: not further specified,racial,White,0,2,2
312653,Acute myocarditis,racial,White,0,2,2
442262,Blister of toe without infection,racial,Black or African American ,0,2,2
79916,Acquired hallux rigidus,racial,Unknown,0,2,2
317576,Coronary arteriosclerosis,racial,Alaska Native,2,0,2
133414,Candidiasis of skin and nails,racial,Native Hawaiian or Other Pacific Islander ,2,0,2
4237906,Poisoning by caffeine,ethnic,Hispanic or Latino,0,2,2
372913,Impairment level: one eye: near-total impairment: other eye: not specified,ethnic,Hispanic or Latino,0,2,2
433393,Fall into hole,ethnic,Not Hispanic or Latino,2,0,2
76521,"Fetus OR newborn affected by malpresentation, malposition AND/OR disproportion during labor AND/OR delivery",ethnic,Hispanic or Latino,0,2,2
200174,Disease of skin AND/OR subcutaneous tissue,racial,American Indian,0,2,2
444401,Delusions,ethnic,Not Hispanic or Latino,2,0,2
194704,Spontaneous abortion complicated by embolism,ethnic,Hispanic or Latino,2,0,2
193402,Bacterial enteritis,racial,Asian,2,0,2
74726,Dislocated joint,racial,White,2,0,2
137666,Congenital ear lobe absence,ethnic,Not Hispanic or Latino,2,0,2
4153745,Late effect of musculoskeletal and connective tissue injury NOS,racial,White,0,2,2
200962,Primary malignant neoplasm of prostate,racial,Native Hawaiian or Other Pacific Islander ,0,2,2
377552,Moderate nonproliferative diabetic retinopathy,ethnic,Not Hispanic or Latino,0,2,2
373487,AION - Acute ischaemic optic neuropathy,ethnic,Not Hispanic or Latino,2,0,2
443887,Superficial foreign body of ankle without major open wound AND without infection,racial,Other Race,2,0,2
438064,Bacterial infection due to Pseudomonas,racial,White,0,2,2
433316,Giddiness,racial,Alaska Native,2,0,2
4166443,Family history: Arthritis,ethnic,Not Hispanic or Latino,2,0,2
4104864,Migraine NOS,racial,Black or African American ,0,2,2
437369,Postmature infancy,ethnic,Not Hispanic or Latino,0,2,2
4102739,Screening for cardiovascular system disease,racial,American Indian or Alaska Native ,0,2,2
442216,Kernicterus not due to isoimmunization,ethnic,Hispanic or Latino,2,0,2
4081759,Transplant follow-up,ethnic,Hispanic or Latino,2,0,2
77882,Vestibular active Meniere's disease,ethnic,Hispanic or Latino,2,0,2
73673,Disorder of prosthetic joint,ethnic,Not Hispanic or Latino,0,2,2
438541,Fetus OR newborn affected by abnormality of chorion,ethnic,Hispanic or Latino,0,2,2
434926,Iridocyclitis,racial,Black or African American ,2,0,2
4286638,Childhood,ethnic,Not Hispanic or Latino,0,2,2
444234,Late effect of complications of trauma,racial,Unknown,2,0,2
438872,Hyperphagia,racial,Unknown,2,0,2
4086927,Contraception status,racial,Asian,2,0,2
438865,Complete trisomy 18 syndrome,racial,White,0,2,2
73075,Contusion of upper limb,racial,Black or African American ,0,2,2
196735,Acute pyelonephritis without medullary necrosis,racial,American Indian or Alaska Native ,2,0,2
433527,Endometriosis,racial,Asian,2,0,2
434002,Mineral deficiency,ethnic,Hispanic or Latino,2,0,2
133566,Necrotizing fasciitis,racial,White,2,0,2
258780,Chronic obstructive bronchitis,racial,Native Hawaiian or Other Pacific Islander ,2,0,2
375275,Hypertropia,racial,White,2,0,2
439162,"Closed fracture ankle, medial malleolus",racial,Unknown,2,0,2
80494,Arthropathy associated with another disorder,racial,Unknown,0,2,2
4204904,Education about sexually transmitted disease prevention,racial,Asian,2,0,2
434339,Adolescent - emotional problem,racial,Other Race,0,2,2
313500,Acute rheumatic heart disease,racial,White,0,2,2
4183058,Fitting of hearing aid,ethnic,Hispanic or Latino,2,0,2
4104431,Alcohol intoxication,ethnic,Hispanic or Latino,0,2,2
252947,Acute pulmonary edema due to fumes AND/OR vapors,racial,White,2,0,2
433405,Proteus infection,ethnic,Hispanic or Latino,2,0,2
73845,Ankylosis of joint of shoulder region,racial,Unknown,2,0,2
81659,Traumatic arthropathy of the pelvic region and thigh,ethnic,Not Hispanic or Latino,0,2,2
435979,Late effect of open wound of extremities without tendon injury,ethnic,Hispanic or Latino,0,2,2
439318,Complete illegal abortion with metabolic disorder,racial,White,0,2,2
440448,Appendicitis,ethnic,Hispanic or Latino,0,2,2
433376,Burning due to contact with hot solid objects and materials,racial,Unknown,2,0,2
201621,Chronic cystitis,racial,Other Race,2,0,2
77076,Diastasis of muscle,racial,Unknown,0,2,2
133569,Fasciitis,racial,Black or African American ,0,2,2
4100912,Screening for rheumatoid conditions,racial,Native Hawaiian or Other Pacific Islander ,2,0,2
196488,Atonic postpartum hemorrhage,racial,White,2,0,2
139737,Pediculosis corporis,racial,Unknown,2,0,2
376394,Menstrual migraine,ethnic,Not Hispanic or Latino,2,0,2
4263370,R.I.N.D. syndrome,racial,Native Hawaiian or Other Pacific Islander ,0,2,2
77635,Disease of hand,racial,Native Hawaiian or Other Pacific Islander ,2,0,2
193641,Lumbar nerve root injury,ethnic,Not Hispanic or Latino,0,2,2
141056,Acute ethmoidal sinusitis,racial,American Indian or Alaska Native ,2,0,2
437993,Closed fracture of cervical spine,racial,White,0,2,2
374923,Bell palsy,racial,American Indian or Alaska Native ,2,0,2
440417,Pulmonary embolism,racial,White,0,2,2
436445,Abrasion of teeth,racial,American Indian or Alaska Native ,2,0,2
76202,Non-traumatic rupture of Achilles tendon,ethnic,Not Hispanic or Latino,2,0,2
198695,"Malignant neoplasm, overlapping lesion of biliary tract",ethnic,Hispanic or Latino,2,0,2
140062,Iodine hypothyroidism,ethnic,Not Hispanic or Latino,0,2,2
373198,Unqualified visual loss of both eyes,racial,Other Race,0,2,2
436253,Sprain of foot,racial,American Indian or Alaska Native ,0,2,2
441716,Open wound of axillary region with complication,ethnic,Hispanic or Latino,0,2,2
437754,Toxic effect of metal,ethnic,Hispanic or Latino,0,2,2
74507,Sprain of radiohumeral joint,ethnic,Hispanic or Latino,2,0,2
440369,Histrionic personality disorder,ethnic,Hispanic or Latino,2,0,2
80815,Mucous cyst of skin,racial,Asian,2,0,2
4162218,Vaginal enterocele,racial,White,2,0,2
436666,Psychosexual disorder,racial,Unknown,0,2,2
443414,Chronic post-traumatic stress disorder,racial,Filipino,0,2,2
438941,Poisoning by hydantoin derivative,racial,Unknown,2,0,2
444239,Postprocedural state finding,racial,Native Hawaiian or Other Pacific Islander ,2,0,2
440158,"Venereal disease in mother complicating pregnancy, childbirth AND/OR puerperium",ethnic,Not Hispanic or Latino,2,0,2
381504,Post-herpetic trigeminal neuralgia,ethnic,Not Hispanic or Latino,2,0,2
4223530,Spondylitis,ethnic,Not Hispanic or Latino,2,0,2
192859,Postablative ovarian failure,ethnic,Not Hispanic or Latino,2,0,2
134870,Pityriasis versicolor,racial,American Indian,2,0,2
4201717,Ileostomy present,racial,Unknown,0,2,2
78909,"Contusion, shoulder and upper arm, multiple sites",racial,Unknown,2,0,2
4183977,Oligohydramnios without rupture of membranes,racial,White,2,0,2
77636,Primary localized osteoarthrosis of upper arm,ethnic,Hispanic or Latino,2,0,2
134116,Dermatitis due to drug AND/OR medicine taken internally,racial,Other Race,2,0,2
437791,Chickenpox with complication,racial,White,0,2,2
132835,Pediculosis capitis,racial,American Indian or Alaska Native ,2,0,2
435651,Atypical squamous cells on cervical Papanicolaou smear cannot exclude high grade squamous intraepithelial lesion,racial,Asian,2,0,2
434688,Tight hymenal ring,racial,White,2,0,2
372909,Impairment level: better eye: severe impairment: lesser eye: not further specified,ethnic,Hispanic or Latino,2,0,2
435444,Poisoning due to venomous marine animals or plants,ethnic,Hispanic or Latino,2,0,2
256717,Bronchospasm,racial,Filipino,2,0,2
4109395,Other visual pathway disorder,ethnic,Hispanic or Latino,2,0,2
382003,Burn of face AND/OR head,racial,White,2,0,2
440940,Methicillin resistant Staphylococcus aureus infection,racial,Other Race,0,2,2
443081,Drowning and non-fatal immersion,racial,White,2,0,2
4112658,Chest infection - pneumonia organism OS,racial,White,2,0,2
77647,Mallet finger,racial,Asian,0,2,2
381384,Congenital absence of external ear,racial,Unknown,0,2,2
134569,Erythema infectiosum,ethnic,Not Hispanic or Latino,2,0,2
439242,Adverse reaction to tetanus vaccine,racial,Unknown,0,2,2
443709,Atypical squamous cells of undetermined significance on anal Papanicolaou smear,ethnic,Hispanic or Latino,0,2,2
434003,GSD - Glycogen storage disease,racial,White,2,0,2
443367,Antihypertensive adverse reaction,racial,Unknown,2,0,2
200433,Dissecting aneurysm of renal artery,racial,White,0,2,2
437461,Disorder of prosthetic cardiac valve,racial,White,2,0,2
376680,Generalized nonconvulsive epilepsy,racial,Black or African American ,2,0,2
134243,Second degree burn of knee,racial,White,2,0,2
141159,Open wound of buccal mucosa without complication,racial,White,2,0,2
132412,Failed back syndrome,racial,Black or African American ,0,2,2
316376,Eosinophilia,racial,Alaska Native,2,0,2
4178964,Malignant tumour of roof of mouth,racial,White,0,2,2
441918,"Emotional AND/OR mental disease in mother complicating pregnancy, childbirth AND/OR puerperium",racial,Other Race,2,0,2
436541,Closed fracture of ulna,ethnic,Not Hispanic or Latino,0,2,2
443604,Factitious disorder with predominantly psychological signs and symptoms,racial,White,2,0,2
4269584,Finding relating to religious movement or belief,racial,Asian,2,0,2
136917,Primary malignant neoplasm of skin of face,ethnic,Not Hispanic or Latino,2,0,2
261393,Congenital polycystic lung,racial,Black or African American ,0,2,2
76196,Palindromic rheumatism,racial,Unknown,0,2,2
195301,Acute dilatation of stomach,racial,Unknown,0,2,2
193541,Perineal laceration involving anal sphincter,ethnic,Hispanic or Latino,2,0,2
432969,Multiple pregnancy,racial,Unknown,2,0,2
4063429,Other specified erythematous conditions,ethnic,Hispanic or Latino,2,0,2
443539,Motor vehicle injury,racial,Unknown,2,0,2
374748,Perinatal anoxic-ischemic brain injury,ethnic,Hispanic or Latino,0,2,2
40489926,Removal of dental prosthesis,ethnic,Hispanic or Latino,0,2,2
76784,Bleeding into joint,racial,White,0,2,2
4111411,Aortic valve disorders NOS,ethnic,Hispanic or Latino,0,2,2
372888,Sciatic nerve lesion,racial,Black or African American ,0,2,2
4156802,"Blister of finger, infected",racial,White,0,2,2
4111113,Other external ear disorder NOS,racial,White,2,0,2
437643,Gait abnormality,racial,American Indian,2,0,2
312733,"Abnormal foetal heart beat, not clear if noted before OR after onset of labour in liveborn infant",racial,White,2,0,2
374955,Spasm of conjugate gaze,racial,White,0,2,2
192359,RF - Renal failure,racial,Native Hawaiian or Other Pacific Islander ,0,2,2
442031,Accidentally struck by or against stationary object,racial,Unknown,0,2,2
432600,Stress reaction causing mixed disturbance of emotion and conduct,ethnic,Not Hispanic or Latino,2,0,2
443406,Eosinophilic gastroenteritis,ethnic,Hispanic or Latino,2,0,2
441764,Inhalation or ingestion of foreign body with respiratory obstruction or suffocation,racial,Black or African American ,0,2,2
444435,Superficial injury of elbow without infection,racial,Unknown,2,0,2
372610,Post-concussion syndrome,racial,Other Race,2,0,2
440409,Disorder of orbit proper,ethnic,Hispanic or Latino,2,0,2
24230,Laryngeal FB - foreign body,racial,Unknown,0,2,2
196792,Acquired claw foot,racial,White,0,2,2
435011,Vulvar vestibulitis,racial,Other Race,2,0,2
197006,Residual hemorrhoidal skin tags,racial,Unknown,2,0,2
201240,Metastasis to female genital organ,ethnic,Not Hispanic or Latino,2,0,2
443715,Atypical squamous cells on anal Papanicolaou smear cannot exclude high grade squamous intraepithelial lesion,ethnic,Hispanic or Latino,2,0,2
73090,Superficial bruising of foot,racial,American Indian or Alaska Native ,2,0,2
440518,5p partial monosomy syndrome,racial,White,0,2,2
434766,Open supracondylar fracture of humerus,ethnic,Hispanic or Latino,2,0,2
140641,Verruca vulgaris,racial,Native Hawaiian or Other Pacific Islander ,0,2,2
4103471,Observation of body mass index,racial,European,0,2,2
372435,Periventricular leukomalacia,racial,White,0,2,2
436826,Closed fracture of shaft of radius,racial,Asian,0,2,2
193353,Abrasion AND/OR friction burn of trunk with infection,ethnic,Hispanic or Latino,2,0,2
4273622,Operation on bone injury of carpals and metacarpals,racial,Native Hawaiian or Other Pacific Islander ,0,2,2
374342,Headache associated with sexual activity,racial,White,2,0,2
440922,Diabetic on insulin,racial,Black or African American ,0,2,2
439134,Acrocephalosyndactyly,racial,Unknown,0,2,2
195769,Submucous uterine leiomyoma,racial,American Indian or Alaska Native ,2,0,2
4296024,Family disruption due to divorce,ethnic,Not Hispanic or Latino,2,0,2
75044,"Stiff joint NEC, of the hand",racial,Asian,0,2,2
4021807,Interpersonal relationship observations,racial,White,0,2,2
133794,Chronic gingivitis,racial,Filipino,0,2,2
195464,Epidemic pleurodynia,racial,Unknown,0,2,2
201257,Disorder of endocrine ovary,ethnic,Not Hispanic or Latino,2,0,2
442943,Abrasion or friction burn of shoulder and upper arm without mention of infection,ethnic,Not Hispanic or Latino,0,2,2
442540,Liver moderate laceration without mention of open wound into cavity,racial,White,0,2,2
4064926,Ischemic heart disease screening,racial,White,2,0,2
381568,Pseudomembranous conjunctivitis,ethnic,Hispanic or Latino,0,2,2
135895,Variation in hair color,ethnic,Hispanic or Latino,0,2,2
377865,Acquired color vision deficiency,racial,White,0,2,2
317100,Fetal tachycardia,racial,White,2,0,2
4305303,Sleep deprivation,racial,Other Race,2,0,2
4215909,Artificial pacemaker rate check,racial,Unknown,2,0,2
433516,Duodenitis,racial,Other Race,2,0,2
134596,Lymphoid leukemia in remission,racial,Unknown,2,0,2
443459,Pathological fracture of neck of femur,ethnic,Hispanic or Latino,2,0,2
4243973,Laparoscopic appendectomy,racial,Other Race,2,0,2
4054908,Closed injury of kidney,racial,White,2,0,2
4108982,Cataract associated with other syndromes,ethnic,Not Hispanic or Latino,0,2,2
4105880,Contact of sexually transmissible disorder,racial,American Indian,2,0,2
442926,"Motor vehicle traffic accident involving collision with another motor vehicle, parked, driver of motor vehicle injured",racial,White,0,2,2
4275756,Dependent drug abuse,ethnic,Hispanic or Latino,2,0,2
435503,Hemolytic anemia,racial,White,2,0,2
437872,Rupture in Descemet membrane,racial,White,2,0,2
254980,Intrinsic asthma with asthma attack,racial,Black or African American ,2,0,2
441447,Open wound of external genital organs without complication,racial,White,2,0,2
198062,"Infectious colitis, enteritis and gastroenteritis",racial,Black or African American ,2,0,2
27674,N&V - Nausea and vomiting,racial,Filipino,2,0,2
443367,Antihypertensive adverse reaction,racial,Other Race,2,0,2
434819,Benzodiazepine poisoning,ethnic,Not Hispanic or Latino,2,0,2
440237,Open fracture of upper end of lower leg,racial,White,2,0,2
29735,Candidiasis of mouth,racial,American Indian or Alaska Native ,0,2,2
76801,Polyostotic fibrous dysplasia of bone,racial,White,0,2,2
439406,Allergy to animal,racial,Other Race,0,2,2
257004,Acute exacerbation of chronic obstructive airways disease,racial,American Indian,0,2,2
437120,Closed dislocation of foot,ethnic,Not Hispanic or Latino,0,2,2
373786,Abnormal vision,racial,Other Race,0,2,2
200275,Burn erythema of multiple sites of trunk,ethnic,Hispanic or Latino,2,0,2
379823,Acute myringitis without otitis media,ethnic,Hispanic or Latino,0,2,2
4062635,Measles screening,ethnic,Hispanic or Latino,2,0,2
380094,Carpal tunnel syndrome,racial,American Indian,2,0,2
436510,Acquired cavus foot deformity,racial,Unknown,0,2,2
30770,Chronic peptic ulcer with hemorrhage but without obstruction,racial,Unknown,2,0,2
438739,Sympathetic uveitis,racial,Asian,0,2,2
4150157,Other anemias,ethnic,Not Hispanic or Latino,2,0,2
72710,Effusion of joint of forearm,ethnic,Hispanic or Latino,0,2,2
199875,Vaginal wall prolapse without uterine prolapse,racial,Unknown,2,0,2
192971,"Pelvic soft tissue abnormality in pregnancy, childbirth and the puerperium - delivered with postnatal complication",racial,White,2,0,2
198334,Campylobacter diarrhoea,racial,Unknown,2,0,2
381854,Disorder of conjunctiva,racial,Unknown,0,2,2
136057,Benign neoplasm of skin of trunk,racial,Asian,2,0,2
373494,Cholesterin granuloma of middle ear,racial,Other Race,0,2,2
79884,Galactorrhea not associated with childbirth,racial,American Indian or Alaska Native ,2,0,2
376707,Acute conjunctivitis,racial,American Indian,2,0,2
443753,Abrasion AND/OR friction burn of wrist without infection,racial,American Indian or Alaska Native ,2,0,2
80294,Foreign body in genitourinary tract,racial,White,2,0,2
78619,"Contusion, knee",racial,Native Hawaiian or Other Pacific Islander ,2,0,2
4085803,Microsporosis nigra,ethnic,Hispanic or Latino,2,0,2
372766,Open wound of head with complication,racial,White,0,2,2
141933,Alopecia areata,racial,Filipino,0,2,2
4020669,Coronary arteriography using single catheter,ethnic,Hispanic or Latino,2,0,2
199771,Carcinoid syndrome,racial,White,2,0,2
4041798,"Hodgkin's disease, lymphocytic depletion",racial,White,0,2,2
195019,"Pelvic soft tissue abnormality in pregnancy, childbirth and the puerperium with antenatal problem",racial,Unknown,2,0,2
439348,Pregnancy complications,racial,Asian,2,0,2
437663,Fever,racial,American Indian,2,0,2
441153,Closed supracondylar fracture of femur,ethnic,Hispanic or Latino,2,0,2
442943,Abrasion or friction burn of shoulder and upper arm without mention of infection,racial,Asian,0,2,2
443545,Nonvenomous insect bite,racial,Asian Indian,2,0,2
436089,"Nondependent cocaine abuse, episodic",ethnic,Not Hispanic or Latino,2,0,2
257086,Incomplete bilateral cleft palate,racial,White,0,2,2
433915,Burn of thigh,racial,White,2,0,2
197218,Capillaria infection,ethnic,Hispanic or Latino,2,0,2
379779,Subacute delirium,racial,White,2,0,2
4312857,Incision of spleen,racial,White,0,2,2
141825,Non-toxic goiter,racial,Unknown,2,0,2
4147639,Cellulitis and abscess of toe NOS,racial,Black or African American ,2,0,2
4110815,"Sensorineural hearing loss, bilateral",racial,Native Hawaiian or Other Pacific Islander ,0,2,2
40414926,"Accidental cut, puncture, perforation or haemorrhage during administration of enema",racial,Unknown,0,2,2
372903,Retinal edema,racial,Filipino,0,2,2
137940,Transient hypertension of pregnancy - delivered,racial,Unknown,2,0,2
4085075,At risk state,racial,American Indian or Alaska Native ,2,0,2
136775,Contact dermatitis due to solar radiation,racial,Black or African American ,2,0,2
374950,Oedema of eyelid,racial,Black or African American ,2,0,2
378425,Eyelid inflammation,racial,American Indian or Alaska Native ,2,0,2
141253,Disease of thyroid gland,racial,American Indian,2,0,2
436246,Low libido,racial,American Indian,2,0,2
436299,Fall from one level to another,ethnic,Hispanic or Latino,2,0,2
434156,Congenital anemia,ethnic,Hispanic or Latino,0,2,2
4111255,Unspecified labyrinthitis,racial,Asian,0,2,2
253121,"Tuberculosis of lung, confirmed by culture only",racial,White,0,2,2
437041,Mother not delivered,racial,Middle Eastern or North African,2,0,2
196757,Fetal-maternal haemorrhage with antenatal problem,ethnic,Not Hispanic or Latino,0,2,2
4052921,FH: Consanguinity,racial,Unknown,0,2,2
201626,Mid-cycle pain,racial,Asian,2,0,2
375475,Meningoencephalitis due to acquired toxoplasmosis,racial,Unknown,0,2,2
73649,Contusion of finger,racial,Asian Indian,2,0,2
434821,SIRS - System inflammatory response syndrome,racial,Asian,2,0,2
76887,Disorders of urogenital prostheses or implants,racial,American Indian or Alaska Native ,2,0,2
200040,Acute gonococcal endometritis,racial,White,2,0,2
444129,Wrist injury,racial,Asian,0,2,2
432682,Complete spontaneous abortion with delayed or excessive haemorrhage,ethnic,Hispanic or Latino,2,0,2
434344,Accommodative spasm,ethnic,Hispanic or Latino,0,2,2
442038,Anaphylactic shock due to serum,ethnic,Not Hispanic or Latino,2,0,2
81659,Traumatic arthropathy of the pelvic region and thigh,racial,Asian,0,2,2
373489,Congenital nystagmus,ethnic,Not Hispanic or Latino,2,0,2
198558,Nycturia,racial,Black or African American ,0,2,2
441571,Retained old foreign body following penetrating wound of orbit,racial,Unknown,0,2,2
4133311,Tetanus vaccination,racial,White,2,0,2
4058089,Mild hyperemesis gravidarum NOS,racial,White,2,0,2
198401,Neoplasm of uncertain behavior of bladder,ethnic,Not Hispanic or Latino,0,2,2
198363,Candidiasis of vagina,racial,American Indian,2,0,2
4019044,Sprain of ischiocapsular ligament,ethnic,Not Hispanic or Latino,2,0,2
81893,Chronic ulcerative colitis,racial,Other Race,2,0,2
4287237,Vascular hamartoma of skin,ethnic,Not Hispanic or Latino,0,2,2
437187,Assault by striking by blunt or thrown object,ethnic,Hispanic or Latino,0,2,2
436238,Elevated levels of transaminase and lactic acid dehydrogenase,racial,American Indian,2,0,2
74138,Pathological fracture of vertebra,racial,Black or African American ,2,0,2
437557,Eczematous dermatitis of eyelid,racial,Asian,0,2,2
195009,Leukoplakia of penis,racial,White,0,2,2
133002,Acute osteomyelitis,ethnic,Not Hispanic or Latino,0,2,2
377551,Blind hypertensive eye,ethnic,Not Hispanic or Latino,2,0,2
439743,Late effects of respiratory tuberculosis,racial,Unknown,2,0,2
4095304,Malignant neoplasm of pituitary gland and craniopharyngeal duct,racial,White,2,0,2
4234299,Repair of cystocele,racial,White,2,0,2
443464,Central pain syndrome,racial,White,0,2,2
4062733,Neurological screening,ethnic,Hispanic or Latino,0,2,2
435024,Precipitate labour with antenatal problem,racial,Unknown,2,0,2
194802,Foreign body in vulva and vagina,racial,Native Hawaiian or Other Pacific Islander ,2,0,2
4147650,"Muscular calcification and ossification, unspecified",racial,Black or African American ,0,2,2
198846,Enthesopathy of hip region,racial,Black or African American ,2,0,2
75311,Fibrosclerosis of breast,racial,White,2,0,2
4148412,Family history: Genitourinary disease,racial,Other Race,2,0,2
432661,Stomatitis,racial,Black or African American ,2,0,2
136960,Vascular myelopathies,racial,White,2,0,2
433032,Pyrexia postprocedure,racial,White,0,2,2
436612,Gaseous hydrocarbon causing toxic effect,racial,White,2,0,2
199885,Acute female pelvic peritonitis,racial,White,2,0,2
439982,Infection as complication of medical care,ethnic,Hispanic or Latino,2,0,2
72576,Benign tumour of breast,racial,Other Race,2,0,2
441460,Late effect of sprain AND/OR strain without tendon injury,racial,Black or African American ,2,0,2
4053600,Open wound of elbow,ethnic,Not Hispanic or Latino,2,0,2
442167,Neoplasm of uncertain behaviour of craniopharyngeal duct,racial,Unknown,0,2,2
433565,Juvenile osteochondrosis of spine,ethnic,Hispanic or Latino,2,0,2
261116,Acquired nasal deformity,racial,Unknown,0,2,2
443789,Victim of trauma,racial,Unknown,2,0,2
4052804,FH: Allergy,racial,Black or African American ,0,2,2
76573,Full thickness burn of hand,ethnic,Hispanic or Latino,0,2,2
4311114,Sensory disorder,ethnic,Hispanic or Latino,2,0,2
312664,Influenza with respiratory manifestation other than pneumonia,racial,American Indian,2,0,2
443577,Asymmetric sensorineural hearing loss,racial,Filipino,2,0,2
373870,Neonatal dacryocystitis and conjunctivitis,ethnic,Not Hispanic or Latino,2,0,2
78605,Superficial bruising of elbow,racial,Asian,0,2,2
4048727,Neoplasm screening,racial,Asian,2,0,2
192380,Failed attempted abortion without complication,racial,Unknown,2,0,2
199764,Benign ovarian tumour,ethnic,Not Hispanic or Latino,2,0,2
27411,Open wound of multiple sites of mouth with complication,racial,White,0,2,2
72778,Open wound of toe(s) without mention of complication,racial,Other Race,2,0,2
134404,Anal spasm,racial,Black or African American ,2,0,2
321815,Malignant histiocytosis of lymph nodes of multiple sites,ethnic,Hispanic or Latino,2,0,2
4287844,alpha Thalassemia,racial,White,2,0,2
438975,Multisystemic disseminated toxoplasmosis,racial,White,2,0,2
432656,Embolism and thrombosis of the thoracic aorta,racial,White,2,0,2
76737,Hydrocele,ethnic,Not Hispanic or Latino,0,2,2
433746,"Combined drug dependence, excluding opioid, continuous",racial,Unknown,2,0,2
436075,Adjustment disorder with anxious mood,racial,Other Race,0,2,2
77070,Allergic arthritis of the hand,racial,Black or African American ,0,2,2
377844,Status migrainosus,racial,White,2,0,2
313833,Puerperal cerebrovascular disorder with postnatal complication,racial,Unknown,2,0,2
380719,Impairment level: one eye: moderate impairment: other eye: normal vision,racial,Unknown,2,0,2
75045,Climacteric arthritis of the pelvic region and thigh,ethnic,Hispanic or Latino,0,2,2
437247,Anaemia of chronic disease,racial,American Indian or Alaska Native ,0,2,2
137648,Osteomyelitis of hand,racial,White,0,2,2
4103961,Removal of acoustic neuroma,racial,White,2,0,2
198199,Pyelonephritis,racial,American Indian,2,0,2
139202,"Burn involving 20-29 percent of body surface, with 10-19 percent of body surface with full thickness burn",racial,White,0,2,2
138676,Gram negative septicemia,racial,Unknown,0,2,2
4110022,Acute bronchitis and/or bronchiolitis,racial,Unknown,2,0,2
438668,Accidents due to travel and motion,racial,Unknown,0,2,2
433111,Effects of hunger,racial,White,2,0,2
441615,Trigonitis,racial,Unknown,2,0,2
72471,Sprain of carpometacarpal joint,ethnic,Not Hispanic or Latino,2,0,2
4112819,Pneumonia due to other specified bacteria,racial,Unknown,0,2,2
441680,Fetus OR newborn affected by multiple pregnancy,racial,White,2,0,2
193636,Foreign body in bladder AND/OR urethra,ethnic,Hispanic or Latino,2,0,2
4292726,Contact - infectious disease,racial,Filipino,2,0,2
433455,Teeth grinding whilst asleep,racial,Asian,2,0,2
440989,Intermittent explosive disorder,ethnic,Not Hispanic or Latino,2,0,2
132932,Chronic ethmoidal sinusitis,racial,Other Race,2,0,2
437027,Acute duodenitis,racial,Unknown,0,2,2
434628,Separation anxiety,ethnic,Not Hispanic or Latino,0,2,2
4050797,Family history of urological neoplasm,ethnic,Not Hispanic or Latino,0,2,2
434605,Benign tumor of lacrimal drainage structure,racial,White,0,2,2
136516,Congenital pes planus,racial,Asian,2,0,2
4108374,Other specified peripheral vascular disease NOS,racial,Unknown,0,2,2
440612,Toxic effect of tobacco and nicotine,racial,Asian,2,0,2
4053600,Open wound of elbow,racial,Asian,2,0,2
199063,"Hernia, with obstruction",ethnic,Not Hispanic or Latino,2,0,2
4169009,FH: CVA,racial,Asian,0,2,2
4008089,Dysentery,racial,American Indian or Alaska Native ,2,0,2
78472,Microscopic haematuria,racial,American Indian or Alaska Native ,2,0,2
436956,Evans syndrome,racial,White,0,2,2
256571,FB - Nasal foreign body,racial,Unknown,0,2,2
134870,Pityriasis versicolor,racial,Asian Indian,2,0,2
78607,Open wound of multiple sites of one upper limb with complication,ethnic,Hispanic or Latino,0,2,2
438812,Abortion complicated by genital-pelvic infection,racial,White,2,0,2
440853,Closed fracture of surgical neck of humerus,ethnic,Hispanic or Latino,2,0,2
201618,Disease of intestine,racial,American Indian,2,0,2
193804,Achlorhydria,ethnic,Hispanic or Latino,2,0,2
433536,Severe pre-eclampsia,ethnic,Hispanic or Latino,2,0,2
80573,Contusion of ankle,racial,Black or African American ,0,2,2
74511,Open wound of knee and/or leg and/or ankle with complication,racial,Other Race,2,0,2
81425,Closed fracture of sacrum AND/OR coccyx with complete cauda equina lesion,racial,White,2,0,2
4287237,Vascular hamartoma of skin,racial,Asian,0,2,2
432975,Trauma to perineum and/or vulva during delivery,ethnic,Hispanic or Latino,2,0,2
317002,Hypopiesis,racial,American Indian or Alaska Native ,0,2,2
444369,Hyperosmolality,racial,White,2,0,2
433015,Congenital anomaly of aortic arch,racial,Unknown,2,0,2
434673,Soft tissue impingement on teeth,racial,Black or African American ,0,2,2
378419,AD - Alzheimer's disease,racial,American Indian or Alaska Native ,2,0,2
257293,Disorder of visual pathways,ethnic,Not Hispanic or Latino,0,2,2
376955,Gouty tophi of ear,racial,White,0,2,2
201627,Abnormal vaginal bleeding,racial,Black or African American ,2,0,2
132253,Mixed pediculosis,ethnic,Hispanic or Latino,2,0,2
434119,Hidradenitis,racial,American Indian or Alaska Native ,2,0,2
194411,Unilateral simple inguinal hernia,racial,Native Hawaiian or Other Pacific Islander ,0,2,2
439372,"Motor vehicle traffic accident involving collision, on highway, between motor vehicle and fallen stone, traffic sign, tree or utility pole, pedestrian injured",ethnic,Hispanic or Latino,2,0,2
196715,Budd-Chiari syndrome,racial,White,2,0,2
316994,Malignant hypertensive heart disease with congestive cardiac failure,racial,Asian,2,0,2
432289,Drug-induced neutropenia,racial,Asian,0,2,2
373201,Acute eustachian tube salpingitis,ethnic,Not Hispanic or Latino,2,0,2
372925,Cholesteatoma,ethnic,Not Hispanic or Latino,2,0,2
4171434,Immunization refused,racial,American Indian,2,0,2
4049954,Open wound of nasal sinus,racial,Unknown,0,2,2
81659,Traumatic arthropathy of the pelvic region and thigh,ethnic,Hispanic or Latino,2,0,2
441579,Acute inferoposterior infarction,racial,White,0,2,2
201257,Disorder of endocrine ovary,racial,Asian,2,0,2
380714,Minor opacity of cornea,ethnic,Not Hispanic or Latino,2,0,2
79904,Secondary localised osteoarthrosis of hand,racial,White,0,2,2
75954,Sprain of interphalangeal joint of finger,racial,Other Race,0,2,2
195012,Metrorrhagia,racial,American Indian or Alaska Native ,2,0,2
438067,Malaria,racial,White,0,2,2
138864,Congenital anomaly of nail,racial,Unknown,2,0,2
75863,Chronic interstitial cystitis,racial,Asian,2,0,2
432308,Mononeuritis of lower limb,racial,Asian,2,0,2
198809,Acute cholecystitis,racial,Black or African American ,2,0,2
4193570,Abnormal results of hearing screening test,racial,Other Race,0,2,2
4270051,Arthrodesis of ankle,ethnic,Hispanic or Latino,2,0,2
199771,Carcinoid syndrome,racial,Unknown,2,0,2
4210636,Transient tic disorder,ethnic,Hispanic or Latino,2,0,2
4228073,Peripheral nerve block,ethnic,Hispanic or Latino,2,0,2
441259,Non-thrombocytopenic purpura,racial,Black or African American ,0,2,2
381392,Congenital subcapsular cataract,racial,Unknown,2,0,2
198853,Congenital anomaly of ovary,ethnic,Hispanic or Latino,2,0,2
435269,Optic papillitis,ethnic,Hispanic or Latino,2,0,2
432810,Injury of unknown intent by burns or fire,racial,Unknown,2,0,2
440396,Glaucoma associated with ocular trauma,racial,White,0,2,2
443677,Open wound of knee and/or leg and/or ankle,racial,Asian,0,2,2
439147,Amnesia,racial,Native Hawaiian or Other Pacific Islander ,0,2,2
197601,Spermatocele,racial,Other Race,0,2,2
434885,Benign neoplasm of skull and facial bones,racial,White,0,2,2
441692,Finding of serum tumour marker level,racial,Unknown,0,2,2
440529,Abnormal findings on diagnostic imaging of urinary organs,racial,Asian,2,0,2
199855,Acute gastric ulcer with hemorrhage AND with perforation but without obstruction,racial,White,0,2,2
440980,Atypical manic disorder,racial,White,0,2,2
193591,Meconium ileus,racial,White,0,2,2
73065,"Contusion, genital organs",racial,Other Race,0,2,2
4113027,Dietary intake observations,racial,Black or African American ,0,2,2
4046893,Lifestyle,racial,Filipino,0,2,2
435859,Acute duodenal ulcer without hemorrhage AND without perforation but with obstruction,racial,White,2,0,2
313780,Mobitz type 2 second degree atrioventricular block,ethnic,Hispanic or Latino,2,0,2
441546,Functional vomiting,racial,Other Race,0,2,2
74150,"Congenital subluxation of hip, bilateral",racial,Asian,2,0,2
194071,Pylorospasm,racial,White,2,0,2
4150157,Other anemias,racial,Asian,2,0,2
258955,Whooping cough due to organism other than Bordetella pertussis,ethnic,Hispanic or Latino,2,0,2
40484010,Unilateral conductive hearing loss,racial,Other Race,2,0,2
373412,Otitis externa due to Herpes zoster,racial,White,0,2,2
200763,Chronic hepatitis,racial,Native Hawaiian or Other Pacific Islander ,0,2,2
375115,Nonmagnetic foreign body penetrating eyeball,ethnic,Hispanic or Latino,0,2,2
4062480,Diphtheria screening,ethnic,Hispanic or Latino,0,2,2
435786,Disorder of sleep-wake cycle,ethnic,Not Hispanic or Latino,2,0,2
372765,Open wound of head without complication,racial,Asian,0,2,2
4005743,Female sterility,racial,Asian,2,0,2
201820,Diabetes mellitus,racial,Asian,0,2,2
436839,Closed fracture of metacarpal bone,racial,Asian,2,0,2
137063,Corns and callus,racial,American Indian or Alaska Native ,2,0,2
439053,Exostosis of jaw,racial,Black or African American ,2,0,2
200200,Lumbar spina bifida with hydrocephalus,ethnic,Hispanic or Latino,2,0,2
134681,Spasm of oesophagus,racial,Unknown,0,2,2
4215445,Arthroplasty of shoulder for recurrent dislocation,ethnic,Hispanic or Latino,2,0,2
139179,Open wound of lip without complication,racial,American Indian,2,0,2
135178,Streptococcal septicaemia,racial,White,0,2,2
75555,Viral labyrinthitis,ethnic,Not Hispanic or Latino,2,0,2
438559,Abnormal vaginal Papanicolaou smear,racial,Asian,2,0,2
194412,Dysplasia of vagina,racial,Unknown,2,0,2
433911,Contusion of eye AND ocular adnexa,racial,Other Race,0,2,2
440067,"Moderate bipolar I disorder, single manic episode",ethnic,Not Hispanic or Latino,2,0,2
137425,"Insect bite, nonvenomous, of trunk, infected",ethnic,Hispanic or Latino,2,0,2
438391,Amino acid transport disorder,racial,Unknown,2,0,2
441266,Thiamin deficiency,racial,Black or African American ,2,0,2
138824,Contact dermatitis due to metal,ethnic,Not Hispanic or Latino,0,2,2
4087756,Late latent syphilis,racial,Other Race,0,2,2
441132,Laboratory finding abnormal,racial,Other Race,0,2,2
379832,Mixed conductive and sensorineural deafness,racial,Black or African American ,0,2,2
435120,Blister of toe with infection,racial,Black or African American ,2,0,2
436134,Disorder of sclera,racial,Filipino,0,2,2
77455,Burn of chest wall,ethnic,Hispanic or Latino,2,0,2
4108982,Cataract associated with other syndromes,racial,Asian,0,2,2
432507,Suicide - hanging,racial,Black or African American ,0,2,2
75311,Fibrosclerosis of breast,racial,Unknown,2,0,2
4155527,Unspecified polyarthropathy or polyarthritis,racial,White,2,0,2
438077,Disseminated candidiasis,racial,White,0,2,2
75667,Sprain of calcaneofibular ligament,racial,Filipino,0,2,2
444291,Cochlear hearing loss,racial,Other Race,2,0,2
317009,Hyperreactive airway disease,racial,Alaska Native,0,2,2
432596,Immune defect,racial,White,0,2,2
315523,Hemoglobin S-F disease,racial,Unknown,2,0,2
373200,Chronic fungal otitis externa,racial,Unknown,0,2,2
72993,Primary localised osteoarthrosis,racial,Asian,0,2,2
81936,Monoarthritis,racial,Other Race,0,2,2
193016,Cystic disease of kidney,racial,American Indian or Alaska Native ,2,0,2
436466,Balanoposthitis,racial,Asian,0,2,2
438365,Phaeohyphomycosis,racial,White,0,2,2
253670,Injury of optic pathways,racial,White,0,2,2
198191,Acquired hypertrophic pyloric stenosis,ethnic,Not Hispanic or Latino,0,2,2
80186,Recurrent dislocation of shoulder region,racial,Other Race,0,2,2
197032,Hyperplasia of prostate,racial,Asian Indian,0,2,2
437400,Closed fracture of shaft of ulna,ethnic,Not Hispanic or Latino,0,2,2
441201,"[X]Fall from, out of or through building or structure",ethnic,Not Hispanic or Latino,2,0,2
4062641,Malaria screening,racial,Native Hawaiian or Other Pacific Islander ,2,0,2
313459,Sleep apnea,racial,Alaska Native,0,2,2
435093,Closed fracture of femur,racial,Black or African American ,2,0,2
81425,Closed fracture of sacrum AND/OR coccyx with complete cauda equina lesion,racial,Unknown,2,0,2
436804,Fetus OR newborn affected by premature rupture of membranes,racial,White,2,0,2
436906,Rickettsial disease,racial,Unknown,2,0,2
4103889,Unspecified blepharoconjunctivitis,racial,White,2,0,2
432827,Infection due to Bacteroides,racial,Other Race,0,2,2
442651,"Noncollision motor vehicle traffic accident involving fire starting in motor vehicle whilst in motion, passenger of motor vehicle injured",ethnic,Hispanic or Latino,2,0,2
443228,"Abrasion or friction burn of foot and toe, without mention of infection",racial,Asian,2,0,2
438559,Abnormal vaginal Papanicolaou smear,ethnic,Not Hispanic or Latino,2,0,2
4059445,Chronic glomerulonephritis NOS,racial,White,0,2,2
443084,"Periostitis without mention of osteomyelitis, of the ankle and/or foot",ethnic,Hispanic or Latino,2,0,2
442324,Psychologic dyspareunia,ethnic,Hispanic or Latino,2,0,2
4129665,Hearing aid care,racial,Unknown,2,0,2
442610,Degenerative AND/OR vascular disorder of ear,racial,White,0,2,2
373126,Non-arthropod-borne viral disease of the central nervous system,racial,White,2,0,2
254514,Contusion of lung without open wound into thorax,ethnic,Hispanic or Latino,2,0,2
374025,Retinal haemorrhages,racial,Asian,0,2,2
444438,Leucoplakia of tongue,racial,Unknown,2,0,2
441189,Pertussis vaccine adverse reaction,ethnic,Not Hispanic or Latino,0,2,2
259995,Foreign body in orifice,racial,White,0,2,2
73012,Saddle back,ethnic,Hispanic or Latino,2,0,2
433257,Mesangiocapillary glomerulonephritis,racial,Black or African American ,0,2,2
4005933,Urethral meatus underneath penis,racial,Black or African American ,0,2,2
4280605,Common duodenal ulcer,racial,White,2,0,2
372247,Candidal otomycosis,racial,Asian,2,0,2
435299,Failure of dental prosthesis,racial,Other Race,2,0,2
141997,Open wound of forearm with complication,ethnic,Hispanic or Latino,2,0,2
4024567,Respiratory observation,racial,Other Race,2,0,2
4150002,Retained placenta with no haemorrhage NOS,racial,Asian,2,0,2
4143915,Cholestasis,ethnic,Not Hispanic or Latino,2,0,2
433949,Human bite,racial,White,0,2,2
201129,Newborn swallowing maternal blood causing hematemesis or melena,racial,Black or African American ,0,2,2
380650,Epidemic haemorrhagic conjunctivitis,ethnic,Hispanic or Latino,2,0,2
134453,Inflammation of bursa,racial,Other Race,0,2,2
443438,Claw hand - acquired,ethnic,Hispanic or Latino,0,2,2
74582,Primary malignant neoplasm of rectum,racial,American Indian or Alaska Native ,2,0,2
74150,"Congenital subluxation of hip, bilateral",ethnic,Not Hispanic or Latino,2,0,2
433668,Burn of two OR more fingers including thumb,racial,White,0,2,2
443449,Acute laryngitis with obstruction,racial,White,0,2,2
440409,Disorder of orbit proper,ethnic,Not Hispanic or Latino,2,0,2
141693,Elevated blood-pressure reading without diagnosis of hypertension,racial,Middle Eastern or North African,2,0,2
4009601,Fracture of one or more phalanges of hand NOS,racial,White,2,0,2
376115,Cystoid macular retinal degeneration,racial,Unknown,0,2,2
192731,Digestive symptom,racial,American Indian or Alaska Native ,2,0,2
197023,Bilateral inguinal hernia,racial,Other Race,0,2,2
4085803,Microsporosis nigra,ethnic,Not Hispanic or Latino,2,0,2
200675,Neoplasm of uncertain behavior of ovary,ethnic,Not Hispanic or Latino,2,0,2
77079,SS - Spinal stenosis,racial,Black or African American ,2,0,2
438130,Opioid abuse,racial,Black or African American ,2,0,2
199075,Neurogenic bladder,racial,Asian,2,0,2
440465,Postpartum state,racial,American Indian,0,2,2
77653,Traumatic myositis ossificans,ethnic,Hispanic or Latino,0,2,2
438749,Posterior subcapsular polar senile cataract,racial,Unknown,0,2,2
196821,Observation of urethral discharge,racial,Other Race,0,2,2
435799,Adjustment disorder with disturbance of conduct,ethnic,Not Hispanic or Latino,0,2,2
133299,Swelling of limb,racial,Asian Indian,2,0,2
4098410,Atrial cardioversion,ethnic,Hispanic or Latino,0,2,2
72576,Benign tumour of breast,racial,American Indian or Alaska Native ,2,0,2
432454,Excessive thirst,racial,Native Hawaiian or Other Pacific Islander ,0,2,2
443915,Poisoning by autonomous nervous system drug,racial,White,2,0,2
4062733,Neurological screening,ethnic,Not Hispanic or Latino,2,0,2
4066820,Ingestion dermatitis due to food,racial,Black or African American ,2,0,2
75050,Coxa valga - acquired,racial,Black or African American ,0,2,2
375067,Microphthalmos associated with other anomalies of eye AND/OR adnexa,racial,White,2,0,2
4197217,Arteriovenous anastomosis for renal dialysis,racial,Unknown,2,0,2
255711,Optic nerve and pathway injury,racial,White,0,2,2
78907,Superficial injury of foot without infection,ethnic,Not Hispanic or Latino,2,0,2
440953,Cysticercosis,ethnic,Not Hispanic or Latino,2,0,2
435416,Poisoning by anti-infective agent,ethnic,Hispanic or Latino,2,0,2
254387,Upper respiratory tract hypersensitivity reaction,racial,Filipino,0,2,2
78009,Open traumatic pneumothorax,racial,Unknown,0,2,2
443586,Transient organic mental disorder,ethnic,Hispanic or Latino,2,0,2
435956,Closed fracture of base of neck of femur,ethnic,Not Hispanic or Latino,2,0,2
443392,Malignant neoplastic disease,ethnic,Not Hispanic or Latino,2,0,2
432807,Accidents caused by cutting and piercing instruments or objects,racial,White,2,0,2
434344,Accommodative spasm,ethnic,Not Hispanic or Latino,0,2,2
195197,Primary malignant neoplasm of vulva,racial,White,2,0,2
72991,Traumatic arthropathy of multiple sites,racial,Unknown,0,2,2
441968,Acetonuria,racial,Asian,2,0,2
4324788,Articular cartilage disorder of wrist,racial,White,2,0,2
195513,Vaginal intraepithelial neoplasia grade III,ethnic,Hispanic or Latino,2,0,2
438392,Disorder of hyperalimentation,ethnic,Hispanic or Latino,2,0,2
434173,Fever symptoms,ethnic,Not Hispanic or Latino,0,2,2
432526,Needs influenza immunisation,racial,Middle Eastern or North African,2,0,2
74698,Breech presentation,racial,Asian,0,2,2
380707,Distortion of visual image,racial,White,0,2,2
378679,Acute poliomyelitis,racial,White,2,0,2
440396,Glaucoma associated with ocular trauma,racial,Unknown,0,2,2
138858,Pale complexion,ethnic,Not Hispanic or Latino,2,0,2
4059736,Infective urethral stricture NOS,racial,White,0,2,2
72996,"Stiff joint NEC, of the lower leg",racial,Other Race,0,2,2
442740,"Nontraffic accident involving fall from motor vehicle, except off-road motor vehicle, whilst in motion, not on public highway, motor cyclist injured",ethnic,Hispanic or Latino,2,0,2
195976,Burn of gastrointestinal tract,racial,White,2,0,2
4173452,Exteriorisation of appendix,racial,Unknown,2,0,2
436007,Complication of introduction procedure,racial,White,0,2,2
441819,"Carcinoma in situ of lip, oral cavity and pharynx",racial,White,2,0,2
444125,Satisfactory for evaluation but limited by absence of an endocervical/transformation zone component from a patient with a cervix,racial,Unknown,2,0,2
434069,"Mottled teeth, congenital",racial,White,0,2,2
432451,Abnormal results of function studies of central nervous system,racial,Native Hawaiian or Other Pacific Islander ,0,2,2
193070,Blister of trunk with infection,racial,White,2,0,2
198899,Open wound of trunk with complication,racial,Unknown,2,0,2
195314,Nephrotic syndrome,racial,Black or African American ,0,2,2
439926,Malaise and fatigue,racial,Alaska Native,2,0,2
4144876,Contact dermatitis and other eczemas,ethnic,Not Hispanic or Latino,2,0,2
440385,Obstructive hydrocephalus,racial,American Indian or Alaska Native ,2,0,2
436098,Nondependent cocaine abuse in remission,racial,Other Race,2,0,2
438123,Disorder of corticoadrenal overactivity,racial,White,0,2,2
438067,Malaria,racial,Unknown,2,0,2
312358,CGN - Chronic glomerulonephritis,ethnic,Not Hispanic or Latino,0,2,2
200657,Trichomonal urethritis,ethnic,Hispanic or Latino,0,2,2
4022073,Dependance on wheel chair,racial,Black or African American ,2,0,2
433455,Teeth grinding whilst asleep,ethnic,Not Hispanic or Latino,2,0,2
193523,Broad ligament laceration syndrome,racial,Black or African American ,2,0,2
376512,Microphthalmos,ethnic,Hispanic or Latino,0,2,2
436729,Chronic gastrojejunal ulcer with haemorrhage AND obstruction,ethnic,Hispanic or Latino,2,0,2
372435,Periventricular leukomalacia,racial,Unknown,0,2,2
198483,Stricture or atresia of the vagina,racial,White,2,0,2
440158,"Venereal disease in mother complicating pregnancy, childbirth AND/OR puerperium",racial,Black or African American ,2,0,2
4314253,Visual cortex dysfunction,ethnic,Hispanic or Latino,0,2,2
255348,Polymyalgia rheumatica,racial,Asian,2,0,2
438303,Fall on same level from sports contact,racial,Unknown,2,0,2
441784,Disease due to Hantavirus,racial,White,0,2,2
73300,Radial styloid tenosynovitis,racial,Asian Indian,2,0,2
200662,Lymphosarcoma,racial,American Indian or Alaska Native ,2,0,2
434300,Neuroendocrine tumour,racial,White,2,0,2
319835,Congestive cardiac failure,racial,Alaska Native,2,0,2
4146709,Enteritis due to specified virus,racial,White,2,0,2
137077,Chronic osteomyelitis of the ankle and/or foot,racial,White,2,0,2
315586,Priapism,ethnic,Hispanic or Latino,0,2,2
79884,Galactorrhea not associated with childbirth,racial,Other Race,2,0,2
4063177,Fetal malposition and malpresentation NOS,ethnic,Hispanic or Latino,2,0,2
194419,Infertility due to oligospermia,ethnic,Hispanic or Latino,0,2,2
76221,Neonatal infective mastitis,ethnic,Hispanic or Latino,2,0,2
77029,Epididymo-orchitis without abscess,racial,Unknown,0,2,2
73065,"Contusion, genital organs",racial,American Indian or Alaska Native ,0,2,2
4054908,Closed injury of kidney,racial,Unknown,0,2,2
4093460,Leptospirosis NOS,racial,White,2,0,2
4242435,Reifenstein syndrome,racial,White,0,2,2
4171075,Bite of animal,ethnic,Not Hispanic or Latino,2,0,2
78243,Congenital spondylolysis of lumbosacral region,racial,White,0,2,2
134057,Disease of cardiovascular system,racial,Native Hawaiian or Other Pacific Islander ,0,2,2
442747,Contact dermatitis due to food in contact with skin,racial,Asian,2,0,2
4232595,Platinum asthma,ethnic,Hispanic or Latino,2,0,2
140958,Kaposi's sarcoma of palate,racial,White,0,2,2
381252,Benign neoplasm of eye,ethnic,Not Hispanic or Latino,2,0,2
4019044,Sprain of ischiocapsular ligament,ethnic,Hispanic or Latino,0,2,2
320682,Finding of white blood cell number,racial,Unknown,2,0,2
318712,Peripheral circulatory disorder associated with type I diabetes mellitus,racial,American Indian or Alaska Native ,0,2,2
4258683,Faeces - impacted,ethnic,Not Hispanic or Latino,2,0,2
443752,Ventricular hemorrhage,racial,Black or African American ,2,0,2
440213,Consciousness and/or awareness finding,racial,Asian,0,2,2
380714,Minor opacity of cornea,racial,Asian,2,0,2
435648,Testicular retraction,racial,Unknown,0,2,2
4032877,Chronic amoebic dysentery,racial,Unknown,2,0,2
79119,Thoracic spondylosis with myelopathy,ethnic,Not Hispanic or Latino,0,2,2
4070919,Other specified heart anomalies,ethnic,Hispanic or Latino,0,2,2
436010,Heat edema,ethnic,Hispanic or Latino,2,0,2
439937,C-reactive protein abnormal,racial,Asian,2,0,2
441447,Open wound of external genital organs without complication,racial,Unknown,2,0,2
196165,Cervical intraepithelial neoplasia grade 2,racial,American Indian or Alaska Native ,2,0,2
4143292,Varicose veins of legs in the puerperium,ethnic,Not Hispanic or Latino,2,0,2
320744,Complete atrioventricular block,racial,Other Race,2,0,2
440155,Postartificial menopausal syndrome,racial,Other Race,2,0,2
4171430,Screening for malignant neoplasm of rectum,racial,Native Hawaiian or Other Pacific Islander ,0,2,2
194861,Syphilis of liver,racial,White,0,2,2
40482203,Karyotype evaluation abnormal,racial,Unknown,0,2,2
4062495,Glaucoma screening,racial,Asian Indian,2,0,2
196735,Acute pyelonephritis without medullary necrosis,racial,Black or African American ,0,2,2
196454,Colostomy and enterostomy malfunction,racial,Unknown,2,0,2
40489926,Removal of dental prosthesis,racial,White,0,2,2
73043,Open traumatic dislocation of shoulder,ethnic,Not Hispanic or Latino,0,2,2
141159,Open wound of buccal mucosa without complication,ethnic,Hispanic or Latino,2,0,2
197036,Vesicoureteral reflux,ethnic,Not Hispanic or Latino,0,2,2
80805,Primary localized osteoarthrosis of forearm,racial,American Indian,2,0,2
439134,Acrocephalosyndactyly,racial,White,0,2,2
4144876,Contact dermatitis and other eczemas,racial,Asian,2,0,2
196473,Hypertrophy of uterus,racial,American Indian or Alaska Native ,2,0,2
4178964,Malignant tumour of roof of mouth,ethnic,Hispanic or Latino,0,2,2
195464,Epidemic pleurodynia,racial,White,0,2,2
441829,Hyperosmolality and or hypernatremia,racial,Other Race,0,2,2
192353,Disorder of gallbladder,racial,American Indian or Alaska Native ,2,0,2
319047,Necrosis of artery,ethnic,Hispanic or Latino,0,2,2
72714,Chronic polyarticular juvenile rheumatoid arthritis,racial,Black or African American ,2,0,2
136057,Benign neoplasm of skin of trunk,racial,Other Race,0,2,2
77070,Allergic arthritis of the hand,racial,White,2,0,2
438130,Opioid abuse,racial,Unknown,0,2,2
433410,Primary syphilis,racial,Unknown,0,2,2
4147635,Unspecified otorrhea,racial,White,0,2,2
436357,Primary malignant neoplasm of soft tissues of upper limb,racial,Unknown,0,2,2
443406,Eosinophilic gastroenteritis,racial,White,2,0,2
441764,Inhalation or ingestion of foreign body with respiratory obstruction or suffocation,ethnic,Not Hispanic or Latino,0,2,2
4052804,FH: Allergy,racial,White,2,0,2
76772,Galactorrhea in pregnancy and the puerperium with antenatal complication,ethnic,Hispanic or Latino,2,0,2
133803,Periapical abscess with sinus tract,racial,American Indian or Alaska Native ,2,0,2
193874,Bed wetting,racial,Native Hawaiian or Other Pacific Islander ,2,0,2
378756,Conjunctival hemorrhage,racial,American Indian or Alaska Native ,2,0,2
4144395,Enlarged angioscotoma,ethnic,Not Hispanic or Latino,2,0,2
4037738,Visual alteration,ethnic,Not Hispanic or Latino,2,0,2
438648,Vitamin poisoning,racial,Unknown,2,0,2
434926,Iridocyclitis,racial,American Indian or Alaska Native ,2,0,2
436546,Strain of subscapularis muscle,racial,Filipino,2,0,2
436837,Closed fracture of neck of radius,racial,White,2,0,2
137658,Congenital pigmentary anomaly of skin,racial,Unknown,0,2,2
197324,Disease of peritoneum,racial,Other Race,0,2,2
77965,Nodular tendinous disease of finger,racial,Native Hawaiian or Other Pacific Islander ,2,0,2
440067,"Moderate bipolar I disorder, single manic episode",ethnic,Hispanic or Latino,0,2,2
437699,Strain of infraspinatus muscle AND/OR tendon,ethnic,Not Hispanic or Latino,0,2,2
441398,Anomaly of sex chromosome,ethnic,Not Hispanic or Latino,0,2,2
4239301,Unwanted pregnancy,racial,Native Hawaiian or Other Pacific Islander ,2,0,2
439235,Self inflicted injury,racial,White,0,2,2
4183977,Oligohydramnios without rupture of membranes,ethnic,Hispanic or Latino,2,0,2
193238,Acute appendicitis with peritoneal abscess,ethnic,Not Hispanic or Latino,2,0,2
4168226,Micturition frequency and polyuria,racial,Black or African American ,2,0,2
192679,Renal disease in pregnancy AND/OR puerperium without hypertension,racial,Other Race,2,0,2
201951,Gonadal dysgenesis,ethnic,Not Hispanic or Latino,2,0,2
440417,Pulmonary embolism,ethnic,Hispanic or Latino,0,2,2
199885,Acute female pelvic peritonitis,racial,Unknown,2,0,2
75621,Acute polyarticular juvenile rheumatoid arthritis,racial,White,2,0,2
440369,Histrionic personality disorder,racial,White,2,0,2
4220385,Transection of isthmus of thyroid,ethnic,Hispanic or Latino,2,0,2
376399,Incipient cataract,racial,Asian,2,0,2
4062491,Anemia screening,racial,American Indian,2,0,2
200433,Dissecting aneurysm of renal artery,ethnic,Hispanic or Latino,0,2,2
80204,IUGR - Intrauterine growth retardation,ethnic,Not Hispanic or Latino,0,2,2
135611,Furuncle of hand,racial,Black or African American ,2,0,2
432504,Accident caused by fire and flames,ethnic,Hispanic or Latino,2,0,2
381573,Acute mastoiditis without complications,racial,Unknown,2,0,2
437273,Glaucoma capsulare,ethnic,Not Hispanic or Latino,0,2,2
4062795,Twin pregnancy unspecified,racial,Unknown,2,0,2
4008089,Dysentery,racial,Other Race,0,2,2
433390,Immunosuppressant adverse reaction,racial,Asian,0,2,2
441699,"Closed fracture proximal humerus, greater tuberosity",ethnic,Hispanic or Latino,2,0,2
197019,Bile duct calculus with acute cholecystitis and no obstruction,racial,White,2,0,2
4058089,Mild hyperemesis gravidarum NOS,racial,Unknown,2,0,2
4111103,Disorder of eye and adnexa NOS,racial,Unknown,0,2,2
4112658,Chest infection - pneumonia organism OS,ethnic,Hispanic or Latino,2,0,2
137063,Corns and callus,racial,Filipino,2,0,2
438739,Sympathetic uveitis,ethnic,Hispanic or Latino,0,2,2
4126282,Chlamydial urethritis,ethnic,Not Hispanic or Latino,2,0,2
437478,Bite of nonvenomous arthropod,racial,Native Hawaiian or Other Pacific Islander ,2,0,2
434311,Disorder of the urea cycle metabolism,racial,Other Race,0,2,2
375807,Degenerative disorder of globe,ethnic,Hispanic or Latino,2,0,2
4109699,Unspecified chronic conjunctivitis,racial,Unknown,2,0,2
443629,Generalised abdominal tenderness,racial,White,2,0,2
440971,Neoplasm of uncertain behaviour of testis,ethnic,Not Hispanic or Latino,0,2,2
438865,Complete trisomy 18 syndrome,ethnic,Hispanic or Latino,0,2,2
4017388,Closed dislocation lumbar spine,racial,Other Race,2,0,2
194403,Obstructed diaphragmatic hernia,ethnic,Hispanic or Latino,0,2,2
375819,TM - Tympanic membrane disorder,ethnic,Not Hispanic or Latino,0,2,2
440409,Disorder of orbit proper,racial,Asian,2,0,2
434928,Glaucoma due to iris anomaly,ethnic,Hispanic or Latino,2,0,2
372924,Cerebral arterial occlusion,ethnic,Not Hispanic or Latino,2,0,2
376387,Spasmodic torticollis,racial,Asian,2,0,2
77961,Disseminated idiopathic skeletal hyperostosis,racial,White,2,0,2
440396,Glaucoma associated with ocular trauma,racial,Black or African American ,2,0,2
4303805,Allergic reaction to bite and/or sting,racial,Native Hawaiian or Other Pacific Islander ,0,2,2
4153745,Late effect of musculoskeletal and connective tissue injury NOS,ethnic,Hispanic or Latino,0,2,2
437127,Closed dislocation of acromioclavicular joint,racial,Black or African American ,0,2,2
438660,Toxic effect of nonpetroleum-based solvent,racial,Unknown,0,2,2
433413,Disease due to Adenovirus,racial,White,2,0,2
372903,Retinal edema,racial,Asian,0,2,2
437580,Retropharyngeal abscess,ethnic,Hispanic or Latino,2,0,2
379963,Open wound of external ear without complication,racial,White,0,2,2
433823,"Infections of pregnancy, childbirth and the puerperium",ethnic,Hispanic or Latino,2,0,2
4150002,Retained placenta with no haemorrhage NOS,ethnic,Not Hispanic or Latino,2,0,2
77661,Congenital dislocation of one hip with subluxation of other,racial,White,0,2,2
195862,Urethritis,racial,Asian,0,2,2
442308,Abrasion AND/OR friction burn of thigh without infection,racial,Asian,2,0,2
441980,Closed fracture of foot,racial,American Indian or Alaska Native ,2,0,2
440058,Malignant lymphoma of extranodal AND/OR solid organ site,racial,Other Race,2,0,2
134619,Toxic nodular goiter,ethnic,Hispanic or Latino,2,0,2
313219,Phlebitis and thrombophlebitis,racial,Other Race,2,0,2
320752,Influenza with non-respiratory manifestation,racial,Native Hawaiian or Other Pacific Islander ,2,0,2
193641,Lumbar nerve root injury,racial,Black or African American ,0,2,2
437525,Overweight,racial,European,0,2,2
196488,Atonic postpartum hemorrhage,ethnic,Hispanic or Latino,2,0,2
374639,Chronic headache disorder,racial,Unknown,2,0,2
436228,Fetal death due to termination of pregnancy,racial,Unknown,2,0,2
4004621,Other bone and cartilage disorders,racial,Asian,2,0,2
438064,Bacterial infection due to Pseudomonas,racial,Other Race,0,2,2
440035,European cryptococcosis,racial,American Indian or Alaska Native ,2,0,2
438067,Malaria,racial,Black or African American ,0,2,2
378416,Retinal disorder,racial,Black or African American ,0,2,2
312349,Venous varices,racial,Black or African American ,2,0,2
4202322,Amputated big toe,racial,Black or African American ,2,0,2
4064924,Ear disorder screening,ethnic,Hispanic or Latino,2,0,2
373201,Acute eustachian tube salpingitis,ethnic,Hispanic or Latino,2,0,2
375275,Hypertropia,ethnic,Hispanic or Latino,2,0,2
4183058,Fitting of hearing aid,racial,White,2,0,2
4104431,Alcohol intoxication,racial,White,0,2,2
313324,Cheyne-Stokes respiration,ethnic,Hispanic or Latino,2,0,2
441836,Depressed bipolar I disorder,racial,Native Hawaiian or Other Pacific Islander ,0,2,2
199925,Perinatal intestinal perforation,ethnic,Not Hispanic or Latino,0,2,2
439081,Premenstrual tension syndrome,racial,Black or African American ,2,0,2
140976,Toxic uninodular goiter,racial,Unknown,0,2,2
438737,Acute paranoid reaction,ethnic,Not Hispanic or Latino,0,2,2
373756,Exudative retinopathy,racial,Unknown,2,0,2
441739,Burn erythema of axilla,ethnic,Hispanic or Latino,2,0,2
374915,Localisation-related epilepsy,ethnic,Hispanic or Latino,0,2,2
4087763,Gonococcal infection of other specified sites,ethnic,Hispanic or Latino,0,2,2
443617,Conduct disorder,racial,Native Hawaiian or Other Pacific Islander ,0,2,2
258441,Cholesteatoma of attic,racial,White,2,0,2
198246,Congenital hiatus hernia,ethnic,Not Hispanic or Latino,2,0,2
374649,Strabismic amblyopia,racial,Black or African American ,2,0,2
139841,Chronic frontal sinusitis,racial,Other Race,0,2,2
380727,Transient refractive change,racial,Unknown,2,0,2
4148115,Ectopic beats unspecified,racial,White,0,2,2
193597,Visible peristalsis,racial,White,0,2,2
432308,Mononeuritis of lower limb,racial,American Indian or Alaska Native ,2,0,2
197751,Burn of lower limb,racial,Unknown,2,0,2
443677,Open wound of knee and/or leg and/or ankle,racial,American Indian or Alaska Native ,2,0,2
432816,Tuberculosis of limb bones,racial,White,0,2,2
315831,Chronic pulmonary heart disease,racial,American Indian or Alaska Native ,0,2,2
76887,Disorders of urogenital prostheses or implants,racial,American Indian,2,0,2
372913,Impairment level: one eye: near-total impairment: other eye: not specified,racial,White,0,2,2
381007,Impairment level: better eye: profound impairment: lesser eye: not further specified,ethnic,Hispanic or Latino,0,2,2
432878,Drug abuse using speed,racial,Other Race,0,2,2
80861,Closed fracture of ischium,racial,Unknown,2,0,2
432382,Complication of labor AND/OR delivery,racial,White,2,0,2
77653,Traumatic myositis ossificans,racial,Other Race,0,2,2
4173657,Congenital malformation of the respiratory system,racial,Asian,0,2,2
201254,Insulin dependent diabetes mellitus,racial,American Indian or Alaska Native ,0,2,2
198978,Acute gonorrhea of lower genitourinary tract,racial,Asian,0,2,2
438912,Chemical burn of eyelid AND/OR periocular area,racial,White,0,2,2
200792,Retained placenta with no haemorrhage with postnatal problem,racial,White,2,0,2
200774,Detrusor and sphincter dyssynergia,racial,Unknown,2,0,2
442018,Foreign body accidentally left during a procedure,racial,Unknown,0,2,2
435018,Twin pregnancy - delivered,ethnic,Not Hispanic or Latino,2,0,2
312653,Acute myocarditis,ethnic,Hispanic or Latino,0,2,2
77069,Old posterior cruciate ligament disruption,racial,White,0,2,2
313209,Left bundle branch hemiblock,racial,American Indian,0,2,2
4104558,Unspecified blepharitis,racial,White,0,2,2
4088777,Vagina observation,racial,Native Hawaiian or Other Pacific Islander ,2,0,2
373692,West Nile encephalitis,racial,White,2,0,2
440211,Fetus OR newborn affected by morphologic abnormality of placenta,ethnic,Hispanic or Latino,0,2,2
4176874,Infantile melanodontia,racial,Asian,0,2,2
433862,Congenital anomaly of tongue,racial,Other Race,2,0,2
4004621,Other bone and cartilage disorders,ethnic,Not Hispanic or Latino,2,0,2
437240,Carcinoma in situ of skin of upper limb and shoulder,racial,White,2,0,2
197988,General abdominal pain-symptom,racial,Filipino,0,2,2
4152047,Lipid screening,racial,Filipino,2,0,2
140633,Vaccinia,racial,White,2,0,2
436166,Mild hyperemesis gravidarum,racial,Native Hawaiian or Other Pacific Islander ,2,0,2
197506,Malignant tumor of abdomen,racial,White,0,2,2
79098,Suppressed lactation,racial,White,0,2,2
73872,Congenital deformity of knee joint,ethnic,Not Hispanic or Latino,0,2,2
437088,Fetus OR newborn affected by oligohydramnios,racial,Unknown,2,0,2
192353,Disorder of gallbladder,racial,Asian,0,2,2
4062557,False labor,racial,Unknown,2,0,2
81695,Sprain of radiocarpal ligament,racial,White,2,0,2
27137,Open wound of mouth with complication,racial,Unknown,2,0,2
444421,Congenital malformation of liver,ethnic,Hispanic or Latino,2,0,2
40479575,Dysphasia as late effect of cerebrovascular disease,racial,Asian,0,2,2
195581,Peritoneal adhesion,racial,White,2,0,2
4169658,No help available,ethnic,Not Hispanic or Latino,2,0,2
432919,Discoid lupus erythematosus eyelid,ethnic,Hispanic or Latino,2,0,2
141499,Septicemia,racial,Black or African American ,0,2,2
260630,"Tuberculosis of lung, bacteriological and histological examination not done",racial,Unknown,0,2,2
133278,Disorder of hair,racial,Black or African American ,2,0,2
192286,Intestinal disaccharidase deficiency,racial,Black or African American ,2,0,2
432944,Major anomaly of jaw size,racial,White,0,2,2
432827,Infection due to Bacteroides,ethnic,Hispanic or Latino,0,2,2
133803,Periapical abscess with sinus tract,racial,Asian,2,0,2
198189,Suppurative peritonitis,ethnic,Not Hispanic or Latino,0,2,2
381021,Lagophthalmos,ethnic,Not Hispanic or Latino,0,2,2
74722,Secondary localized osteoarthrosis of pelvic region,racial,White,0,2,2
193249,Acute erosive gastritis,ethnic,Not Hispanic or Latino,0,2,2
436948,Benign neoplasm of choroid,racial,Unknown,2,0,2
137063,Corns and callus,racial,American Indian,2,0,2
137345,Pressure ulcer stage 4,racial,White,0,2,2
436485,Hyperemesis gravidarum with metabolic disturbance,ethnic,Not Hispanic or Latino,2,0,2
195007,Female stress incontinence,racial,Native Hawaiian or Other Pacific Islander ,2,0,2
441906,Prolapse of urethra,racial,White,2,0,2
4048727,Neoplasm screening,racial,Filipino,0,2,2
195793,Neoplasm of uncertain behavior of uterus,ethnic,Hispanic or Latino,2,0,2
434339,Adolescent - emotional problem,racial,Asian,0,2,2
197320,ARF - Acute renal failure,racial,American Indian,2,0,2
440105,Aqueous humour misdirect,ethnic,Hispanic or Latino,2,0,2
440516,Congenital ureterovesical obstruction,racial,White,0,2,2
137626,Seborrhoeic eczema of scalp,racial,Black or African American ,0,2,2
436254,Closed fractures of multiple bones of lower limb,racial,American Indian or Alaska Native ,2,0,2
432791,Urticaria-angio-oedema,racial,Filipino,0,2,2
4151727,Back disorders - other,racial,White,0,2,2
440695,Encopresis,racial,Other Race,0,2,2
4019044,Sprain of ischiocapsular ligament,racial,Other Race,2,0,2
437536,Somatoform autonomic dysfunction - gastrointestinal tract,racial,Black or African American ,2,0,2
81672,Nonallopathic lesion of thoracic region,racial,White,2,0,2
74250,Burn of foot,racial,Unknown,0,2,2
4153727,Closed fracture of other tarsal and metatarsal bones,racial,Unknown,0,2,2
4218764,Gastroschisis,ethnic,Not Hispanic or Latino,2,0,2
201117,Nonallopathic lesion of pelvic region,ethnic,Hispanic or Latino,2,0,2
4097567,Nodular lymphoma of unspecified site,racial,White,2,0,2
72410,Infection of bone,racial,Black or African American ,0,2,2
200459,Endometrial cystic hyperplasia,ethnic,Not Hispanic or Latino,2,0,2
374948,Acute nonsuppurative otitis media,racial,Asian,0,2,2
135027,"Carbuncle of leg, except foot",racial,Black or African American ,0,2,2
4296205,Second degree burn,racial,Black or African American ,2,0,2
312383,Postpartum cardiomyopathy,racial,Asian,2,0,2
196456,Cholecystolithiasis,racial,Filipino,2,0,2
438338,Epidemic meningitis,racial,Unknown,0,2,2
197344,Caesarean wound disruption,ethnic,Hispanic or Latino,2,0,2
435875,"Complications of pregnancy, childbirth and the puerperium",racial,Native Hawaiian or Other Pacific Islander ,2,0,2
4051241,FH: Asthma,ethnic,Hispanic or Latino,0,2,2
312349,Venous varices,racial,Asian Indian,2,0,2
4097704,Other specified leukaemia,ethnic,Hispanic or Latino,2,0,2
136916,Primary malignant neoplasm of skin of external auditory canal,racial,Unknown,2,0,2
141094,Lichen,racial,Unknown,2,0,2
4108664,Hypertensive heart disease NOS,ethnic,Not Hispanic or Latino,0,2,2
195312,Functional voiding disorder,racial,American Indian or Alaska Native ,2,0,2
376989,Duane's syndrome,ethnic,Hispanic or Latino,2,0,2
432672,Fissure of nipple,ethnic,Not Hispanic or Latino,0,2,2
434908,Disorder of porphyrin and haem metabolism,ethnic,Not Hispanic or Latino,0,2,2
256717,Bronchospasm,racial,Asian,0,2,2
443865,Non-infective colitis,racial,American Indian,2,0,2
22426,Congenital macrostomia,ethnic,Hispanic or Latino,0,2,2
4058984,Small kidneys unspecified,racial,White,2,0,2
200031,Viral hepatitis B with hepatic coma,racial,White,0,2,2
438171,Rupture of chordae tendineae,racial,Unknown,2,0,2
137626,Seborrhoeic eczema of scalp,racial,Native Hawaiian or Other Pacific Islander ,0,2,2
137989,Abnormal results of cardiovascular function studies,racial,Asian,2,0,2
438058,Rape - assault,ethnic,Not Hispanic or Latino,2,0,2
73373,Burn erythema of upper limb,racial,White,0,2,2
378352,Conjunctivitis due to adenovirus,racial,White,2,0,2
4104391,"Better eye: moderate visual impairment, Lesser eye: moderate visual impairment",ethnic,Hispanic or Latino,2,0,2
4112365,Woakes' ethmoiditis,racial,Unknown,0,2,2
443315,"Motor vehicle traffic accident due to motor vehicle going out of control due to burst tire, without collision on the highway, driver of motor vehicle injured",ethnic,Hispanic or Latino,0,2,2
379021,Impairment level: one eye: moderate impairment: other eye: near-normal vision,ethnic,Hispanic or Latino,0,2,2
432729,Crying infant,racial,Black or African American ,2,0,2
135766,Leukaemia in remission,racial,White,2,0,2
4062491,Anemia screening,racial,Other Race,0,2,2
192676,Cervical intraepithelial neoplasia grade 1,racial,Other Race,2,0,2
435792,Drug-induced sleep disorder,racial,Black or African American ,2,0,2
256450,Pulmonary asbestosis,ethnic,Hispanic or Latino,0,2,2
376657,Lipoma of face,racial,Other Race,2,0,2
27587,Disturbance of salivary secretion,racial,Asian,2,0,2
72471,Sprain of carpometacarpal joint,racial,Other Race,2,0,2
377558,Irregular astigmatism,ethnic,Not Hispanic or Latino,2,0,2
439791,Emotional upset,racial,Black or African American ,0,2,2
432537,Assault by handgun,ethnic,Hispanic or Latino,0,2,2
4109564,Unspecified corneal ulcer,racial,Unknown,2,0,2
435235,Chronic latent schizophrenia,ethnic,Hispanic or Latino,2,0,2
374040,Ill-defined disorder of eye,racial,Black or African American ,0,2,2
319049,Acute respiratory failure,racial,Asian,0,2,2
380103,Retinal detachment with retinal defect,racial,Asian,2,0,2
441980,Closed fracture of foot,racial,Asian,2,0,2
197018,Chronic gastric ulcer with hemorrhage but without obstruction,racial,Unknown,2,0,2
378425,Eyelid inflammation,racial,American Indian,2,0,2
4166443,Family history: Arthritis,racial,Other Race,2,0,2
4104386,"Better eye: profound visual impairment, Lesser eye: profound visual impairment",racial,White,0,2,2
433033,Abnormal cervical Papanicolaou smear,racial,Other Race,2,0,2
4143292,Varicose veins of legs in the puerperium,racial,Asian,2,0,2
24660,Acute tonsillitis,racial,American Indian,2,0,2
443750,Nonvenomous insect bite of finger without infection,racial,White,2,0,2
436075,Adjustment disorder with anxious mood,racial,Asian,2,0,2
443428,Torus fracture of radius,racial,Unknown,2,0,2
441181,Effects of high altitude,racial,White,2,0,2
439796,"Nondependent cocaine abuse, continuous",ethnic,Not Hispanic or Latino,0,2,2
77076,Diastasis of muscle,ethnic,Not Hispanic or Latino,2,0,2
73560,Calcaneal spur,racial,American Indian or Alaska Native ,2,0,2
72501,Superficial foreign body of foot without major open wound AND without infection,ethnic,Not Hispanic or Latino,2,0,2
441480,Poisoning by androgen AND/OR anabolic congener,racial,White,0,2,2
432637,Scleritis with corneal involvement,racial,Unknown,2,0,2
437384,Raised laboratory findings,racial,Unknown,2,0,2
4216906,Suture of laceration of external ear,racial,White,0,2,2
378429,Rosacea conjunctivitis,racial,White,0,2,2
320116,Acute pericarditis,ethnic,Not Hispanic or Latino,0,2,2
198797,Umbilical hernia with gangrene,racial,Unknown,2,0,2
441741,"Motor vehicle accident, passenger",racial,White,2,0,2
376399,Incipient cataract,ethnic,Not Hispanic or Latino,2,0,2
4111998,Esophageal varices associated with another disorder,ethnic,Hispanic or Latino,0,2,2
133547,Pyoderma,ethnic,Not Hispanic or Latino,0,2,2
4166080,Decompression of median nerve,racial,Unknown,2,0,2
4104401,Unspecified corneal oedema,racial,Unknown,2,0,2
437537,Shyness disorder of childhood,ethnic,Not Hispanic or Latino,2,0,2
141673,Aseptic necrosis of head of humerus,racial,Unknown,0,2,2
437273,Glaucoma capsulare,racial,Asian,0,2,2
380375,Organic personality disorder,ethnic,Not Hispanic or Latino,2,0,2
378768,Acute sanguinous otitis media,racial,White,2,0,2
198313,Burn erythema of abdominal wall,racial,Unknown,2,0,2
437186,Hypothermia - accidental,racial,Unknown,0,2,2
4056620,Other urethritis,racial,Asian,0,2,2
79916,Acquired hallux rigidus,ethnic,Not Hispanic or Latino,0,2,2
442764,Anal pain,racial,Other Race,0,2,2
433978,Benign tumour of laryngopharynx,racial,White,0,2,2
4138253,Malabsorption syndrome,racial,Other Race,2,0,2
438837,Boutonniere deformity,racial,White,2,0,2
136516,Congenital pes planus,racial,Other Race,2,0,2
435271,Mooren ulcer,racial,Unknown,0,2,2
75971,Open wound of multiple sites of one upper limb with tendon involvement,racial,White,2,0,2
434155,"Intraventricular (nontraumatic) haemorrhage, grade 3, of foetus and newborn",racial,White,0,2,2
80541,Closed fracture of eight OR more ribs,ethnic,Hispanic or Latino,2,0,2
440556,Closed transcervical fracture of femur,ethnic,Not Hispanic or Latino,0,2,2
436489,Complication of obstetrical surgery AND/OR procedure,racial,White,2,0,2
4078366,Repair of syndactyly,racial,White,0,2,2
4308543,Postoperative infection NOS,racial,White,2,0,2
4063026,Herpes gestationis NOS,ethnic,Not Hispanic or Latino,2,0,2
4091319,Streptococcal sore throat with scarlatina NOS,racial,Native Hawaiian or Other Pacific Islander ,2,0,2
137350,Radiation dermatitis,racial,Unknown,2,0,2
135611,Furuncle of hand,racial,Unknown,0,2,2
436230,Blood chemistry abnormal,racial,Native Hawaiian or Other Pacific Islander ,2,0,2
80591,Superficial injury of hand without infection,racial,White,0,2,2
72715,Exostosis,racial,Native Hawaiian or Other Pacific Islander ,0,2,2
376394,Menstrual migraine,racial,Other Race,2,0,2
434572,"Pinta, intermediate lesion",ethnic,Hispanic or Latino,2,0,2
78769,Acute petrositis,racial,White,2,0,2
24977,Mucocele of salivary gland,racial,Other Race,0,2,2
195213,Aldosteronism,ethnic,Hispanic or Latino,0,2,2
25189,Malignant tumour of mouth,ethnic,Hispanic or Latino,0,2,2
75555,Viral labyrinthitis,racial,American Indian or Alaska Native ,2,0,2
433942,Accident whilst engaged in household activity,racial,Black or African American ,0,2,2
315296,Preinfarction syndrome,racial,Filipino,2,0,2
440202,Multiple congenital malformations,racial,Other Race,2,0,2
194393,CACS - Coeliac axis compression syndrome,racial,White,2,0,2
4343820,Diagnostic arthroscopy of hip joint,racial,Unknown,2,0,2
441364,Complications of the puerperium,racial,Unknown,2,0,2
440940,Methicillin resistant Staphylococcus aureus infection,racial,Black or African American ,2,0,2
22856,Polyglandular dysfunction,ethnic,Not Hispanic or Latino,0,2,2
442864,"Splinter of elbow, without major open wound, infected",racial,White,2,0,2
74513,Open wound of foot without mention of complication,racial,Native Hawaiian or Other Pacific Islander ,2,0,2
436235,Taste sense altered,racial,Asian,2,0,2
4056620,Other urethritis,ethnic,Hispanic or Latino,0,2,2
440703,Trigeminal nerve disorder,racial,Other Race,2,0,2
193238,Acute appendicitis with peritoneal abscess,ethnic,Hispanic or Latino,0,2,2
321638,"Benign essential hypertension complicating pregnancy, childbirth and the puerperium",racial,Unknown,2,0,2
437896,Disorder of language,racial,American Indian or Alaska Native ,0,2,2
434657,Weakness of face muscles,racial,Unknown,2,0,2
434742,Congenital abnormality of skull and face bones,racial,Native Hawaiian or Other Pacific Islander ,2,0,2
437791,Chickenpox with complication,ethnic,Not Hispanic or Latino,0,2,2
194984,Hepatopathy,racial,American Indian or Alaska Native ,2,0,2
192859,Postablative ovarian failure,racial,White,2,0,2
437902,Teeth development and eruption disorders,racial,American Indian or Alaska Native ,2,0,2
4064917,Urinary neoplasm screening,racial,Unknown,0,2,2
372887,Disease of brain,racial,Black or African American ,0,2,2
199726,Granuloma inguinale,racial,Unknown,2,0,2
137652,Specific bursitis often of occupational origin,ethnic,Hispanic or Latino,0,2,2
140018,Tuberculous abscess of spinal cord,racial,White,0,2,2
192667,Atrophic gastritis,racial,Filipino,2,0,2
4104072,Purulent otitis media NOS,ethnic,Hispanic or Latino,2,0,2
4014230,Ankle sprain NOS,racial,Native Hawaiian or Other Pacific Islander ,0,2,2
439136,"Asphyxia, in liveborn infant",ethnic,Not Hispanic or Latino,0,2,2
4156802,"Blister of finger, infected",ethnic,Not Hispanic or Latino,2,0,2
375252,Disorder of eye,racial,Filipino,2,0,2
438134,Excessive sleep,racial,Asian,0,2,2
436948,Benign neoplasm of choroid,racial,White,0,2,2
80819,Acquired hallux varus,racial,Black or African American ,2,0,2
197006,Residual hemorrhoidal skin tags,racial,Black or African American ,2,0,2
254561,Pneumonic plague,racial,White,2,0,2
4053387,Family history of polycystic kidney,racial,Unknown,2,0,2
193322,Right lower quadrant pain,racial,Native Hawaiian or Other Pacific Islander ,0,2,2
441906,Prolapse of urethra,racial,Unknown,2,0,2
440603,Blood transfusion reaction,ethnic,Hispanic or Latino,2,0,2
75605,Intrauterine death affecting management of mother,ethnic,Hispanic or Latino,2,0,2
24230,Laryngeal FB - foreign body,racial,Black or African American ,0,2,2
40484952,Retinal function study abnormal,racial,White,2,0,2
440371,Disorder of immune function,ethnic,Hispanic or Latino,2,0,2
372409,Sciatica neuralgia,racial,Filipino,2,0,2
254068,Upper respiratory disease,racial,Other Race,2,0,2
441026,Orbital deformity due to trauma,ethnic,Hispanic or Latino,2,0,2
4256640,Body mass index 40+ - severely obese,racial,Native Hawaiian or Other Pacific Islander ,0,2,2
135975,Blister of finger without infection,racial,Unknown,2,0,2
79911,Effusion of joint of upper arm,racial,Unknown,2,0,2
438170,Acute myocardial infarction of inferior wall,racial,Filipino,0,2,2
436256,Open fracture metatarsal,ethnic,Hispanic or Latino,2,0,2
320682,Finding of white blood cell number,racial,Black or African American ,2,0,2
4100382,Acute hysterical psychosis,racial,White,2,0,2
321483,Respiratory complication,ethnic,Not Hispanic or Latino,2,0,2
194475,Singultus,racial,Native Hawaiian or Other Pacific Islander ,0,2,2
81696,Closed fracture of acetabulum,racial,Asian,2,0,2
381569,Myogenic ptosis,ethnic,Hispanic or Latino,0,2,2
259874,Ulceration of vulva associated with another disorder,ethnic,Hispanic or Latino,2,0,2
443081,Drowning and non-fatal immersion,racial,Black or African American ,0,2,2
4133967,Meckel's diverticulum,racial,White,0,2,2
373449,Drug-induced delirium,ethnic,Not Hispanic or Latino,0,2,2
196159,Old laceration of pelvic floor muscle,racial,Other Race,2,0,2
261255,Benign neoplasm of bronchus and lung,ethnic,Hispanic or Latino,2,0,2
434254,Heat stroke and sunstroke,ethnic,Not Hispanic or Latino,0,2,2
193552,Furuncle of skin AND/OR subcutaneous tissue,racial,Asian,0,2,2
437505,Nodular lymphoma of lymph nodes of axilla and upper limb,racial,Unknown,2,0,2
140487,Dermatitis herpetiformis,ethnic,Not Hispanic or Latino,0,2,2
435410,Burn of palm,racial,White,2,0,2
437169,Disorder of transplanted bone marrow,racial,White,0,2,2
440988,Antisocial personality disorder,racial,White,0,2,2
4073865,Construction of penis,racial,White,0,2,2
81395,Metatarsus primus varus,racial,White,0,2,2
136264,Open wound of floor of mouth without complication,racial,American Indian or Alaska Native ,2,0,2
439799,Leg cramps,racial,Native Hawaiian or Other Pacific Islander ,0,2,2
75971,Open wound of multiple sites of one upper limb with tendon involvement,racial,Unknown,2,0,2
436919,Primary malignant neoplasm of unspecified site,racial,Black or African American ,0,2,2
76498,Arthropathy associated with bacterial disease,racial,White,2,0,2
74726,Dislocated joint,ethnic,Not Hispanic or Latino,2,0,2
440994,Psychic factor associated with another disorder,ethnic,Hispanic or Latino,2,0,2
133669,Superficial burn of lower leg,ethnic,Hispanic or Latino,0,2,2
443257,Swellings and lumps,racial,American Indian,2,0,2
199867,CPH - Chronic persistent hepatitis,racial,Asian,2,0,2
440577,Late effect of radiation,ethnic,Hispanic or Latino,2,0,2
4285417,Incision of pituitary gland,ethnic,Not Hispanic or Latino,0,2,2
443111,Tenosynovitis of foot,racial,American Indian or Alaska Native ,0,2,2
381035,Vertigo of central origin,ethnic,Not Hispanic or Latino,2,0,2
261904,Class III buccal segment relationship,racial,White,2,0,2
201635,Female infertility of uterine origin,ethnic,Hispanic or Latino,2,0,2
197227,Overlapping malignant neoplasm of gastrointestinal tract,racial,White,0,2,2
436588,Traumatic wound dehiscence,ethnic,Hispanic or Latino,2,0,2
435574,Abnormal form of root of tooth,racial,Unknown,2,0,2
201254,Insulin dependent diabetes mellitus,racial,Filipino,0,2,2
258079,Histoplasmosis with pneumonia,ethnic,Hispanic or Latino,2,0,2
439941,Closed fracture of condyle of humerus,ethnic,Not Hispanic or Latino,0,2,2
315296,Preinfarction syndrome,racial,Other Race,2,0,2
373205,Hemorrhage of eyelid,ethnic,Not Hispanic or Latino,0,2,2
4089998,Other venereal diseases,ethnic,Hispanic or Latino,2,0,2
440238,Closed fracture of metatarsal bone,racial,American Indian or Alaska Native ,2,0,2
141038,Diastolic dysfunction,ethnic,Not Hispanic or Latino,2,0,2
444291,Cochlear hearing loss,racial,Asian,2,0,2
436730,"Appendicitis, unqualified",racial,Black or African American ,2,0,2
372765,Open wound of head without complication,racial,Other Race,2,0,2
192676,Cervical intraepithelial neoplasia grade 1,racial,American Indian or Alaska Native ,2,0,2
440905,Toxic effect of venom,racial,Asian,2,0,2
436253,Sprain of foot,racial,Asian,2,0,2
192854,Interstitial uterine fibroid,racial,Asian,2,0,2
441737,Bruising,racial,Filipino,2,0,2
438737,Acute paranoid reaction,ethnic,Hispanic or Latino,2,0,2
433930,Motor vehicle on road in collision with another motor vehicle,racial,Unknown,2,0,2
81379,Lateral epicondylitis,racial,Filipino,0,2,2
443753,Abrasion AND/OR friction burn of wrist without infection,racial,Asian,0,2,2
136057,Benign neoplasm of skin of trunk,racial,American Indian or Alaska Native ,2,0,2
260936,Infiltrative tuberculosis of lung,ethnic,Hispanic or Latino,0,2,2
440066,Disorder of purine and pyrimidine metabolism,racial,Asian,2,0,2
197925,Haemorrhage of rectum and anus,racial,Filipino,0,2,2
258866,Respiratory distress syndrome in the newborn,ethnic,Hispanic or Latino,0,2,2
4143915,Cholestasis,racial,Other Race,2,0,2
78272,Sprain of wrist,racial,Native Hawaiian or Other Pacific Islander ,2,0,2
72245,Chlamydial infection of lower genitourinary tract,racial,Black or African American ,0,2,2
73754,Restless legs,racial,Native Hawaiian or Other Pacific Islander ,0,2,2
440211,Fetus OR newborn affected by morphologic abnormality of placenta,ethnic,Not Hispanic or Latino,0,2,2
432814,Device withdrawn and / or removed,racial,Unknown,0,2,2
73851,Effusion of joint of multiple sites,ethnic,Hispanic or Latino,2,0,2
140057,Chronic leukemia,ethnic,Hispanic or Latino,0,2,2
135858,Disorder of lip,racial,Native Hawaiian or Other Pacific Islander ,0,2,2
433823,"Infections of pregnancy, childbirth and the puerperium",ethnic,Not Hispanic or Latino,2,0,2
374168,Complex febrile seizure,racial,Unknown,0,2,2
74132,Degeneration of lumbosacral intervertebral disc,racial,Filipino,2,0,2
434012,Developmental dyslexia,ethnic,Not Hispanic or Latino,0,2,2
442794,Poisoning by wasp sting,racial,Asian,2,0,2
198528,Acquired unequal leg length,racial,Other Race,0,2,2
4303359,Acute septal infarction,ethnic,Hispanic or Latino,2,0,2
441269,Autoimmune hemolytic anemia,racial,Black or African American ,2,0,2
77961,Disseminated idiopathic skeletal hyperostosis,racial,Black or African American ,0,2,2
133803,Periapical abscess with sinus tract,ethnic,Hispanic or Latino,2,0,2
314090,PET - Mild pre-eclamptic toxaemia,ethnic,Not Hispanic or Latino,2,0,2
4286638,Childhood,racial,White,0,2,2
4054550,Open wound of scrotum and testes,racial,White,0,2,2
133284,Impetigo herpetiformis,racial,Unknown,0,2,2
434459,Ganglion of tendon sheath,racial,Native Hawaiian or Other Pacific Islander ,0,2,2
435887,Antepartum deep phlebothrombosis,ethnic,Hispanic or Latino,0,2,2
4299535,Pregnancy confirmed,racial,Native Hawaiian or Other Pacific Islander ,2,0,2
434111,Oligohydramnios,ethnic,Hispanic or Latino,2,0,2
443458,Closed fracture of facial bone,ethnic,Not Hispanic or Latino,2,0,2
133569,Fasciitis,racial,Other Race,2,0,2
4085803,Microsporosis nigra,racial,Other Race,2,0,2
442941,"Nontraffic accident involving being trapped by door of motor vehicle whilst boarding or alighting from motor vehicle, except off-road vehicle, not on highway, driver of motor vehicle injured",ethnic,Hispanic or Latino,0,2,2
437015,Congenital alveolar hyperplasia of mandible,ethnic,Hispanic or Latino,2,0,2
381569,Myogenic ptosis,racial,Asian,0,2,2
433390,Immunosuppressant adverse reaction,racial,Other Race,2,0,2
4008089,Dysentery,racial,Asian,2,0,2
443709,Atypical squamous cells of undetermined significance on anal Papanicolaou smear,racial,Unknown,2,0,2
4120666,Conjunctival biopsy,racial,White,2,0,2
378849,Microtia,racial,Black or African American ,0,2,2
4016888,Rabies contact,ethnic,Hispanic or Latino,2,0,2
4110945,Benign hypertensive heart disease NOS,ethnic,Not Hispanic or Latino,2,0,2
438205,Maternal syphilis during pregnancy - baby not yet delivered,ethnic,Not Hispanic or Latino,2,0,2
443750,Nonvenomous insect bite of finger without infection,racial,Unknown,2,0,2
254390,Malignant effusion,racial,Asian,0,2,2
438872,Hyperphagia,racial,Black or African American ,2,0,2
434633,Disorder of autonomic nervous system,racial,Unknown,0,2,2
78529,Kyphoscoliosis and scoliosis,racial,Other Race,2,0,2
318174,Phlebitis,racial,Unknown,0,2,2
442075,Chronic glomerulonephritis associated with another disorder,ethnic,Hispanic or Latino,0,2,2
378735,Migraine without aura,racial,Black or African American ,0,2,2
23798,Acute laryngopharyngitis,racial,Asian,0,2,2
137785,Verruca plantaris,racial,Asian Indian,0,2,2
73090,Superficial bruising of foot,racial,Asian,2,0,2
197096,Urethra and bladder neck atresia and stenosis,racial,White,0,2,2
75053,Fracture of bone,racial,Asian,2,0,2
434323,Disorder of sulphur-bearing amino acid metabolism,racial,Asian,2,0,2
193256,Alcoholic fatty liver,racial,Other Race,0,2,2
195562,Hemorrhoids,racial,Asian Indian,2,0,2
4098600,Gouty nephropathy unspecified,racial,Unknown,2,0,2
442300,"Thyroid disease in mother complicating pregnancy, childbirth AND/OR puerperium",ethnic,Hispanic or Latino,2,0,2
4149353,"Attention deficit hyperactivity disorder, predominantly inattentive type",racial,Native Hawaiian or Other Pacific Islander ,0,2,2
72996,"Stiff joint NEC, of the lower leg",ethnic,Not Hispanic or Latino,0,2,2
4287237,Vascular hamartoma of skin,racial,American Indian or Alaska Native ,0,2,2
380728,Filamentary keratitis,ethnic,Not Hispanic or Latino,2,0,2
78517,Arthralgia of multiple joints,racial,Filipino,2,0,2
200445,Chronic prostatitis,racial,Asian,0,2,2
440953,Cysticercosis,racial,Filipino,2,0,2
433320,Excessive crying of child,racial,Asian,0,2,2
444052,"Bone AND/OR joint disorder of back in mother complicating pregnancy, childbirth AND/OR puerperium",ethnic,Hispanic or Latino,2,0,2
439391,Physical abuse of adult,racial,Asian,2,0,2
375290,Chronic suppurative otitis media - tubotympanic,ethnic,Not Hispanic or Latino,0,2,2
4098582,Hyperemesis gravidarum before end of 22 week gestation with carbohydrate depletion,racial,Unknown,2,0,2
436373,DSD - Developmental speech disorder,racial,Native Hawaiian or Other Pacific Islander ,0,2,2
437838,"Cannabis dependence, episodic",ethnic,Hispanic or Latino,0,2,2
198191,Acquired hypertrophic pyloric stenosis,racial,Other Race,2,0,2
438941,Poisoning by hydantoin derivative,ethnic,Hispanic or Latino,2,0,2
380038,Viral conjunctivitis,racial,Black or African American ,0,2,2
77815,"Benign neoplasm of vertebral column, excluding sacrum and coccyx",ethnic,Hispanic or Latino,2,0,2
4046893,Lifestyle,racial,Asian,0,2,2
439894,Post-term pregnancy - delivered,racial,White,2,0,2
433759,Developmental reading disorder,racial,Unknown,2,0,2
440865,Closed fracture of epiphysis of femur,ethnic,Hispanic or Latino,0,2,2
436546,Strain of subscapularis muscle,racial,Asian,0,2,2
137322,Oral submucosal fibrosis,racial,White,2,0,2
195312,Functional voiding disorder,racial,Filipino,2,0,2
4191387,Infertility care,ethnic,Hispanic or Latino,0,2,2
444200,Neoplasm of nervous system,ethnic,Not Hispanic or Latino,2,0,2
4073858,Excision of cyst of epididymis,ethnic,Hispanic or Latino,0,2,2
432541,Primary tuberculosis,racial,White,0,2,2
138312,Burn of scalp,racial,White,2,0,2
434614,Disorder of iron metabolism,racial,White,0,2,2
197039,Male genital organ vascular diseases,racial,White,0,2,2
381549,Migraine with aura,racial,Filipino,2,0,2
76797,Congenital deformity of genital organ,racial,American Indian,0,2,2
439960,Late effect of external cause,ethnic,Not Hispanic or Latino,2,0,2
4017388,Closed dislocation lumbar spine,racial,Asian,2,0,2
197601,Spermatocele,racial,Asian,0,2,2
72992,Allergic arthritis,racial,Black or African American ,2,0,2
432725,Congenital anomaly of integument,racial,Black or African American ,2,0,2
4175807,Rheumatic disease of tricuspid valve,ethnic,Not Hispanic or Latino,2,0,2
4101660,Amputated below knee,racial,Alaska Native,2,0,2
4147630,Other disorders of binocular eye movements,ethnic,Not Hispanic or Latino,2,0,2
199726,Granuloma inguinale,racial,White,2,0,2
436466,Balanoposthitis,racial,Filipino,0,2,2
4343127,Evans operation,racial,White,0,2,2
200459,Endometrial cystic hyperplasia,ethnic,Hispanic or Latino,2,0,2
372330,Acute allergic mucoid otitis media,ethnic,Hispanic or Latino,2,0,2
375817,Conjunctivochalasis,racial,Unknown,2,0,2
80205,Perinatal condition,ethnic,Not Hispanic or Latino,0,2,2
193541,Perineal laceration involving anal sphincter,racial,Unknown,2,0,2
436366,Benign tumour of testis,racial,Unknown,0,2,2
4292726,Contact - infectious disease,racial,American Indian,2,0,2
440309,Adverse reaction to diphtheria vaccine,racial,Other Race,0,2,2
435170,Effects of thirst,ethnic,Not Hispanic or Latino,2,0,2
436222,Altered mental status,racial,American Indian,2,0,2
196462,Unilateral recurrent femoral hernia without obstruction AND without gangrene,ethnic,Hispanic or Latino,2,0,2
4234546,Nasolacrimal duct probe - diag,ethnic,Hispanic or Latino,0,2,2
76196,Palindromic rheumatism,ethnic,Hispanic or Latino,0,2,2
438931,Foreign body accidentally entering eye and adnexa,ethnic,Not Hispanic or Latino,0,2,2
440525,Prematurity of fetus,racial,Filipino,2,0,2
4118958,Unilateral total thyroid lobectomy,racial,Unknown,2,0,2
134441,Chronic ulcer of skin,racial,Black or African American ,2,0,2
439053,Exostosis of jaw,racial,Unknown,2,0,2
75413,Burn of wrist,racial,Unknown,2,0,2
437744,Heat exhaustion,ethnic,Not Hispanic or Latino,2,0,2
4095592,Malignant melanoma of scalp and/or neck,racial,White,2,0,2
257423,"Late effect of burns of eye, face, head AND/OR neck",racial,White,0,2,2
432296,Coagulation factor deficiency syndrome,racial,Black or African American ,2,0,2
194704,Spontaneous abortion complicated by embolism,racial,Unknown,2,0,2
442920,Mental disorder during pregnancy - baby delivered,racial,White,2,0,2
375525,Athetoid cerebral palsy,racial,Unknown,0,2,2
438912,Chemical burn of eyelid AND/OR periocular area,racial,Unknown,2,0,2
193666,Hip injury,racial,Asian Indian,0,2,2
195584,Acute peptic ulcer without hemorrhage AND without perforation but with obstruction,ethnic,Not Hispanic or Latino,0,2,2
77069,Old posterior cruciate ligament disruption,racial,Unknown,0,2,2
433320,Excessive crying of child,ethnic,Not Hispanic or Latino,0,2,2
73534,Disproportion between fetus and pelvis,racial,White,2,0,2
4143490,Blindness or low vision NOS,ethnic,Hispanic or Latino,0,2,2
318450,Cardiac tamponade,racial,White,0,2,2
194152,Renal agenesis and dysgenesis,racial,Black or African American ,2,0,2
443421,Gallbladder and bile duct calculi,ethnic,Not Hispanic or Latino,2,0,2
441015,Pigmentary iris degeneration,racial,White,2,0,2
375290,Chronic suppurative otitis media - tubotympanic,racial,Asian,0,2,2
77673,Sign or symptom of the urinary system,racial,Black or African American ,2,0,2
313209,Left bundle branch hemiblock,racial,Asian,0,2,2
442011,Mechanical complication due to cardiac pacemaker electrode,racial,Unknown,2,0,2
443235,Ankle and/or foot joint stiffness,ethnic,Hispanic or Latino,0,2,2
254669,Disease of vocal cords,ethnic,Not Hispanic or Latino,2,0,2
381275,Anterior horn cell disease,ethnic,Hispanic or Latino,2,0,2
378420,Carcinomatous neuropathy,racial,White,2,0,2
4104558,Unspecified blepharitis,racial,Unknown,2,0,2
140961,Infestation by Phthirus pubis,racial,White,0,2,2
75046,Old bucket handle tear of medial meniscus,racial,Black or African American ,0,2,2
318382,Malignant mast cell tumor of extranodal AND/OR solid organ site,racial,White,0,2,2
257293,Disorder of visual pathways,racial,Other Race,0,2,2
443178,"Insect bite, nonvenomous, of face",racial,Unknown,2,0,2
375475,Meningoencephalitis due to acquired toxoplasmosis,racial,Black or African American ,0,2,2
317576,Coronary arteriosclerosis,racial,American Indian,2,0,2
440820,Contracture of wrist joint,racial,Unknown,0,2,2
4109544,"Total, mature senile cataract",racial,White,2,0,2
433376,Burning due to contact with hot solid objects and materials,ethnic,Hispanic or Latino,2,0,2
74698,Breech presentation,racial,Other Race,2,0,2
440021,Herpes simplex without complication,racial,American Indian,2,0,2
140266,Superficial bruising of back,racial,Black or African American ,2,0,2
316822,Finding of heart murmur,racial,African American,2,0,2
4062557,False labor,racial,White,2,0,2
4103752,Limited eye examination,racial,White,2,0,2
318222,Acute adenitis,racial,Asian,2,0,2
78621,Crushing injury of knee,racial,White,0,2,2
313543,Venous complication in pregnancy AND/OR the puerperium,ethnic,Not Hispanic or Latino,2,0,2
197751,Burn of lower limb,racial,White,0,2,2
75667,Sprain of calcaneofibular ligament,ethnic,Not Hispanic or Latino,0,2,2
443533,"Epispadias, male",ethnic,Hispanic or Latino,0,2,2
434002,Mineral deficiency,racial,Unknown,2,0,2
444453,Benign tumour of soft tissue of leg,ethnic,Not Hispanic or Latino,0,2,2
4104555,Other and unspecified conjunctivitis,racial,Asian,2,0,2
437093,Congenital ptosis of upper eyelid,racial,Asian,0,2,2
314666,Healed coronary,racial,Asian Indian,0,2,2
4097586,Myeloid leukaemia NOS,racial,White,0,2,2
196364,Benign tumour of cervix,ethnic,Hispanic or Latino,2,0,2
73845,Ankylosis of joint of shoulder region,ethnic,Hispanic or Latino,2,0,2
81696,Closed fracture of acetabulum,ethnic,Not Hispanic or Latino,2,0,2
75863,Chronic interstitial cystitis,racial,American Indian or Alaska Native ,2,0,2
78233,Old disruption of medial collateral ligament,racial,Unknown,2,0,2
435796,Dehydration,racial,Native Hawaiian or Other Pacific Islander ,2,0,2
433316,Giddiness,racial,American Indian,2,0,2
195401,Superficial bruising of hip,ethnic,Not Hispanic or Latino,2,0,2
81984,Sprain of shoulder and upper arm,racial,Filipino,0,2,2
80946,Tinea manus,racial,Black or African American ,2,0,2
198192,Renal and perinephric abscess,ethnic,Hispanic or Latino,2,0,2
437249,Recurrent manic episodes,racial,White,2,0,2
4145010,Knee enthesopathy NOS,racial,White,0,2,2
4088072,Pulmonary tuberculosis NOS,racial,Unknown,2,0,2
444212,Injury of descending left colon without open wound into abdominal cavity,ethnic,Hispanic or Latino,0,2,2
4220063,"Repair of knee, five-in-one",ethnic,Hispanic or Latino,2,0,2
133547,Pyoderma,ethnic,Hispanic or Latino,2,0,2
196284,Burn of mouth and pharynx,racial,White,2,0,2
195306,Gastroduodenitis,racial,American Indian,0,2,2
80205,Perinatal condition,racial,Asian,0,2,2
318137,Phlebitis and thrombophlebitis of intracranial sinuses,ethnic,Hispanic or Latino,0,2,2
260430,Pneumonia due to E. coli,ethnic,Not Hispanic or Latino,0,2,2
200792,Retained placenta with no haemorrhage with postnatal problem,racial,Unknown,2,0,2
133737,Acute thyroiditis,racial,Unknown,2,0,2
377555,Solar retinitis,racial,White,2,0,2
255302,Spontaneous pneumothorax,racial,Other Race,0,2,2
4104391,"Better eye: moderate visual impairment, Lesser eye: moderate visual impairment",ethnic,Not Hispanic or Latino,2,0,2
444437,Congenital abnormality of cervix,racial,Black or African American ,2,0,2
4175807,Rheumatic disease of tricuspid valve,racial,Asian,2,0,2
23808,"Chronic peptic ulcer without hemorrhage, without perforation AND without obstruction",racial,Unknown,2,0,2
4156802,"Blister of finger, infected",racial,Asian,2,0,2
40479583,Iatrogenic pneumothorax,ethnic,Not Hispanic or Latino,0,2,2
432620,Disorder of choroid of eye,racial,White,2,0,2
4061587,Obstetric pulmonary embolism NOS,ethnic,Hispanic or Latino,0,2,2
381783,Viral disease of central nervous system,racial,White,0,2,2
440396,Glaucoma associated with ocular trauma,ethnic,Not Hispanic or Latino,0,2,2
432588,Megaloblastic anemia due to vitamin B>12< deficiency,racial,Asian,0,2,2
443111,Tenosynovitis of foot,racial,Filipino,2,0,2
141004,Lesion of radial nerve,racial,White,0,2,2
4192676,Born by caesarean section,ethnic,Not Hispanic or Latino,2,0,2
73925,Burn of upper limb,racial,White,0,2,2
433413,Disease due to Adenovirus,ethnic,Hispanic or Latino,2,0,2
437580,Retropharyngeal abscess,racial,White,2,0,2
77317,Chronic ulcerative rectosigmoiditis,ethnic,Hispanic or Latino,2,0,2
314409,Vascular disorder of penis,racial,White,0,2,2
378081,Overlapping malignant neoplasm of connective and other soft tissues,ethnic,Hispanic or Latino,0,2,2
23245,Hemorrhage of esophagus,ethnic,Hispanic or Latino,0,2,2
375807,Degenerative disorder of globe,racial,White,2,0,2
379812,Exposure keratitis,racial,White,2,0,2
434089,Antepartum hemorrhage,racial,Unknown,2,0,2
73231,Arthralgia of temporomandibular joint,racial,American Indian or Alaska Native ,2,0,2
4285417,Incision of pituitary gland,ethnic,Hispanic or Latino,2,0,2
441546,Functional vomiting,ethnic,Not Hispanic or Latino,0,2,2
440066,Disorder of purine and pyrimidine metabolism,ethnic,Not Hispanic or Latino,2,0,2
441153,Closed supracondylar fracture of femur,racial,Unknown,2,0,2
137275,Disorder of muscle,racial,Other Race,0,2,2
434165,Abnormal cervical smear,racial,Filipino,2,0,2
195019,"Pelvic soft tissue abnormality in pregnancy, childbirth and the puerperium with antenatal problem",ethnic,Hispanic or Latino,2,0,2
436222,Altered mental status,racial,Black or African American ,0,2,2
381677,SBO - Spina bifida occulta,racial,Asian,0,2,2
79904,Secondary localised osteoarthrosis of hand,ethnic,Not Hispanic or Latino,0,2,2
194686,Acquired renal cyst,racial,American Indian,0,2,2
132776,Injury involving multiple body regions,racial,Unknown,2,0,2
373201,Acute eustachian tube salpingitis,racial,White,2,0,2
4168396,Dilation of cervix uteri and curettage for termination of pregnancy,racial,White,2,0,2
437894,Ventricular fibrillation,racial,Native Hawaiian or Other Pacific Islander ,0,2,2
133283,Pyoderma gangrenosum,ethnic,Hispanic or Latino,2,0,2
443228,"Abrasion or friction burn of foot and toe, without mention of infection",racial,Other Race,0,2,2
373724,Neoplasm of brain,racial,Other Race,0,2,2
140582,Superficial burn of foot,racial,Other Race,2,0,2
141038,Diastolic dysfunction,racial,Asian,2,0,2
4110945,Benign hypertensive heart disease NOS,racial,Asian,2,0,2
433621,Sprain of sternoclavicular joint AND/OR ligament,racial,Unknown,2,0,2
24970,Chronic laryngitis,racial,American Indian or Alaska Native ,0,2,2
254390,Malignant effusion,ethnic,Not Hispanic or Latino,0,2,2
201418,"Flatulence, eructation and gas pain",racial,American Indian or Alaska Native ,0,2,2
135178,Streptococcal septicaemia,ethnic,Not Hispanic or Latino,0,2,2
439794,CSA - Central sleep apnoea,racial,White,2,0,2
440213,Consciousness and/or awareness finding,racial,Unknown,2,0,2
4064908,Trypanosomiasis screening,ethnic,Hispanic or Latino,2,0,2
438744,"Pigment epitheliopathy, disseminated retinitis AND retinochoroiditis",racial,Asian,0,2,2
444129,Wrist injury,racial,American Indian or Alaska Native ,2,0,2
439035,Otosclerosis,racial,White,0,2,2
318186,Achalasia of esophagus,racial,Asian,2,0,2
75621,Acute polyarticular juvenile rheumatoid arthritis,ethnic,Hispanic or Latino,2,0,2
4088920,Womb absent,racial,Filipino,2,0,2
381569,Myogenic ptosis,ethnic,Not Hispanic or Latino,0,2,2
80509,Bone cyst,racial,Other Race,2,0,2
73290,Contracture of joint,ethnic,Not Hispanic or Latino,2,0,2
375551,Blepharochalasis,racial,White,2,0,2
435024,Precipitate labour with antenatal problem,ethnic,Hispanic or Latino,2,0,2
4062733,Neurological screening,racial,Unknown,0,2,2
313761,Central retinal vein occlusion,racial,Other Race,0,2,2
4171115,Low birth weight infant,ethnic,Not Hispanic or Latino,2,0,2
4063522,Congenital absence of uterus,ethnic,Hispanic or Latino,2,0,2
318712,Peripheral circulatory disorder associated with type I diabetes mellitus,racial,Black or African American ,0,2,2
441545,Somatisation disorder,racial,Unknown,2,0,2
259153,Throat soreness,racial,Alaska Native,2,0,2
435666,Closed fracture of upper end of tibia,ethnic,Not Hispanic or Latino,2,0,2
434893,Selective IgM immunodeficiency,racial,White,0,2,2
436403,Retinal vasculitis,racial,White,2,0,2
437784,Pfeiffer's disease,racial,Native Hawaiian or Other Pacific Islander ,2,0,2
134452,Miners' elbow,racial,Native Hawaiian or Other Pacific Islander ,0,2,2
77029,Epididymo-orchitis without abscess,racial,Asian,0,2,2
439937,C-reactive protein abnormal,racial,American Indian,2,0,2
197023,Bilateral inguinal hernia,racial,Asian,0,2,2
134898,Non-toxic single thyroid nodule,racial,American Indian or Alaska Native ,2,0,2
316501,Disorder of blood vessels affecting skin,racial,Other Race,2,0,2
377845,Anoxic encephalopathy,racial,Black or African American ,0,2,2
72404,Joint stiffness,racial,Asian,2,0,2
443178,"Insect bite, nonvenomous, of face",racial,Other Race,2,0,2
432504,Accident caused by fire and flames,racial,White,2,0,2
374957,Acquired stenosis of external ear canal,racial,Unknown,0,2,2
80186,Recurrent dislocation of shoulder region,ethnic,Not Hispanic or Latino,0,2,2
28457,Hypertrophy of tonsils,racial,Filipino,0,2,2
315505,Benign neoplasm of lymph node,ethnic,Not Hispanic or Latino,2,0,2
438827,Foreign body granuloma of subcutaneous tissue,ethnic,Not Hispanic or Latino,0,2,2
4063177,Fetal malposition and malpresentation NOS,racial,White,2,0,2
374905,Non-organic sleep disorder,racial,American Indian or Alaska Native ,2,0,2
197019,Bile duct calculus with acute cholecystitis and no obstruction,ethnic,Hispanic or Latino,2,0,2
256215,"Lung agenesis, hypoplasia and dysplasia",racial,Unknown,0,2,2
441571,Retained old foreign body following penetrating wound of orbit,ethnic,Hispanic or Latino,0,2,2
441333,Geographic tongue,racial,Other Race,0,2,2
4218764,Gastroschisis,racial,Black or African American ,2,0,2
438905,Sequelae of injury of spinal cord,ethnic,Hispanic or Latino,0,2,2
4052804,FH: Allergy,racial,Other Race,2,0,2
432969,Multiple pregnancy,ethnic,Hispanic or Latino,2,0,2
440538,Closed fracture of lower end of radius AND ulna,racial,Unknown,2,0,2
200459,Endometrial cystic hyperplasia,racial,Black or African American ,2,0,2
441980,Closed fracture of foot,racial,Black or African American ,2,0,2
434241,Accidental poisoning by soap products,racial,White,2,0,2
72410,Infection of bone,ethnic,Not Hispanic or Latino,0,2,2
377551,Blind hypertensive eye,racial,White,2,0,2
132449,Transient limb paralysis,racial,Unknown,2,0,2
314664,Long Q-T syndrome,ethnic,Not Hispanic or Latino,2,0,2
194419,Infertility due to oligospermia,racial,White,0,2,2
4050797,Family history of urological neoplasm,racial,White,0,2,2
439134,Acrocephalosyndactyly,ethnic,Hispanic or Latino,0,2,2
135615,Pityriasis,racial,Native Hawaiian or Other Pacific Islander ,0,2,2
441784,Disease due to Hantavirus,ethnic,Hispanic or Latino,0,2,2
73300,Radial styloid tenosynovitis,racial,American Indian or Alaska Native ,2,0,2
439242,Adverse reaction to tetanus vaccine,ethnic,Hispanic or Latino,0,2,2
4150307,Dental restoration observation,racial,American Indian,2,0,2
442038,Anaphylactic shock due to serum,racial,White,2,0,2
444438,Leucoplakia of tongue,ethnic,Not Hispanic or Latino,2,0,2
441189,Pertussis vaccine adverse reaction,racial,Unknown,2,0,2
435242,Cerebellar ataxia,racial,Black or African American ,0,2,2
435444,Poisoning due to venomous marine animals or plants,racial,Unknown,2,0,2
4109395,Other visual pathway disorder,racial,Unknown,2,0,2
140949,Scabies,racial,Native Hawaiian or Other Pacific Islander ,0,2,2
72714,Chronic polyarticular juvenile rheumatoid arthritis,ethnic,Not Hispanic or Latino,2,0,2
436480,Dystrophy of vulva,racial,Unknown,2,0,2
321876,Disease of capillaries,ethnic,Not Hispanic or Latino,0,2,2
372909,Impairment level: better eye: severe impairment: lesser eye: not further specified,racial,Unknown,2,0,2
72576,Benign tumour of breast,racial,Black or African American ,2,0,2
140958,Kaposi's sarcoma of palate,ethnic,Hispanic or Latino,0,2,2
433846,Ankylosis of joint of lower leg,ethnic,Not Hispanic or Latino,0,2,2
4019044,Sprain of ischiocapsular ligament,racial,White,0,2,2
438975,Multisystemic disseminated toxoplasmosis,ethnic,Not Hispanic or Latino,2,0,2
136282,"Burn erythema of single finger, not thumb",racial,Unknown,0,2,2
4146709,Enteritis due to specified virus,ethnic,Hispanic or Latino,2,0,2
134870,Pityriasis versicolor,racial,Filipino,0,2,2
256439,Allergic rhinitis due to pollen,racial,Native Hawaiian or Other Pacific Islander ,0,2,2
433596,Abnormal sputum,racial,Other Race,2,0,2
75426,Burn of hand,racial,Unknown,0,2,2
200452,Disease of female genital organ,racial,American Indian or Alaska Native ,2,0,2
197236,Uterine fibroid,racial,Filipino,2,0,2
317109,Respiratory arrest,racial,Unknown,2,0,2
139202,"Burn involving 20-29 percent of body surface, with 10-19 percent of body surface with full thickness burn",ethnic,Not Hispanic or Latino,0,2,2
4051770,"Contusion, ankle and foot, excluding toe(s)",racial,White,0,2,2
441828,Disorganized schizophrenia,ethnic,Not Hispanic or Latino,2,0,2
136237,Cardiovascular system problem,racial,Other Race,2,0,2
432746,"Open fracture of radius and ulna, shaft",racial,Unknown,0,2,2
442740,"Nontraffic accident involving fall from motor vehicle, except off-road motor vehicle, whilst in motion, not on public highway, motor cyclist injured",racial,White,2,0,2
193353,Abrasion AND/OR friction burn of trunk with infection,racial,Unknown,2,0,2
195562,Hemorrhoids,racial,American Indian,2,0,2
140273,"Contusion, forearm area",racial,American Indian or Alaska Native ,2,0,2
437464,"Injury undetermined whether accidentally or purposely inflicted, fall from residential premises",racial,American Indian or Alaska Native ,2,0,2
443864,Multi-infarct dementia with depression,racial,Other Race,0,2,2
434689,Incomplete abortion,racial,Unknown,2,0,2
4232595,Platinum asthma,racial,White,2,0,2
376512,Microphthalmos,racial,White,0,2,2
4070919,Other specified heart anomalies,racial,White,0,2,2
435917,Fetus OR newborn affected by incompetent cervix,racial,Unknown,2,0,2
436010,Heat edema,racial,White,2,0,2
259048,Pneumonia in systemic mycosis,ethnic,Hispanic or Latino,0,2,2
438485,Postoperative state,ethnic,Hispanic or Latino,2,0,2
433083,Opiate and narcotic poisoning,ethnic,Not Hispanic or Latino,2,0,2
76221,Neonatal infective mastitis,racial,White,2,0,2
442601,Sedative abuse,racial,Other Race,0,2,2
4185302,Chronic myocardial ischemia,racial,Native Hawaiian or Other Pacific Islander ,2,0,2
437703,Closed fracture of intracapsular section of femur,racial,White,2,0,2
4145004,Osteoarthritis of spine NOS,racial,Unknown,0,2,2
381568,Pseudomembranous conjunctivitis,racial,Unknown,0,2,2
80204,IUGR - Intrauterine growth retardation,racial,Black or African American ,0,2,2
436956,Evans syndrome,ethnic,Not Hispanic or Latino,0,2,2
75365,Oliguria and anuria,racial,Asian,2,0,2
377844,Status migrainosus,ethnic,Not Hispanic or Latino,2,0,2
443459,Pathological fracture of neck of femur,racial,Unknown,2,0,2
200657,Trichomonal urethritis,racial,White,0,2,2
440325,Rubella without complication,ethnic,Not Hispanic or Latino,2,0,2
4049954,Open wound of nasal sinus,ethnic,Not Hispanic or Latino,0,2,2
435262,Primary open angle glaucoma,racial,Filipino,0,2,2
316376,Eosinophilia,racial,Black or African American ,2,0,2
440971,Neoplasm of uncertain behaviour of testis,racial,Unknown,0,2,2
192372,Placenta praevia without haemorrhage - not delivered,racial,Asian,2,0,2
435308,Acute exudative glomerulonephritis,racial,White,0,2,2
442747,Contact dermatitis due to food in contact with skin,racial,Unknown,2,0,2
4064377,Depression screening,racial,Middle Eastern or North African,2,0,2
441819,"Carcinoma in situ of lip, oral cavity and pharynx",ethnic,Hispanic or Latino,2,0,2
135975,Blister of finger without infection,racial,American Indian or Alaska Native ,0,2,2
436007,Complication of introduction procedure,ethnic,Hispanic or Latino,0,2,2
434069,"Mottled teeth, congenital",ethnic,Hispanic or Latino,0,2,2
138519,Spondylosis without myelopathy,racial,American Indian,2,0,2
80294,Foreign body in genitourinary tract,ethnic,Not Hispanic or Latino,2,0,2
4270051,Arthrodesis of ankle,racial,Unknown,2,0,2
432677,Habitual aborter-not pregnant,racial,Unknown,2,0,2
441896,Plicated tongue,racial,Other Race,0,2,2
436832,Closed fracture of sternum,racial,Asian,2,0,2
432807,Accidents caused by cutting and piercing instruments or objects,ethnic,Hispanic or Latino,2,0,2
4059736,Infective urethral stricture NOS,ethnic,Hispanic or Latino,0,2,2
73558,Allergic arthritis of the lower leg,racial,White,2,0,2
4324788,Articular cartilage disorder of wrist,ethnic,Hispanic or Latino,2,0,2
381392,Congenital subcapsular cataract,ethnic,Hispanic or Latino,2,0,2
4269584,Finding relating to religious movement or belief,racial,White,2,0,2
439937,C-reactive protein abnormal,racial,Black or African American ,2,0,2
4215971,Obstructed incisional ventral hernia,racial,White,2,0,2
200768,Inflammatory disease of vagina and/or vulva,racial,Other Race,2,0,2
200444,Post-cholecystectomy syndrome,racial,Other Race,0,2,2
4041798,"Hodgkin's disease, lymphocytic depletion",ethnic,Not Hispanic or Latino,0,2,2
435244,Developmental disorder,racial,Unknown,2,0,2
443913,Congenital anomaly of trachea,racial,Other Race,2,0,2
135333,Pressure sore,racial,Black or African American ,2,0,2
436729,Chronic gastrojejunal ulcer with haemorrhage AND obstruction,racial,White,2,0,2
439796,"Nondependent cocaine abuse, continuous",racial,Black or African American ,0,2,2
256909,Primary pulmonary coccidioidomycosis,racial,Asian,0,2,2
444082,False labor without delivery,racial,Unknown,2,0,2
439615,Fall from stationary vehicle,ethnic,Hispanic or Latino,2,0,2
373126,Non-arthropod-borne viral disease of the central nervous system,ethnic,Hispanic or Latino,2,0,2
259995,Foreign body in orifice,ethnic,Hispanic or Latino,0,2,2
73012,Saddle back,racial,White,2,0,2
433915,Burn of thigh,ethnic,Not Hispanic or Latino,2,0,2
442139,Primary bronchial cancer,racial,American Indian or Alaska Native ,0,2,2
73318,Polydactyly of fingers,ethnic,Not Hispanic or Latino,0,2,2
80070,Uric acid urolithiasis,ethnic,Not Hispanic or Latino,0,2,2
4012320,Autotransplantation of thyroid tissue,ethnic,Hispanic or Latino,2,0,2
134870,Pityriasis versicolor,racial,Other Race,2,0,2
4059445,Chronic glomerulonephritis NOS,ethnic,Hispanic or Latino,0,2,2
4178537,Family history: nervous system disorder,racial,White,0,2,2
4103889,Unspecified blepharoconjunctivitis,ethnic,Hispanic or Latino,2,0,2
436252,Closed fracture of shaft of tibia,ethnic,Not Hispanic or Latino,0,2,2
136775,Contact dermatitis due to solar radiation,racial,Other Race,2,0,2
200837,Congenital anomaly of fixation of intestine,racial,Other Race,2,0,2
438836,Poliomyelitis osteopathy of the lower leg,ethnic,Not Hispanic or Latino,2,0,2
438478,Hemorrhage in early pregnancy,racial,White,2,0,2
435723,Wound seroma,ethnic,Not Hispanic or Latino,0,2,2
381021,Lagophthalmos,racial,Black or African American ,0,2,2
4085626,Other protozoal intestinal diseases,ethnic,Hispanic or Latino,0,2,2
139750,Primary malignant neoplasm of skin,ethnic,Not Hispanic or Latino,2,0,2
200174,Disease of skin AND/OR subcutaneous tissue,racial,Filipino,0,2,2
199839,External haemorrhoids without complication,racial,Native Hawaiian or Other Pacific Islander ,2,0,2
439237,Assault,racial,Other Race,0,2,2
196156,Urethral diverticulum,racial,White,2,0,2
141693,Elevated blood-pressure reading without diagnosis of hypertension,racial,Asian Indian,0,2,2
27017,Defective dental restoration,racial,Other Race,0,2,2
4009601,Fracture of one or more phalanges of hand NOS,ethnic,Hispanic or Latino,2,0,2
72501,Superficial foreign body of foot without major open wound AND without infection,racial,Black or African American ,2,0,2
80242,Current tear of medial cartilage AND/OR meniscus of knee,racial,American Indian or Alaska Native ,2,0,2
74138,Pathological fracture of vertebra,racial,Other Race,0,2,2
4312857,Incision of spleen,ethnic,Not Hispanic or Latino,0,2,2
4280605,Common duodenal ulcer,ethnic,Hispanic or Latino,2,0,2
439982,Infection as complication of medical care,racial,Unknown,2,0,2
381842,Petit mal status,racial,Other Race,2,0,2
196757,Fetal-maternal haemorrhage with antenatal problem,racial,White,0,2,2
197230,Malignant neoplasm of uterus,racial,Asian,2,0,2
441460,Late effect of sprain AND/OR strain without tendon injury,racial,Other Race,2,0,2
77352,Pyogenic arthritis of the lower leg,ethnic,Not Hispanic or Latino,2,0,2
441561,Low tension glaucoma,racial,White,0,2,2
23325,Heartburn,racial,American Indian or Alaska Native ,2,0,2
197440,Nonvenomous insect bite of trunk without infection,racial,Unknown,2,0,2
255711,Optic nerve and pathway injury,ethnic,Hispanic or Latino,0,2,2
442936,"Motor vehicle traffic accident due to motor vehicle going out of control due to failure of mechanical part, without collision on the highway, passenger of motor vehicle injured",racial,Unknown,0,2,2
433125,Infection due to Staphylocccus aureus,racial,Asian,0,2,2
196159,Old laceration of pelvic floor muscle,racial,White,2,0,2
443751,"Late effect of open wound of head, neck AND/OR trunk",ethnic,Hispanic or Latino,2,0,2
436832,Closed fracture of sternum,ethnic,Not Hispanic or Latino,2,0,2
193255,"Noninflammatory disorders of the ovary, fallopian tube and broad ligament",racial,Asian,2,0,2
314754,Wheezing,racial,Asian Indian,2,0,2
76784,Bleeding into joint,ethnic,Not Hispanic or Latino,0,2,2
440035,European cryptococcosis,racial,Unknown,2,0,2
135287,Non-neoplastic naevus,racial,Other Race,2,0,2
77734,Contusion of lower leg,racial,Asian,2,0,2
439136,"Asphyxia, in liveborn infant",racial,Black or African American ,0,2,2
439743,Late effects of respiratory tuberculosis,ethnic,Hispanic or Latino,2,0,2
254514,Contusion of lung without open wound into thorax,racial,White,2,0,2
80819,Acquired hallux varus,ethnic,Not Hispanic or Latino,2,0,2
4090114,Toxoplasmosis chorioretinitis,racial,White,0,2,2
442610,Degenerative AND/OR vascular disorder of ear,ethnic,Hispanic or Latino,0,2,2
434616,Haemoglobinuria due to haemolysis from external causes,racial,Asian,0,2,2
138117,Benign tumour of spinal cord,racial,Unknown,2,0,2
443081,Drowning and non-fatal immersion,ethnic,Not Hispanic or Latino,0,2,2
141499,Septicemia,ethnic,Not Hispanic or Latino,0,2,2
377556,Sudden visual loss,racial,Unknown,2,0,2
437027,Acute duodenitis,ethnic,Hispanic or Latino,0,2,2
196454,Colostomy and enterostomy malfunction,ethnic,Not Hispanic or Latino,0,2,2
434688,Tight hymenal ring,ethnic,Not Hispanic or Latino,2,0,2
4046500,Acute peptic ulcer with hemorrhage,racial,Unknown,2,0,2
140480,Impetigo,racial,Native Hawaiian or Other Pacific Islander ,2,0,2
374009,Organic mental disorder,racial,Black or African American ,2,0,2
4113351,Unspecified spontaneous abortion with complication NOS,racial,White,2,0,2
433496,Unilateral sensory hearing loss,ethnic,Hispanic or Latino,2,0,2
442651,"Noncollision motor vehicle traffic accident involving fire starting in motor vehicle whilst in motion, passenger of motor vehicle injured",racial,White,2,0,2
437461,Disorder of prosthetic cardiac valve,ethnic,Not Hispanic or Latino,2,0,2
444391,Pain around eye,racial,American Indian or Alaska Native ,2,0,2
198928,Mechanical complication due to intrauterine contraceptive device,racial,Other Race,2,0,2
73847,Observation of elbow joint,racial,Unknown,0,2,2
375115,Nonmagnetic foreign body penetrating eyeball,racial,White,0,2,2
439346,"Motor vehicle traffic accident involving pedestrian run over by motor vehicle, occupant of tram injured",racial,White,2,0,2
381854,Disorder of conjunctiva,racial,American Indian,0,2,2
440464,Complication following molar AND/OR ectopic pregnancy,racial,White,2,0,2
439246,"Mixed bipolar affective disorder, severe, with psychosis",racial,Unknown,2,0,2
443716,Blister of shoulder without infection,ethnic,Not Hispanic or Latino,2,0,2
435933,Closed fracture of lumbar vertebra without spinal cord injury,racial,American Indian or Alaska Native ,2,0,2
433031,Hallucinations,racial,Black or African American ,0,2,2
75045,Climacteric arthritis of the pelvic region and thigh,racial,Unknown,0,2,2
4085922,Infection screening,racial,Unknown,2,0,2
435912,Endocardial cushion defect,ethnic,Not Hispanic or Latino,2,0,2
142026,Disorder of cardiovascular prostheses and implants,racial,Black or African American ,2,0,2
80862,"Closed fractures of phalanx or phalanges, multiple sites",racial,Unknown,2,0,2
443449,Acute laryngitis with obstruction,ethnic,Hispanic or Latino,0,2,2
433565,Juvenile osteochondrosis of spine,racial,Unknown,2,0,2
4204989,Disturbance in sleep behavior,racial,Unknown,2,0,2
440922,Diabetic on insulin,racial,Other Race,0,2,2
319844,Acute ischemic heart disease,ethnic,Not Hispanic or Latino,2,0,2
381297,Xanthoma of eyelid,racial,White,2,0,2
201240,Metastasis to female genital organ,racial,White,2,0,2
78909,"Contusion, shoulder and upper arm, multiple sites",racial,Black or African American ,2,0,2
193693,Viral hepatitis without hepatic coma,ethnic,Not Hispanic or Latino,0,2,2
4171556,Ankle ulcer,racial,Asian,0,2,2
137591,Chronic apical periodontitis,racial,Unknown,2,0,2
434819,Benzodiazepine poisoning,racial,White,2,0,2
381028,Acute suppurative otitis media - tympanic membrane ruptured,racial,Native Hawaiian or Other Pacific Islander ,0,2,2
438365,Phaeohyphomycosis,ethnic,Hispanic or Latino,0,2,2
197913,Disorder of function of stomach,racial,Filipino,2,0,2
439372,"Motor vehicle traffic accident involving collision, on highway, between motor vehicle and fallen stone, traffic sign, tree or utility pole, pedestrian injured",racial,Unknown,2,0,2
436445,Abrasion of teeth,racial,Asian,0,2,2
438077,Disseminated candidiasis,ethnic,Hispanic or Latino,0,2,2
440233,Strain of supraspinatus muscle AND/OR tendon,ethnic,Not Hispanic or Latino,2,0,2
192380,Failed attempted abortion without complication,ethnic,Hispanic or Latino,2,0,2
74451,Palindromic rheumatism of the forearm,racial,Asian,2,0,2
4155527,Unspecified polyarthropathy or polyarthritis,ethnic,Hispanic or Latino,2,0,2
437536,Somatoform autonomic dysfunction - gastrointestinal tract,ethnic,Not Hispanic or Latino,2,0,2
133566,Necrotizing fasciitis,ethnic,Not Hispanic or Latino,2,0,2
432975,Trauma to perineum and/or vulva during delivery,racial,Unknown,2,0,2
437982,Semen observations,racial,Unknown,0,2,2
438297,"Mechanical complication of cardiac device, implant AND/OR graft",racial,Unknown,0,2,2
442189,Blister of wrist without infection,ethnic,Hispanic or Latino,2,0,2
443207,Single organ dysfunction,racial,White,0,2,2
195014,Renal failure following molar AND/OR ectopic pregnancy,ethnic,Hispanic or Latino,2,0,2
73290,Contracture of joint,racial,Asian,2,0,2
436510,Acquired cavus foot deformity,ethnic,Hispanic or Latino,0,2,2
200275,Burn erythema of multiple sites of trunk,racial,Unknown,2,0,2
133298,Musculoskeletal disorder of the neck,racial,Filipino,0,2,2
432661,Stomatitis,racial,Filipino,2,0,2
438168,Aneurysm of heart,racial,Unknown,2,0,2
443367,Antihypertensive adverse reaction,racial,Black or African American ,0,2,2
137991,Sick-euthyroid syndrome,racial,Other Race,0,2,2
376415,Hypermetropia,racial,Asian,2,0,2
439318,Complete illegal abortion with metabolic disorder,ethnic,Not Hispanic or Latino,0,2,2
376422,Mucopurulent conjunctivitis,racial,Asian,2,0,2
443750,Nonvenomous insect bite of finger without infection,racial,Other Race,0,2,2
253670,Injury of optic pathways,ethnic,Hispanic or Latino,0,2,2
435503,Hemolytic anemia,ethnic,Not Hispanic or Latino,2,0,2
438744,"Pigment epitheliopathy, disseminated retinitis AND retinochoroiditis",ethnic,Not Hispanic or Latino,0,2,2
433393,Fall into hole,racial,White,2,0,2
193591,Meconium ileus,ethnic,Hispanic or Latino,0,2,2
197206,Balantidiasis,ethnic,Not Hispanic or Latino,0,2,2
381252,Benign neoplasm of eye,racial,Unknown,2,0,2
435269,Optic papillitis,racial,White,2,0,2
198853,Congenital anomaly of ovary,racial,White,2,0,2
132834,White piedra,ethnic,Not Hispanic or Latino,2,0,2
437369,Postmature infancy,racial,White,0,2,2
377280,Corneal disorder,racial,Asian,2,0,2
442862,"Abrasion or friction burn of hand, without mention of infection",racial,Asian,2,0,2
74468,Congenital anomaly of rib,racial,Unknown,2,0,2
72991,Traumatic arthropathy of multiple sites,ethnic,Hispanic or Latino,0,2,2
139180,Open wound of multiple sites of face without complication,racial,Asian,0,2,2
4062480,Diphtheria screening,racial,White,0,2,2
435859,Acute duodenal ulcer without hemorrhage AND without perforation but with obstruction,ethnic,Hispanic or Latino,2,0,2
435416,Poisoning by anti-infective agent,racial,Unknown,2,0,2
201244,Benign tumour of vagina,ethnic,Not Hispanic or Latino,2,0,2
441561,Low tension glaucoma,racial,Unknown,2,0,2
437390,Hypoxaemia,racial,Black or African American ,2,0,2
140654,Deep seated dermatophytosis,racial,Asian,2,0,2
372765,Open wound of head without complication,racial,Unknown,2,0,2
434605,Benign tumor of lacrimal drainage structure,ethnic,Hispanic or Latino,0,2,2
194071,Pylorospasm,ethnic,Hispanic or Latino,2,0,2
134569,Erythema infectiosum,racial,Filipino,2,0,2
433596,Abnormal sputum,racial,American Indian or Alaska Native ,0,2,2
435243,Alcohol dependence,racial,Other Race,2,0,2
439235,Self inflicted injury,ethnic,Not Hispanic or Latino,0,2,2
437993,Closed fracture of cervical spine,ethnic,Not Hispanic or Latino,0,2,2
433263,Complications following abortion and ectopic and molar pregnancies,racial,White,2,0,2
136760,Transient hypertension of pregnancy - not delivered,racial,Black or African American ,2,0,2
77455,Burn of chest wall,racial,White,2,0,2
439907,Spontaneous tendon rupture,racial,White,2,0,2
200843,Observation of frequency of urination,racial,Asian Indian,0,2,2
200452,Disease of female genital organ,racial,Other Race,2,0,2
137940,Transient hypertension of pregnancy - delivered,ethnic,Hispanic or Latino,2,0,2
439183,Concussion,racial,American Indian or Alaska Native ,0,2,2
77354,Primary localised osteoarthrosis of lower leg,racial,American Indian,2,0,2
76545,Closed traumatic dislocation of patella,racial,Other Race,0,2,2
193804,Achlorhydria,racial,White,2,0,2
140062,Iodine hypothyroidism,racial,White,0,2,2
432600,Stress reaction causing mixed disturbance of emotion and conduct,racial,Unknown,2,0,2
4204989,Disturbance in sleep behavior,racial,White,0,2,2
381017,Ametropic amblyopia,racial,Black or African American ,2,0,2
137425,"Insect bite, nonvenomous, of trunk, infected",racial,Unknown,2,0,2
432656,Embolism and thrombosis of the thoracic aorta,ethnic,Hispanic or Latino,2,0,2
81938,Climacteric arthritis of the shoulder region,racial,White,2,0,2
4098410,Atrial cardioversion,racial,Unknown,0,2,2
438630,Exposure to radiation,ethnic,Hispanic or Latino,2,0,2
4311114,Sensory disorder,racial,White,2,0,2
380109,Exophoria,racial,White,2,0,2
321320,Myocardial degeneration,racial,Other Race,0,2,2
199071,Nephrotic syndrome with minimal change glomerulonephritis,ethnic,Hispanic or Latino,2,0,2
436204,Subcutaneous hematoma,racial,Unknown,2,0,2
76573,Full thickness burn of hand,racial,White,0,2,2
440179,"Chondrocalcinosis due to dicalcium phosphate crystals, of the lower leg",ethnic,Hispanic or Latino,2,0,2
438367,Primary malignant neoplasm of nasal cavity,racial,White,0,2,2
4002318,Cleft palate with cleft lip NOS,racial,White,2,0,2
137591,Chronic apical periodontitis,racial,White,0,2,2
259048,Pneumonia in systemic mycosis,ethnic,Not Hispanic or Latino,0,2,2
24966,OV - Oesophageal varices,racial,Native Hawaiian or Other Pacific Islander ,0,2,2
27411,Open wound of multiple sites of mouth with complication,ethnic,Hispanic or Latino,0,2,2
4022073,Dependance on wheel chair,racial,Other Race,0,2,2
380095,Lesions of nerves plexuses and roots,racial,White,2,0,2
78473,Solitary cyst of breast,racial,Native Hawaiian or Other Pacific Islander ,2,0,2
436954,Drug abuse,racial,Native Hawaiian or Other Pacific Islander ,0,2,2
440392,Retinal vascular occlusion,racial,Asian,0,2,2
256811,Congenital anomaly of nose,ethnic,Hispanic or Latino,0,2,2
198899,Open wound of trunk with complication,ethnic,Hispanic or Latino,2,0,2
443452,Bleeding of unknown origin,racial,American Indian or Alaska Native ,2,0,2
4101602,Henoch-Schonlein purpura,racial,Asian,0,2,2
378679,Acute poliomyelitis,ethnic,Not Hispanic or Latino,2,0,2
4173452,Exteriorisation of appendix,ethnic,Hispanic or Latino,2,0,2
76506,Effusion of joint of lower leg,racial,American Indian or Alaska Native ,2,0,2
136775,Contact dermatitis due to solar radiation,racial,American Indian or Alaska Native ,2,0,2
138790,Chronic periodontitis,racial,American Indian,2,0,2
40414926,"Accidental cut, puncture, perforation or haemorrhage during administration of enema",ethnic,Not Hispanic or Latino,0,2,2
440980,Atypical manic disorder,ethnic,Hispanic or Latino,0,2,2
4103961,Removal of acoustic neuroma,ethnic,Hispanic or Latino,2,0,2
436700,Eye displaced forwards,racial,Asian,2,0,2
437878,Persistent mydriasis,ethnic,Not Hispanic or Latino,2,0,2
25572,Disease of salivary gland,racial,Black or African American ,0,2,2
438392,Disorder of hyperalimentation,racial,Unknown,2,0,2
436522,Irregular sleep-wake pattern,ethnic,Hispanic or Latino,0,2,2
4105880,Contact of sexually transmissible disorder,racial,Native Hawaiian or Other Pacific Islander ,0,2,2
4094876,"Malignant neoplasm of lower lobe, bronchus or lung",racial,White,2,0,2
77661,Congenital dislocation of one hip with subluxation of other,ethnic,Not Hispanic or Latino,0,2,2
4185471,Disorder of pigmentation,racial,Native Hawaiian or Other Pacific Islander ,2,0,2
4263370,R.I.N.D. syndrome,racial,American Indian,2,0,2
4214763,Repair of brain,ethnic,Not Hispanic or Latino,0,2,2
80862,"Closed fractures of phalanx or phalanges, multiple sites",racial,White,2,0,2
77961,Disseminated idiopathic skeletal hyperostosis,ethnic,Not Hispanic or Latino,0,2,2
134741,Congenital anomaly of limb,racial,Asian,2,0,2
441269,Autoimmune hemolytic anemia,ethnic,Not Hispanic or Latino,2,0,2
372924,Cerebral arterial occlusion,racial,White,2,0,2
75052,Enthesopathy of wrist AND/OR carpus,racial,Other Race,0,2,2
443562,Closed dislocation of radiocarpal joint,ethnic,Hispanic or Latino,2,0,2
318247,Apnea in the newborn,racial,Other Race,0,2,2
261116,Acquired nasal deformity,racial,Asian,2,0,2
436906,Rickettsial disease,ethnic,Hispanic or Latino,2,0,2
195009,Leukoplakia of penis,ethnic,Hispanic or Latino,0,2,2
437187,Assault by striking by blunt or thrown object,racial,White,0,2,2
78838,Acquired deformity of knee,racial,Unknown,2,0,2
81425,Closed fracture of sacrum AND/OR coccyx with complete cauda equina lesion,ethnic,Hispanic or Latino,2,0,2
4113351,Unspecified spontaneous abortion with complication NOS,racial,Unknown,2,0,2
433536,Severe pre-eclampsia,racial,White,2,0,2
378140,Inflammatory and toxic neuropathy,racial,Asian,0,2,2
438391,Amino acid transport disorder,racial,Asian,2,0,2
80286,Prosthetic joint loosening,ethnic,Hispanic or Latino,0,2,2
201418,"Flatulence, eructation and gas pain",racial,Alaska Native,0,2,2
261889,Simple chronic bronchitis,racial,Asian,0,2,2
79119,Thoracic spondylosis with myelopathy,racial,White,0,2,2
444100,Mood disorder,racial,American Indian or Alaska Native ,0,2,2
379805,Myopia,racial,Native Hawaiian or Other Pacific Islander ,0,2,2
132703,Lichen planus,racial,American Indian or Alaska Native ,2,0,2
438931,Foreign body accidentally entering eye and adnexa,racial,Black or African American ,0,2,2
436612,Gaseous hydrocarbon causing toxic effect,ethnic,Hispanic or Latino,2,0,2
377574,Presbycusis,racial,Black or African American ,0,2,2
4129404,Open wound of upper arm,racial,Unknown,2,0,2
434261,"Motor vehicle nontraffic accident involving collision, not on public highway, between motor vehicle, except off-road motor vehicle, and nonmotor vehicle, motor cyclist injured",ethnic,Not Hispanic or Latino,0,2,2
441868,Optic disc oedema,racial,Other Race,2,0,2
442792,Pes anserinus bursitis,racial,Asian,0,2,2
4008683,Anxiety neurosis,racial,Filipino,2,0,2
376955,Gouty tophi of ear,ethnic,Hispanic or Latino,0,2,2
437744,Heat exhaustion,racial,Black or African American ,2,0,2
4234299,Repair of cystocele,ethnic,Hispanic or Latino,2,0,2
435080,Biliuria,racial,Other Race,2,0,2
75347,Spinal enthesopathy,ethnic,Hispanic or Latino,2,0,2
443616,Refractory migraine without aura,ethnic,Not Hispanic or Latino,2,0,2
437791,Chickenpox with complication,racial,Black or African American ,0,2,2
74716,Galactorrhea associated with childbirth,ethnic,Hispanic or Latino,2,0,2
443464,Central pain syndrome,ethnic,Hispanic or Latino,0,2,2
4095304,Malignant neoplasm of pituitary gland and craniopharyngeal duct,ethnic,Hispanic or Latino,2,0,2
433025,Complication of vaccination,racial,Unknown,2,0,2
435940,"Closed fracture of humerus, shaft",racial,Asian,0,2,2
315505,Benign neoplasm of lymph node,ethnic,Hispanic or Latino,2,0,2
444369,Hyperosmolality,ethnic,Hispanic or Latino,2,0,2
4112819,Pneumonia due to other specified bacteria,racial,Asian,0,2,2
434300,Neuroendocrine tumour,ethnic,Not Hispanic or Latino,2,0,2
74150,"Congenital subluxation of hip, bilateral",racial,White,2,0,2
22856,Polyglandular dysfunction,racial,Black or African American ,0,2,2
441701,Sprain of hip joint,racial,Asian,0,2,2
139888,Threatened premature labor - not delivered,racial,American Indian or Alaska Native ,2,0,2
4147635,Unspecified otorrhea,ethnic,Not Hispanic or Latino,0,2,2
78607,Open wound of multiple sites of one upper limb with complication,racial,Unknown,0,2,2
379779,Subacute delirium,ethnic,Hispanic or Latino,2,0,2
441764,Inhalation or ingestion of foreign body with respiratory obstruction or suffocation,racial,White,2,0,2
257086,Incomplete bilateral cleft palate,ethnic,Hispanic or Latino,0,2,2
321815,Malignant histiocytosis of lymph nodes of multiple sites,racial,White,2,0,2
440454,Abortion without complication,racial,Asian,2,0,2
444202,Abscess,racial,Asian Indian,2,0,2
24230,Laryngeal FB - foreign body,ethnic,Not Hispanic or Latino,0,2,2
261326,Viral pneumonia,racial,Asian,0,2,2
437969,Acquired pes planus,racial,American Indian or Alaska Native ,0,2,2
432301,Opioid dependence in remission,racial,Black or African American ,2,0,2
436398,Glaucoma associated with ocular disorder,racial,Unknown,2,0,2
4210149,Substance abuse counseling,racial,American Indian or Alaska Native ,0,2,2
440925,Suicide,racial,Black or African American ,2,0,2
4115379,"Localised, primary osteoarthritis of the pelvic region and thigh",racial,American Indian,2,0,2
437295,Abnormal pupillary function,racial,White,2,0,2
434203,Late effect of contusion,ethnic,Not Hispanic or Latino,2,0,2
443774,"Disease condition determination, uncontrolled",ethnic,Not Hispanic or Latino,2,0,2
435524,Sleep disorder,racial,American Indian or Alaska Native ,2,0,2
138841,Disorder of sacrum,racial,Filipino,0,2,2
442295,Disorder of carbohydrate transport,racial,White,2,0,2
80805,Primary localized osteoarthrosis of forearm,racial,Black or African American ,2,0,2
442597,Meteorism,racial,Other Race,2,0,2
193636,Foreign body in bladder AND/OR urethra,racial,White,2,0,2
195197,Primary malignant neoplasm of vulva,ethnic,Not Hispanic or Latino,2,0,2
432810,Injury of unknown intent by burns or fire,ethnic,Hispanic or Latino,2,0,2
4275756,Dependent drug abuse,racial,White,2,0,2
4296024,Family disruption due to divorce,racial,Unknown,0,2,2
439134,Acrocephalosyndactyly,ethnic,Not Hispanic or Latino,0,2,2
24075,Esophageal stricture and stenosis,racial,Black or African American ,0,2,2
81186,Contusion of wrist,racial,Native Hawaiian or Other Pacific Islander ,2,0,2
193787,Varicose veins of lower extremity with ulcer AND inflammation,racial,Other Race,0,2,2
436804,Fetus OR newborn affected by premature rupture of membranes,racial,Asian,0,2,2
200447,Gastrointestinal complication,ethnic,Hispanic or Latino,2,0,2
192971,"Pelvic soft tissue abnormality in pregnancy, childbirth and the puerperium - delivered with postnatal complication",ethnic,Hispanic or Latino,2,0,2
4129482,Ovary observations,racial,Unknown,2,0,2
4228073,Peripheral nerve block,racial,Unknown,2,0,2
438872,Hyperphagia,ethnic,Not Hispanic or Latino,2,0,2
4085803,Microsporosis nigra,racial,White,2,0,2
434616,Haemoglobinuria due to haemolysis from external causes,ethnic,Hispanic or Latino,0,2,2
200675,Neoplasm of uncertain behavior of ovary,racial,White,2,0,2
442324,Psychologic dyspareunia,racial,Unknown,2,0,2
435150,Effects of heat AND/OR light,racial,White,2,0,2
260427,Common cold,racial,Native Hawaiian or Other Pacific Islander ,0,2,2
4020669,Coronary arteriography using single catheter,racial,White,2,0,2
199771,Carcinoid syndrome,ethnic,Hispanic or Latino,2,0,2
433111,Effects of hunger,ethnic,Hispanic or Latino,2,0,2
201257,Disorder of endocrine ovary,racial,Unknown,2,0,2
75911,Acquired hallux valgus,racial,American Indian or Alaska Native ,0,2,2
442444,"Motor vehicle traffic accident involving pedestrian hit by motor vehicle, pedestrian injured",racial,Unknown,2,0,2
132416,Chronic haematoma of pinna,racial,Unknown,0,2,2
439221,"Adverse effect, due to correct medicinal substance properly administered",racial,Native Hawaiian or Other Pacific Islander ,2,0,2
443915,Poisoning by autonomous nervous system drug,ethnic,Not Hispanic or Latino,2,0,2
196821,Observation of urethral discharge,racial,Black or African American ,0,2,2
440940,Methicillin resistant Staphylococcus aureus infection,racial,Asian,2,0,2
4133029,Primigravida,racial,American Indian or Alaska Native ,2,0,2
201727,Superficial injury of trunk without infection,racial,Unknown,2,0,2
75614,Acrodermatitis continua,racial,American Indian or Alaska Native ,0,2,2
4062635,Measles screening,racial,White,2,0,2
4220385,Transection of isthmus of thyroid,racial,Unknown,2,0,2
81659,Traumatic arthropathy of the pelvic region and thigh,racial,Unknown,2,0,2
4133311,Tetanus vaccination,ethnic,Hispanic or Latino,2,0,2
4111103,Disorder of eye and adnexa NOS,ethnic,Hispanic or Latino,0,2,2
437257,Continuous acute alcoholic intoxication in alcoholism,ethnic,Not Hispanic or Latino,0,2,2
196792,Acquired claw foot,ethnic,Hispanic or Latino,0,2,2
26711,Chronic pharyngitis,racial,Black or African American ,0,2,2
444258,Abrasion AND/OR friction burn of neck with infection,racial,Asian,0,2,2
321638,"Benign essential hypertension complicating pregnancy, childbirth and the puerperium",racial,American Indian or Alaska Native ,2,0,2
432682,Complete spontaneous abortion with delayed or excessive haemorrhage,racial,White,2,0,2
136960,Vascular myelopathies,ethnic,Hispanic or Latino,2,0,2
31967,Nausea,racial,Native Hawaiian or Other Pacific Islander ,2,0,2
443715,Atypical squamous cells on anal Papanicolaou smear cannot exclude high grade squamous intraepithelial lesion,racial,White,2,0,2
444283,Superficial foreign body of hand without major open wound AND without infection,ethnic,Not Hispanic or Latino,2,0,2
374955,Spasm of conjugate gaze,ethnic,Hispanic or Latino,0,2,2
4111113,Other external ear disorder NOS,ethnic,Hispanic or Latino,2,0,2
319844,Acute ischemic heart disease,ethnic,Hispanic or Latino,0,2,2
442181,Secondary malignant neoplasm of lymph nodes of neck,ethnic,Hispanic or Latino,2,0,2
132659,Acute apical periodontitis,racial,Arab,2,0,2
4062733,Neurological screening,racial,White,2,0,2
440938,Infection by Shigella,racial,Unknown,0,2,2
373166,Benign neoplasm of lower jaw bone,ethnic,Hispanic or Latino,2,0,2
79939,Sprain of tarsometatarsal joint AND/OR ligament,ethnic,Not Hispanic or Latino,2,0,2
254980,Intrinsic asthma with asthma attack,racial,American Indian or Alaska Native ,2,0,2
80809,Rheumatoid arthritis,racial,Native Hawaiian or Other Pacific Islander ,2,0,2
438391,Amino acid transport disorder,ethnic,Not Hispanic or Latino,2,0,2
4064926,Ischemic heart disease screening,ethnic,Hispanic or Latino,2,0,2
4021807,Interpersonal relationship observations,ethnic,Hispanic or Latino,0,2,2
255302,Spontaneous pneumothorax,racial,White,0,2,2
74816,Contusion of toe,racial,Native Hawaiian or Other Pacific Islander ,0,2,2
444453,Benign tumour of soft tissue of leg,racial,Black or African American ,0,2,2
377865,Acquired color vision deficiency,ethnic,Hispanic or Latino,0,2,2
435141,Haemorrhage AND/OR haematoma complicating procedure,ethnic,Not Hispanic or Latino,2,0,2
317100,Fetal tachycardia,ethnic,Hispanic or Latino,2,0,2
79115,"Spondylopathy, NOS",ethnic,Hispanic or Latino,2,0,2
138538,Longitudinal deficiency of limb,racial,Black or African American ,0,2,2
438123,Disorder of corticoadrenal overactivity,ethnic,Not Hispanic or Latino,0,2,2
435933,Closed fracture of lumbar vertebra without spinal cord injury,racial,Other Race,0,2,2
433915,Burn of thigh,ethnic,Hispanic or Latino,2,0,2
432746,"Open fracture of radius and ulna, shaft",racial,White,0,2,2
4060318,Chest pain NOS,racial,Native Hawaiian or Other Pacific Islander ,0,2,2
373472,Pigmentary retinal dystrophy,ethnic,Not Hispanic or Latino,0,2,2
4186238,Louse infestation,racial,Black or African American ,2,0,2
444132,Knee injury,racial,Asian,2,0,2
4053378,FH: Blood disorder,racial,Black or African American ,2,0,2
372766,Open wound of head with complication,ethnic,Hispanic or Latino,0,2,2
72471,Sprain of carpometacarpal joint,racial,Unknown,2,0,2
78633,Stokers' cramp,racial,Unknown,2,0,2
196284,Burn of mouth and pharynx,racial,Other Race,2,0,2
435805,Cerebrospinal rhinorrhoea,racial,Other Race,2,0,2
197032,Hyperplasia of prostate,racial,Filipino,0,2,2
441918,"Emotional AND/OR mental disease in mother complicating pregnancy, childbirth AND/OR puerperium",racial,Asian,2,0,2
380707,Distortion of visual image,ethnic,Not Hispanic or Latino,0,2,2
4112819,Pneumonia due to other specified bacteria,ethnic,Not Hispanic or Latino,0,2,2
373412,Otitis externa due to Herpes zoster,ethnic,Not Hispanic or Latino,0,2,2
436859,"Insect bite, nonvenomous, of shoulder and upper arm, infected",racial,Unknown,2,0,2
434689,Incomplete abortion,racial,White,2,0,2
253121,"Tuberculosis of lung, confirmed by culture only",ethnic,Hispanic or Latino,0,2,2
79914,Polydactyly of toes,ethnic,Hispanic or Latino,0,2,2
373489,Congenital nystagmus,racial,Unknown,2,0,2
382003,Burn of face AND/OR head,ethnic,Hispanic or Latino,2,0,2
432586,Mental disorder,racial,American Indian or Alaska Native ,0,2,2
438698,"Malignant lymphoma of lymph nodes of head, face AND/OR neck",racial,Unknown,2,0,2
195976,Burn of gastrointestinal tract,ethnic,Not Hispanic or Latino,2,0,2
436804,Fetus OR newborn affected by premature rupture of membranes,ethnic,Not Hispanic or Latino,0,2,2
372907,Macular scar,racial,Other Race,2,0,2
136282,"Burn erythema of single finger, not thumb",racial,White,2,0,2
377885,Disorder of eye movements,racial,Filipino,2,0,2
377551,Blind hypertensive eye,racial,Unknown,2,0,2
4032877,Chronic amoebic dysentery,ethnic,Hispanic or Latino,2,0,2
442299,Injury of female external genital organs,racial,Unknown,0,2,2
436730,"Appendicitis, unqualified",racial,Asian,0,2,2
4108374,Other specified peripheral vascular disease NOS,ethnic,Not Hispanic or Latino,0,2,2
40481819,Early satiety,ethnic,Not Hispanic or Latino,0,2,2
4064383,Rheumatoid arthritis screening,racial,Filipino,2,0,2
436289,Non-medicinal agent causing toxic effects,racial,Other Race,2,0,2
437872,Rupture in Descemet membrane,ethnic,Hispanic or Latino,2,0,2
197684,Dysuria,racial,Alaska Native,2,0,2
438303,Fall on same level from sports contact,ethnic,Hispanic or Latino,2,0,2
376125,Disorder of eyelid,racial,Black or African American ,2,0,2
314958,Benign secondary hypertension,racial,Unknown,0,2,2
434872,Infection by Trichomonas,racial,Other Race,2,0,2
201927,Cellulitis and abscess of leg,racial,Asian Indian,2,0,2
435508,Adrenal cortical hypofunction,racial,Filipino,2,0,2
135895,Variation in hair color,racial,White,0,2,2
443564,Malignant neoplasm of bone,ethnic,Not Hispanic or Latino,2,0,2
432877,Socialised behaviour disorder,racial,Unknown,0,2,2
443774,"Disease condition determination, uncontrolled",racial,Asian,2,0,2
192963,Disease of pancreas,racial,Asian,2,0,2
197324,Disease of peritoneum,racial,Unknown,0,2,2
256440,Disorder of paranasal sinuses,racial,Native Hawaiian or Other Pacific Islander ,2,0,2
198695,"Malignant neoplasm, overlapping lesion of biliary tract",racial,White,2,0,2
4110499,Allergic rhinitis NOS,racial,Black or African American ,0,2,2
441716,Open wound of axillary region with complication,racial,White,0,2,2
132932,Chronic ethmoidal sinusitis,racial,Black or African American ,0,2,2
4061081,Other male genital organ diseases OS,racial,Unknown,0,2,2
199860,Hernia of abdominal cavity,racial,Native Hawaiian or Other Pacific Islander ,0,2,2
4179235,Family history of malignant neoplasm of lung,racial,Unknown,2,0,2
253321,Stridor,racial,Native Hawaiian or Other Pacific Islander ,0,2,2
141955,Pectus excavatum,racial,Asian,0,2,2
140654,Deep seated dermatophytosis,ethnic,Not Hispanic or Latino,2,0,2
435000,Complete spontaneous abortion with metabolic disorder,ethnic,Hispanic or Latino,2,0,2
254669,Disease of vocal cords,racial,Black or African American ,2,0,2
74507,Sprain of radiohumeral joint,racial,White,2,0,2
373747,Extrapyramidal disease,racial,Other Race,0,2,2
438812,Abortion complicated by genital-pelvic infection,ethnic,Not Hispanic or Latino,2,0,2
4051770,"Contusion, ankle and foot, excluding toe(s)",racial,Unknown,0,2,2
443865,Non-infective colitis,racial,Asian Indian,0,2,2
372328,Otitis media,racial,Alaska Native,0,2,2
440237,Open fracture of upper end of lower leg,ethnic,Hispanic or Latino,2,0,2
76801,Polyostotic fibrous dysplasia of bone,ethnic,Hispanic or Latino,0,2,2
378679,Acute poliomyelitis,racial,Asian,2,0,2
4088930,Confirmation of pregnancy,racial,African American,2,0,2
135029,Peeling of skin,ethnic,Hispanic or Latino,2,0,2
440309,Adverse reaction to diphtheria vaccine,racial,White,2,0,2
434766,Open supracondylar fracture of humerus,racial,White,2,0,2
439155,Carcinoembryonic antigen present,racial,Asian,0,2,2
198928,Mechanical complication due to intrauterine contraceptive device,racial,American Indian or Alaska Native ,2,0,2
4052921,FH: Consanguinity,ethnic,Not Hispanic or Latino,0,2,2
440518,5p partial monosomy syndrome,ethnic,Hispanic or Latino,0,2,2
433527,Endometriosis,racial,Other Race,2,0,2
77636,Primary localized osteoarthrosis of upper arm,racial,White,2,0,2
433746,"Combined drug dependence, excluding opioid, continuous",ethnic,Not Hispanic or Latino,2,0,2
443449,Acute laryngitis with obstruction,ethnic,Not Hispanic or Latino,0,2,2
75046,Old bucket handle tear of medial meniscus,ethnic,Not Hispanic or Latino,0,2,2
442013,Burn,racial,Black or African American ,0,2,2
435368,Congenital pigeon chest,ethnic,Not Hispanic or Latino,0,2,2
440409,Disorder of orbit proper,racial,White,2,0,2
436480,Dystrophy of vulva,racial,White,2,0,2
375475,Meningoencephalitis due to acquired toxoplasmosis,ethnic,Not Hispanic or Latino,0,2,2
440069,Drug dependence,racial,Asian Indian,0,2,2
76737,Hydrocele,racial,Unknown,0,2,2
254662,Pulmonary infarction,racial,Asian,0,2,2
4273630,Patch repair of arteriovenous fistula,ethnic,Hispanic or Latino,0,2,2
76772,Galactorrhea in pregnancy and the puerperium with antenatal complication,racial,Unknown,2,0,2
443753,Abrasion AND/OR friction burn of wrist without infection,racial,Black or African American ,2,0,2
442540,Liver moderate laceration without mention of open wound into cavity,ethnic,Hispanic or Latino,0,2,2
380719,Impairment level: one eye: moderate impairment: other eye: normal vision,ethnic,Not Hispanic or Latino,2,0,2
441170,Superficial injury with infection,racial,Native Hawaiian or Other Pacific Islander ,0,2,2
139850,Acute frontal sinusitis,racial,American Indian,2,0,2
4059178,Gastrojejunal ulcer,racial,American Indian or Alaska Native ,2,0,2
4081759,Transplant follow-up,racial,White,2,0,2
319047,Necrosis of artery,racial,Unknown,0,2,2
435219,Schizophrenia in remission,racial,Unknown,2,0,2
77882,Vestibular active Meniere's disease,racial,White,2,0,2
201527,Neoplasm of uncertain behaviour of prostate,racial,Asian,0,2,2
195513,Vaginal intraepithelial neoplasia grade III,racial,Unknown,2,0,2
439960,Late effect of external cause,racial,Black or African American ,2,0,2
77960,Joint observation,racial,Black or African American ,0,2,2
74458,Enthesopathy of knee region,racial,American Indian,2,0,2
442216,Kernicterus not due to isoimmunization,racial,White,2,0,2
442610,Degenerative AND/OR vascular disorder of ear,ethnic,Not Hispanic or Latino,0,2,2
4100367,Simple schizophrenia NOS,ethnic,Hispanic or Latino,0,2,2
438021,Sequelae of fracture of arm,racial,Unknown,0,2,2
433454,Adjustment disorder with mixed emotional features,racial,Filipino,0,2,2
78009,Open traumatic pneumothorax,ethnic,Hispanic or Latino,0,2,2
443586,Transient organic mental disorder,racial,Unknown,2,0,2
435231,Nondependent cannabis abuse in remission,racial,Black or African American ,0,2,2
442792,Pes anserinus bursitis,ethnic,Not Hispanic or Latino,0,2,2
435979,Late effect of open wound of extremities without tendon injury,racial,White,0,2,2
378140,Inflammatory and toxic neuropathy,ethnic,Not Hispanic or Latino,0,2,2
76725,Fissure in ano,racial,Asian,0,2,2
4184252,Observation of neck region,racial,White,0,2,2
252947,Acute pulmonary edema due to fumes AND/OR vapors,ethnic,Hispanic or Latino,2,0,2
443753,Abrasion AND/OR friction burn of wrist without infection,racial,Asian Indian,0,2,2
132706,Nail disease,racial,Native Hawaiian or Other Pacific Islander ,2,0,2
133088,Late amputation stump complication,racial,White,0,2,2
440600,Assault by bite of human being,racial,White,0,2,2
377282,Conjunctivitis with mucocutaneous disorder,ethnic,Not Hispanic or Latino,2,0,2
440432,Accretion on teeth,ethnic,Not Hispanic or Latino,0,2,2
4110787,Other otitis externa,racial,Other Race,2,0,2
439391,Physical abuse of adult,racial,Native Hawaiian or Other Pacific Islander ,2,0,2
80183,"Localised, secondary osteoarthritis of the ankle and/or foot",racial,White,2,0,2
443447,Iatrogenic hypotension,racial,Native Hawaiian or Other Pacific Islander ,0,2,2
132553,Herpangina,racial,Black or African American ,0,2,2
4200655,Urostomy present,racial,Unknown,0,2,2
77638,Displacement of intervertebral disc without myelopathy,racial,American Indian or Alaska Native ,2,0,2
137213,Fungal dermatosis,racial,Filipino,2,0,2
76791,Acquired deformity of hip,racial,Other Race,0,2,2
440329,Herpes zoster without complication,racial,Asian Indian,2,0,2
195977,Contusion of trunk,racial,Black or African American ,0,2,2
4048191,Enlargement of tonsil or adenoid,racial,Black or African American ,2,0,2
435320,Acute glomerulonephritis associated with another disorder,ethnic,Hispanic or Latino,0,2,2
4059637,Work environment deleterious,racial,Black or African American ,2,0,2
312934,Atherosclerosis of aorta,racial,Filipino,2,0,2
4057346,"Contusion, hip and thigh",ethnic,Hispanic or Latino,0,2,2
437985,Disturbance of temperature regulation of newborn,ethnic,Hispanic or Latino,2,0,2
435647,Congenital folds and cysts of the posterior segment,racial,Unknown,2,0,2
4237140,Abnormal sexual function,racial,Asian,0,2,2
75346,Disorder of meniscus of knee,racial,Other Race,2,0,2
434172,Insomnia with sleep apnoea,racial,Black or African American ,0,2,2
373748,Grand mal status,racial,White,2,0,2
140490,Anhidrosis,ethnic,Hispanic or Latino,0,2,2
439776,Pervasive developmental disorder,racial,Asian,0,2,2
193359,Open wound of multiple sites of one lower limb AND thigh with complication,racial,White,2,0,2
432246,Leptospirosis,ethnic,Hispanic or Latino,2,0,2
254677,Adenoviral pneumonia,ethnic,Hispanic or Latino,2,0,2
436339,Bacterial infection due to Klebsiella pneumoniae,racial,White,2,0,2
438460,Edentulous alveolar ridge atrophy,racial,Asian,0,2,2
437779,Streptococcal infectious disease,racial,Unknown,0,2,2
435081,Abnormal findings on diagnostic imaging of heart and coronary circulation,racial,Black or African American ,2,0,2
195313,Urethral abscess,racial,White,2,0,2
4180167,Joint infection,ethnic,Hispanic or Latino,0,2,2
40480082,Hemicrania continua,ethnic,Not Hispanic or Latino,2,0,2
438407,BN - Bulimia nervosa,racial,American Indian,2,0,2
434272,Varicella infection,racial,Other Race,2,0,2
374053,Sudden hearing loss,racial,White,0,2,2
4175331,Congenital haemolytic anaemia,ethnic,Not Hispanic or Latino,0,2,2
199079,Hypertrophy of clitoris,ethnic,Not Hispanic or Latino,2,0,2
433813,Bladder neck obstruction,racial,White,0,2,2
78834,Effusion of joint of hand,racial,Black or African American ,0,2,2
373755,Thunderclap headache,ethnic,Hispanic or Latino,2,0,2
441170,Superficial injury with infection,racial,Black or African American ,2,0,2
193525,Abdominal pregnancy,racial,American Indian or Alaska Native ,2,0,2
141370,Toxic erythema,racial,Unknown,2,0,2
435170,Effects of thirst,racial,Native Hawaiian or Other Pacific Islander ,2,0,2
4087437,Other specified bacterial disease NOS,ethnic,Hispanic or Latino,0,2,2
140364,Disorder of thyrocalcitonin secretion,ethnic,Hispanic or Latino,2,0,2
437221,Chlamydia trachomatis infection,racial,Asian,2,0,2
433457,Agoraphobia without mention of panic attacks,racial,Other Race,0,2,2
257008,Abscess of parapharyngeal space,ethnic,Not Hispanic or Latino,0,2,2
375791,Uncomplicated senile dementia,racial,Alaska Native,2,0,2
435563,Acute and subacute infective endocarditis associated with another disorder,ethnic,Hispanic or Latino,2,0,2
436015,Accidental poisoning from foodstuffs and poisonous plants,ethnic,Hispanic or Latino,0,2,2
194018,"Functional enuresis, NOS",racial,Asian,0,2,2
199868,Incisional hernia with gangrene,racial,White,2,0,2
255175,Nodular tuberculosis of lung,racial,White,0,2,2
137974,Abnormal fetal heart beat noted before labor in liveborn infant,racial,White,2,0,2
77960,Joint observation,racial,Native Hawaiian or Other Pacific Islander ,0,2,2
377126,Concussion with brief loss of consciousness,ethnic,Not Hispanic or Latino,2,0,2
252942,Asthmatic pulmonary eosinophilia,ethnic,Hispanic or Latino,0,2,2
381040,Acute myringitis,ethnic,Hispanic or Latino,0,2,2
4085104,Dermatosis due to mites,ethnic,Hispanic or Latino,2,0,2
4092879,Absent kidney,racial,Black or African American ,0,2,2
440653,Infection by toxoplasma gondii,racial,Black or African American ,2,0,2
4153441,Fetus or neonate affected by breech delivery and extraction,racial,White,2,0,2
433750,"Single major depressive episode, in full remission",racial,Other Race,2,0,2
432463,"Closed fracture clavicle, lateral end",racial,White,2,0,2
441855,Epiphora due to excess lacrimation,ethnic,Hispanic or Latino,2,0,2
438250,Congenital talipes varus,racial,Black or African American ,0,2,2
380688,Hypoglycaemic coma,ethnic,Hispanic or Latino,0,2,2
134661,Chronic sphenoidal sinusitis,ethnic,Hispanic or Latino,0,2,2
138644,Burn erythema of lower limb,racial,Asian,0,2,2
440255,Open wound of axillary region without complication,racial,White,2,0,2
434459,Ganglion of tendon sheath,racial,Asian,0,2,2
440847,Neonatal jaundice associated with preterm delivery,ethnic,Hispanic or Latino,0,2,2
135032,Dermatitis due to substances taken internally,racial,Black or African American ,2,0,2
441589,Endocarditis,racial,Black or African American ,2,0,2
435186,Disease due to Rhinovirus,racial,White,0,2,2
4285734,Instability of joint,racial,Unknown,0,2,2
442013,Burn,racial,Native Hawaiian or Other Pacific Islander ,0,2,2
434212,Contusion of axillary region,racial,Unknown,2,0,2
442325,Furuncle of foot,racial,Unknown,2,0,2
433862,Congenital anomaly of tongue,racial,Unknown,0,2,2
196895,Viral gastroenteritis due to Norwalk-like agents,racial,White,2,0,2
438820,Postpartum deep phlebothrombosis,racial,White,2,0,2
437449,Victim of child abuse,racial,Other Race,2,0,2
197917,Disorder of biliary tract,racial,Asian,2,0,2
193079,Injury of nerve of trunk,racial,Unknown,2,0,2
4147507,Retinal detachments and defects,ethnic,Hispanic or Latino,2,0,2
196053,Metastatic tumour in kidney,ethnic,Not Hispanic or Latino,0,2,2
201901,Abscess of liver,racial,White,0,2,2
443858,Superficial injury of ankle with infection,ethnic,Hispanic or Latino,0,2,2
201519,Ca liver - primary,racial,Asian,2,0,2
4090206,Late effects of tuberculosis NOS,racial,White,0,2,2
4096038,Diabetes mellitus NOS with ophthalmic manifestation,ethnic,Hispanic or Latino,2,0,2
4001138,Other soft tissue disorders,racial,Unknown,2,0,2
138918,Partial thickness burn of lip,ethnic,Hispanic or Latino,0,2,2
196360,Primary malignant neoplasm of bladder,racial,Other Race,2,0,2
40481792,Acquired auditory processing disorder,racial,Black or African American ,0,2,2
76240,Closed fracture of pubis,racial,White,2,0,2
381575,Disorder of external ear,racial,Asian,2,0,2
258785,Pneumococcal pneumonia,racial,Asian,2,0,2
376208,Soft tissue disorder,racial,Asian,2,0,2
4065992,Cellulitis and abscess of finger unspecified,racial,Black or African American ,0,2,2
438760,Chronic dacryocystitis,ethnic,Hispanic or Latino,2,0,2
79742,Primary genital syphilis,racial,Unknown,0,2,2
4112816,Other respiratory system diseases,racial,Other Race,0,2,2
201332,Alveolitis of jaw,racial,White,2,0,2
4117578,Other and unspecified joint disorders,racial,Unknown,2,0,2
375536,Organic writer's cramp,ethnic,Hispanic or Latino,2,0,2
432967,Anemia during pregnancy - baby not yet delivered,racial,Arab,2,0,2
439221,"Adverse effect, due to correct medicinal substance properly administered",racial,Black or African American ,0,2,2
4194160,Thyroid function tests abnormal,racial,American Indian,2,0,2
193863,Congenital abnormality of lower limb AND/OR pelvic girdle,racial,Unknown,0,2,2
133655,Burn of forearm,racial,Unknown,2,0,2
372316,ARC - Abnormal retinal correspondence,ethnic,Hispanic or Latino,2,0,2
4109719,Other optic disc disorder NOS,ethnic,Hispanic or Latino,2,0,2
4234990,Cardiac revascularisation with bypass aortocoronary anastomosis of two coronary vessels,ethnic,Hispanic or Latino,2,0,2
4062641,Malaria screening,racial,Unknown,2,0,2
442067,Atopic dermatitis and related conditions,racial,American Indian,2,0,2
31057,Disorder of pharynx,racial,Unknown,2,0,2
312327,Acute myocardial infarction,racial,Alaska Native,2,0,2
4067459,Heterotopic liver transplant,racial,Black or African American ,0,2,2
436118,After-cataract with vision obscured,racial,Filipino,0,2,2
256142,Dental arch relationship anomaly,racial,Asian,0,2,2
435094,Open fracture of lower end of femur,racial,White,0,2,2
4215568,Sensory disturbance in limb,ethnic,Not Hispanic or Latino,2,0,2
252442,Neonatal aspiration of blood,ethnic,Hispanic or Latino,2,0,2
437841,Somatoform autonomic dysfunction - respiratory tract,racial,Unknown,2,0,2
373054,Open wound of auricle of ear without complication,racial,Filipino,2,0,2
139188,Open wound of scalp without complication,racial,Black or African American ,2,0,2
441193,Accident caused by nonpowered hand tools and implements,racial,Unknown,2,0,2
196259,Injury of gastrointestinal tract without open wound into abdominal cavity,ethnic,Hispanic or Latino,0,2,2
192568,Secondary malignant neoplasm of intra-abdominal lymph nodes,ethnic,Hispanic or Latino,2,0,2
436076,Adjustment disorder with mixed disturbance of emotions AND conduct,ethnic,Not Hispanic or Latino,2,0,2
80165,Fetal disproportion,racial,White,2,0,2
4252594,Subconjunctival injection,racial,Asian,2,0,2
78586,Sprain of interphalangeal joint of toe,racial,Unknown,0,2,2
433540,Polyhydramnios with antenatal problem,racial,Asian,0,2,2
197917,Disorder of biliary tract,ethnic,Not Hispanic or Latino,2,0,2
441191,Poisoning by arthropod,racial,Unknown,2,0,2
4147972,Specific academic or work inhibition,ethnic,Hispanic or Latino,0,2,2
196053,Metastatic tumour in kidney,racial,Asian,0,2,2
195731,Shigella dysenteriae (group A),racial,White,0,2,2
194680,Acute gastric ulcer with perforation but without obstruction,racial,Unknown,2,0,2
435640,"Gestation period, 25 weeks",racial,Asian,2,0,2
199881,Endometriosis of ovary,racial,Unknown,2,0,2
442105,Benign tumor of soft tissue,racial,White,2,0,2
441961,Congenital pelviureteric junction obstruction,ethnic,Hispanic or Latino,0,2,2
321587,Bilateral bundle branch block,racial,White,2,0,2
321683,TTN - Transient tachypnoea of newborn,racial,White,2,0,2
440059,Recurrent disease,racial,White,2,0,2
4208388,Laryngotracheitis,racial,White,2,0,2
74124,Traumatic arthropathy,ethnic,Hispanic or Latino,0,2,2
78230,Rheumatoid arthritis with organ / system involvement,racial,White,2,0,2
435835,Non-infectious disorder of lymphatics,racial,Asian,2,0,2
435914,Metatarsus varus,racial,Unknown,2,0,2
199856,Varicose veins of lower extremity with inflammation,racial,Asian,2,0,2
439922,"Gestation period, 24 weeks",ethnic,Not Hispanic or Latino,0,2,2
193322,Right lower quadrant pain,racial,American Indian,2,0,2
441481,Adult victim of abuse,racial,Other Race,2,0,2
437794,Juvenile syphilis,ethnic,Hispanic or Latino,0,2,2
314059,Right bundle branch block,racial,Other Race,2,0,2
4025663,Obstructed inguinal hernia,racial,White,0,2,2
433886,Closed fracture of trapezium bone of wrist,ethnic,Hispanic or Latino,2,0,2
438411,Endophthalmitis,racial,Unknown,0,2,2
435904,Derangement of anterior horn of medial meniscus,ethnic,Not Hispanic or Latino,2,0,2
197311,Pelvic varices,racial,White,0,2,2
256142,Dental arch relationship anomaly,ethnic,Not Hispanic or Latino,0,2,2
381444,Black eye,racial,American Indian or Alaska Native ,0,2,2
192259,Ascariasis,racial,Unknown,2,0,2
197596,Toxic gastroenteritis,racial,White,0,2,2
437165,Motor vehicle traffic accident,racial,Native Hawaiian or Other Pacific Islander ,0,2,2
437738,Motor vehicle accident off public road,ethnic,Hispanic or Latino,2,0,2
195058,Nonallopathic lesion of abdomen,ethnic,Not Hispanic or Latino,2,0,2
437693,Open fracture shaft of tibia,racial,White,0,2,2
194109,Delayed postpartum haemorrhage,ethnic,Hispanic or Latino,2,0,2
442281,Sprain of septal cartilage of nose,ethnic,Hispanic or Latino,2,0,2
4242962,Benign tumour of small intestine,ethnic,Hispanic or Latino,2,0,2
201817,Benign tumour of female genital organs,ethnic,Not Hispanic or Latino,2,0,2
378125,Presenile dementia,racial,Unknown,2,0,2
4201472,Varicella contact,ethnic,Not Hispanic or Latino,0,2,2
313800,Thrombotic microangiopathy,ethnic,Not Hispanic or Latino,2,0,2
435836,Disorder of nasopharynx,racial,Black or African American ,0,2,2
73041,Closed fracture of five ribs,racial,White,0,2,2
78267,Closed anterior dislocation of humerus,racial,Unknown,2,0,2
201624,Pyelitis associated with another disorder,ethnic,Hispanic or Latino,2,0,2
198551,"Embryonic cyst of cervix, vagina and external female genitalia",racial,Unknown,2,0,2
81186,Contusion of wrist,racial,Black or African American ,2,0,2
134057,Disease of cardiovascular system,racial,Filipino,0,2,2
4297166,Closed reduction of fracture without internal fixation,ethnic,Hispanic or Latino,2,0,2
141323,Acute maxillary sinusitis,racial,American Indian or Alaska Native ,2,0,2
4222126,Removal of urethral stent,racial,White,2,0,2
80225,Sprain of ligament of lumbosacral joint,racial,Black or African American ,0,2,2
133327,Viremia,racial,White,2,0,2
316457,Mallory-Weiss syndrome,racial,Native Hawaiian or Other Pacific Islander ,0,2,2
132408,Back problem,racial,Native Hawaiian or Other Pacific Islander ,2,0,2
75375,Closed fracture lunate,ethnic,Hispanic or Latino,0,2,2
79061,Colonic constipation,racial,Other Race,2,0,2
443743,Plasma cell neoplasm,racial,White,2,0,2
4056045,Other functional disorder of bladder,racial,Unknown,2,0,2
74080,Orthostatic proteinuria,ethnic,Not Hispanic or Latino,0,2,2
133280,Alopecia,racial,American Indian,0,2,2
434164,Glycosuria,racial,Asian,2,0,2
433981,Benign neoplasm of short bone of upper limb,ethnic,Hispanic or Latino,0,2,2
444219,Osteitis deformans without bone tumor,racial,White,0,2,2
444084,Extrinsic allergic alveolitis,racial,Unknown,0,2,2
376703,Disorder of pinna,ethnic,Not Hispanic or Latino,2,0,2
436097,"Nondependent mixed drug abuse, continuous",racial,Black or African American ,0,2,2
4101989,Closed fracture of shaft of bone of forearm,ethnic,Hispanic or Latino,0,2,2
133859,Preauricular cyst,racial,White,2,0,2
4093048,Reduction deformity of leg,racial,White,0,2,2
432804,Fall from scaffold,ethnic,Hispanic or Latino,2,0,2
260759,Malocclusion of teeth,racial,Black or African American ,0,2,2
4104583,Mechanical strabismus NOS,racial,White,2,0,2
432454,Excessive thirst,racial,Other Race,0,2,2
4139420,Foreign body in auditory canal,racial,American Indian or Alaska Native ,0,2,2
4069541,Other acquired ankle and foot deformity,racial,Unknown,2,0,2
435642,Disturbance in speech,racial,Black or African American ,2,0,2
433466,Childhood and adolescent relationship problem,ethnic,Not Hispanic or Latino,2,0,2
440930,Adverse effect of radiation therapy,ethnic,Hispanic or Latino,2,0,2
24818,Neck injury,racial,Asian,2,0,2
201346,Oedema of penis,ethnic,Not Hispanic or Latino,0,2,2
435835,Non-infectious disorder of lymphatics,ethnic,Not Hispanic or Latino,2,0,2
434348,Acute and subacute iridocyclitis,ethnic,Hispanic or Latino,2,0,2
4228475,Peripheral degeneration of retina,ethnic,Hispanic or Latino,2,0,2
442019,Complication of procedure,racial,Unknown,2,0,2
440112,Chloasma of eyelid,racial,Other Race,2,0,2
196613,Neuroma of amputation stump,ethnic,Hispanic or Latino,2,0,2
443535,Infection due to enterococcus,racial,Unknown,2,0,2
440088,Academic underachievement disorder,racial,Black or African American ,2,0,2
435993,Foreign body in conjunctival sac,ethnic,Not Hispanic or Latino,0,2,2
199192,Abrasion AND/OR friction burn of trunk without infection,racial,American Indian or Alaska Native ,0,2,2
317009,Hyperreactive airway disease,racial,African American,2,0,2
439847,Intracranial hemorrhage,racial,Unknown,2,0,2
4066260,Galactorrhea in pregnancy and the puerperium,ethnic,Not Hispanic or Latino,2,0,2
373766,Retinopathy of prematurity,racial,Other Race,2,0,2
437954,Lateral meniscus derangement,ethnic,Not Hispanic or Latino,2,0,2
442306,Adjustment disorder with depressed mood,racial,Asian Indian,2,0,2
201078,Senile atrophic vaginitis,racial,American Indian or Alaska Native ,2,0,2
74806,Open wound of finger with complication,ethnic,Not Hispanic or Latino,0,2,2
437579,Paroxysmal ventricular tachycardia,racial,Native Hawaiian or Other Pacific Islander ,0,2,2
316999,Cardiac arrhythmia,racial,Alaska Native,0,2,2
432789,Opioid analgesic adverse reaction,racial,White,2,0,2
4263748,Recurrent major depression in complete remission,racial,Black or African American ,2,0,2
77644,Adhesive capsulitis of shoulder,racial,American Indian,0,2,2
4094126,Family problems,ethnic,Not Hispanic or Latino,2,0,2
378256,Abnormal reflex,racial,Black or African American ,0,2,2
378165,Nystagmus,racial,Other Race,2,0,2
432478,Intracranial hemorrhage following injury without open intracranial wound AND with concussion,ethnic,Hispanic or Latino,0,2,2
79957,Traumatic amputation of finger with complication,racial,White,0,2,2
4290000,Mumps,ethnic,Not Hispanic or Latino,2,0,2
4062495,Glaucoma screening,racial,American Indian,2,0,2
433319,Fetus OR newborn affected by maternal complication of pregnancy,racial,White,2,0,2
439776,Pervasive developmental disorder,ethnic,Not Hispanic or Latino,0,2,2
79069,Disease of rectum,racial,Unknown,0,2,2
440583,Secondary AND/OR recurrent hemorrhage as early complication of trauma,ethnic,Hispanic or Latino,2,0,2
438733,Profound mental handicap,racial,Unknown,0,2,2
75354,Osteochondropathy,racial,Asian Indian,2,0,2
434621,Autoimmune disease,racial,White,2,0,2
377091,Fits - convulsions,racial,Native Hawaiian or Other Pacific Islander ,0,2,2
436624,Late congenital syphilis - latent,racial,White,0,2,2
134461,Tietze disease,racial,American Indian or Alaska Native ,2,0,2
439989,Insulin adverse reaction,ethnic,Not Hispanic or Latino,2,0,2
318776,Rheumatic mitral regurgitation,racial,White,2,0,2
4237458,Fracture of clavicle,racial,Unknown,2,0,2
137813,Benign neoplasm of mouth region,ethnic,Not Hispanic or Latino,2,0,2
194158,Perinatal gastrointestinal hemorrhage,ethnic,Not Hispanic or Latino,0,2,2
195588,Cystitis,racial,American Indian,2,0,2
443274,Psychostimulant dependence,racial,Black or African American ,2,0,2
372424,Congenital anolmaly of eye,racial,Other Race,0,2,2
4141622,Asthma NOS,racial,American Indian or Alaska Native ,2,0,2
74469,Light-for-dates without mention of fetal malnutrition,racial,Unknown,0,2,2
376961,Disturbance of consciousness,racial,Asian,2,0,2
4275257,Detoxication therapy for alcoholism,racial,White,0,2,2
4185471,Disorder of pigmentation,racial,Asian Indian,2,0,2
443748,Congenital anomaly of the bladder,racial,Unknown,0,2,2
377659,Spina bifida of lumbar region,racial,White,0,2,2
439139,Infections specific to perinatal period,racial,White,0,2,2
438997,Neoplasm of uncertain behavior of meninges,ethnic,Hispanic or Latino,2,0,2
381292,Chronic allergic conjunctivitis,racial,Asian Indian,2,0,2
4143966,Essential hypertension NOS,racial,Unknown,2,0,2
133294,Prepatellar bursitis,racial,Filipino,2,0,2
440314,Injury of unknown intent by shotgun,ethnic,Hispanic or Latino,0,2,2
4227745,Infertility test,ethnic,Not Hispanic or Latino,0,2,2
252477,Extradural haemorrhage following injury without open intracranial wound,ethnic,Hispanic or Latino,0,2,2
192242,Acute hepatitis C,racial,Asian,2,0,2
432517,Posttraumatic wound infection,racial,Black or African American ,2,0,2
433678,Infection of central venous catheter,racial,Asian,2,0,2
438028,Poisoning by drug AND/OR medicinal substance,racial,Asian,0,2,2
196569,Contusion of abdominal wall,racial,Other Race,0,2,2
376981,Amblyopia,racial,Other Race,0,2,2
4099207,Thyroiditis NOS,racial,White,2,0,2
75091,Closed fracture of carpal bone,racial,Filipino,2,0,2
377283,Conjunctival injection,racial,Asian,0,2,2
75343,Contracture of hip joint,racial,White,2,0,2
194703,Leucoplakia of vagina,ethnic,Not Hispanic or Latino,2,0,2
435649,Complication of hemodialysis,racial,Other Race,0,2,2
437922,Hematoma of vulva,racial,White,2,0,2
73302,Curvature of spine,racial,Black or African American ,2,0,2
4269719,Finding of growth of fungi,ethnic,Hispanic or Latino,0,2,2
441267,Cystic fibrosis,racial,Unknown,2,0,2
194081,Acute cystitis,racial,Asian Indian,2,0,2
373469,Symptomatic torsion dystonia,racial,White,2,0,2
4310254,Mediastinal pneumogram,racial,White,0,2,2
30133,Acute laryngitis,racial,Asian,2,0,2
314658,Cardiomegaly,racial,Filipino,2,0,2
436334,Infection by Trypanosoma cruzi,racial,White,2,0,2
436833,Open fracture of metacarpal bone,racial,White,2,0,2
4177115,Malignant tumour of testis,racial,Unknown,0,2,2
138813,Early or threatened labour,racial,Unknown,2,0,2
441540,Reactive confusion,racial,Asian,2,0,2
437255,Passive aggressive personality disorder,ethnic,Not Hispanic or Latino,2,0,2
135892,Erythematous condition,racial,Black or African American ,2,0,2
31120,Congenital anomaly of upper alimentary tract,racial,Unknown,2,0,2
4092896,Stool contents abnormal,racial,Native Hawaiian or Other Pacific Islander ,0,2,2
4069553,Acquired lordosis NOS,racial,White,2,0,2
74129,Allergic arthritis of the ankle and/or foot,racial,Unknown,2,0,2
4303805,Allergic reaction to bite and/or sting,racial,Other Race,0,2,2
374947,Acute infection of pinna,ethnic,Hispanic or Latino,2,0,2
75406,Crush injury of finger,racial,Black or African American ,0,2,2
201957,Necrotizing enterocolitis in fetus OR newborn,racial,Unknown,2,0,2
442553,Injury of bladder,racial,Unknown,0,2,2
438843,Non-traumatic rupture of patellar tendon,ethnic,Hispanic or Latino,2,0,2
4093311,Latent early syphilis NOS,racial,Black or African American ,2,0,2
75066,Nonallopathic lesion of cervical region,ethnic,Not Hispanic or Latino,0,2,2
380702,Cerebral cysts,racial,Other Race,2,0,2
23988,Hemolytic anemia due to glutathione metabolism disorder,racial,Black or African American ,2,0,2
138601,Open wound of face with complication,racial,Unknown,2,0,2
379816,Simple chronic conjunctivitis,ethnic,Hispanic or Latino,2,0,2
443877,Nonvenomous insect bite of shoulder without infection,ethnic,Not Hispanic or Latino,2,0,2
315361,Orthopnea,racial,Other Race,2,0,2
435485,Primary malignant neoplasm of ill-defined site,ethnic,Hispanic or Latino,2,0,2
194684,Crohn's disease of large bowel,racial,American Indian or Alaska Native ,2,0,2
256717,Bronchospasm,racial,Native Hawaiian or Other Pacific Islander ,0,2,2
258781,Pneumonopathy due to inhalation of dust,racial,Unknown,2,0,2
136834,Closed intertrochanteric fracture,racial,Unknown,2,0,2
443535,Infection due to enterococcus,racial,White,0,2,2
4108905,Congenital malformation of the urinary system,racial,Black or African American ,2,0,2
443357,Ankle joint observation,ethnic,Not Hispanic or Latino,2,0,2
374139,Buphthalmos,ethnic,Not Hispanic or Latino,2,0,2
4169009,FH: CVA,racial,Black or African American ,0,2,2
433451,Aggressive unsocial conduct disorder,racial,White,0,2,2
374035,Keratitis,racial,Filipino,2,0,2
440965,Hodgkin's disease of intrathoracic lymph nodes,racial,White,0,2,2
30234,Cervical sprain,racial,Native Hawaiian or Other Pacific Islander ,2,0,2
4112003,Hypotension NOS,racial,Unknown,2,0,2
372610,Post-concussion syndrome,racial,Native Hawaiian or Other Pacific Islander ,2,0,2
376971,Retinal tear,racial,Asian,0,2,2
78282,Closed dislocation of coccyx,racial,White,2,0,2
194406,Urinary tract obstruction,racial,Other Race,0,2,2
438730,Alkalosis,ethnic,Hispanic or Latino,0,2,2
372616,Werdnig-Hoffmann disease,racial,Asian,0,2,2
4069541,Other acquired ankle and foot deformity,racial,White,2,0,2
374360,Disorder of optic nerve,ethnic,Not Hispanic or Latino,0,2,2
435701,Injury of trigeminal nerve,ethnic,Hispanic or Latino,2,0,2
441770,Injury of unknown intent due to fall from high man-made structure,racial,Unknown,2,0,2
258787,Spontaneous tension pneumothorax,ethnic,Not Hispanic or Latino,0,2,2
75943,Open fracture of pubis,ethnic,Hispanic or Latino,2,0,2
138713,Disease of parathyroid glands,racial,Asian,2,0,2
261053,Pneumonia with aspergillosis,ethnic,Not Hispanic or Latino,0,2,2
442170,Blister of neck with infection,ethnic,Not Hispanic or Latino,0,2,2
444424,Open wound of Eustachian tube with complication,racial,White,0,2,2
439234,Poisoning by cardiotonic glycoside,ethnic,Hispanic or Latino,2,0,2
4062652,Galactosaemia screening,ethnic,Not Hispanic or Latino,0,2,2
434328,"Nondependent cannabis abuse, episodic",racial,Black or African American ,0,2,2
437758,Dependance on enabling machine or device,ethnic,Hispanic or Latino,0,2,2
436828,Saliva abnormal,ethnic,Hispanic or Latino,2,0,2
140352,AML - Acute myeloid leukemia,racial,White,0,2,2
4092845,Candidiasis NOS,racial,Black or African American ,0,2,2
438783,Erosion of teeth,ethnic,Hispanic or Latino,0,2,2
25582,Tracheesophageal fistula,racial,Unknown,2,0,2
78647,Peroneal nerve injury,racial,White,0,2,2
73241,Anal and rectal polyp,racial,Black or African American ,0,2,2
4330220,Family history of malignant neoplasm of genital structure,racial,White,2,0,2
441833,Pathological drug intoxication,ethnic,Hispanic or Latino,2,0,2
314463,Congenital anomaly of aorta,racial,Other Race,0,2,2
4057348,"Contusion, knee and lower leg NOS",racial,Unknown,0,2,2
442023,Poisoning of undetermined intent,racial,Other Race,2,0,2
319843,Mitral valve disorder,racial,American Indian,0,2,2
436940,Insulin resistance syndrome,racial,American Indian or Alaska Native ,2,0,2
141729,Burn of forehead AND/OR cheek,ethnic,Not Hispanic or Latino,2,0,2
194683,Obstructed umbilical hernia,racial,White,2,0,2
260336,Primary malignant neoplasm of glottis,racial,White,0,2,2
75721,Prosthetic joint mechanical failure,racial,White,2,0,2
374341,Huntington's chorea,racial,Black or African American ,2,0,2
437671,Abnormal feces,racial,Black or African American ,2,0,2
443262,Lack or loss of sexual desire,racial,Unknown,2,0,2
314381,Kawasaki syndrome,racial,Unknown,0,2,2
27918,Eosinophilic esophagitis,racial,Asian,0,2,2
435357,Conjoined twins,ethnic,Not Hispanic or Latino,2,0,2
141213,Scarlet fever,racial,Filipino,2,0,2
196858,Late effect of fracture of neck of femur,racial,White,0,2,2
434833,Adverse reaction to anti-common cold drugs,racial,White,0,2,2
192785,Second degree burn of abdominal wall,racial,Unknown,2,0,2
443323,Papyraceous fetus - not delivered,ethnic,Hispanic or Latino,2,0,2
432436,Symbolic dysfunction,racial,Unknown,2,0,2
440193,Wristdrop,racial,Unknown,0,2,2
72377,Shoulder girdle dystocia,ethnic,Hispanic or Latino,0,2,2
434321,Schizoaffective schizophrenia in remission,ethnic,Hispanic or Latino,2,0,2
432879,Pneumococcal meningitis,ethnic,Hispanic or Latino,0,2,2
133573,Acute osteomyelitis of shoulder region,ethnic,Not Hispanic or Latino,0,2,2
4064382,Skin disease screening,racial,Unknown,0,2,2
4311591,Cramp in limb,racial,American Indian or Alaska Native ,2,0,2
375823,Optic nerve hypoplasia,ethnic,Not Hispanic or Latino,0,2,2
374049,Acute mucoid otitis media,racial,Other Race,2,0,2
378125,Presenile dementia,racial,White,2,0,2
439810,VKH syndrome,ethnic,Hispanic or Latino,2,0,2
78267,Closed anterior dislocation of humerus,racial,White,0,2,2
75343,Contracture of hip joint,racial,Unknown,2,0,2
4249474,Generalized seborrheic dermatitis of infants,racial,Unknown,2,0,2
140208,Unilateral complete cleft palate with cleft lip,ethnic,Hispanic or Latino,2,0,2
440855,Closed fracture of base of metacarpal bone other than first metacarpal,racial,Asian,0,2,2
80249,Sprain of acromioclavicular ligament,racial,Other Race,0,2,2
133794,Chronic gingivitis,racial,Native Hawaiian or Other Pacific Islander ,0,2,2
23034,Neonatal hypoglycemia,racial,White,0,2,2
441977,Closed dislocation of carpometacarpal joint of wrist,racial,Black or African American ,0,2,2
434007,Congenital factor VIII deficiency,racial,Unknown,0,2,2
372316,ARC - Abnormal retinal correspondence,ethnic,Not Hispanic or Latino,2,0,2
441541,Lymphocytopenia,ethnic,Not Hispanic or Latino,2,0,2
80177,Pyogenic arthritis of the pelvic region and thigh,ethnic,Not Hispanic or Latino,2,0,2
4310395,Open reduction of dislocation of elbow,racial,White,0,2,2
73686,Tuberculosis of genitourinary system,racial,White,0,2,2
80813,Lumbosacral spondylosis without myelopathy,racial,Filipino,2,0,2
4147971,Personality disorder NOS,racial,White,2,0,2
441385,Corrected transposition of great vessels,racial,Other Race,2,0,2
133414,Candidiasis of skin and nails,racial,Filipino,2,0,2
4345458,Staphylococcal toxic shock syndrome,racial,Other Race,2,0,2
436642,Adamantiades-Behcet disease,ethnic,Hispanic or Latino,2,0,2
4252234,Repair of gastroschisis,ethnic,Hispanic or Latino,0,2,2
76550,Sprain of metatarsophalangeal joint,racial,Unknown,2,0,2
320416,Diseases of mitral and aortic valves,racial,Asian,2,0,2
4051568,Family history of mental disorder,racial,Black or African American ,0,2,2
443748,Congenital anomaly of the bladder,racial,White,0,2,2
436313,Shaken baby syndrome - non-accidental injury,racial,White,0,2,2
438536,Congenital anomaly of jaw,racial,Black or African American ,2,0,2
439139,Infections specific to perinatal period,racial,Unknown,0,2,2
439025,Dacryocystitis,ethnic,Not Hispanic or Latino,2,0,2
438208,Atrophy of vulva,racial,Black or African American ,2,0,2
196053,Metastatic tumour in kidney,ethnic,Hispanic or Latino,2,0,2
440794,Elderly primigravida - delivered,racial,Other Race,2,0,2
140318,"Septicemia due to streptococcus, group A",racial,Other Race,2,0,2
438409,Attention deficit hyperactivity disorder,racial,American Indian or Alaska Native ,2,0,2
197928,Menstruation absent,racial,Arab,2,0,2
23798,Acute laryngopharyngitis,racial,Black or African American ,0,2,2
73341,Closed fracture of head of radius,racial,Asian,0,2,2
4077080,Biopsy of chest wall,ethnic,Hispanic or Latino,0,2,2
433618,Open fracture of patella,ethnic,Hispanic or Latino,0,2,2
432287,Immunodeficiency with IgM hypergammaglobulinaemia,racial,Asian,2,0,2
317299,Disorder of vitreous body,racial,Asian,0,2,2
444226,Dental restoration present,ethnic,Hispanic or Latino,0,2,2
374377,Paralytic syndrome,racial,White,0,2,2
378143,Encephalitis,ethnic,Hispanic or Latino,2,0,2
4122175,Carbuncle/boil,ethnic,Not Hispanic or Latino,2,0,2
432366,Hematoma of broad ligament,ethnic,Hispanic or Latino,2,0,2
260315,Tuberculosis of lung with cavitation,ethnic,Not Hispanic or Latino,2,0,2
438134,Excessive sleep,racial,Black or African American ,0,2,2
381686,PVS - Persistent vegetative state,racial,White,0,2,2
4103886,Keratoconus NOS,racial,Unknown,2,0,2
440847,Neonatal jaundice associated with preterm delivery,ethnic,Not Hispanic or Latino,2,0,2
4223382,Comprehensive consultation,ethnic,Hispanic or Latino,0,2,2
4148404,Family history: Anemia,racial,Unknown,2,0,2
435642,Disturbance in speech,racial,Asian,0,2,2
436101,Disorder of meninges,racial,White,0,2,2
318789,Respiratory condition due to chemical fumes AND/OR vapors,ethnic,Hispanic or Latino,0,2,2
4091319,Streptococcal sore throat with scarlatina NOS,ethnic,Not Hispanic or Latino,2,0,2
4052931,Abandoned child,racial,Other Race,2,0,2
377539,Syringomyelia and syringobulbia,racial,Black or African American ,0,2,2
437894,Ventricular fibrillation,ethnic,Hispanic or Latino,0,2,2
321107,AR - Congenital aortic regurgitation,racial,Asian,0,2,2
137144,Open wound of palate with complication,racial,White,0,2,2
380102,Corneal edema,racial,White,2,0,2
434327,Cannabis abuse,racial,Asian,0,2,2
317895,Hypertension due to renovascular disease,racial,Other Race,0,2,2
197135,Ureter injury without mention of open wound into cavity,racial,Unknown,2,0,2
4095918,Other disorders of thyroid,ethnic,Not Hispanic or Latino,2,0,2
435510,Hypocalcemia,racial,Asian,2,0,2
441553,Myoclonus,racial,Black or African American ,0,2,2
321873,Dissection of carotid artery,ethnic,Hispanic or Latino,2,0,2
197163,Burn of trunk,ethnic,Not Hispanic or Latino,0,2,2
140168,Psoriasis,racial,Black or African American ,0,2,2
4026029,Primary ulcer of intestine,ethnic,Hispanic or Latino,2,0,2
439347,"Motor vehicle traffic accident involving pedestrian dragged by motor vehicle, passenger on motor cycle injured",racial,White,0,2,2
439665,Violent spouse,ethnic,Hispanic or Latino,2,0,2
138029,Second degree burn of palm,ethnic,Hispanic or Latino,0,2,2
443372,Lipid-lowering drug adverse reaction,ethnic,Not Hispanic or Latino,2,0,2
381036,Multiple AND bilateral precerebral artery stenosis,racial,Asian,0,2,2
78232,Shoulder joint pain,racial,Alaska Native,0,2,2
320416,Diseases of mitral and aortic valves,ethnic,Not Hispanic or Latino,2,0,2
4021168,Natural contraception,ethnic,Not Hispanic or Latino,2,0,2
381278,Cluster headache,racial,Asian,0,2,2
4110052,Bronchiectasis NOS,racial,Unknown,2,0,2
4145947,Subnormal birth weight,racial,White,0,2,2
441541,Lymphocytopenia,racial,Asian,2,0,2
4016359,Streptococcus carrier,racial,Other Race,2,0,2
372316,ARC - Abnormal retinal correspondence,racial,Asian,2,0,2
140949,Scabies,racial,Asian Indian,2,0,2
137944,Bullous dermatosis,racial,Filipino,0,2,2
197684,Dysuria,racial,Middle Eastern or North African,2,0,2
437590,Pulp necrosis,ethnic,Hispanic or Latino,0,2,2
72992,Allergic arthritis,ethnic,Not Hispanic or Latino,2,0,2
4290927,Impairment level: low vision of both eyes,racial,Asian Indian,0,2,2
31821,Endocrinopathy,racial,Other Race,2,0,2
137989,Abnormal results of cardiovascular function studies,racial,Native Hawaiian or Other Pacific Islander ,2,0,2
379019,Inflammation of conjunctiva,racial,American Indian,0,2,2
433749,Heparin-induced thrombocytopenia,racial,White,0,2,2
4083043,Convalescence after surgery,ethnic,Hispanic or Latino,0,2,2
138255,Abnormal cardiovascular function,ethnic,Not Hispanic or Latino,2,0,2
4303805,Allergic reaction to bite and/or sting,racial,American Indian or Alaska Native ,2,0,2
444259,Psychogenic amnesia,ethnic,Hispanic or Latino,2,0,2
377274,Nonsenile cataract,ethnic,Not Hispanic or Latino,0,2,2
136937,Benign tumour of endocrine gland,racial,White,2,0,2
443897,Disruption of perineal wound in the puerperium,racial,Unknown,2,0,2
442454,"Motor vehicle traffic accident involving collision between motor vehicle and pedal cycle, passenger of motor vehicle injured",racial,White,0,2,2
136030,Sweating fever,racial,Unknown,0,2,2
436339,Bacterial infection due to Klebsiella pneumoniae,racial,Unknown,2,0,2
4228058,Unilateral mastectomy extended simple,ethnic,Hispanic or Latino,2,0,2
252348,Chronic pulmonary radiation disease,ethnic,Not Hispanic or Latino,2,0,2
439025,Dacryocystitis,racial,Asian,0,2,2
441032,Episcleritis periodica fugax,racial,White,0,2,2
194702,PROM - Premature rupture of membranes,ethnic,Not Hispanic or Latino,2,0,2
435063,Fetus OR newborn affected by ectopic pregnancy,racial,White,2,0,2
4110738,Osteoarthritis deformans,racial,White,2,0,2
435835,Non-infectious disorder of lymphatics,ethnic,Hispanic or Latino,0,2,2
434261,"Motor vehicle nontraffic accident involving collision, not on public highway, between motor vehicle, except off-road motor vehicle, and nonmotor vehicle, motor cyclist injured",racial,Black or African American ,0,2,2
318443,Arteriosclerotic vascular disease,racial,Black or African American ,0,2,2
4188027,Food allergy,racial,Other Race,2,0,2
4235140,Operation for bone injury of phalanges of hand,ethnic,Not Hispanic or Latino,0,2,2
378439,Fourth nerve palsy,racial,Other Race,2,0,2
435418,Accidental poisoning by caustic alkalis,ethnic,Hispanic or Latino,0,2,2
4062555,"Unspecified hypertension complicating pregnancy, childbirth and the puerperium NOS",racial,American Indian or Alaska Native ,2,0,2
438970,Disease due to West Nile virus,ethnic,Hispanic or Latino,2,0,2
432804,Fall from scaffold,ethnic,Not Hispanic or Latino,0,2,2
4101068,Observation of ear discharge,racial,Black or African American ,0,2,2
441691,Atypical squamous cells of undetermined significance on vaginal Papanicolaou smear,racial,Asian,2,0,2
443253,Biological substance poisoning,ethnic,Hispanic or Latino,2,0,2
443430,HPV - Human papillomavirus test positive,racial,Other Race,0,2,2
433675,Toxic effect of chemical,racial,Asian,2,0,2
442008,Injury at T7-T12 level with spinal cord injury AND without bone injury,ethnic,Not Hispanic or Latino,2,0,2
4034214,Open wound of ear,ethnic,Not Hispanic or Latino,0,2,2
253482,Cortical blindness,racial,Other Race,2,0,2
140168,Psoriasis,ethnic,Not Hispanic or Latino,0,2,2
201387,Doubling of uterus,ethnic,Not Hispanic or Latino,2,0,2
374041,External ophthalmoplegia,racial,White,0,2,2
4007913,Closed fracture mandible (site unspecified),ethnic,Not Hispanic or Latino,2,0,2
320136,Disease of respiratory system,racial,Asian,0,2,2
252341,Extrinsic asthma with status asthmaticus,ethnic,Hispanic or Latino,2,0,2
380669,Benign neoplasm of eyelid including canthus,racial,Other Race,0,2,2
435533,"Hypnotic or anxiolytic dependence, continuous",ethnic,Not Hispanic or Latino,2,0,2
436882,[X]Fall involving bed,racial,Asian,2,0,2
435517,Acidosis,racial,Asian,2,0,2
432868,Hemoglobinopathy,racial,Black or African American ,0,2,2
4232212,Hypoglycemic shock,ethnic,Not Hispanic or Latino,2,0,2
434951,Lacrimal sac mucocele,racial,White,2,0,2
317299,Disorder of vitreous body,ethnic,Not Hispanic or Latino,0,2,2
436630,Visceral herpes simplex,racial,White,0,2,2
438302,Accidental poisoning by fumigants,ethnic,Hispanic or Latino,2,0,2
315830,Variant angina,racial,Unknown,2,0,2
440776,Abortion with complication,racial,White,2,0,2
436080,"Neoplasm of uncertain behaviour of lip, oral cavity and pharynx",racial,Unknown,2,0,2
440786,Threatened premature labor,ethnic,Not Hispanic or Latino,2,0,2
260315,Tuberculosis of lung with cavitation,racial,Asian,2,0,2
197911,Hernia of anterior abdominal wall without obstruction AND without gangrene,racial,Filipino,2,0,2
437176,Late effect of accidental fall,racial,Asian,0,2,2
4110815,"Sensorineural hearing loss, bilateral",racial,Other Race,0,2,2
437828,Disorder of calcium metabolism,racial,American Indian or Alaska Native ,2,0,2
201617,Prostatic cyst,ethnic,Hispanic or Latino,0,2,2
441192,Accidentally struck by or against objects or persons,racial,Black or African American ,2,0,2
378253,HA - Headache,racial,Asian Indian,2,0,2
321042,Cardiac arrest,racial,Unknown,2,0,2
443883,Acute disease,racial,Other Race,2,0,2
433315,Feeding difficulties in newborn,racial,Asian,0,2,2
434675,Complication of gastrostomy,racial,Asian,2,0,2
377294,Exotropia,racial,Other Race,2,0,2
378413,Partial recent retinal detachment with multiple defects,racial,Other Race,0,2,2
381869,Intermitent squint,racial,White,2,0,2
197377,Abnormal bowel sounds,ethnic,Hispanic or Latino,2,0,2
197950,Cellulitis and abscess of trunk,racial,Native Hawaiian or Other Pacific Islander ,0,2,2
4155526,Acute otitis media with effusion,ethnic,Not Hispanic or Latino,2,0,2
433905,Open wound of vulva without complication,racial,Unknown,2,0,2
440589,Toxic effect of caustic substance,ethnic,Not Hispanic or Latino,0,2,2
192581,Carcinoma in situ of uterus,racial,Unknown,2,0,2
142016,Nonvenomous insect bite of finger with infection,ethnic,Not Hispanic or Latino,2,0,2
73383,Full thickness burn of foot,ethnic,Hispanic or Latino,0,2,2
433187,Cyclitis,ethnic,Hispanic or Latino,0,2,2
194802,Foreign body in vulva and vagina,racial,Other Race,2,0,2
432310,Meningitis due to cryptococcus,racial,Black or African American ,0,2,2
432513,Animal bite wound,racial,Other Race,0,2,2
72726,Light-for-dates with signs of fetal malnutrition,racial,Unknown,2,0,2
313867,Double outlet right ventricle,racial,Black or African American ,2,0,2
201900,Neurogenic bowel,racial,Unknown,0,2,2
198860,Congenital anomaly of lower alimentary tract,racial,Black or African American ,2,0,2
441827,Disorder of amino acid and organic acid metabolism,racial,White,0,2,2
4326601,Anorectal abscess,racial,Black or African American ,0,2,2
4111875,Varicose veins of the leg NOS,ethnic,Not Hispanic or Latino,0,2,2
433606,Closed fracture of base of skull without intracranial injury,ethnic,Hispanic or Latino,2,0,2
76563,Late effect of burn of wrist AND/OR hand,racial,White,2,0,2
4058364,Superficial injury of foot and toe(s),ethnic,Hispanic or Latino,0,2,2
442116,Allergy to eggs,racial,Other Race,0,2,2
78015,Open wound of chest wall without complication,ethnic,Not Hispanic or Latino,2,0,2
4181604,Subcutaneous contraceptive implant,racial,Other Race,2,0,2
441540,Reactive confusion,ethnic,Not Hispanic or Latino,2,0,2
376971,Retinal tear,ethnic,Not Hispanic or Latino,0,2,2
193688,Clostridium difficile infection,racial,Other Race,2,0,2
434490,Shivering,racial,Asian,0,2,2
444364,Superficial foreign body of shoulder without major open wound AND without infection,ethnic,Hispanic or Latino,2,0,2
257010,Abscess of lung,ethnic,Not Hispanic or Latino,0,2,2
4102348,Common migraine NOS,racial,Unknown,2,0,2
136710,Perichondritis of pinna,ethnic,Not Hispanic or Latino,2,0,2
258787,Spontaneous tension pneumothorax,racial,Asian,0,2,2
444028,Open wound of alveolar process without complication,racial,Black or African American ,0,2,2
81380,Cervical syndrome,racial,Unknown,2,0,2
443375,Vitamin products adverse reaction,ethnic,Not Hispanic or Latino,2,0,2
443430,HPV - Human papillomavirus test positive,racial,Filipino,2,0,2
435610,Varicose veins of perineum and vulva in pregnancy and the puerperium - delivered,ethnic,Not Hispanic or Latino,2,0,2
439439,Injury of unknown intent by cutting instrument,racial,Unknown,2,0,2
4015717,Amebiasis carrier,racial,White,2,0,2
435205,Benign tumour of oropharynx,racial,Unknown,2,0,2
440195,Aniridia,racial,Unknown,2,0,2
4062653,Gout screening,racial,White,2,0,2
4195572,"Mild major depression, single episode",racial,Black or African American ,0,2,2
381278,Cluster headache,racial,Black or African American ,0,2,2
438903,Injury of external jugular vein,racial,White,2,0,2
81942,Enthesopathy of ankle AND/OR tarsus,racial,Other Race,2,0,2
4290000,Mumps,ethnic,Hispanic or Latino,2,0,2
441563,Lacrimal sac granuloma,ethnic,Hispanic or Latino,2,0,2
438701,UKP - Disseminated malignancy of unknown primary,racial,Unknown,2,0,2
72715,Exostosis,racial,Asian,2,0,2
197415,"Spleen capsular tear without major disruption of parenchyma, with open wound into cavity",racial,White,2,0,2
440855,Closed fracture of base of metacarpal bone other than first metacarpal,ethnic,Not Hispanic or Latino,2,0,2
433458,"Combined drug dependence, excluding opioid, in remission",ethnic,Hispanic or Latino,0,2,2
376104,Posttraumatic headache,racial,Filipino,0,2,2
134461,Tietze disease,racial,Filipino,2,0,2
198194,Female genital organ symptoms,racial,Asian Indian,2,0,2
77984,Congenital cleft hand,racial,White,0,2,2
4223536,Classical cesarean section,racial,White,2,0,2
438583,Open fracture of femur,racial,White,2,0,2
442276,Closed medial dislocation of proximal end of tibia,racial,Unknown,2,0,2
4061056,Endometriosis NOS,racial,Unknown,2,0,2
4293175,"Mental state, behaviour and/or psychosocial function finding",racial,American Indian,0,2,2
437841,Somatoform autonomic dysfunction - respiratory tract,racial,White,2,0,2
374360,Disorder of optic nerve,racial,Asian,0,2,2
435082,Closed fracture nasal bone,racial,Black or African American ,0,2,2
194985,Postgastric surgery syndrome,racial,Unknown,2,0,2
4025175,Tracheostomy complication NOS,racial,White,2,0,2
4012454,"Open fracture of tibia and/or fibula, shaft",ethnic,Hispanic or Latino,0,2,2
435011,Vulvar vestibulitis,racial,White,2,0,2
4001138,Other soft tissue disorders,racial,White,2,0,2
141771,"Injury undetermined whether accidentally or purposely inflicted, by crashing of motor vehicle",racial,Unknown,2,0,2
438112,Neoplastic disease,racial,Other Race,0,2,2
320420,Vitreous degeneration,racial,Black or African American ,2,0,2
4110029,Chronic pharyngitis and nasopharyngitis NOS,ethnic,Hispanic or Latino,0,2,2
4299653,Unilateral orchidectomy,ethnic,Hispanic or Latino,0,2,2
432463,"Closed fracture clavicle, lateral end",racial,Unknown,0,2,2
443172,"Splinter of face, without major open wound",ethnic,Hispanic or Latino,0,2,2
72332,Serous labyrinthitis,ethnic,Hispanic or Latino,2,0,2
74513,Open wound of foot without mention of complication,racial,Asian,2,0,2
380415,Acute swimmer's ear,racial,American Indian or Alaska Native ,2,0,2
195209,Benign neoplasm of liver and/or biliary ducts,racial,Unknown,2,0,2
377869,Conjunctival deposit,ethnic,Hispanic or Latino,0,2,2
443627,Adverse reaction to aromatic analgesic,ethnic,Not Hispanic or Latino,2,0,2
4268973,Jaw-blinking,ethnic,Not Hispanic or Latino,2,0,2
316999,Cardiac arrhythmia,racial,American Indian or Alaska Native ,0,2,2
435155,Injury of unknown intent by firearms and explosives,racial,White,0,2,2
192698,Hypertonic uterine dysfunction,racial,White,0,2,2
435785,Meningitis,ethnic,Not Hispanic or Latino,2,0,2
315523,Hemoglobin S-F disease,racial,White,0,2,2
378765,TS - Tympanosclerosis,racial,Unknown,0,2,2
434758,Exceptionally large baby,racial,Unknown,2,0,2
434164,Glycosuria,racial,Black or African American ,2,0,2
194696,Menorrhalgia,racial,Filipino,2,0,2
40490888,Herniation of rectum into vagina,racial,Asian,2,0,2
438701,UKP - Disseminated malignancy of unknown primary,racial,Other Race,2,0,2
192964,Renal infection,ethnic,Not Hispanic or Latino,2,0,2
198197,Male infertility,racial,Other Race,0,2,2
381014,Conjunctival pigmentation,racial,White,0,2,2
436228,Fetal death due to termination of pregnancy,racial,White,2,0,2
437240,Carcinoma in situ of skin of upper limb and shoulder,racial,Unknown,0,2,2
313217,Atrial fibrillation,racial,Alaska Native,2,0,2
137350,Radiation dermatitis,racial,White,0,2,2
381281,Degenerative progressive high myopia,ethnic,Not Hispanic or Latino,0,2,2
4204966,Regurgitant esophagitis,racial,Asian,0,2,2
138616,Superficial burn of hand,racial,White,0,2,2
435640,"Gestation period, 25 weeks",racial,Black or African American ,0,2,2
40481367,Chronic left-sided ulcerative colitis,ethnic,Hispanic or Latino,0,2,2
199192,Abrasion AND/OR friction burn of trunk without infection,racial,Alaska Native,0,2,2
443387,Cancer of stomach,racial,White,0,2,2
4071485,Foetus or neonate affected by caesarean section,racial,American Indian or Alaska Native ,2,0,2
437394,Closed fracture of lower end of forearm,racial,American Indian,2,0,2
133364,Second degree burn of back,racial,White,2,0,2
438112,Neoplastic disease,racial,Unknown,2,0,2
77634,Transient arthropathy of the lower leg,ethnic,Hispanic or Latino,2,0,2
433695,Trypanosomiasis,racial,Unknown,2,0,2
439191,"Late effect of poison due to drug, medicament or biological substance",ethnic,Hispanic or Latino,2,0,2
4067459,Heterotopic liver transplant,ethnic,Not Hispanic or Latino,0,2,2
193253,Nephritis,racial,Filipino,2,0,2
4090255,Colloid bodies in retina,ethnic,Not Hispanic or Latino,2,0,2
73553,Arthropathy,racial,Asian Indian,2,0,2
73282,"Breast engorgement in pregnancy, the puerperium or lactation with antenatal complication",ethnic,Hispanic or Latino,2,0,2
77698,Sprain of coracoclavicular ligament,racial,White,2,0,2
78509,Loose body in joint of ankle and/or foot,racial,Unknown,2,0,2
376807,Congenital macular changes,ethnic,Hispanic or Latino,2,0,2
373216,Disorder of mastoid,racial,White,2,0,2
132579,Giant-cell thyroiditis,ethnic,Hispanic or Latino,0,2,2
140570,Open wound of back without complication,racial,Unknown,0,2,2
200588,Injury of abdomen,ethnic,Not Hispanic or Latino,2,0,2
195212,Hypercortisolism,ethnic,Not Hispanic or Latino,0,2,2
441641,FTND - Full term normal delivery,racial,Unknown,2,0,2
194802,Foreign body in vulva and vagina,racial,Unknown,2,0,2
443541,Recurrent inguinal hernia with gangrene,racial,White,0,2,2
377788,General paresis,racial,White,2,0,2
314457,Congenital stenosis of aortic valve,racial,Asian,2,0,2
434824,Injury of cranial nerve,racial,White,2,0,2
4065992,Cellulitis and abscess of finger unspecified,ethnic,Not Hispanic or Latino,0,2,2
4059157,Family circumstance NOS,racial,Asian,0,2,2
4038835,HD - Hodgkin's disease,racial,White,0,2,2
40493424,Abdominal rigidity of right upper quadrant,racial,Unknown,2,0,2
376400,Combined form of senile cataract,racial,Black or African American ,2,0,2
381583,Acquired deformity of pinna,ethnic,Hispanic or Latino,2,0,2
4190189,Menstruation finding,ethnic,Hispanic or Latino,2,0,2
438531,Chondromalacia,racial,Filipino,0,2,2
201998,Unilateral traumatic amputation of leg at OR above knee without complication,racial,White,2,0,2
140214,Eruption of skin,racial,Alaska Native,0,2,2
373356,Open wound of multiple sites of ear with complication,ethnic,Hispanic or Latino,2,0,2
192674,Allergic gastroenteritis and colitis,ethnic,Not Hispanic or Latino,2,0,2
4184816,Repair of prostate,racial,Unknown,0,2,2
381864,Subjective tinnitus,racial,Black or African American ,2,0,2
432522,Transfusion reaction due to serum protein reaction,racial,White,2,0,2
74724,Transient arthropathy of multiple sites,ethnic,Hispanic or Latino,0,2,2
437334,Cervical incompetence with antenatal problem,racial,Unknown,2,0,2
435836,Disorder of nasopharynx,racial,Asian,2,0,2
436941,Hypervitaminosis A,racial,Asian,0,2,2
375550,Senile corneal changes,ethnic,Not Hispanic or Latino,0,2,2
81186,Contusion of wrist,racial,Asian,0,2,2
77631,Secondary localized osteoarthrosis of shoulder region,racial,White,0,2,2
436147,Glossitis,racial,Asian,2,0,2
196444,Angiodysplasia of intestine,racial,White,2,0,2
74864,Gonococcal joint infection,ethnic,Hispanic or Latino,0,2,2
433919,Heroin poisoning,racial,White,0,2,2
4114451,"Localized, primary osteoarthritis of unspecified site",racial,Asian,0,2,2
434842,Cause of overdose - accidental,ethnic,Not Hispanic or Latino,0,2,2
260125,Acute bronchiolitis,racial,American Indian or Alaska Native ,0,2,2
438259,Umbilical hemorrhage after birth,ethnic,Not Hispanic or Latino,2,0,2
433997,Lymphangioma,racial,Other Race,2,0,2
4060318,Chest pain NOS,ethnic,Not Hispanic or Latino,0,2,2
434810,Burn of genitalia,racial,White,2,0,2
433243,Anomaly of tooth position,ethnic,Not Hispanic or Latino,2,0,2
4108242,Atrial fibrillation and flutter NOS,racial,Other Race,0,2,2
4023168,Home alone,racial,Asian,2,0,2
4232212,Hypoglycemic shock,racial,Black or African American ,2,0,2
444069,Abrasion AND/OR friction burn of leg with infection,ethnic,Not Hispanic or Latino,2,0,2
432719,Panniculitis,racial,Asian,2,0,2
433860,IAA - Interrupted aortic arch,ethnic,Hispanic or Latino,2,0,2
434887,Disorders of bilirubin excretion,racial,Asian,0,2,2
136661,Nodular goiter,racial,Unknown,2,0,2
436519,Perinatal intraventricular hemorrhage,ethnic,Hispanic or Latino,2,0,2
198678,Intestinal infectious disease,racial,American Indian or Alaska Native ,0,2,2
373470,Polyneuropathy due to toxic agents,ethnic,Hispanic or Latino,2,0,2
441973,Closed fracture of proximal end of radius,ethnic,Hispanic or Latino,0,2,2
140435,Arrested dental caries,racial,Asian,0,2,2
313023,Neonatal chronic respiratory disease,racial,Other Race,2,0,2
378256,Abnormal reflex,racial,Asian,2,0,2
199059,Ventral hernia with obstruction but no gangrene,racial,White,2,0,2
26052,Primary malignant neoplasm of larynx,racial,Other Race,2,0,2
377291,"Peripheral pterygium, progressive",racial,Asian,2,0,2
141104,Intervertebral disc disorder of lumbar region with myelopathy,racial,Filipino,2,0,2
4058247,Anaemia during pregnancy/childbirth/puerperium NOS,ethnic,Not Hispanic or Latino,2,0,2
435231,Nondependent cannabis abuse in remission,ethnic,Not Hispanic or Latino,0,2,2
4280828,"Carrier, infectious agent",racial,Asian,2,0,2
4111259,Labyrinthine dysfunction NOS,ethnic,Not Hispanic or Latino,2,0,2
376578,Otitic barotrauma,ethnic,Not Hispanic or Latino,2,0,2
4088083,Tuberculosis of other organs,racial,White,0,2,2
81496,Tuberculosis of vertebral column,ethnic,Hispanic or Latino,0,2,2
374037,Night blindness,racial,White,2,0,2
196455,Hepatorenal syndrome,ethnic,Hispanic or Latino,2,0,2
435840,Acute epiglottitis without obstruction,racial,White,0,2,2
372324,Eustachian tube disorder,racial,Native Hawaiian or Other Pacific Islander ,2,0,2
321887,Disorder of artery,racial,American Indian or Alaska Native ,2,0,2
373212,Esophoria,racial,Asian,0,2,2
377126,Concussion with brief loss of consciousness,racial,Black or African American ,2,0,2
30133,Acute laryngitis,racial,Black or African American ,2,0,2
4172146,Proctostomy,racial,White,0,2,2
440858,Cortex contusion without open intracranial wound,ethnic,Not Hispanic or Latino,2,0,2
440692,"Cocaine dependence, episodic",racial,White,2,0,2
432447,Atypical glandular cells on cervical Papanicolaou smear,racial,Filipino,2,0,2
197921,Renal osteodystrophy,ethnic,Not Hispanic or Latino,2,0,2
441170,Superficial injury with infection,ethnic,Not Hispanic or Latino,2,0,2
28779,Oesophageal varices with bleeding,racial,Asian,2,0,2
377565,Optic atrophy associated with retinal dystrophy,racial,Unknown,2,0,2
81711,Glenoid labrum detachment,ethnic,Hispanic or Latino,0,2,2
435368,Congenital pigeon chest,racial,Native Hawaiian or Other Pacific Islander ,0,2,2
4211527,Operation on globus pallidus,racial,White,2,0,2
443429,Endothelial corneal dystrophy,ethnic,Not Hispanic or Latino,2,0,2
433957,Progressive multifocal leukoencephalopathy,ethnic,Not Hispanic or Latino,0,2,2
436080,"Neoplasm of uncertain behaviour of lip, oral cavity and pharynx",racial,Other Race,0,2,2
4337834,Hyperthyroidism due to ectopic thyroid nodule,ethnic,Hispanic or Latino,0,2,2
444433,Open wound of toe with complication,ethnic,Not Hispanic or Latino,2,0,2
434944,Scleritis,racial,Black or African American ,0,2,2
193518,Intestinal obstruction,racial,Native Hawaiian or Other Pacific Islander ,0,2,2
432899,Normal pressure hydrocephalus,ethnic,Not Hispanic or Latino,2,0,2
440694,"Nondependent mixed drug abuse, episodic",racial,Asian,0,2,2
378087,Secondary malignant neoplasm of brain and spinal cord,ethnic,Not Hispanic or Latino,2,0,2
435226,"Bipolar affective disorder, current episode mixed",racial,Unknown,0,2,2
316998,Left bundle branch block,racial,Other Race,2,0,2
433687,Botulism,ethnic,Not Hispanic or Latino,0,2,2
4106274,Neonatal cardiac arrest,ethnic,Not Hispanic or Latino,0,2,2
253797,Post-inflammatory pulmonary fibrosis,racial,American Indian or Alaska Native ,2,0,2
192687,Vulvovaginitis associated with another disease,racial,Native Hawaiian or Other Pacific Islander ,2,0,2
4300419,Submammary mastitis associated with childbirth,ethnic,Hispanic or Latino,2,0,2
440380,"Combined drug dependence, excluding opioid, episodic",ethnic,Not Hispanic or Latino,2,0,2
199878,Light and infrequent menstruation,racial,American Indian or Alaska Native ,2,0,2
443232,Eyelid and lacrimal drainage system laceration,ethnic,Hispanic or Latino,0,2,2
436249,Closed fracture of femoral condyle of femur,racial,Unknown,2,0,2
199079,Hypertrophy of clitoris,racial,Black or African American ,2,0,2
197612,Abortion complicated by delayed AND/OR excessive hemorrhage,ethnic,Hispanic or Latino,2,0,2
443295,Maternal care for diminished foetal movements,racial,Unknown,2,0,2
76153,Low compliance bladder,racial,Other Race,0,2,2
432941,Disease of tongue,racial,Filipino,2,0,2
135489,Primary malignant neoplasm of male breast,racial,White,2,0,2
252280,Neoplasm of respiratory tract,ethnic,Not Hispanic or Latino,2,0,2
440422,Noise-induced hearing loss,ethnic,Not Hispanic or Latino,2,0,2
140435,Arrested dental caries,ethnic,Not Hispanic or Latino,0,2,2
432893,Myasthenic syndrome due to another disorder,ethnic,Hispanic or Latino,2,0,2
434246,Burn with deep necrosis of underlying tissues without loss of body part,racial,White,2,0,2
441073,Complete legal abortion,racial,White,2,0,2
442073,Malunion and nonunion of fracture,ethnic,Not Hispanic or Latino,0,2,2
4065363,Dyschromia NOS,racial,White,2,0,2
372914,Optic atrophy,racial,Native Hawaiian or Other Pacific Islander ,2,0,2
312622,BVO - Branch retinal occlusion,racial,Other Race,0,2,2
4059637,Work environment deleterious,racial,Asian,2,0,2
77592,Articular crepitus of temporomandibular joint,racial,Asian,0,2,2
134312,Iatrogenic hypothyroidism,racial,Asian,0,2,2
316427,Aneurysm of coronary vessels,ethnic,Hispanic or Latino,2,0,2
254676,Lung involvement associated with another disorder,racial,Unknown,0,2,2
194079,Post-surgical malabsorption,racial,Unknown,0,2,2
4144274,Housing lack,racial,Other Race,0,2,2
77355,Articular cartilage disorder of ankle AND/OR foot,ethnic,Hispanic or Latino,0,2,2
435999,Local astringent and detergent poisoning,ethnic,Hispanic or Latino,0,2,2
197921,Renal osteodystrophy,racial,Asian,2,0,2
76201,Non-traumatic rupture of biceps brachii tendon,racial,Unknown,2,0,2
4050929,FH: Skin disease,ethnic,Not Hispanic or Latino,2,0,2
436587,"Toxic effect of gas, fumes AND/OR vapors",ethnic,Hispanic or Latino,0,2,2
432609,"Acute alcoholic intoxication in remission, in alcoholism",ethnic,Hispanic or Latino,0,2,2
4060813,Cystitis NOS,racial,Unknown,2,0,2
4058247,Anaemia during pregnancy/childbirth/puerperium NOS,racial,Asian,2,0,2
76491,Obstetric non-purulent mastitis with antenatal complication,racial,White,2,0,2
4066882,Excision of anal skin tag,racial,Unknown,2,0,2
375278,Acquired stenosis of external ear canal secondary to inflammation,ethnic,Hispanic or Latino,2,0,2
434501,"Open fracture ankle, trimalleolar",racial,Unknown,2,0,2
434527,Poisoning by primarily systemic agent,ethnic,Hispanic or Latino,2,0,2
314665,Atrial flutter,racial,Black or African American ,2,0,2
440404,Stenosis of lacrimal punctum,ethnic,Hispanic or Latino,2,0,2
4227745,Infertility test,racial,Black or African American ,0,2,2
316995,Coronary occlusion,racial,Black or African American ,2,0,2
201221,Intestinal infection due to Class Cestoda and/or Class Trematoda and/or Phylum Nemata,racial,White,0,2,2
440112,Chloasma of eyelid,racial,White,0,2,2
200970,CIS - Carcinoma in situ of prostate,racial,Unknown,0,2,2
381010,Intralenticular foreign body,racial,White,2,0,2
76270,Superficial injury of foot with infection,racial,White,2,0,2
443429,Endothelial corneal dystrophy,racial,Asian,2,0,2
192433,Congenital hypertrophic pyloric stenosis,ethnic,Not Hispanic or Latino,0,2,2
377678,EEG abnormality,racial,Unknown,2,0,2
440032,CMV - Cytomegalovirus infection,racial,Unknown,2,0,2
376124,Pinguecula,racial,Filipino,2,0,2
197823,Lipoma of spermatic cord,ethnic,Hispanic or Latino,0,2,2
75708,Foreign body in anus and rectum,racial,White,0,2,2
4001965,Infection of multiple bones,ethnic,Not Hispanic or Latino,2,0,2
440370,Nutritional marasmus,racial,White,0,2,2
77357,Intrapelvic protrusion of acetabulum,racial,White,2,0,2
440851,Open fracture of forearm,racial,White,2,0,2
254163,Pulmonary aspiration of gastric contents,ethnic,Hispanic or Latino,0,2,2
194093,Postcoital bleeding,racial,American Indian or Alaska Native ,2,0,2
194871,Trichomonal vulvovaginitis,racial,Filipino,2,0,2
134305,Acute lymphoid leukaemia,racial,White,0,2,2
443675,Traumatic amputation of toe(s) without mention of complication,racial,Unknown,0,2,2
78834,Effusion of joint of hand,racial,Asian,0,2,2
316478,"Heart disease in mother complicating pregnancy, childbirth AND/OR puerperium",ethnic,Hispanic or Latino,2,0,2
433452,"Cannabis dependence, continuous",racial,White,0,2,2
4296204,First degree burn,ethnic,Not Hispanic or Latino,2,0,2
198187,"Acute peptic ulcer without hemorrhage, without perforation AND without obstruction",racial,Black or African American ,0,2,2
192387,Obstetric perineal wound disruption - delivered with postnatal complication,racial,White,2,0,2
4012297,Closed fracture of one or more phalanges of hand NOS,racial,Unknown,2,0,2
133725,Carcinoma in situ of skin of lip,racial,White,2,0,2
194158,Perinatal gastrointestinal hemorrhage,racial,Black or African American ,0,2,2
434063,Jaw to cranial base anomaly,racial,Other Race,2,0,2
73302,Curvature of spine,ethnic,Not Hispanic or Latino,2,0,2
196724,Disease of diaphragm,racial,Other Race,2,0,2
4317960,Neonatal respiratory failure,ethnic,Hispanic or Latino,2,0,2
4173811,Congenital quadriplegia,racial,Filipino,2,0,2
4062685,Diabetes mellitus in the puerperium - baby delivered during current episode of care,ethnic,Hispanic or Latino,2,0,2
140318,"Septicemia due to streptococcus, group A",racial,Unknown,2,0,2
442749,Inhibited female orgasm,racial,Unknown,2,0,2
432593,Kwashiorkor,racial,White,2,0,2
437753,Seen by surgical fitting - service,ethnic,Not Hispanic or Latino,2,0,2
197145,Open wound of pelvic region without complication,racial,American Indian or Alaska Native ,2,0,2
435903,Juvenile osteochondrosis of foot,racial,Black or African American ,0,2,2
4006436,Other congenital musculoskeletal anomalies,ethnic,Hispanic or Latino,0,2,2
4097716,"Benign neoplasm of lip, oral cavity and pharynx NOS",racial,Unknown,2,0,2
434153,Chromosomopathy,racial,Asian,2,0,2
141666,Acute osteomyelitis of lower leg,racial,White,2,0,2
432941,Disease of tongue,racial,Other Race,0,2,2
4154309,Severe recurrent major depression with psychotic features,racial,Native Hawaiian or Other Pacific Islander ,2,0,2
439111,Pathological dislocation of pelvic region,ethnic,Hispanic or Latino,0,2,2
192958,Floating kidney,ethnic,Hispanic or Latino,0,2,2
40353121,"Accidental cut, puncture, perforation or haemorrhage during medical care",ethnic,Not Hispanic or Latino,0,2,2
440999,Choroidal rupture,ethnic,Not Hispanic or Latino,0,2,2
80811,Rupture of extensor tendons of hand AND/OR wrist,ethnic,Hispanic or Latino,0,2,2
195306,Gastroduodenitis,racial,European,0,2,2
4090094,Unspecified histoplasmosis infection,ethnic,Hispanic or Latino,0,2,2
78073,Urogenital infection by Trichomonas vaginalis,ethnic,Hispanic or Latino,2,0,2
4148244,SN - Supernumerary tooth,ethnic,Not Hispanic or Latino,0,2,2
4170576,Pressure ulcer,racial,Black or African American ,2,0,2
25297,Acute pharyngitis,racial,Asian Indian,2,0,2
440993,Psychogenic skin disease,ethnic,Hispanic or Latino,2,0,2
4128540,Partial excision of pituitary gland by transsphenoidal approach,ethnic,Hispanic or Latino,2,0,2
73889,Sprain of distal tibiofibular ligament,ethnic,Not Hispanic or Latino,0,2,2
4112364,Other upper respiratory tract diseases,ethnic,Hispanic or Latino,2,0,2
443460,Pathological fracture of femur,racial,White,2,0,2
438546,Congenital anomaly of anterior chamber of eye,ethnic,Not Hispanic or Latino,0,2,2
442189,Blister of wrist without infection,ethnic,Not Hispanic or Latino,2,0,2
74728,Synovitis and tenosynovitis,racial,Black or African American ,0,2,2
141216,MC - Molluscum contagiosum,racial,Filipino,0,2,2
74606,Benign bone tumor,racial,Other Race,2,0,2
4333977,Acquired anophthalmos,racial,Other Race,0,2,2
26727,Vomiting blood,racial,Asian,2,0,2
192964,Renal infection,racial,Asian,2,0,2
201603,Disease of teeth AND/OR supporting structures,racial,Asian Indian,0,2,2
318437,Accelerated secondary hypertension,racial,Unknown,2,0,2
433701,Mycosis,racial,Native Hawaiian or Other Pacific Islander ,0,2,2
376703,Disorder of pinna,racial,Black or African American ,2,0,2
314383,Myocarditis,ethnic,Hispanic or Latino,2,0,2
4345578,Rhabdomyolysis,ethnic,Not Hispanic or Latino,2,0,2
441593,Arteriovenous fistula of pulmonary vessels,racial,White,2,0,2
381574,External auditory canal exostosis,ethnic,Not Hispanic or Latino,0,2,2
441607,Mediastinal abscess,ethnic,Hispanic or Latino,0,2,2
192675,Biliary cirrhosis,ethnic,Not Hispanic or Latino,2,0,2
4050929,FH: Skin disease,ethnic,Hispanic or Latino,2,0,2
314426,Congenital cardiovascular disorder during pregnancy - baby not yet delivered,racial,Unknown,2,0,2
314463,Congenital anomaly of aorta,racial,Unknown,2,0,2
194018,"Functional enuresis, NOS",racial,Black or African American ,2,0,2
439815,Choroidal degeneration,racial,Unknown,2,0,2
4059014,Spontaneous bruising,racial,Asian,2,0,2
433985,Hypercarotinemia,racial,Filipino,0,2,2
435808,Diffuse secondary choroid atrophy,ethnic,Hispanic or Latino,2,0,2
4178898,Economic problem,racial,Unknown,2,0,2
73383,Full thickness burn of foot,ethnic,Not Hispanic or Latino,2,0,2
436358,Primary malignant neoplasm of exocervix,ethnic,Not Hispanic or Latino,2,0,2
439700,Inhibited sexual desire,racial,Native Hawaiian or Other Pacific Islander ,0,2,2
134214,Burn erythema of wrist,ethnic,Hispanic or Latino,2,0,2
24969,Laryngitis,ethnic,Not Hispanic or Latino,0,2,2
4070415,Fetus or neonate affected by chorioamnionitis,racial,White,2,0,2
444093,Patient status finding,racial,Native Hawaiian or Other Pacific Islander ,0,2,2
141216,MC - Molluscum contagiosum,racial,American Indian or Alaska Native ,0,2,2
193739,Ovarian failure,racial,White,2,0,2
139980,Burn erythema of forearm,ethnic,Hispanic or Latino,0,2,2
378742,Blind hypotensive eye,racial,White,2,0,2
4104054,Vitreous disorders NOS,racial,White,2,0,2
73562,Solitary sacroiliitis,racial,Asian,2,0,2
381866,Degenerative disorder of eyelid,ethnic,Not Hispanic or Latino,0,2,2
4052837,Open wound of breast,racial,White,2,0,2
434193,Closed dislocation of distal radioulnar joint of wrist,racial,White,2,0,2
4114451,"Localized, primary osteoarthritis of unspecified site",ethnic,Not Hispanic or Latino,0,2,2
197484,Diarrhea of presumed infectious origin,racial,Black or African American ,2,0,2
135473,Dermatophytosis,racial,American Indian or Alaska Native ,2,0,2
373499,Disorder of eye region,racial,Other Race,2,0,2
436941,Hypervitaminosis A,ethnic,Not Hispanic or Latino,0,2,2
194871,Trichomonal vulvovaginitis,racial,Other Race,2,0,2
378142,Retinal ischemia,ethnic,Hispanic or Latino,2,0,2
432821,Leprosy,racial,White,0,2,2
4063304,Rhesus isoimmunization unspecified,racial,White,2,0,2
438129,"Severe manic bipolar I disorder with psychotic features, mood-congruent",racial,Black or African American ,0,2,2
194519,Open wound of vagina without complication,racial,Unknown,2,0,2
375550,Senile corneal changes,racial,Asian,0,2,2
376964,Partial recent retinal detachment with giant tear,ethnic,Not Hispanic or Latino,2,0,2
77139,Open wound of finger without complication,racial,American Indian or Alaska Native ,0,2,2
441918,"Emotional AND/OR mental disease in mother complicating pregnancy, childbirth AND/OR puerperium",racial,Native Hawaiian or Other Pacific Islander ,2,0,2
4099356,Haemangioma of unspecified site,ethnic,Not Hispanic or Latino,0,2,2
443415,Gestation greater than 24 weeks,racial,Asian,0,2,2
439695,Hypertensive heart and renal disease with renal failure,racial,Asian,2,0,2
78073,Urogenital infection by Trichomonas vaginalis,ethnic,Not Hispanic or Latino,0,2,2
314457,Congenital stenosis of aortic valve,ethnic,Not Hispanic or Latino,2,0,2
4056196,Other breast disorders,racial,White,2,0,2
319825,Rheumatic heart disease,ethnic,Not Hispanic or Latino,2,0,2
436088,Nondependent opioid abuse in remission,racial,Black or African American ,0,2,2
261687,Hemoptysis,racial,Other Race,2,0,2
197606,Female infertility of tubal origin,racial,Unknown,2,0,2
138102,Benign tumour of skin,racial,Native Hawaiian or Other Pacific Islander ,0,2,2
439314,Thrombophlebitis of the femoral vein,racial,American Indian or Alaska Native ,2,0,2
4151244,Fracture NOS,racial,White,0,2,2
79915,Hemarthrosis of hand,racial,White,0,2,2
200783,Previous cesarean section,racial,Asian,2,0,2
432874,Lipidosis,racial,Unknown,2,0,2
373035,Closed fracture of malar AND/OR maxillary bones,racial,White,2,0,2
444363,Drug-related disorder,ethnic,Hispanic or Latino,0,2,2
77624,"Breast engorgement in pregnancy, the puerperium or lactation - delivered",ethnic,Hispanic or Latino,2,0,2
439303,Horseshoe retinal tear without detachment,racial,Unknown,2,0,2
373648,Superficial injury of eyelid AND/OR periocular area,ethnic,Not Hispanic or Latino,0,2,2
4080568,Problem behaviour,racial,Asian,0,2,2
444236,Superficial foreign body of hand without major open wound but with infection,ethnic,Hispanic or Latino,2,0,2
4113680,Ruptured tubal pregnancy,racial,White,2,0,2
194092,Uterine prolapse without vaginal wall prolapse,racial,Native Hawaiian or Other Pacific Islander ,2,0,2
434584,Epidemic Kaposi's sarcoma,ethnic,Hispanic or Latino,0,2,2
4103737,"Better eye: low vision, Lesser eye: profound visual impairment",racial,White,0,2,2
375547,Anisometropia,ethnic,Not Hispanic or Latino,0,2,2
4070557,Incision of testis,ethnic,Hispanic or Latino,2,0,2
200780,Disease of uterus,racial,American Indian or Alaska Native ,2,0,2
437167,Accident caused by firearm missile,racial,Unknown,2,0,2
438259,Umbilical hemorrhage after birth,ethnic,Hispanic or Latino,0,2,2
441691,Atypical squamous cells of undetermined significance on vaginal Papanicolaou smear,racial,Black or African American ,2,0,2
441977,Closed dislocation of carpometacarpal joint of wrist,ethnic,Not Hispanic or Latino,0,2,2
4067061,Psoriasis and similar disorders NOS,racial,Unknown,2,0,2
439696,Hypertensive heart and renal disease with (congestive) heart failure,racial,Other Race,0,2,2
314383,Myocarditis,ethnic,Not Hispanic or Latino,2,0,2
435247,Metallosis,ethnic,Hispanic or Latino,0,2,2
4177115,Malignant tumour of testis,racial,Other Race,0,2,2
78890,Sprain of elbow and forearm,racial,American Indian or Alaska Native ,2,0,2
444419,Quadriparesis,racial,Unknown,0,2,2
4179925,Basic learning problem,racial,Other Race,0,2,2
440389,MR - Mental retardation,racial,Native Hawaiian or Other Pacific Islander ,0,2,2
441385,Corrected transposition of great vessels,racial,White,0,2,2
140586,Collapse - heat,ethnic,Hispanic or Latino,0,2,2
79165,Closed Monteggia fracture,racial,White,0,2,2
443570,Cervicovaginal cytology: Low grade squamous intraepithelial lesion,racial,American Indian,2,0,2
380859,Closed fracture of lower jaw bone,racial,White,0,2,2
75708,Foreign body in anus and rectum,racial,Unknown,0,2,2
4056329,Vaginitis and vulvovaginitis NOS,racial,Other Race,2,0,2
437986,FTT - Failure to thrive,racial,Filipino,2,0,2
372894,central serous retinopathy,ethnic,Hispanic or Latino,0,2,2
435207,"Nodular lymphoma of lymph nodes of head, face and neck",ethnic,Not Hispanic or Latino,0,2,2
40481792,Acquired auditory processing disorder,ethnic,Hispanic or Latino,0,2,2
4314713,Abusive parenting,ethnic,Hispanic or Latino,2,0,2
438836,Poliomyelitis osteopathy of the lower leg,racial,Asian,2,0,2
440697,Nonaggressive unsocial conduct disorder,racial,Asian,0,2,2
75608,Shoulder dystocia with antenatal problem,ethnic,Hispanic or Latino,2,0,2
4144123,Other kidney and ureter disorders,ethnic,Hispanic or Latino,2,0,2
200588,Injury of abdomen,ethnic,Hispanic or Latino,0,2,2
75356,Congenital deformity of sternocleidomastoid muscle,racial,White,2,0,2
74114,Cellulitis and abscess of foot excluding toe,racial,Asian Indian,0,2,2
376416,Chronic dacryoadenitis,ethnic,Hispanic or Latino,0,2,2
4082086,No home medical services,ethnic,Not Hispanic or Latino,2,0,2
138389,Benign neoplasm of scalp and skin of neck,racial,Other Race,0,2,2
4143966,Essential hypertension NOS,racial,Other Race,0,2,2
443585,Abrasion AND/OR friction burn of multiple sites,racial,Filipino,0,2,2
4160185,Anterior acute poliomyelitis,ethnic,Hispanic or Latino,2,0,2
136538,Closed fracture larynx and/or trachea,ethnic,Not Hispanic or Latino,0,2,2
436953,Continuous chronic alcoholism,racial,Unknown,0,2,2
137900,Acute sphenoidal sinusitis,racial,Unknown,0,2,2
437833,Hypokalaemia,racial,Filipino,2,0,2
443345,Antineoplastic adverse reaction,ethnic,Hispanic or Latino,0,2,2
4062686,Diabetes mellitus in the pueperium - baby delivered during previous episode of care,racial,White,0,2,2
24909,Hereditary spherocytosis,ethnic,Not Hispanic or Latino,2,0,2
31967,Nausea,racial,American Indian,2,0,2
4122175,Carbuncle/boil,racial,Black or African American ,2,0,2
193253,Nephritis,racial,American Indian or Alaska Native ,0,2,2
432660,Dentofacial anomaly,ethnic,Not Hispanic or Latino,0,2,2
4105628,Facial nerve disorder NOS,racial,White,0,2,2
373463,Benign cough headache,ethnic,Not Hispanic or Latino,2,0,2
443747,Acute laryngotracheitis without obstruction,racial,Unknown,2,0,2
434820,Cold injury,racial,White,0,2,2
78835,Palindromic rheumatism of the lower leg,racial,Filipino,2,0,2
433811,Hydronephrosis,racial,American Indian,2,0,2
436358,Primary malignant neoplasm of exocervix,racial,Asian,2,0,2
254062,Acute chest syndrome,racial,Black or African American ,0,2,2
373648,Superficial injury of eyelid AND/OR periocular area,racial,Asian,0,2,2
4177966,Kaposi's sarcoma,racial,Unknown,0,2,2
437202,Giardiasis,ethnic,Hispanic or Latino,2,0,2
441553,Myoclonus,ethnic,Not Hispanic or Latino,0,2,2
200527,Splenomegaly,racial,Asian,2,0,2
372547,Viral encephalitis,ethnic,Hispanic or Latino,2,0,2
254796,Open wound of nose with complication,racial,White,0,2,2
434903,Ego-dystonic sexual orientation,racial,White,2,0,2
442793,Diabetic complication,racial,Asian Indian,0,2,2
432868,Hemoglobinopathy,racial,Asian,2,0,2
4109691,Persistent alcohol abuse,racial,Unknown,0,2,2
22666,Vomiting after gastrointestinal tract surgery,ethnic,Hispanic or Latino,2,0,2
320136,Disease of respiratory system,racial,Black or African American ,2,0,2
254676,Lung involvement associated with another disorder,racial,White,2,0,2
433678,Infection of central venous catheter,ethnic,Not Hispanic or Latino,2,0,2
200766,Ureteric fistula,ethnic,Hispanic or Latino,0,2,2
4326681,Family history of malignant neoplasm of ovary,racial,Unknown,2,0,2
436298,Adverse reaction to food,racial,American Indian or Alaska Native ,2,0,2
77517,Benign neoplasm of scapula and long bones of upper limb,ethnic,Hispanic or Latino,2,0,2
141941,Cervical spondylosis without myelopathy,racial,Black or African American ,2,0,2
436957,Functional disorders of polymorphonuclear neutrophils,racial,White,2,0,2
437255,Passive aggressive personality disorder,racial,Black or African American ,2,0,2
313590,Perinatal respiratory failure,ethnic,Not Hispanic or Latino,0,2,2
313504,Osler hemorrhagic telangiectasia syndrome,ethnic,Not Hispanic or Latino,2,0,2
433899,Subdural hemorrhage following injury without open intracranial wound AND with loss of consciousness,ethnic,Hispanic or Latino,0,2,2
437943,Pulp abscess of finger,racial,Black or African American ,0,2,2
438947,Burning due to contact with hot water,racial,Unknown,2,0,2
75908,Kissing spine,ethnic,Not Hispanic or Latino,0,2,2
4208970,History of physical abuse,racial,Asian,0,2,2
4155526,Acute otitis media with effusion,racial,Black or African American ,2,0,2
442289,Death in less then 24 hours from onset of symptoms,racial,White,0,2,2
377830,Alcohol withdrawal delirium,racial,Unknown,0,2,2
139850,Acute frontal sinusitis,racial,Native Hawaiian or Other Pacific Islander ,2,0,2
440543,Fracture of tibia,ethnic,Hispanic or Latino,0,2,2
433687,Botulism,ethnic,Hispanic or Latino,0,2,2
194519,Open wound of vagina without complication,racial,White,2,0,2
140842,Changes in skin texture,racial,Native Hawaiian or Other Pacific Islander ,0,2,2
4151244,Fracture NOS,racial,Unknown,0,2,2
441925,Obstetric nipple infection,ethnic,Hispanic or Latino,2,0,2
136198,Cervical spondylosis with myelopathy,racial,Other Race,2,0,2
435661,Closed orbital blow-out fracture,racial,White,0,2,2
198464,Incisional hernia,racial,Asian,0,2,2
442632,Abrasion AND/OR friction burn of wrist with infection,racial,White,2,0,2
201238,Primary malignant neoplasm of female genital organ,racial,White,0,2,2
439968,Late effect of tendon injury,racial,White,0,2,2
81250,Carcinoma in situ of breast,racial,Filipino,2,0,2
78504,"Arthropathy associated with mycoses, of the hand",ethnic,Not Hispanic or Latino,2,0,2
373035,Closed fracture of malar AND/OR maxillary bones,racial,Unknown,0,2,2
4092845,Candidiasis NOS,ethnic,Not Hispanic or Latino,0,2,2
435151,Physical child abuse,racial,Asian,0,2,2
77067,Bucket handle tear of lateral meniscus,racial,White,2,0,2
441170,Superficial injury with infection,ethnic,Hispanic or Latino,0,2,2
4106274,Neonatal cardiac arrest,ethnic,Hispanic or Latino,0,2,2
316866,Hyperpiesis,ethnic,Hispanic or Latino,2,0,2
139766,Carcinoma in situ of scalp and skin of neck,racial,White,2,0,2
436040,Infection by Strongyloides,racial,White,0,2,2
4273622,Operation on bone injury of carpals and metacarpals,racial,White,2,0,2
437854,Cataplexy and narcolepsy,ethnic,Hispanic or Latino,0,2,2
138641,Foreign body in tracheobronchial tree,racial,Unknown,0,2,2
74216,Injury of nerves at shoulder and upper arm level,ethnic,Not Hispanic or Latino,2,0,2
438090,"Overlapping malignant neoplasm of rectum, anus and anal canal",racial,White,0,2,2
4093311,Latent early syphilis NOS,ethnic,Not Hispanic or Latino,2,0,2
4108055,Other forms of retinal detachment,racial,Unknown,2,0,2
138225,Disease of sebaceous glands,racial,Black or African American ,0,2,2
4296205,Second degree burn,racial,Native Hawaiian or Other Pacific Islander ,2,0,2
198470,Unilateral inguinal hernia with obstruction but no gangrene,ethnic,Not Hispanic or Latino,0,2,2
4108517,Eustachian tube obstruction NOS,racial,White,0,2,2
435914,Metatarsus varus,racial,Other Race,2,0,2
4036945,Consciousness disturbance NOS,racial,Black or African American ,2,0,2
376412,Acute follicular conjunctivitis,ethnic,Hispanic or Latino,2,0,2
81382,Tendon sheath giant cell tumor,ethnic,Hispanic or Latino,2,0,2
434207,"Insect bite, nonvenomous, of hand, without mention of infection",racial,Asian,0,2,2
135618,Prurigo,racial,Filipino,0,2,2
374142,Congenital malformation of the nervous system,ethnic,Hispanic or Latino,2,0,2
442130,Open wound of tongue with complication,racial,White,0,2,2
434228,Passenger in vehicular AND/OR traffic accident,racial,White,0,2,2
321726,Injury of blood vessels of lower extremity,racial,White,2,0,2
439815,Choroidal degeneration,racial,White,0,2,2
4147164,Hematologic malignancy,racial,Unknown,0,2,2
72693,Poor fetal growth affecting management,racial,White,2,0,2
200579,Superficial injury of hip without infection,racial,White,2,0,2
442749,Inhibited female orgasm,racial,White,2,0,2
381559,Sensory disorder of eyelid,ethnic,Hispanic or Latino,2,0,2
432632,Noninfectious secondary iridocyclitis,racial,White,2,0,2
4060433,Multiple pregnancy NOS,racial,White,2,0,2
4086927,Contraception status,ethnic,Not Hispanic or Latino,2,0,2
443460,Pathological fracture of femur,racial,Unknown,2,0,2
317305,Stricture of artery,racial,Other Race,2,0,2
4177025,Fracture of patella,racial,Unknown,0,2,2
198995,Type 1 diabetes mellitus - poor control,racial,Alaska Native,2,0,2
81496,Tuberculosis of vertebral column,ethnic,Not Hispanic or Latino,0,2,2
436897,Transport fever,ethnic,Not Hispanic or Latino,0,2,2
375557,Cerebral embolism,racial,Asian,2,0,2
319038,Postmyocardial infarction syndrome,racial,White,0,2,2
25582,Tracheesophageal fistula,ethnic,Not Hispanic or Latino,0,2,2
435418,Accidental poisoning by caustic alkalis,racial,White,0,2,2
435835,Non-infectious disorder of lymphatics,racial,White,0,2,2
373755,Thunderclap headache,racial,Unknown,2,0,2
433657,Fall from furniture,racial,Other Race,2,0,2
440855,Closed fracture of base of metacarpal bone other than first metacarpal,racial,Unknown,0,2,2
136497,Scar conditions and fibrosis of skin,racial,Asian,2,0,2
434172,Insomnia with sleep apnoea,racial,Filipino,0,2,2
201905,Constipation by outlet obstruction,racial,Unknown,2,0,2
257905,Mucopurulent chronic bronchitis,racial,American Indian or Alaska Native ,2,0,2
439347,"Motor vehicle traffic accident involving pedestrian dragged by motor vehicle, passenger on motor cycle injured",ethnic,Hispanic or Latino,0,2,2
4064382,Skin disease screening,racial,Asian,2,0,2
321873,Dissection of carotid artery,racial,White,2,0,2
442170,Blister of neck with infection,racial,Unknown,2,0,2
81380,Cervical syndrome,racial,Asian,2,0,2
201332,Alveolitis of jaw,ethnic,Not Hispanic or Latino,2,0,2
192819,Typhoid fever,racial,White,2,0,2
442276,Closed medial dislocation of proximal end of tibia,ethnic,Not Hispanic or Latino,2,0,2
378734,Intraspinal abscess,ethnic,Hispanic or Latino,0,2,2
374139,Buphthalmos,racial,Unknown,2,0,2
4164770,Acute inflammatory demyelinating polyradiculoneuropathy,racial,White,0,2,2
433749,Heparin-induced thrombocytopenia,ethnic,Hispanic or Latino,0,2,2
372318,Chronic follicular conjunctivitis,racial,White,0,2,2
261738,Multiple burns of head and neck,ethnic,Hispanic or Latino,0,2,2
437590,Pulp necrosis,racial,White,0,2,2
137144,Open wound of palate with complication,ethnic,Hispanic or Latino,0,2,2
4237458,Fracture of clavicle,ethnic,Hispanic or Latino,2,0,2
137213,Fungal dermatosis,racial,Black or African American ,0,2,2
444384,Nonvenomous insect bite of leg with infection,ethnic,Not Hispanic or Latino,0,2,2
442454,"Motor vehicle traffic accident involving collision between motor vehicle and pedal cycle, passenger of motor vehicle injured",ethnic,Hispanic or Latino,0,2,2
4331070,Family history of polyp of colon,racial,Black or African American ,2,0,2
138502,Vitiligo,racial,Black or African American ,0,2,2
432478,Intracranial hemorrhage following injury without open intracranial wound AND with concussion,racial,Unknown,0,2,2
444259,Psychogenic amnesia,racial,White,2,0,2
433187,Cyclitis,racial,White,0,2,2
436940,Insulin resistance syndrome,racial,Black or African American ,0,2,2
433987,Benign tumour of orbit,ethnic,Hispanic or Latino,2,0,2
76777,Arthropathy associated with infection,racial,Other Race,2,0,2
375823,Optic nerve hypoplasia,racial,Unknown,0,2,2
443698,Abnormal anal Papanicolaou smear,ethnic,Not Hispanic or Latino,2,0,2
437693,Open fracture shaft of tibia,ethnic,Not Hispanic or Latino,0,2,2
442124,Orbital edema,racial,Unknown,2,0,2
317376,Tachypnoeic,racial,Unknown,0,2,2
437623,Polyhydramnios,ethnic,Hispanic or Latino,2,0,2
77178,Contusion of multiple sites of upper limb,ethnic,Not Hispanic or Latino,2,0,2
197377,Abnormal bowel sounds,racial,White,2,0,2
4286333,Carcinoma in situ,ethnic,Not Hispanic or Latino,2,0,2
4057346,"Contusion, hip and thigh",racial,Unknown,0,2,2
192785,Second degree burn of abdominal wall,ethnic,Not Hispanic or Latino,2,0,2
4147971,Personality disorder NOS,ethnic,Hispanic or Latino,2,0,2
197596,Toxic gastroenteritis,ethnic,Not Hispanic or Latino,0,2,2
256142,Dental arch relationship anomaly,racial,White,2,0,2
435925,Very premature - less than 1000g or less than 28 weeks,ethnic,Not Hispanic or Latino,0,2,2
436642,Adamantiades-Behcet disease,racial,White,2,0,2
444219,Osteitis deformans without bone tumor,ethnic,Not Hispanic or Latino,0,2,2
443262,Lack or loss of sexual desire,ethnic,Not Hispanic or Latino,2,0,2
135923,CP - Cleft palate,racial,Asian,2,0,2
78230,Rheumatoid arthritis with organ / system involvement,ethnic,Not Hispanic or Latino,2,0,2
436630,Visceral herpes simplex,ethnic,Hispanic or Latino,0,2,2
81380,Cervical syndrome,ethnic,Not Hispanic or Latino,2,0,2
440776,Abortion with complication,ethnic,Hispanic or Latino,2,0,2
40484028,Dental caries extending into dentine,racial,Asian,0,2,2
443415,Gestation greater than 24 weeks,racial,Other Race,0,2,2
380100,Glossopharyngeal neuralgia,racial,Unknown,2,0,2
381301,Chronic serous otitis media,racial,Other Race,2,0,2
4077080,Biopsy of chest wall,racial,White,0,2,2
441193,Accident caused by nonpowered hand tools and implements,ethnic,Hispanic or Latino,2,0,2
440088,Academic underachievement disorder,racial,Filipino,0,2,2
433095,Fall on or from steps,racial,Other Race,2,0,2
4096657,Toxic multinodular goitre NOS,racial,Unknown,2,0,2
78473,Solitary cyst of breast,racial,Other Race,2,0,2
444253,Blister of scalp without infection,ethnic,Not Hispanic or Latino,0,2,2
135893,Decubitus ulcer of heel,racial,Native Hawaiian or Other Pacific Islander ,0,2,2
437222,Respiratory syncytial virus infection,racial,Asian,0,2,2
194680,Acute gastric ulcer with perforation but without obstruction,ethnic,Hispanic or Latino,2,0,2
438903,Injury of external jugular vein,ethnic,Hispanic or Latino,2,0,2
433811,Hydronephrosis,racial,Filipino,2,0,2
4147972,Specific academic or work inhibition,racial,Unknown,0,2,2
441979,Open fracture of upper end of tibia,ethnic,Hispanic or Latino,0,2,2
138644,Burn erythema of lower limb,racial,White,2,0,2
372634,Nonphysiologic vision loss,racial,Filipino,0,2,2
199839,External haemorrhoids without complication,racial,American Indian or Alaska Native ,2,0,2
4058364,Superficial injury of foot and toe(s),racial,White,0,2,2
197050,Abnormality of organs AND/OR soft tissues of pelvis affecting pregnancy,racial,Unknown,2,0,2
432517,Posttraumatic wound infection,racial,Other Race,0,2,2
193693,Viral hepatitis without hepatic coma,racial,American Indian or Alaska Native ,0,2,2
260336,Primary malignant neoplasm of glottis,ethnic,Hispanic or Latino,0,2,2
196569,Contusion of abdominal wall,racial,Black or African American ,2,0,2
40480082,Hemicrania continua,racial,White,2,0,2
4129342,Nephrectomy of remaining or solitary kidney,ethnic,Not Hispanic or Latino,2,0,2
258458,Bacterial pleurisy with effusion,ethnic,Not Hispanic or Latino,2,0,2
141305,Unilateral sensorineural hearing loss with unrestricted hearing on the contralateral side,racial,Black or African American ,0,2,2
4062641,Malaria screening,racial,Black or African American ,2,0,2
315830,Variant angina,ethnic,Not Hispanic or Latino,2,0,2
77592,Articular crepitus of temporomandibular joint,racial,Other Race,2,0,2
75721,Prosthetic joint mechanical failure,ethnic,Hispanic or Latino,2,0,2
437922,Hematoma of vulva,ethnic,Not Hispanic or Latino,2,0,2
376106,Disorder of the central nervous system,racial,Unknown,2,0,2
4004785,Fetal alcohol syndrome,racial,Unknown,0,2,2
433675,Toxic effect of chemical,racial,Unknown,0,2,2
195864,Diverticulum of bladder,racial,White,0,2,2
377546,Chronic post-traumatic headache,ethnic,Hispanic or Latino,2,0,2
4298824,Free skin graft,ethnic,Hispanic or Latino,0,2,2
440840,Neonatal candidiasis,racial,Asian,2,0,2
77068,Secondary localised osteoarthrosis of lower leg,racial,Unknown,0,2,2
4096038,Diabetes mellitus NOS with ophthalmic manifestation,racial,Unknown,2,0,2
443323,Papyraceous fetus - not delivered,racial,White,2,0,2
434272,Varicella infection,racial,Black or African American ,0,2,2
434321,Schizoaffective schizophrenia in remission,racial,White,2,0,2
436624,Late congenital syphilis - latent,ethnic,Not Hispanic or Latino,0,2,2
193079,Injury of nerve of trunk,ethnic,Hispanic or Latino,2,0,2
72332,Serous labyrinthitis,racial,White,2,0,2
372886,Refractory migraine with aura,ethnic,Not Hispanic or Latino,2,0,2
4299653,Unilateral orchidectomy,racial,White,0,2,2
432719,Panniculitis,racial,Other Race,2,0,2
372423,Reduction deformities of brain,racial,Asian,2,0,2
438531,Chondromalacia,ethnic,Not Hispanic or Latino,2,0,2
441139,Instantaneous death,racial,Other Race,2,0,2
40482247,Organic sleep apnea,racial,Black or African American ,2,0,2
138918,Partial thickness burn of lip,racial,Unknown,0,2,2
441063,Acute gastrojejunal ulcer with hemorrhage AND obstruction,ethnic,Hispanic or Latino,2,0,2
379805,Myopia,racial,Filipino,0,2,2
378165,Nystagmus,racial,Black or African American ,2,0,2
260125,Acute bronchiolitis,racial,American Indian,2,0,2
4211231,Panic disorder without agoraphobia,racial,American Indian,2,0,2
379816,Simple chronic conjunctivitis,racial,White,2,0,2
314479,Primary apnea in the newborn,ethnic,Not Hispanic or Latino,0,2,2
136496,Cellulitis and abscess of face,racial,Filipino,0,2,2
197415,"Spleen capsular tear without major disruption of parenchyma, with open wound into cavity",ethnic,Hispanic or Latino,2,0,2
4117578,Other and unspecified joint disorders,ethnic,Hispanic or Latino,2,0,2
23798,Acute laryngopharyngitis,racial,American Indian or Alaska Native ,2,0,2
4204967,Laryngismus,racial,Other Race,2,0,2
257012,Chronic rhinosinusitis,racial,Asian Indian,0,2,2
4280828,"Carrier, infectious agent",racial,Other Race,2,0,2
437746,"Infection after injection, infusion, transfusion and vaccination",ethnic,Hispanic or Latino,0,2,2
75099,Coccyx sprain,ethnic,Not Hispanic or Latino,2,0,2
438783,Erosion of teeth,racial,White,0,2,2
437241,Qualitative platelet defect,racial,Unknown,0,2,2
444424,Open wound of Eustachian tube with complication,ethnic,Hispanic or Latino,0,2,2
318173,Vascular graft calcification,ethnic,Hispanic or Latino,2,0,2
4223536,Classical cesarean section,ethnic,Hispanic or Latino,2,0,2
435802,Blepharospasm,racial,Other Race,2,0,2
258453,Acute upper respiratory infection of multiple sites,racial,Filipino,2,0,2
377573,Pars tensa central perforation,racial,Other Race,0,2,2
436333,Orf virus disease,ethnic,Not Hispanic or Latino,2,0,2
433458,"Combined drug dependence, excluding opioid, in remission",racial,White,0,2,2
438583,Open fracture of femur,ethnic,Hispanic or Latino,2,0,2
4247802,Muscular dystrophy,racial,Other Race,0,2,2
441969,Radiology result abnormal,racial,Black or African American ,2,0,2
432789,Opioid analgesic adverse reaction,ethnic,Not Hispanic or Latino,0,2,2
437449,Victim of child abuse,racial,Black or African American ,0,2,2
77984,Congenital cleft hand,ethnic,Hispanic or Latino,0,2,2
434212,Contusion of axillary region,ethnic,Hispanic or Latino,2,0,2
4285734,Instability of joint,ethnic,Hispanic or Latino,0,2,2
376103,Retinopathy,racial,Asian,2,0,2
436230,Blood chemistry abnormal,racial,Asian Indian,2,0,2
432804,Fall from scaffold,racial,Unknown,2,0,2
138821,Seborrhea,racial,American Indian or Alaska Native ,2,0,2
438730,Alkalosis,racial,White,0,2,2
76744,Azoospermia,ethnic,Not Hispanic or Latino,0,2,2
378165,Nystagmus,racial,Asian Indian,0,2,2
437589,Pulpitis,racial,Other Race,2,0,2
4161977,Patient with cardiac pacemaker,racial,Filipino,2,0,2
196341,Dermatophytosis of the perianal area,racial,American Indian or Alaska Native ,2,0,2
441534,"Severe major depression, single episode, without psychotic features",racial,Other Race,2,0,2
