omop_concept_id,omop_concept_name,category,category_value,count_females,count_males,count_total
201826,Type 2 diabetes mellitus,ethnic,Hispanic or Latino,55198,33152,88350
320128,Essential hypertension,ethnic,Hispanic or Latino,54935,31048,85983
312648,Benign essential hypertension,ethnic,Hispanic or Latino,39101,21549,60650
433736,Obesity,ethnic,Hispanic or Latino,40373,19009,59382
432867,Hyperlipidemia,ethnic,Hispanic or Latino,37743,21284,59027
4103471,Observation of body mass index,ethnic,Hispanic or Latino,31039,25024,56063
201826,Type 2 diabetes mellitus,racial,White,28276,19546,47822
192278,Type II diabetes mellitus - poor control,ethnic,Hispanic or Latino,24757,17078,41835
320128,Essential hypertension,racial,White,22919,15860,38779
4103471,Observation of body mass index,racial,White,20114,17488,37602
433736,Obesity,racial,White,21943,11959,33902
312648,Benign essential hypertension,racial,White,21427,12358,33785
376065,Neurologic disorder associated with type II diabetes mellitus,ethnic,Hispanic or Latino,21649,11378,33027
437525,Overweight,ethnic,Hispanic or Latino,18642,13433,32075
4079876,Familial combined hyperlipidemia,ethnic,Hispanic or Latino,17923,13530,31453
320128,Essential hypertension,racial,Unknown,20740,9652,30392
4060985,BMI 30+ - obesity,ethnic,Hispanic or Latino,17899,7990,25889
432867,Hyperlipidemia,racial,White,14943,10033,24976
318800,GERD - Gastro-esophageal reflux disease,ethnic,Hispanic or Latino,16240,8621,24861
201826,Type 2 diabetes mellitus,racial,Unknown,15425,7774,23199
317009,Hyperreactive airway disease,ethnic,Hispanic or Latino,12488,10429,22917
80180,Osteoarthritis,ethnic,Hispanic or Latino,15712,5610,21322
432867,Hyperlipidemia,racial,Unknown,13880,7322,21202
257011,Acute upper respiratory infection,ethnic,Hispanic or Latino,11179,9062,20241
192278,Type II diabetes mellitus - poor control,racial,White,10990,9038,20028
432526,Needs influenza immunisation,ethnic,Hispanic or Latino,11218,8663,19881
4064377,Depression screening,ethnic,Hispanic or Latino,12047,7464,19511
140673,Hypothyroid,ethnic,Hispanic or Latino,16251,3209,19460
4079876,Familial combined hyperlipidemia,racial,White,11087,8357,19444
437525,Overweight,racial,White,10811,8295,19106
434005,Morbid obesity,ethnic,Hispanic or Latino,12288,6295,18583
440383,Depressive disorder,ethnic,Hispanic or Latino,13043,4846,17889
376065,Neurologic disorder associated with type II diabetes mellitus,racial,Unknown,12038,5769,17807
312648,Benign essential hypertension,racial,Unknown,10804,6194,16998
4060985,BMI 30+ - obesity,racial,White,11095,5578,16673
320128,Essential hypertension,ethnic,Not Hispanic or Latino,9230,6823,16053
317009,Hyperreactive airway disease,racial,White,7835,7435,15270
4096215,"Hyperlipidemia, group A",ethnic,Hispanic or Latino,10201,5054,15255
433736,Obesity,racial,Unknown,10279,3921,14200
257007,Allergic rhinitis,ethnic,Hispanic or Latino,8110,6046,14156
441542,Anxiety,ethnic,Hispanic or Latino,10652,2809,13461
257011,Acute upper respiratory infection,racial,White,7190,6235,13425
317576,Coronary arteriosclerosis,ethnic,Hispanic or Latino,7229,5891,13120
4064377,Depression screening,racial,White,7691,5077,12768
432526,Needs influenza immunisation,racial,White,6969,5649,12618
75617,Polyarticular osteoarthritis,ethnic,Hispanic or Latino,9376,3143,12519
4175226,Screening for malignant neoplasm of colon,ethnic,Hispanic or Latino,7784,4703,12487
439777,Anemia,ethnic,Hispanic or Latino,8824,3521,12345
432867,Hyperlipidemia,ethnic,Not Hispanic or Latino,7564,4754,12318
201826,Type 2 diabetes mellitus,ethnic,Not Hispanic or Latino,6685,5196,11881
434005,Morbid obesity,racial,White,7643,4186,11829
192278,Type II diabetes mellitus - poor control,racial,Unknown,7200,4238,11438
312648,Benign essential hypertension,ethnic,Not Hispanic or Latino,7031,4400,11431
4062637,TB - Tuberculosis screening,ethnic,Hispanic or Latino,6250,5132,11382
80502,Osteoporosis,ethnic,Hispanic or Latino,10336,407,10743
439727,HIV - Human immunodeficiency virus infection,ethnic,Hispanic or Latino,1349,9374,10723
436962,Sleeplessness,ethnic,Hispanic or Latino,7811,2812,10623
318800,GERD - Gastro-esophageal reflux disease,racial,Unknown,7051,3365,10416
4103471,Observation of body mass index,ethnic,Not Hispanic or Latino,5552,4714,10266
75860,Costiveness,ethnic,Hispanic or Latino,6958,3185,10143
439727,HIV - Human immunodeficiency virus infection,racial,White,1311,8731,10042
197684,Dysuria,ethnic,Hispanic or Latino,7241,2685,9926
4103471,Observation of body mass index,racial,Unknown,5717,4205,9922
318800,GERD - Gastro-esophageal reflux disease,racial,White,6212,3610,9822
140673,Hypothyroid,racial,White,8212,1583,9795
80180,Osteoarthritis,racial,Unknown,6955,2616,9571
81112,Arthralgia of the lower leg,ethnic,Hispanic or Latino,6280,2819,9099
194133,Low back pain,ethnic,Hispanic or Latino,5593,3455,9048
4096215,"Hyperlipidemia, group A",racial,White,5137,3708,8845
257007,Allergic rhinitis,racial,White,4878,3877,8755
4086918,Viral screening,ethnic,Hispanic or Latino,5341,3209,8550
192279,Diabetic nephropathy,ethnic,Hispanic or Latino,4618,3816,8434
376065,Neurologic disorder associated with type II diabetes mellitus,racial,White,5403,2861,8264
254761,Cough,ethnic,Hispanic or Latino,4922,2911,7833
440383,Depressive disorder,racial,White,5624,2066,7690
4175226,Screening for malignant neoplasm of colon,racial,White,4747,2881,7628
433736,Obesity,ethnic,Not Hispanic or Latino,4936,2675,7611
4062637,TB - Tuberculosis screening,racial,White,3940,3610,7550
25297,Acute pharyngitis,ethnic,Hispanic or Latino,4539,2854,7393
374022,Hemiplegia,ethnic,Hispanic or Latino,3261,4118,7379
4079876,Familial combined hyperlipidemia,racial,Unknown,3914,3222,7136
4064918,Diabetes mellitus screening,ethnic,Hispanic or Latino,4189,2932,7121
140673,Hypothyroid,racial,Unknown,5775,1244,7019
440383,Depressive disorder,racial,Unknown,5069,1840,6909
440360,Pure hyperglyceridemia,ethnic,Hispanic or Latino,3148,3748,6896
200219,Abdominal pain,ethnic,Hispanic or Latino,4887,1856,6743
198995,Type 1 diabetes mellitus - poor control,ethnic,Hispanic or Latino,3620,3005,6625
313217,Atrial fibrillation,ethnic,Hispanic or Latino,3609,2819,6428
197684,Dysuria,racial,White,4643,1774,6417
372328,Otitis media,ethnic,Hispanic or Latino,3184,3226,6410
437525,Overweight,racial,Unknown,3684,2719,6403
81902,Urinary tract infectious disease,ethnic,Hispanic or Latino,5530,793,6323
441542,Anxiety,racial,White,4312,1853,6165
134736,Backache,ethnic,Hispanic or Latino,4061,2048,6109
192278,Type II diabetes mellitus - poor control,ethnic,Not Hispanic or Latino,3617,2481,6098
317576,Coronary arteriosclerosis,racial,Unknown,3618,2468,6086
195306,Gastroduodenitis,ethnic,Hispanic or Latino,4174,1888,6062
436962,Sleeplessness,racial,Unknown,4475,1569,6044
432867,Hyperlipidemia,racial,Asian,4009,1946,5955
80180,Osteoarthritis,racial,White,4529,1378,5907
320128,Essential hypertension,racial,Asian,3415,2396,5811
312648,Benign essential hypertension,racial,Asian,3829,1933,5762
443767,Diabetic oculopathy,ethnic,Hispanic or Latino,3428,2312,5740
378253,HA - Headache,ethnic,Hispanic or Latino,4119,1532,5651
317009,Hyperreactive airway disease,racial,Unknown,3484,2069,5553
4086918,Viral screening,racial,White,3381,2167,5548
75617,Polyarticular osteoarthritis,racial,Unknown,3720,1760,5480
439777,Anemia,racial,White,3591,1879,5470
260123,Acute inflammation of sinus,ethnic,Hispanic or Latino,3395,2071,5466
433316,Giddiness,ethnic,Hispanic or Latino,3781,1677,5458
194133,Low back pain,racial,White,3260,2192,5452
260139,Acute bronchitis,ethnic,Hispanic or Latino,3476,1962,5438
73553,Arthropathy,ethnic,Hispanic or Latino,4157,1226,5383
317009,Hyperreactive airway disease,ethnic,Not Hispanic or Latino,3014,2347,5361
77670,Chest pain,ethnic,Hispanic or Latino,3379,1964,5343
432285,Recurrent major depressive episodes,ethnic,Hispanic or Latino,3824,1478,5302
198803,Nodular hyperplasia of prostate gland,ethnic,Hispanic or Latino,21,5254,5275
80502,Osteoporosis,racial,Unknown,4697,492,5189
25297,Acute pharyngitis,racial,White,3032,2107,5139
254761,Cough,racial,White,3033,2024,5057
437525,Overweight,ethnic,Not Hispanic or Latino,2716,2328,5044
441542,Anxiety,racial,Unknown,3850,1147,4997
319835,Congestive cardiac failure,ethnic,Hispanic or Latino,3276,1711,4987
377861,Disorder of refraction AND/OR accommodation,ethnic,Hispanic or Latino,2930,2025,4955
140648,Onychomycosis due to dermatophyte,ethnic,Hispanic or Latino,2642,2216,4858
372328,Otitis media,racial,White,2294,2486,4780
4060985,BMI 30+ - obesity,racial,Unknown,3444,1333,4777
80180,Osteoarthritis,ethnic,Not Hispanic or Latino,3580,1186,4766
197672,Urinary incontinence,ethnic,Hispanic or Latino,3776,915,4691
317576,Coronary arteriosclerosis,ethnic,Not Hispanic or Latino,2778,1862,4640
443597,Chronic kidney disease stage 3,ethnic,Hispanic or Latino,2553,2083,4636
4096215,"Hyperlipidemia, group A",racial,Unknown,3499,1122,4621
201826,Type 2 diabetes mellitus,racial,Asian,2947,1673,4620
439141,Abnormal increase in weight,ethnic,Hispanic or Latino,2508,2100,4608
4064375,Iron deficiency screening,ethnic,Hispanic or Latino,2666,1929,4595
80824,Senile osteoporosis,ethnic,Hispanic or Latino,4259,246,4505
78232,Shoulder joint pain,ethnic,Hispanic or Latino,2963,1481,4444
440360,Pure hyperglyceridemia,racial,White,2023,2413,4436
75617,Polyarticular osteoarthritis,racial,White,3474,956,4430
432284,Single major depressive episode,ethnic,Hispanic or Latino,3137,1283,4420
318800,GERD - Gastro-esophageal reflux disease,ethnic,Not Hispanic or Latino,2595,1747,4342
317576,Coronary arteriosclerosis,racial,White,1921,2382,4303
80502,Osteoporosis,ethnic,Not Hispanic or Latino,3457,841,4298
434005,Morbid obesity,racial,Unknown,2891,1305,4196
376112,Diabetic polyneuropathy,ethnic,Hispanic or Latino,2588,1605,4193
138525,Pain in limb,ethnic,Hispanic or Latino,2732,1421,4153
438557,Abnormal glucose level,ethnic,Hispanic or Latino,2488,1645,4133
439777,Anemia,racial,Unknown,3136,994,4130
4060985,BMI 30+ - obesity,ethnic,Not Hispanic or Latino,2572,1555,4127
194083,Vaginitis and vulvovaginitis,ethnic,Hispanic or Latino,4095,0,4095
260123,Acute inflammation of sinus,racial,White,2518,1567,4085
81112,Arthralgia of the lower leg,racial,White,2817,1253,4070
4064918,Diabetes mellitus screening,racial,White,2287,1781,4068
75860,Costiveness,racial,White,2509,1555,4064
200219,Abdominal pain,racial,White,2797,1265,4062
321318,Angina,ethnic,Hispanic or Latino,2914,1127,4041
433595,Interstitial edema,ethnic,Hispanic or Latino,2696,1324,4020
443729,Peripheral circulatory disorder associated with type II diabetes mellitus,ethnic,Hispanic or Latino,2657,1342,3999
4062484,Cervical neoplasia screening,ethnic,Hispanic or Latino,3969,5,3974
378419,AD - Alzheimer's disease,ethnic,Hispanic or Latino,2305,1639,3944
81112,Arthralgia of the lower leg,racial,Unknown,2818,1107,3925
257011,Acute upper respiratory infection,racial,Unknown,2312,1573,3885
4064377,Depression screening,ethnic,Not Hispanic or Latino,2230,1634,3864
439147,Amnesia,ethnic,Hispanic or Latino,2081,1754,3835
198995,Type 1 diabetes mellitus - poor control,racial,White,1979,1846,3825
432526,Needs influenza immunisation,racial,Unknown,2253,1570,3823
260139,Acute bronchitis,racial,White,2343,1475,3818
133141,Tinea pedis,ethnic,Hispanic or Latino,1914,1889,3803
440383,Depressive disorder,ethnic,Not Hispanic or Latino,2426,1371,3797
437541,Glaucoma,ethnic,Hispanic or Latino,2399,1389,3788
140673,Hypothyroid,ethnic,Not Hispanic or Latino,2990,786,3776
134438,CD - Contact dermatitis,ethnic,Hispanic or Latino,2212,1556,3768
80809,Rheumatoid arthritis,ethnic,Hispanic or Latino,3383,383,3766
378253,HA - Headache,racial,White,2782,961,3743
80502,Osteoporosis,racial,White,3499,212,3711
257581,Exacerbation of asthma,ethnic,Hispanic or Latino,1690,2019,3709
75860,Costiveness,racial,Unknown,2871,821,3692
320128,Essential hypertension,racial,Other Race,2522,1152,3674
436238,Elevated levels of transaminase and lactic acid dehydrogenase,ethnic,Hispanic or Latino,2168,1506,3674
437264,Tobacco dependence syndrome,ethnic,Hispanic or Latino,1475,2194,3669
381591,Cerebrovascular disease,ethnic,Hispanic or Latino,1336,2317,3653
4079876,Familial combined hyperlipidemia,ethnic,Not Hispanic or Latino,1801,1834,3635
81902,Urinary tract infectious disease,racial,White,3179,455,3634
134736,Backache,racial,White,2294,1301,3595
257007,Allergic rhinitis,racial,Unknown,2152,1441,3593
192279,Diabetic nephropathy,racial,Unknown,1607,1979,3586
436962,Sleeplessness,racial,White,2485,1096,3581
80502,Osteoporosis,racial,Asian,2896,650,3546
141693,Elevated blood-pressure reading without diagnosis of hypertension,ethnic,Hispanic or Latino,1826,1697,3523
377889,Hearing loss,ethnic,Hispanic or Latino,1838,1684,3522
140214,Eruption of skin,ethnic,Hispanic or Latino,2000,1510,3510
4064377,Depression screening,racial,Unknown,2209,1240,3449
321052,Peripheral vascular disease,ethnic,Hispanic or Latino,2096,1349,3445
4308509,Impaired fasting glycaemia,ethnic,Hispanic or Latino,1883,1520,3403
437643,Gait abnormality,ethnic,Hispanic or Latino,1679,1715,3394
436659,Iron deficiency anaemia,ethnic,Hispanic or Latino,2456,924,3380
4147961,Screening for malignant neoplasm of breast,ethnic,Hispanic or Latino,3360,2,3362
436962,Sleeplessness,ethnic,Not Hispanic or Latino,2155,1186,3341
197928,Menstruation absent,ethnic,Hispanic or Latino,3304,5,3309
374888,Dementia associated with another disease,ethnic,Hispanic or Latino,2305,1000,3305
438332,Disease of possible viral origin,ethnic,Hispanic or Latino,1514,1768,3282
374022,Hemiplegia,racial,Unknown,1722,1549,3271
443767,Diabetic oculopathy,racial,Unknown,1844,1372,3216
439147,Amnesia,racial,Unknown,1742,1472,3214
374366,Sensorineural hearing loss,ethnic,Hispanic or Latino,2073,1124,3197
80180,Osteoarthritis,racial,Asian,2434,731,3165
439926,Malaise and fatigue,ethnic,Hispanic or Latino,1921,1223,3144
374375,Impacted cerumen,ethnic,Hispanic or Latino,1739,1366,3105
192279,Diabetic nephropathy,racial,White,1637,1450,3087
313217,Atrial fibrillation,racial,White,1464,1621,3085
376065,Neurologic disorder associated with type II diabetes mellitus,ethnic,Not Hispanic or Latino,1714,1344,3058
196991,Chronic renal disease,ethnic,Hispanic or Latino,1556,1498,3054
434056,Late effects of cerebrovascular disease,ethnic,Hispanic or Latino,1481,1571,3052
432526,Needs influenza immunisation,ethnic,Not Hispanic or Latino,1648,1370,3018
443350,Lower urinary tract symptoms,ethnic,Hispanic or Latino,2,2998,3000
4299535,Pregnancy confirmed,ethnic,Hispanic or Latino,2990,4,2994
195306,Gastroduodenitis,racial,Unknown,2321,666,2987
313878,Respiratory symptoms,ethnic,Hispanic or Latino,1716,1271,2987
196523,Diarrhea,ethnic,Hispanic or Latino,1750,1235,2985
437264,Tobacco dependence syndrome,racial,White,1333,1587,2920
4064375,Iron deficiency screening,racial,White,1624,1238,2862
375545,Lens opacity,ethnic,Hispanic or Latino,1871,991,2862
434005,Morbid obesity,ethnic,Not Hispanic or Latino,1872,981,2853
437041,Mother not delivered,ethnic,Hispanic or Latino,2838,2,2840
320128,Essential hypertension,racial,Black or African American ,1539,1277,2816
444202,Abscess,ethnic,Hispanic or Latino,1610,1200,2810
441542,Anxiety,ethnic,Not Hispanic or Latino,1760,1014,2774
377861,Disorder of refraction AND/OR accommodation,racial,White,1553,1193,2746
314658,Cardiomegaly,ethnic,Hispanic or Latino,1945,789,2734
4299535,Pregnancy confirmed,racial,White,2717,11,2728
317576,Coronary arteriosclerosis,racial,Asian,1832,860,2692
375281,Acute suppurative otitis media - tympanic membrane intact,ethnic,Hispanic or Latino,1346,1341,2687
138525,Pain in limb,racial,White,1806,857,2663
374060,Acute ill-defined cerebrovascular disease,ethnic,Hispanic or Latino,1097,1538,2635
201826,Type 2 diabetes mellitus,racial,Other Race,1670,932,2602
313217,Atrial fibrillation,racial,Unknown,1601,982,2583
257581,Exacerbation of asthma,racial,White,1221,1357,2578
432867,Hyperlipidemia,racial,Other Race,1746,827,2573
201254,Insulin dependent diabetes mellitus,ethnic,Hispanic or Latino,1610,956,2566
198558,Nycturia,ethnic,Hispanic or Latino,1730,833,2563
4096215,"Hyperlipidemia, group A",ethnic,Not Hispanic or Latino,1450,1062,2512
437663,Fever,ethnic,Hispanic or Latino,1271,1232,2503
439727,HIV - Human immunodeficiency virus infection,ethnic,Not Hispanic or Latino,610,1893,2503
77670,Chest pain,racial,White,1429,1066,2495
4175226,Screening for malignant neoplasm of colon,racial,Unknown,1491,993,2484
198803,Nodular hyperplasia of prostate gland,racial,Unknown,0,2482,2482
194133,Low back pain,racial,Unknown,1525,955,2480
438557,Abnormal glucose level,racial,White,1300,1167,2467
134438,CD - Contact dermatitis,racial,White,1412,1052,2464
443783,Chronic disease,ethnic,Hispanic or Latino,1376,1082,2458
80824,Senile osteoporosis,racial,Unknown,2274,167,2441
375806,Idiopathic peripheral neuropathy,ethnic,Hispanic or Latino,1574,862,2436
439141,Abnormal increase in weight,racial,White,1245,1189,2434
75650,Proteinuria,ethnic,Hispanic or Latino,1194,1237,2431
321318,Angina,racial,Unknown,1547,883,2430
140648,Onychomycosis due to dermatophyte,racial,White,1235,1184,2419
194133,Low back pain,ethnic,Not Hispanic or Latino,1403,1004,2407
140214,Eruption of skin,racial,White,1277,1115,2392
198964,Chronic type C viral hepatitis,ethnic,Hispanic or Latino,866,1489,2355
77354,Primary localised osteoarthrosis of lower leg,ethnic,Hispanic or Latino,1778,572,2350
257007,Allergic rhinitis,ethnic,Not Hispanic or Latino,1339,1007,2346
378419,AD - Alzheimer's disease,racial,Unknown,1517,823,2340
440029,Viral disease,ethnic,Hispanic or Latino,1202,1124,2326
443865,Non-infective colitis,ethnic,Hispanic or Latino,1259,1067,2326
197913,Disorder of function of stomach,ethnic,Hispanic or Latino,1578,735,2313
442793,Diabetic complication,ethnic,Hispanic or Latino,1288,1009,2297
79106,Arthralgia of the pelvic region and thigh,ethnic,Hispanic or Latino,1481,817,2298
372409,Sciatica neuralgia,ethnic,Hispanic or Latino,1552,741,2293
433316,Giddiness,racial,White,1596,697,2293
259153,Throat soreness,ethnic,Hispanic or Latino,1468,817,2285
4062637,TB - Tuberculosis screening,racial,Unknown,1326,943,2269
73553,Arthropathy,racial,Unknown,1880,383,2263
319835,Congestive cardiac failure,racial,Unknown,1662,595,2257
141693,Elevated blood-pressure reading without diagnosis of hypertension,racial,White,1178,1066,2244
312338,Benign hypertensive heart disease with congestive heart failure,ethnic,Hispanic or Latino,963,1277,2240
444101,Hypertensive heart failure,ethnic,Hispanic or Latino,1425,812,2237
194083,Vaginitis and vulvovaginitis,racial,White,2223,5,2228
443238,Diabetic - poor control,ethnic,Hispanic or Latino,1150,1068,2218
381270,Parkinson's disease,ethnic,Hispanic or Latino,1274,942,2216
443597,Chronic kidney disease stage 3,racial,White,1217,997,2214
195306,Gastroduodenitis,racial,White,1232,980,2212
442752,Myalgia,ethnic,Hispanic or Latino,1813,383,2196
198803,Nodular hyperplasia of prostate gland,ethnic,Not Hispanic or Latino,1,2193,2194
438332,Disease of possible viral origin,racial,White,1019,1174,2193
257011,Acute upper respiratory infection,ethnic,Not Hispanic or Latino,1154,1031,2185
197928,Menstruation absent,racial,White,2120,55,2175
255573,Chronic obstructive lung disease,ethnic,Hispanic or Latino,1274,896,2170
132740,Positive skin test reaction,ethnic,Hispanic or Latino,1448,704,2152
78232,Shoulder joint pain,racial,White,1312,832,2144
436238,Elevated levels of transaminase and lactic acid dehydrogenase,racial,White,1153,973,2126
4175226,Screening for malignant neoplasm of colon,ethnic,Not Hispanic or Latino,1192,902,2094
432285,Recurrent major depressive episodes,racial,White,1581,507,2088
318800,GERD - Gastro-esophageal reflux disease,racial,Asian,1282,801,2083
4147961,Screening for malignant neoplasm of breast,racial,White,2074,7,2081
4062484,Cervical neoplasia screening,racial,White,2067,12,2079
197684,Dysuria,racial,Unknown,1518,557,2075
439777,Anemia,ethnic,Not Hispanic or Latino,1342,650,1992
256451,Bronchitis,ethnic,Hispanic or Latino,1262,729,1991
133141,Tinea pedis,racial,White,995,986,1981
258780,Chronic obstructive bronchitis,ethnic,Hispanic or Latino,1235,738,1973
4308509,Impaired fasting glycaemia,racial,White,1057,904,1961
377091,Fits - convulsions,ethnic,Hispanic or Latino,720,1233,1953
196523,Diarrhea,racial,White,1069,880,1949
4064905,Venereal disease screening,ethnic,Hispanic or Latino,1281,652,1933
374366,Sensorineural hearing loss,racial,Unknown,1279,652,1931
197672,Urinary incontinence,racial,White,1698,231,1929
440674,Gout,ethnic,Hispanic or Latino,382,1547,1929
374375,Impacted cerumen,racial,White,1036,890,1926
432285,Recurrent major depressive episodes,racial,Unknown,1222,702,1924
75617,Polyarticular osteoarthritis,ethnic,Not Hispanic or Latino,1442,481,1923
77074,Joint pain,ethnic,Hispanic or Latino,1354,558,1912
198995,Type 1 diabetes mellitus - poor control,racial,Unknown,1112,797,1909
375281,Acute suppurative otitis media - tympanic membrane intact,racial,White,901,1006,1907
444202,Abscess,racial,White,1035,856,1891
134736,Backache,racial,Unknown,1315,575,1890
439926,Malaise and fatigue,racial,White,982,901,1883
432867,Hyperlipidemia,racial,Black or African American ,1137,742,1879
443597,Chronic kidney disease stage 3,racial,Unknown,964,906,1870
319835,Congestive cardiac failure,racial,White,1073,791,1864
442067,Atopic dermatitis and related conditions,ethnic,Hispanic or Latino,955,904,1859
374888,Dementia associated with another disease,racial,Unknown,1332,522,1854
255848,Pneumonia,ethnic,Hispanic or Latino,923,913,1836
376707,Acute conjunctivitis,ethnic,Hispanic or Latino,972,864,1836
439708,Disorders of initiating and maintaining sleep,ethnic,Hispanic or Latino,1286,540,1826
257012,Chronic rhinosinusitis,ethnic,Hispanic or Latino,1172,652,1824
436962,Sleeplessness,racial,Asian,1253,569,1822
436659,Iron deficiency anaemia,racial,White,1296,520,1816
318736,Migraine,ethnic,Hispanic or Latino,1624,188,1812
198964,Chronic type C viral hepatitis,racial,White,654,1149,1803
314658,Cardiomegaly,racial,Unknown,1368,435,1803
80767,Breast irregular nodularity,ethnic,Hispanic or Latino,1762,38,1800
433736,Obesity,racial,Other Race,1144,649,1793
437541,Glaucoma,racial,Unknown,1113,677,1790
380378,Epilepsy,ethnic,Hispanic or Latino,836,950,1786
432284,Single major depressive episode,racial,White,1225,556,1781
80809,Rheumatoid arthritis,racial,Unknown,1620,149,1769
4302252,High risk pregnancy care,ethnic,Hispanic or Latino,1766,0,1766
254761,Cough,racial,Unknown,1197,561,1758
437663,Fever,racial,White,832,923,1755
81902,Urinary tract infectious disease,racial,Unknown,1553,202,1755
313878,Respiratory symptoms,racial,White,945,809,1754
4103471,Observation of body mass index,racial,Asian,998,752,1750
192278,Type II diabetes mellitus - poor control,racial,Asian,1202,544,1746
434613,Generalized anxiety disorder,ethnic,Hispanic or Latino,1331,403,1734
433316,Giddiness,racial,Unknown,1232,499,1731
193782,End stage renal disease,ethnic,Hispanic or Latino,767,949,1716
192667,Atrophic gastritis,ethnic,Hispanic or Latino,1106,599,1705
260125,Acute bronchiolitis,ethnic,Hispanic or Latino,796,908,1704
73553,Arthropathy,racial,White,1358,345,1703
443767,Diabetic oculopathy,racial,White,1015,682,1697
81112,Arthralgia of the lower leg,ethnic,Not Hispanic or Latino,1295,389,1684
437264,Tobacco dependence syndrome,ethnic,Not Hispanic or Latino,808,872,1680
198803,Nodular hyperplasia of prostate gland,racial,White,2,1675,1677
312934,Atherosclerosis of aorta,ethnic,Hispanic or Latino,1129,538,1667
4093344,Prostate observation,ethnic,Hispanic or Latino,5,1645,1650
316999,Cardiac arrhythmia,ethnic,Hispanic or Latino,1106,541,1647
4077577,Moderate recurrent major depression,ethnic,Hispanic or Latino,1101,528,1629
259153,Throat soreness,racial,White,1052,574,1626
375791,Uncomplicated senile dementia,ethnic,Hispanic or Latino,952,673,1625
379019,Inflammation of conjunctiva,ethnic,Hispanic or Latino,887,734,1621
24134,Nonspecific pain in the neck region,ethnic,Hispanic or Latino,1191,426,1617
200219,Abdominal pain,racial,Unknown,1244,364,1608
195562,Hemorrhoids,ethnic,Hispanic or Latino,952,646,1598
75860,Costiveness,ethnic,Not Hispanic or Latino,1025,572,1597
433595,Interstitial edema,racial,White,1097,494,1591
434169,Abnormal findings on diagnostic imaging of breast,ethnic,Hispanic or Latino,1579,4,1583
433595,Interstitial edema,racial,Unknown,938,635,1573
443729,Peripheral circulatory disorder associated with type II diabetes mellitus,racial,Unknown,959,612,1571
197381,Epigastric pain,ethnic,Hispanic or Latino,1178,391,1569
440029,Viral disease,racial,White,811,757,1568
196168,Irregular menstrual bleeding,ethnic,Hispanic or Latino,1556,0,1556
376112,Diabetic polyneuropathy,racial,White,925,628,1553
192278,Type II diabetes mellitus - poor control,racial,Other Race,1028,524,1552
77670,Chest pain,racial,Unknown,1168,383,1551
381859,Infective OE,ethnic,Hispanic or Latino,941,605,1546
437041,Mother not delivered,racial,White,1534,8,1542
381292,Chronic allergic conjunctivitis,ethnic,Hispanic or Latino,917,622,1539
201826,Type 2 diabetes mellitus,racial,Black or African American ,814,722,1536
4298854,HIV seropositivity,racial,White,178,1357,1535
198194,Female genital organ symptoms,ethnic,Hispanic or Latino,1533,1,1534
4103471,Observation of body mass index,racial,Other Race,809,724,1533
25297,Acute pharyngitis,racial,Unknown,1061,469,1530
317302,Coronary sinus rhythm disorder,ethnic,Hispanic or Latino,973,553,1526
443350,Lower urinary tract symptoms,racial,White,1,1524,1525
443865,Non-infective colitis,racial,White,783,737,1520
377889,Hearing loss,racial,White,760,752,1512
4298854,HIV seropositivity,ethnic,Hispanic or Latino,166,1336,1502
193253,Nephritis,ethnic,Hispanic or Latino,806,686,1492
4103471,Observation of body mass index,racial,Black or African American ,674,806,1480
199866,Acute gastritis,ethnic,Hispanic or Latino,1064,416,1480
442752,Myalgia,racial,White,1297,178,1475
376683,Non proliferative diabetic retinopathy,ethnic,Hispanic or Latino,844,630,1474
432870,Thrombocytopenia,ethnic,Hispanic or Latino,970,504,1474
197672,Urinary incontinence,racial,Unknown,1034,437,1471
78232,Shoulder joint pain,racial,Unknown,926,536,1462
198124,Disorder of kidney,ethnic,Hispanic or Latino,828,632,1460
257004,Acute exacerbation of chronic obstructive airways disease,ethnic,Hispanic or Latino,686,773,1459
196456,Cholecystolithiasis,ethnic,Hispanic or Latino,1127,332,1459
258780,Chronic obstructive bronchitis,racial,Unknown,883,571,1454
4086918,Viral screening,racial,Unknown,955,498,1453
141095,Acne,ethnic,Hispanic or Latino,811,641,1452
81611,Diverticular disease of colon,ethnic,Hispanic or Latino,1069,383,1452
440383,Depressive disorder,racial,Asian,925,523,1448
313236,Cough variant asthma,ethnic,Hispanic or Latino,751,694,1445
197684,Dysuria,ethnic,Not Hispanic or Latino,1021,421,1442
374924,Generalized convulsive epilepsy,ethnic,Hispanic or Latino,647,794,1441
198803,Nodular hyperplasia of prostate gland,racial,Asian,1,1438,1439
74132,Degeneration of lumbosacral intervertebral disc,ethnic,Hispanic or Latino,1093,344,1437
377861,Disorder of refraction AND/OR accommodation,racial,Unknown,923,512,1435
444246,Cirrhosis of liver not due to alcohol,ethnic,Hispanic or Latino,780,640,1420
75354,Osteochondropathy,ethnic,Hispanic or Latino,1330,89,1419
4161977,Patient with cardiac pacemaker,ethnic,Hispanic or Latino,777,641,1418
201254,Insulin dependent diabetes mellitus,racial,White,733,683,1416
374060,Acute ill-defined cerebrovascular disease,racial,Unknown,875,537,1412
133228,Dental caries,ethnic,Hispanic or Latino,804,602,1406
437643,Gait abnormality,racial,Unknown,660,746,1406
440360,Pure hyperglyceridemia,racial,Unknown,620,784,1404
134736,Backache,ethnic,Not Hispanic or Latino,814,587,1401
439141,Abnormal increase in weight,racial,Unknown,756,640,1396
78517,Arthralgia of multiple joints,ethnic,Hispanic or Latino,1104,290,1394
439727,HIV - Human immunodeficiency virus infection,racial,Black or African American ,394,997,1391
196991,Chronic renal disease,racial,White,661,724,1385
140648,Onychomycosis due to dermatophyte,racial,Unknown,839,535,1374
80809,Rheumatoid arthritis,racial,White,1208,165,1373
436230,Blood chemistry abnormal,ethnic,Hispanic or Latino,877,494,1371
4062637,TB - Tuberculosis screening,ethnic,Not Hispanic or Latino,704,660,1364
80824,Senile osteoporosis,racial,White,1337,26,1363
432284,Single major depressive episode,racial,Unknown,800,559,1359
321052,Peripheral vascular disease,racial,Unknown,652,705,1357
4064918,Diabetes mellitus screening,racial,Unknown,844,514,1358
197236,Uterine fibroid,ethnic,Hispanic or Latino,1346,0,1346
316822,Finding of heart murmur,ethnic,Hispanic or Latino,877,451,1328
372409,Sciatica neuralgia,racial,White,920,406,1326
260139,Acute bronchitis,racial,Unknown,902,421,1323
257012,Chronic rhinosinusitis,racial,White,826,494,1320
4100857,Pickwickian syndrome,ethnic,Hispanic or Latino,745,575,1320
315078,Palpitations,ethnic,Hispanic or Latino,1033,280,1313
321318,Angina,ethnic,Not Hispanic or Latino,1007,304,1311
312338,Benign hypertensive heart disease with congestive heart failure,racial,Unknown,576,734,1310
312648,Benign essential hypertension,racial,Other Race,812,497,1309
256451,Bronchitis,racial,White,773,535,1308
379784,Senile dementia with depression,ethnic,Hispanic or Latino,880,425,1305
437247,Anaemia of chronic disease,ethnic,Hispanic or Latino,740,559,1299
75617,Polyarticular osteoarthritis,racial,Asian,1052,247,1299
260123,Acute inflammation of sinus,ethnic,Not Hispanic or Latino,790,506,1296
434056,Late effects of cerebrovascular disease,racial,Unknown,485,802,1287
437382,Urine observation,ethnic,Hispanic or Latino,1042,242,1284
375806,Idiopathic peripheral neuropathy,racial,White,945,338,1283
4086918,Viral screening,ethnic,Not Hispanic or Latino,755,526,1281
381591,Cerebrovascular disease,racial,Unknown,583,692,1275
381591,Cerebrovascular disease,ethnic,Not Hispanic or Latino,568,707,1275
198995,Type 1 diabetes mellitus - poor control,ethnic,Not Hispanic or Latino,676,598,1274
377574,Presbycusis,ethnic,Hispanic or Latino,414,857,1271
440426,Vertigo as late effect of stroke,ethnic,Hispanic or Latino,820,452,1272
376065,Neurologic disorder associated with type II diabetes mellitus,racial,Asian,543,728,1271
376112,Diabetic polyneuropathy,racial,Unknown,843,425,1268
380094,Carpal tunnel syndrome,ethnic,Hispanic or Latino,1007,260,1267
441408,Vomiting,ethnic,Hispanic or Latino,705,556,1261
318800,GERD - Gastro-esophageal reflux disease,racial,Other Race,847,413,1260
433736,Obesity,racial,Black or African American ,920,334,1254
137682,Skin sensation disturbance,ethnic,Hispanic or Latino,860,393,1253
140821,Spasm,ethnic,Hispanic or Latino,700,546,1246
255848,Pneumonia,racial,White,601,644,1245
443783,Chronic disease,racial,White,740,499,1239
376707,Acute conjunctivitis,racial,White,640,598,1238
75650,Proteinuria,racial,White,572,662,1234
437038,Blood in urine,ethnic,Hispanic or Latino,732,502,1234
260427,Common cold,ethnic,Hispanic or Latino,680,553,1233
434056,Late effects of cerebrovascular disease,racial,White,514,718,1232
312648,Benign essential hypertension,racial,Black or African American ,819,407,1226
24660,Acute tonsillitis,ethnic,Hispanic or Latino,737,484,1221
443729,Peripheral circulatory disorder associated with type II diabetes mellitus,racial,White,825,395,1220
378253,HA - Headache,racial,Unknown,841,374,1215
443537,Deep venous thrombosis of lower extremity,ethnic,Hispanic or Latino,748,465,1213
254761,Cough,ethnic,Not Hispanic or Latino,697,506,1203
258780,Chronic obstructive bronchitis,ethnic,Not Hispanic or Latino,616,581,1197
140641,Verruca vulgaris,ethnic,Hispanic or Latino,592,604,1196
433440,Dysthymia,ethnic,Hispanic or Latino,827,358,1185
313217,Atrial fibrillation,ethnic,Not Hispanic or Latino,442,739,1181
138525,Pain in limb,racial,Unknown,773,407,1180
314754,Wheezing,ethnic,Hispanic or Latino,629,545,1174
80767,Breast irregular nodularity,racial,White,1133,40,1173
260125,Acute bronchiolitis,racial,White,554,617,1171
437541,Glaucoma,racial,White,766,404,1170
321052,Peripheral vascular disease,racial,White,655,513,1168
373995,Delirium,ethnic,Not Hispanic or Latino,849,317,1166
374022,Hemiplegia,racial,White,547,616,1163
318736,Migraine,racial,White,1026,136,1162
4093344,Prostate observation,racial,White,4,1158,1162
442067,Atopic dermatitis and related conditions,racial,White,590,565,1155
4228802,Mild recurrent major depression,ethnic,Hispanic or Latino,815,336,1151
312950,IgE-mediated allergic asthma,ethnic,Hispanic or Latino,767,382,1149
440321,Helicobacter-associated disease,ethnic,Hispanic or Latino,796,347,1143
260123,Acute inflammation of sinus,racial,Unknown,786,353,1139
198363,Candidiasis of vagina,ethnic,Hispanic or Latino,1135,0,1135
442604,Hypertensive heart disease,ethnic,Hispanic or Latino,591,541,1132
139099,Ingrowing nail,ethnic,Hispanic or Latino,653,476,1129
4064905,Venereal disease screening,racial,White,794,331,1125
443238,Diabetic - poor control,racial,Unknown,484,634,1118
255573,Chronic obstructive lung disease,racial,White,581,530,1111
201613,Chronic nonalcoholic liver disease,ethnic,Hispanic or Latino,756,352,1108
4171430,Screening for malignant neoplasm of rectum,ethnic,Hispanic or Latino,518,589,1107
373995,Delirium,racial,Unknown,468,635,1103
77074,Joint pain,racial,White,774,328,1102
440360,Pure hyperglyceridemia,ethnic,Not Hispanic or Latino,486,614,1100
198558,Nycturia,racial,Unknown,848,241,1089
375545,Lens opacity,racial,White,709,377,1086
319835,Congestive cardiac failure,ethnic,Not Hispanic or Latino,503,582,1085
437525,Overweight,racial,Other Race,581,502,1083
134460,Plantar fascial fibromatosis,ethnic,Hispanic or Latino,741,340,1081
373995,Delirium,ethnic,Hispanic or Latino,583,493,1076
443524,Mixed incontinence,ethnic,Hispanic or Latino,996,77,1073
442793,Diabetic complication,racial,White,592,479,1071
312934,Atherosclerosis of aorta,racial,Unknown,755,315,1070
436096,Chronic pain,ethnic,Hispanic or Latino,668,401,1069
444101,Hypertensive heart failure,racial,Unknown,657,411,1068
77354,Primary localised osteoarthrosis of lower leg,racial,White,798,269,1067
4114314,Screening for osteoporosis,ethnic,Hispanic or Latino,1028,37,1065
79106,Arthralgia of the pelvic region and thigh,racial,White,606,458,1064
141095,Acne,racial,White,598,464,1062
376382,Tension-type headache,ethnic,Hispanic or Latino,806,256,1062
198263,Right upper quadrant pain,ethnic,Hispanic or Latino,835,226,1061
317009,Hyperreactive airway disease,racial,Black or African American ,502,555,1057
374022,Hemiplegia,ethnic,Not Hispanic or Latino,515,540,1055
140673,Hypothyroid,racial,Asian,834,218,1052
28060,Strept throat,ethnic,Hispanic or Latino,581,471,1052
313236,Cough variant asthma,racial,White,571,481,1052
4133029,Primigravida,ethnic,Hispanic or Latino,1048,2,1050
194083,Vaginitis and vulvovaginitis,racial,Unknown,1047,0,1047
317576,Coronary arteriosclerosis,racial,Black or African American ,601,445,1046
4062484,Cervical neoplasia screening,racial,Unknown,1040,1,1041
439708,Disorders of initiating and maintaining sleep,racial,White,726,313,1039
313459,Sleep apnea,ethnic,Hispanic or Latino,437,601,1038
198194,Female genital organ symptoms,racial,White,1031,2,1033
440426,Vertigo as late effect of stroke,racial,Unknown,646,386,1032
40484513,Hemiplegia of nondominant side as late effect of cerebrovascular disease,ethnic,Hispanic or Latino,417,614,1031
437264,Tobacco dependence syndrome,racial,Unknown,373,656,1029
321318,Angina,racial,White,662,366,1028
77354,Primary localised osteoarthrosis of lower leg,racial,Unknown,793,233,1026
196991,Chronic renal disease,ethnic,Not Hispanic or Latino,543,479,1022
79908,Muscle strength reduced,ethnic,Hispanic or Latino,473,546,1019
137497,Dermatophytosis of the body,ethnic,Hispanic or Latino,593,425,1018
31317,Can't get food down,ethnic,Hispanic or Latino,543,470,1013
4245252,Raised prostate specific antigen,ethnic,Hispanic or Latino,1,1007,1008
443350,Lower urinary tract symptoms,racial,Unknown,0,1008,1008
440383,Depressive disorder,racial,Other Race,681,326,1007
436659,Iron deficiency anaemia,racial,Unknown,716,290,1006
444239,Postprocedural state finding,ethnic,Hispanic or Latino,634,370,1004
197913,Disorder of function of stomach,racial,Unknown,748,256,1004
381859,Infective OE,racial,White,611,392,1003
255841,Chronic bronchitis,ethnic,Hispanic or Latino,671,330,1001
443597,Chronic kidney disease stage 3,ethnic,Not Hispanic or Latino,520,478,998
4096215,"Hyperlipidemia, group A",racial,Asian,616,379,995
321596,Peripheral venous insufficiency,ethnic,Hispanic or Latino,690,304,994
78508,Arthralgia of the ankle and/or foot,ethnic,Hispanic or Latino,745,248,993
434169,Abnormal findings on diagnostic imaging of breast,racial,White,989,4,993
4077577,Moderate recurrent major depression,racial,Unknown,580,412,992
378427,Tear film insufficiency,ethnic,Hispanic or Latino,751,238,989
377889,Hearing loss,racial,Unknown,536,451,987
375545,Lens opacity,racial,Unknown,704,284,988
197381,Epigastric pain,racial,White,727,260,987
255573,Chronic obstructive lung disease,ethnic,Not Hispanic or Latino,414,571,985
260139,Acute bronchitis,ethnic,Not Hispanic or Latino,603,379,982
439795,Minimal cognitive impairment,ethnic,Hispanic or Latino,349,632,981
439727,HIV - Human immunodeficiency virus infection,racial,Unknown,155,820,975
375827,Acute non-suppurative otitis media - serous,ethnic,Hispanic or Latino,442,528,970
197913,Disorder of function of stomach,racial,White,632,335,967
137809,Primary malignant neoplasm of female breast,ethnic,Hispanic or Latino,961,5,966
435928,Abnormal decrease in weight,ethnic,Hispanic or Latino,551,414,965
376065,Neurologic disorder associated with type II diabetes mellitus,racial,Other Race,709,256,965
197032,Hyperplasia of prostate,ethnic,Hispanic or Latino,1,962,963
201620,Calculus of kidney,ethnic,Hispanic or Latino,661,298,959
197610,Ovarian cyst,ethnic,Hispanic or Latino,958,0,958
443431,Disorder of menstruation,ethnic,Hispanic or Latino,953,0,953
79106,Arthralgia of the pelvic region and thigh,racial,Unknown,622,325,947
194081,Acute cystitis,ethnic,Hispanic or Latino,853,92,945
196991,Chronic renal disease,racial,Unknown,527,417,944
195562,Hemorrhoids,racial,White,511,432,943
74132,Degeneration of lumbosacral intervertebral disc,racial,Unknown,827,115,942
317009,Hyperreactive airway disease,racial,Asian,583,359,942
4302252,High risk pregnancy care,racial,White,938,1,939
196168,Irregular menstrual bleeding,racial,White,937,2,939
379019,Inflammation of conjunctiva,racial,White,489,445,934
259055,Extrinsic asthma with asthma attack,ethnic,Hispanic or Latino,479,455,934
133436,Thyrotoxic crisis,ethnic,Hispanic or Latino,725,203,928
260427,Common cold,racial,White,484,445,929
40484522,Hemiplegia of dominant side as late effect of cerebrovascular disease,ethnic,Hispanic or Latino,379,547,926
439700,Inhibited sexual desire,ethnic,Hispanic or Latino,1,925,926
140641,Verruca vulgaris,racial,White,421,504,925
259848,Chronic rhinitis,ethnic,Hispanic or Latino,524,400,924
140673,Hypothyroid,racial,Other Race,706,217,923
25297,Acute pharyngitis,ethnic,Not Hispanic or Latino,534,389,923
438557,Abnormal glucose level,racial,Unknown,551,368,919
132740,Positive skin test reaction,racial,White,572,343,915
24134,Nonspecific pain in the neck region,racial,White,628,286,914
436583,[X]Falls,ethnic,Hispanic or Latino,629,283,912
4064918,Diabetes mellitus screening,ethnic,Not Hispanic or Latino,470,442,912
313878,Respiratory symptoms,racial,Unknown,578,333,911
200843,Observation of frequency of urination,ethnic,Hispanic or Latino,596,312,908
195007,Female stress incontinence,ethnic,Hispanic or Latino,905,0,905
381270,Parkinson's disease,racial,Unknown,484,421,905
317576,Coronary arteriosclerosis,racial,Other Race,619,284,903
434613,Generalized anxiety disorder,racial,Unknown,659,241,900
436373,DSD - Developmental speech disorder,ethnic,Hispanic or Latino,239,658,897
376406,"Impairment level: blindness, one eye - low vision other eye",ethnic,Hispanic or Latino,506,390,896
201254,Insulin dependent diabetes mellitus,racial,Unknown,574,322,896
133141,Tinea pedis,racial,Unknown,470,421,891
374034,Visual disturbance,ethnic,Hispanic or Latino,537,352,889
197607,Polymenorrhagia,ethnic,Hispanic or Latino,887,0,887
138525,Pain in limb,ethnic,Not Hispanic or Latino,576,310,886
197236,Uterine fibroid,racial,White,884,2,886
76161,Impotence of organic origin,ethnic,Hispanic or Latino,1,884,885
27674,N&V - Nausea and vomiting,ethnic,Hispanic or Latino,616,269,885
380378,Epilepsy,ethnic,Not Hispanic or Latino,424,461,885
436238,Elevated levels of transaminase and lactic acid dehydrogenase,racial,Unknown,575,308,883
4100857,Pickwickian syndrome,racial,White,486,398,884
201069,"Peptic ulcer without hemorrhage, without perforation AND without obstruction",ethnic,Hispanic or Latino,417,467,884
443783,Chronic disease,racial,Unknown,463,419,882
198964,Chronic type C viral hepatitis,ethnic,Not Hispanic or Latino,343,534,877
436230,Blood chemistry abnormal,racial,White,530,346,876
376979,Diabetic cataract,ethnic,Hispanic or Latino,636,238,874
437643,Gait abnormality,racial,White,542,332,874
24660,Acute tonsillitis,racial,White,513,360,873
78517,Arthralgia of multiple joints,racial,White,676,196,872
432285,Recurrent major depressive episodes,ethnic,Not Hispanic or Latino,541,330,871
192279,Diabetic nephropathy,ethnic,Not Hispanic or Latino,376,493,869
193253,Nephritis,racial,White,418,450,868
132740,Positive skin test reaction,racial,Unknown,590,271,861
374060,Acute ill-defined cerebrovascular disease,racial,White,202,657,859
373503,Intermittent cerebral ischaemia,ethnic,Hispanic or Latino,469,389,858
439694,Hypertensive heart and renal disease with both (congestive) heart failure and renal failure,ethnic,Hispanic or Latino,648,207,855
196456,Cholecystolithiasis,racial,White,620,234,854
375806,Idiopathic peripheral neuropathy,racial,Unknown,443,408,851
380733,Otalgia,ethnic,Hispanic or Latino,622,227,849
439777,Anemia,racial,Asian,646,202,848
75614,Acrodermatitis continua,ethnic,Hispanic or Latino,308,539,847
436972,Glaucoma associated with systemic syndromes,ethnic,Hispanic or Latino,498,348,846
441408,Vomiting,racial,White,467,379,846
4064375,Iron deficiency screening,racial,Unknown,503,341,844
440674,Gout,racial,White,194,649,843
437525,Overweight,racial,Asian,433,408,841
372328,Otitis media,racial,Unknown,476,364,840
26662,Testicular hypofunction,ethnic,Hispanic or Latino,0,840,840
320536,Abnormal EKG finding,ethnic,Hispanic or Latino,459,379,838
374924,Generalized convulsive epilepsy,racial,White,371,464,835
442588,OSA - Obstructive sleep apnoea,ethnic,Hispanic or Latino,388,447,835
313459,Sleep apnea,racial,White,347,487,834
438878,Abnormal results of liver function studies,ethnic,Hispanic or Latino,563,269,832
312437,Dyspnea,ethnic,Hispanic or Latino,544,287,831
74719,Foot ulcer,ethnic,Hispanic or Latino,311,518,829
199866,Acute gastritis,racial,White,518,311,829
438409,Attention deficit hyperactivity disorder,ethnic,Hispanic or Latino,110,711,821
193326,Urge incontinence of urine,ethnic,Hispanic or Latino,639,177,816
75860,Costiveness,racial,Asian,551,263,814
436665,Manic-depressive psychosis,ethnic,Hispanic or Latino,618,196,814
255573,Chronic obstructive lung disease,racial,Unknown,405,407,812
258780,Chronic obstructive bronchitis,racial,Asian,330,481,811
375791,Uncomplicated senile dementia,racial,Unknown,583,227,810
443537,Deep venous thrombosis of lower extremity,racial,White,493,316,809
312327,Acute myocardial infarction,ethnic,Hispanic or Latino,631,177,808
316822,Finding of heart murmur,racial,White,502,304,806
432284,Single major depressive episode,ethnic,Not Hispanic or Latino,510,292,802
440674,Gout,ethnic,Not Hispanic or Latino,265,535,800
315078,Palpitations,racial,White,598,202,800
438557,Abnormal glucose level,ethnic,Not Hispanic or Latino,447,352,799
314666,Healed coronary,ethnic,Hispanic or Latino,390,408,798
77670,Chest pain,ethnic,Not Hispanic or Latino,430,367,797
26662,Testicular hypofunction,racial,White,0,797,797
141693,Elevated blood-pressure reading without diagnosis of hypertension,racial,Unknown,425,372,797
200219,Abdominal pain,ethnic,Not Hispanic or Latino,536,259,795
197672,Urinary incontinence,ethnic,Not Hispanic or Latino,707,85,792
439926,Malaise and fatigue,racial,Unknown,520,272,792
434610,Hyperkalemia,ethnic,Hispanic or Latino,416,376,792
4171430,Screening for malignant neoplasm of rectum,racial,White,388,404,792
312349,Venous varices,ethnic,Hispanic or Latino,686,104,790
4147961,Screening for malignant neoplasm of breast,racial,Unknown,788,1,789
374060,Acute ill-defined cerebrovascular disease,ethnic,Not Hispanic or Latino,324,463,787
4060985,BMI 30+ - obesity,racial,Other Race,508,277,785
381292,Chronic allergic conjunctivitis,racial,White,432,347,779
437038,Blood in urine,racial,White,452,327,779
78234,Arthralgia of the hand,ethnic,Hispanic or Latino,547,231,778
437382,Urine observation,racial,White,623,154,777
436096,Chronic pain,racial,White,434,343,777
4049623,"Moderate major depression, single episode",ethnic,Hispanic or Latino,553,224,777
433316,Giddiness,ethnic,Not Hispanic or Latino,554,223,777
321052,Peripheral vascular disease,ethnic,Not Hispanic or Latino,175,600,775
134461,Tietze disease,ethnic,Hispanic or Latino,541,231,772
377574,Presbycusis,racial,Unknown,256,515,771
200962,Primary malignant neoplasm of prostate,ethnic,Hispanic or Latino,0,770,770
78472,Microscopic haematuria,ethnic,Hispanic or Latino,441,329,770
313217,Atrial fibrillation,racial,Asian,373,396,769
192278,Type II diabetes mellitus - poor control,racial,Black or African American ,511,257,768
28060,Strept throat,racial,White,407,359,766
380378,Epilepsy,racial,White,314,452,766
257628,Systemic lupus erythematosus,ethnic,Hispanic or Latino,690,74,764
198363,Candidiasis of vagina,racial,White,760,4,764
441542,Anxiety,racial,Other Race,675,88,763
435171,Allergic state,ethnic,Hispanic or Latino,486,274,760
200174,Disease of skin AND/OR subcutaneous tissue,ethnic,Hispanic or Latino,501,259,760
81151,Sprain of ankle joint,ethnic,Hispanic or Latino,485,274,759
133727,Thyrotoxicosis without goiter OR other cause,ethnic,Hispanic or Latino,671,88,759
195306,Gastroduodenitis,ethnic,Not Hispanic or Latino,506,251,757
439147,Amnesia,racial,White,407,350,757
74464,Idiopathic scoliosis AND/OR kyphoscoliosis,ethnic,Hispanic or Latino,508,248,756
380096,Proliferative diabetic retinopathy,ethnic,Hispanic or Latino,413,343,756
376085,Uncomplicated presenile dementia,ethnic,Hispanic or Latino,670,86,756
314754,Wheezing,racial,White,416,339,755
139900,Urticaria,ethnic,Hispanic or Latino,472,283,755
140214,Eruption of skin,racial,Unknown,477,275,752
73553,Arthropathy,ethnic,Not Hispanic or Latino,494,258,752
443570,Cervicovaginal cytology: Low grade squamous intraepithelial lesion,ethnic,Hispanic or Latino,745,7,752
379784,Senile dementia with depression,racial,Unknown,541,211,752
438409,Attention deficit hyperactivity disorder,racial,White,133,619,752
4147961,Screening for malignant neoplasm of breast,ethnic,Not Hispanic or Latino,743,6,749
139099,Ingrowing nail,racial,White,421,328,749
4308509,Impaired fasting glycaemia,racial,Unknown,390,350,740
196991,Chronic renal disease,racial,Asian,455,285,740
134438,CD - Contact dermatitis,ethnic,Not Hispanic or Latino,377,361,738
375827,Acute non-suppurative otitis media - serous,racial,White,358,379,737
381591,Cerebrovascular disease,racial,White,365,370,735
318556,Nosebleed,ethnic,Hispanic or Latino,324,410,734
316999,Cardiac arrhythmia,racial,Unknown,458,275,733
378419,AD - Alzheimer's disease,ethnic,Not Hispanic or Latino,649,85,734
81878,Benign paroxysmal positional vertigo,ethnic,Hispanic or Latino,544,189,733
192667,Atrophic gastritis,racial,Unknown,556,177,733
257581,Exacerbation of asthma,ethnic,Not Hispanic or Latino,391,341,732
197988,General abdominal pain-symptom,ethnic,Hispanic or Latino,546,181,727
372328,Otitis media,ethnic,Not Hispanic or Latino,368,356,724
81902,Urinary tract infectious disease,ethnic,Not Hispanic or Latino,632,92,724
134438,CD - Contact dermatitis,racial,Unknown,461,262,723
374375,Impacted cerumen,racial,Unknown,454,269,723
4114314,Screening for osteoporosis,racial,White,697,22,719
434170,Atypical squamous cells of undetermined significance on cervical Papanicolaou smear,ethnic,Hispanic or Latino,711,8,719
380094,Carpal tunnel syndrome,racial,White,569,149,718
259055,Extrinsic asthma with asthma attack,racial,White,334,383,717
372409,Sciatica neuralgia,racial,Unknown,464,253,717
4133029,Primigravida,racial,White,701,14,715
4079876,Familial combined hyperlipidemia,racial,Other Race,397,317,714
4195572,"Mild major depression, single episode",ethnic,Hispanic or Latino,412,301,713
30437,Gastroesophageal reflux disease with esophagitis,ethnic,Hispanic or Latino,491,220,711
4062484,Cervical neoplasia screening,ethnic,Not Hispanic or Latino,700,10,710
438878,Abnormal results of liver function studies,racial,White,451,256,707
4161977,Patient with cardiac pacemaker,racial,Unknown,263,443,706
4311591,Cramp in limb,ethnic,Hispanic or Latino,420,286,706
198964,Chronic type C viral hepatitis,racial,Unknown,247,459,706
377091,Fits - convulsions,racial,White,299,404,703
256440,Disorder of paranasal sinuses,ethnic,Hispanic or Latino,374,329,703
317009,Hyperreactive airway disease,racial,Other Race,444,254,698
314054,Aortic valve disease,ethnic,Hispanic or Latino,343,356,699
201603,Disease of teeth AND/OR supporting structures,ethnic,Hispanic or Latino,403,295,698
432597,Schizoaffective schizophrenia,ethnic,Hispanic or Latino,482,214,696
137682,Skin sensation disturbance,racial,White,437,259,696
78232,Shoulder joint pain,ethnic,Not Hispanic or Latino,400,295,695
373995,Delirium,racial,Asian,563,131,694
443431,Disorder of menstruation,racial,White,692,1,693
4077577,Moderate recurrent major depression,racial,White,326,365,691
436070,Vitamin D deficiency,ethnic,Hispanic or Latino,460,230,690
134460,Plantar fascial fibromatosis,racial,White,475,212,687
378253,HA - Headache,ethnic,Not Hispanic or Latino,488,198,686
321318,Angina,racial,Asian,574,112,686
255841,Chronic bronchitis,racial,Unknown,476,208,684
193809,Melena due to gastrointestinal hemorrhage,ethnic,Hispanic or Latino,409,274,683
135360,Fainting,ethnic,Hispanic or Latino,481,201,682
312950,IgE-mediated allergic asthma,racial,Unknown,491,190,681
376085,Uncomplicated presenile dementia,racial,Unknown,445,234,679
73819,Painful breasts,ethnic,Hispanic or Latino,663,16,679
4064377,Depression screening,racial,Other Race,394,284,678
197928,Menstruation absent,racial,Unknown,677,1,678
137497,Dermatophytosis of the body,racial,White,375,303,678
197610,Ovarian cyst,racial,White,677,0,677
80180,Osteoarthritis,racial,Black or African American ,452,223,675
378427,Tear film insufficiency,racial,Unknown,550,124,674
444202,Abscess,racial,Unknown,410,262,672
198558,Nycturia,racial,White,487,185,672
442604,Hypertensive heart disease,racial,Unknown,294,378,672
441542,Anxiety,racial,Asian,322,350,672
193782,End stage renal disease,racial,White,288,380,668
80809,Rheumatoid arthritis,ethnic,Not Hispanic or Latino,613,54,667
194133,Low back pain,racial,Asian,332,335,667
200164,Urine-induced contact dermatitis,ethnic,Hispanic or Latino,328,335,663
75354,Osteochondropathy,racial,White,622,40,662
195321,Postmenopausal bleeding,ethnic,Hispanic or Latino,662,0,662
373475,Impairment level: one eye: moderate impairment: other eye: not specified,ethnic,Hispanic or Latino,353,309,662
198263,Right upper quadrant pain,racial,White,511,149,660
440321,Helicobacter-associated disease,racial,White,432,227,659
380378,Epilepsy,racial,Unknown,153,506,659
23325,Heartburn,ethnic,Hispanic or Latino,472,186,658
441274,Developmental expressive language disorder,ethnic,Hispanic or Latino,107,550,657
373475,Impairment level: one eye: moderate impairment: other eye: not specified,racial,Unknown,396,260,656
375806,Idiopathic peripheral neuropathy,ethnic,Not Hispanic or Latino,207,447,654
140821,Spasm,racial,White,464,188,652
259848,Chronic rhinitis,racial,White,364,289,653
201613,Chronic nonalcoholic liver disease,racial,White,433,217,650
196523,Diarrhea,racial,Unknown,428,215,643
436659,Iron deficiency anaemia,ethnic,Not Hispanic or Latino,420,223,643
437247,Anaemia of chronic disease,racial,White,377,265,642
141693,Elevated blood-pressure reading without diagnosis of hypertension,ethnic,Not Hispanic or Latino,338,302,640
377290,Legal blindness USA,ethnic,Hispanic or Latino,302,338,640
440704,Chronic pain syndrome,ethnic,Hispanic or Latino,455,184,639
257004,Acute exacerbation of chronic obstructive airways disease,racial,Unknown,290,350,640
4245252,Raised prostate specific antigen,racial,White,1,638,639
81112,Arthralgia of the lower leg,racial,Asian,465,170,635
440674,Gout,racial,Unknown,130,503,633
440216,Abnormal glucose tolerance test,ethnic,Hispanic or Latino,341,292,633
4228802,Mild recurrent major depression,racial,Unknown,466,167,633
439708,Disorders of initiating and maintaining sleep,racial,Unknown,443,188,631
196341,Dermatophytosis of the perianal area,ethnic,Hispanic or Latino,182,449,631
377575,Tinnitus,ethnic,Hispanic or Latino,439,190,629
437092,Physiological development failure,ethnic,Hispanic or Latino,203,424,627
193782,End stage renal disease,racial,Unknown,336,291,627
200843,Observation of frequency of urination,racial,White,412,215,627
436073,Psychotic disorder,ethnic,Hispanic or Latino,510,116,626
75650,Proteinuria,racial,Unknown,317,308,625
197925,Haemorrhage of rectum and anus,ethnic,Hispanic or Latino,324,299,623
4079876,Familial combined hyperlipidemia,racial,Asian,355,267,622
439082,Menopausal syndrome,ethnic,Hispanic or Latino,620,1,621
254387,Upper respiratory tract hypersensitivity reaction,ethnic,Hispanic or Latino,328,291,619
432870,Thrombocytopenia,racial,Unknown,411,208,619
257581,Exacerbation of asthma,racial,Unknown,317,300,617
433595,Interstitial edema,ethnic,Not Hispanic or Latino,353,263,616
74132,Degeneration of lumbosacral intervertebral disc,racial,White,507,109,616
78508,Arthralgia of the ankle and/or foot,racial,White,410,205,615
436665,Manic-depressive psychosis,racial,White,395,218,613
381270,Parkinson's disease,racial,White,372,241,613
376382,Tension-type headache,racial,White,448,164,612
439700,Inhibited sexual desire,racial,White,1,611,612
201820,Diabetes mellitus,ethnic,Hispanic or Latino,321,291,612
374028,AAMD - Age related macular degeneration,ethnic,Hispanic or Latino,394,217,611
436373,DSD - Developmental speech disorder,racial,White,169,442,611
78835,Palindromic rheumatism of the lower leg,ethnic,Hispanic or Latino,393,218,611
194081,Acute cystitis,racial,White,533,77,610
316999,Cardiac arrhythmia,racial,White,413,196,609
201927,Cellulitis and abscess of leg,ethnic,Hispanic or Latino,269,338,607
381591,Cerebrovascular disease,racial,Asian,374,232,606
133228,Dental caries,racial,White,322,283,605
4263370,R.I.N.D. syndrome,ethnic,Hispanic or Latino,334,271,605
4064375,Iron deficiency screening,ethnic,Not Hispanic or Latino,317,286,603
432526,Needs influenza immunisation,racial,Other Race,321,282,603
133436,Thyrotoxic crisis,racial,White,451,151,602
31967,Nausea,ethnic,Hispanic or Latino,459,142,601
376406,"Impairment level: blindness, one eye - low vision other eye",racial,Unknown,446,155,601
4092896,Stool contents abnormal,ethnic,Hispanic or Latino,372,229,601
435783,Schizophrenia,ethnic,Hispanic or Latino,284,317,601
24134,Nonspecific pain in the neck region,racial,Unknown,435,163,598
256448,Chronic asthmatic bronchitis,ethnic,Hispanic or Latino,438,160,598
321882,Generalised atherosclerosis,ethnic,Hispanic or Latino,302,295,597
200174,Disease of skin AND/OR subcutaneous tissue,racial,White,362,234,596
440704,Chronic pain syndrome,ethnic,Not Hispanic or Latino,219,376,595
140214,Eruption of skin,ethnic,Not Hispanic or Latino,314,280,594
440329,Herpes zoster without complication,ethnic,Hispanic or Latino,362,229,591
201620,Calculus of kidney,racial,White,356,233,589
76161,Impotence of organic origin,racial,White,1,584,585
134736,Backache,racial,Asian,325,259,584
438120,Opioid dependence,ethnic,Hispanic or Latino,278,304,582
437986,FTT - Failure to thrive,ethnic,Hispanic or Latino,299,282,581
4194895,Screening for disorder,ethnic,Hispanic or Latino,285,296,581
374924,Generalized convulsive epilepsy,racial,Unknown,237,343,580
318800,GERD - Gastro-esophageal reflux disease,racial,Black or African American ,305,271,576
197928,Menstruation absent,ethnic,Not Hispanic or Latino,525,50,575
377254,"Multi-infarct dementia, uncomplicated",ethnic,Hispanic or Latino,437,138,575
443257,Swellings and lumps,ethnic,Hispanic or Latino,382,193,575
374923,Bell palsy,ethnic,Hispanic or Latino,242,331,573
78516,Arthralgia of the upper arm,ethnic,Hispanic or Latino,326,248,574
77074,Joint pain,racial,Unknown,433,140,573
312338,Benign hypertensive heart disease with congestive heart failure,racial,White,129,443,572
372634,Nonphysiologic vision loss,ethnic,Hispanic or Latino,311,260,571
317302,Coronary sinus rhythm disorder,racial,Unknown,284,287,571
432869,Hemorrhagic disorder due to circulating anticoagulants,ethnic,Hispanic or Latino,268,303,571
444246,Cirrhosis of liver not due to alcohol,racial,White,272,293,565
257004,Acute exacerbation of chronic obstructive airways disease,racial,White,285,280,565
40479192,Chronic systolic heart failure,ethnic,Hispanic or Latino,444,121,565
439926,Malaise and fatigue,ethnic,Not Hispanic or Latino,344,220,564
437041,Mother not delivered,racial,Unknown,565,0,565
434902,Autistic disorder of childhood onset,ethnic,Hispanic or Latino,83,482,565
437525,Overweight,racial,Black or African American ,247,317,564
75860,Costiveness,racial,Other Race,391,172,563
442588,OSA - Obstructive sleep apnoea,racial,White,260,302,562
261889,Simple chronic bronchitis,ethnic,Hispanic or Latino,397,166,563
312327,Acute myocardial infarction,racial,Unknown,452,109,561
376112,Diabetic polyneuropathy,ethnic,Not Hispanic or Latino,373,187,560
432870,Thrombocytopenia,racial,White,305,255,560
27674,N&V - Nausea and vomiting,racial,White,370,188,558
197607,Polymenorrhagia,racial,White,558,0,558
442985,Male,ethnic,Hispanic or Latino,1,557,558
192667,Atrophic gastritis,racial,White,392,165,557
201820,Diabetes mellitus,racial,White,283,274,557
4113027,Dietary intake observations,ethnic,Hispanic or Latino,294,263,557
320536,Abnormal EKG finding,racial,White,308,248,556
443801,Exercise-induced asthma,ethnic,Hispanic or Latino,301,254,555
73291,Palindromic rheumatism of the ankle and/or foot,ethnic,Hispanic or Latino,365,188,553
75614,Acrodermatitis continua,racial,White,250,303,553
438332,Disease of possible viral origin,racial,Unknown,245,307,552
378419,AD - Alzheimer's disease,racial,White,425,127,552
194083,Vaginitis and vulvovaginitis,ethnic,Not Hispanic or Latino,547,5,552
257012,Chronic rhinosinusitis,ethnic,Not Hispanic or Latino,376,175,551
375791,Uncomplicated senile dementia,racial,White,274,276,550
4064377,Depression screening,racial,Asian,310,240,550
74464,Idiopathic scoliosis AND/OR kyphoscoliosis,racial,White,373,176,549
442256,Disorder of bursae of shoulder region,ethnic,Hispanic or Latino,415,134,549
312950,IgE-mediated allergic asthma,racial,White,377,172,549
195083,Left lower quadrant pain,ethnic,Hispanic or Latino,416,131,547
198678,Intestinal infectious disease,ethnic,Hispanic or Latino,278,268,546
79908,Muscle strength reduced,racial,Unknown,238,308,546
381591,Cerebrovascular disease,racial,Black or African American ,223,322,545
76786,Derangement of knee,ethnic,Hispanic or Latino,301,244,545
433440,Dysthymia,racial,Unknown,410,134,544
433069,Open wound of external genital organs with complication,ethnic,Hispanic or Latino,265,278,543
80180,Osteoarthritis,racial,Other Race,393,149,542
81611,Diverticular disease of colon,racial,White,379,161,540
439125,T21 - Trisomy 21,ethnic,Hispanic or Latino,192,348,540
381295,Age-related cataract,racial,Unknown,308,232,540
432967,Anemia during pregnancy - baby not yet delivered,ethnic,Hispanic or Latino,536,0,536
443767,Diabetic oculopathy,ethnic,Not Hispanic or Latino,370,164,534
380733,Otalgia,racial,White,372,159,531
198124,Disorder of kidney,racial,Unknown,281,250,531
317898,Malignant essential hypertension,ethnic,Hispanic or Latino,420,111,531
194696,Menorrhalgia,ethnic,Hispanic or Latino,530,0,530
81611,Diverticular disease of colon,racial,Unknown,370,160,530
30234,Cervical sprain,ethnic,Hispanic or Latino,357,172,529
434056,Late effects of cerebrovascular disease,ethnic,Not Hispanic or Latino,191,336,527
376229,Abnormal involuntary movement,ethnic,Hispanic or Latino,356,171,527
80189,Displacement of lumbar intervertebral disc without myelopathy,ethnic,Hispanic or Latino,350,176,526
438332,Disease of possible viral origin,ethnic,Not Hispanic or Latino,243,283,526
197032,Hyperplasia of prostate,racial,White,1,525,526
376683,Non proliferative diabetic retinopathy,racial,Unknown,337,188,525
435511,Hypercalcemia,ethnic,Hispanic or Latino,413,112,525
439777,Anemia,racial,Other Race,391,132,523
254387,Upper respiratory tract hypersensitivity reaction,racial,White,267,255,522
443524,Mixed incontinence,racial,Unknown,459,62,521
377889,Hearing loss,ethnic,Not Hispanic or Latino,280,240,520
374375,Impacted cerumen,ethnic,Not Hispanic or Latino,290,229,519
139900,Urticaria,racial,White,319,200,519
433736,Obesity,racial,Asian,274,244,518
193251,Umbilical hernia without obstruction AND without gangrene,ethnic,Hispanic or Latino,310,208,518
257628,Systemic lupus erythematosus,racial,White,500,17,517
378419,AD - Alzheimer's disease,racial,Asian,436,80,516
40484513,Hemiplegia of nondominant side as late effect of cerebrovascular disease,racial,Unknown,221,295,516
434170,Atypical squamous cells of undetermined significance on cervical Papanicolaou smear,racial,White,505,11,516
136788,Spinal stenosis of lumbar region,ethnic,Hispanic or Latino,370,146,516
374366,Sensorineural hearing loss,racial,White,452,63,515
376683,Non proliferative diabetic retinopathy,racial,White,258,257,515
314658,Cardiomegaly,ethnic,Not Hispanic or Latino,490,25,515
376065,Neurologic disorder associated with type II diabetes mellitus,racial,Black or African American ,425,89,514
312922,Coronary bypass graft observation,ethnic,Hispanic or Latino,184,329,513
133228,Dental caries,racial,Unknown,321,193,514
374888,Dementia associated with another disease,racial,White,434,79,513
76194,Osteoarthrosis involving multiple sites but not designated as generalized,ethnic,Hispanic or Latino,325,188,513
375281,Acute suppurative otitis media - tympanic membrane intact,racial,Unknown,257,254,511
444246,Cirrhosis of liver not due to alcohol,racial,Unknown,283,228,511
435220,Severe recurrent major depression without psychotic features,ethnic,Hispanic or Latino,287,224,511
312664,Influenza with respiratory manifestation other than pneumonia,ethnic,Hispanic or Latino,293,217,510
199866,Acute gastritis,racial,Unknown,434,77,511
199839,External haemorrhoids without complication,ethnic,Hispanic or Latino,337,173,510
381295,Age-related cataract,ethnic,Hispanic or Latino,412,98,510
4090651,Dialysis observation,ethnic,Hispanic or Latino,213,294,507
377888,CHL - Conductive hearing loss,ethnic,Hispanic or Latino,199,308,507
81151,Sprain of ankle joint,racial,White,314,193,507
442793,Diabetic complication,racial,Unknown,275,230,505
137063,Corns and callus,ethnic,Hispanic or Latino,316,188,504
442752,Myalgia,ethnic,Not Hispanic or Latino,357,146,503
198124,Disorder of kidney,racial,White,269,233,502
193326,Urge incontinence of urine,racial,White,356,146,502
379805,Myopia,ethnic,Hispanic or Latino,298,205,503
443732,Disorder associated with type II diabetes melliltus,ethnic,Hispanic or Latino,317,185,502
317002,Hypopiesis,ethnic,Hispanic or Latino,298,203,501
374034,Visual disturbance,racial,White,301,198,499
432526,Needs influenza immunisation,racial,Asian,267,232,499
436096,Chronic pain,ethnic,Not Hispanic or Latino,226,272,498
443454,Cerebral infarction,ethnic,Hispanic or Latino,209,289,498
4051114,FH: Diabetes mellitus,ethnic,Hispanic or Latino,309,187,496
316999,Cardiac arrhythmia,ethnic,Not Hispanic or Latino,248,247,495
443782,Tremor,ethnic,Hispanic or Latino,82,412,494
443537,Deep venous thrombosis of lower extremity,ethnic,Not Hispanic or Latino,400,92,492
434610,Hyperkalemia,racial,White,250,242,492
4272867,General well-being finding,ethnic,Hispanic or Latino,235,257,492
444100,Mood disorder,ethnic,Hispanic or Latino,287,205,492
40484522,Hemiplegia of dominant side as late effect of cerebrovascular disease,racial,Unknown,162,330,492
439082,Menopausal syndrome,racial,White,491,1,492
437643,Gait abnormality,ethnic,Not Hispanic or Latino,307,184,491
24134,Nonspecific pain in the neck region,ethnic,Not Hispanic or Latino,324,167,491
256440,Disorder of paranasal sinuses,racial,White,263,227,490
441274,Developmental expressive language disorder,racial,Unknown,2,488,490
4165091,Lack of exercise,ethnic,Hispanic or Latino,258,232,490
4175226,Screening for malignant neoplasm of colon,racial,Other Race,290,199,489
315085,Enlargement of lymph nodes,ethnic,Hispanic or Latino,334,154,488
444239,Postprocedural state finding,racial,White,322,166,488
437247,Anaemia of chronic disease,racial,Unknown,272,215,487
134461,Tietze disease,racial,White,332,155,487
4311591,Cramp in limb,racial,Unknown,246,239,485
437541,Glaucoma,ethnic,Not Hispanic or Latino,295,190,485
193322,Right lower quadrant pain,ethnic,Hispanic or Latino,376,108,484
23325,Heartburn,racial,White,326,157,483
135033,Hair and hair follicle diseases,ethnic,Hispanic or Latino,265,217,482
4161977,Patient with cardiac pacemaker,racial,White,314,168,482
78472,Microscopic haematuria,racial,White,278,205,483
196523,Diarrhea,ethnic,Not Hispanic or Latino,226,257,483
321588,Heart disease,ethnic,Hispanic or Latino,222,259,481
437092,Physiological development failure,racial,White,155,326,481
435613,Cellulitis,ethnic,Hispanic or Latino,281,199,480
257007,Allergic rhinitis,racial,Asian,284,194,478
434613,Generalized anxiety disorder,racial,White,334,144,478
381292,Chronic allergic conjunctivitis,racial,Unknown,339,139,478
137809,Primary malignant neoplasm of female breast,racial,Unknown,475,3,478
317309,Peripheral arterial occlusive disease,ethnic,Hispanic or Latino,306,171,477
443783,Chronic disease,ethnic,Not Hispanic or Latino,263,214,477
81112,Arthralgia of the lower leg,racial,Black or African American ,452,24,476
433440,Dysthymia,racial,White,227,250,477
312648,Benign essential hypertension,racial,Filipino,314,161,475
133729,Hyperparathyroidism,ethnic,Hispanic or Latino,400,76,476
137809,Primary malignant neoplasm of female breast,racial,White,473,2,475
377091,Fits - convulsions,racial,Unknown,194,279,473
134118,Atrophic condition of skin,ethnic,Hispanic or Latino,262,210,472
139057,Disease of oral soft tissues,ethnic,Hispanic or Latino,324,148,472
436682,Moderate mental handicap,ethnic,Hispanic or Latino,135,335,470
442985,Male,racial,Unknown,1,469,470
195771,Secondary diabetes mellitus,ethnic,Hispanic or Latino,333,136,469
312437,Dyspnea,racial,White,290,179,469
318556,Nosebleed,racial,White,191,278,469
133835,Dermatitis,ethnic,Hispanic or Latino,257,209,466
375529,Infantile cerebral palsy,ethnic,Hispanic or Latino,258,208,466
434005,Morbid obesity,racial,Other Race,293,172,465
140949,Scabies,ethnic,Hispanic or Latino,278,184,462
4194895,Screening for disorder,racial,White,214,247,461
80824,Senile osteoporosis,ethnic,Not Hispanic or Latino,398,62,460
194133,Low back pain,racial,Other Race,382,78,460
443537,Deep venous thrombosis of lower extremity,racial,Unknown,325,134,459
435928,Abnormal decrease in weight,racial,White,220,238,458
200164,Urine-induced contact dermatitis,racial,White,230,226,456
76836,Sprain of knee and leg,ethnic,Hispanic or Latino,266,189,455
75617,Polyarticular osteoarthritis,racial,Other Race,371,83,454
375546,Combined nonsenile cataract,ethnic,Hispanic or Latino,451,4,455
444202,Abscess,ethnic,Not Hispanic or Latino,262,191,453
4088930,Confirmation of pregnancy,ethnic,Hispanic or Latino,453,0,453
4005823,Tobacco user,ethnic,Hispanic or Latino,139,314,453
436067,Schizophrenia simplex,ethnic,Hispanic or Latino,328,124,452
436665,Manic-depressive psychosis,ethnic,Not Hispanic or Latino,250,200,450
440704,Chronic pain syndrome,racial,White,262,188,450
81878,Benign paroxysmal positional vertigo,racial,White,341,109,450
443776,Brachial radiculitis,ethnic,Hispanic or Latino,403,46,449
193809,Melena due to gastrointestinal hemorrhage,racial,White,266,181,447
442752,Myalgia,racial,Unknown,367,80,447
318736,Migraine,racial,Unknown,408,38,446
257011,Acute upper respiratory infection,racial,Other Race,262,184,446
375806,Idiopathic peripheral neuropathy,racial,Black or African American ,131,316,447
434902,Autistic disorder of childhood onset,racial,White,55,392,447
442306,Adjustment disorder with depressed mood,ethnic,Hispanic or Latino,312,133,445
375545,Lens opacity,ethnic,Not Hispanic or Latino,187,257,444
31317,Can't get food down,racial,White,264,178,442
436962,Sleeplessness,racial,Other Race,341,101,442
440216,Abnormal glucose tolerance test,racial,White,220,222,442
321596,Peripheral venous insufficiency,racial,Unknown,337,104,441
438867,Generalized body aches,ethnic,Hispanic or Latino,299,142,441
441284,Open-angle glaucoma,ethnic,Hispanic or Latino,215,225,440
436238,Elevated levels of transaminase and lactic acid dehydrogenase,ethnic,Not Hispanic or Latino,233,206,439
256531,Head and neck swelling,ethnic,Hispanic or Latino,297,140,437
80824,Senile osteoporosis,racial,Asian,372,64,436
438120,Opioid dependence,racial,Unknown,216,220,436
256439,Allergic rhinitis due to pollen,ethnic,Hispanic or Latino,264,172,436
433753,Alcohol abuse,ethnic,Hispanic or Latino,52,383,435
31317,Can't get food down,racial,Unknown,169,265,434
77079,SS - Spinal stenosis,ethnic,Hispanic or Latino,301,133,434
377254,"Multi-infarct dementia, uncomplicated",racial,Unknown,170,264,434
374022,Hemiplegia,racial,Black or African American ,125,307,432
443570,Cervicovaginal cytology: Low grade squamous intraepithelial lesion,racial,White,422,9,431
73819,Painful breasts,racial,White,416,15,431
201069,"Peptic ulcer without hemorrhage, without perforation AND without obstruction",racial,Unknown,249,182,431
76153,Low compliance bladder,ethnic,Hispanic or Latino,293,136,429
380378,Epilepsy,racial,Black or African American ,291,139,430
257683,Postnasal drip,ethnic,Hispanic or Latino,300,130,430
443524,Mixed incontinence,racial,White,418,11,429
313878,Respiratory symptoms,ethnic,Not Hispanic or Latino,235,193,428
443865,Non-infective colitis,racial,Unknown,255,173,428
372906,Both eyes total visual impairment,ethnic,Hispanic or Latino,208,219,427
443238,Diabetic - poor control,racial,White,210,217,427
140480,Impetigo,ethnic,Hispanic or Latino,181,245,426
315558,Atherosclerosis of arteries of the extremities,ethnic,Hispanic or Latino,254,170,424
319835,Congestive cardiac failure,racial,Asian,286,137,423
434750,Feeding difficulties and mismanagement,ethnic,Hispanic or Latino,169,254,423
256451,Bronchitis,racial,Unknown,292,132,424
372409,Sciatica neuralgia,ethnic,Not Hispanic or Latino,295,127,422
256451,Bronchitis,ethnic,Not Hispanic or Latino,264,158,422
318712,Peripheral circulatory disorder associated with type I diabetes mellitus,ethnic,Hispanic or Latino,248,173,421
321318,Angina,racial,Black or African American ,414,8,422
193253,Nephritis,racial,Unknown,259,163,422
138102,Benign tumour of skin,ethnic,Hispanic or Latino,256,165,421
443801,Exercise-induced asthma,racial,White,230,190,420
375529,Infantile cerebral palsy,racial,White,215,204,419
138278,Sprains and strains of joints and adjacent muscles,ethnic,Hispanic or Latino,234,185,419
4276723,Finding of child weight centiles,ethnic,Hispanic or Latino,214,204,418
443545,Nonvenomous insect bite,ethnic,Hispanic or Latino,218,199,417
4302252,High risk pregnancy care,racial,Unknown,418,0,418
4175226,Screening for malignant neoplasm of colon,racial,Asian,228,189,417
137351,Epidermoid cyst of skin,ethnic,Hispanic or Latino,244,173,417
196341,Dermatophytosis of the perianal area,racial,White,133,284,417
75354,Osteochondropathy,racial,Unknown,385,31,416
133299,Swelling of limb,ethnic,Hispanic or Latino,321,95,416
439694,Hypertensive heart and renal disease with both (congestive) heart failure and renal failure,racial,Unknown,274,141,415
380094,Carpal tunnel syndrome,racial,Unknown,291,124,415
441737,Bruising,ethnic,Hispanic or Latino,262,152,414
137053,Seborrheic dermatitis,ethnic,Hispanic or Latino,212,202,414
137809,Primary malignant neoplasm of female breast,ethnic,Not Hispanic or Latino,413,0,413
259153,Throat soreness,racial,Unknown,269,142,411
441534,"Severe major depression, single episode, without psychotic features",ethnic,Hispanic or Latino,254,157,411
375791,Uncomplicated senile dementia,ethnic,Not Hispanic or Latino,278,131,409
261889,Simple chronic bronchitis,racial,Unknown,296,113,409
314054,Aortic valve disease,racial,Unknown,217,191,408
192671,GI - Gastrointestinal haemorrhage,ethnic,Hispanic or Latino,188,220,408
195588,Cystitis,ethnic,Hispanic or Latino,392,16,408
321882,Generalised atherosclerosis,racial,Unknown,154,254,408
197911,Hernia of anterior abdominal wall without obstruction AND without gangrene,ethnic,Hispanic or Latino,263,145,408
4064905,Venereal disease screening,racial,Unknown,262,146,408
312338,Benign hypertensive heart disease with congestive heart failure,ethnic,Not Hispanic or Latino,269,137,406
197304,Ulcer of lower limb,ethnic,Hispanic or Latino,229,177,406
374923,Bell palsy,racial,Unknown,213,192,405
4228802,Mild recurrent major depression,racial,White,234,170,404
374022,Hemiplegia,racial,Other Race,253,151,404
373999,Diabetic oculopathy associated with type I diabetes mellitus,ethnic,Hispanic or Latino,244,160,404
374888,Dementia associated with another disease,ethnic,Not Hispanic or Latino,352,52,404
441482,Administrative reason for encounter,ethnic,Hispanic or Latino,205,198,403
435511,Hypercalcemia,racial,White,301,101,402
195873,Leukorrhagia,ethnic,Hispanic or Latino,388,11,399
4158567,Post percutaneous transluminal coronary angioplasty,ethnic,Hispanic or Latino,136,263,399
435783,Schizophrenia,racial,White,181,217,398
196463,Alcoholic cirrhosis,ethnic,Hispanic or Latino,116,282,398
4211231,Panic disorder without agoraphobia,ethnic,Hispanic or Latino,255,143,398
434005,Morbid obesity,racial,Black or African American ,211,185,396
136184,Pruritic disorder,ethnic,Hispanic or Latino,251,145,396
435372,Underweight,ethnic,Hispanic or Latino,224,170,394
257007,Allergic rhinitis,racial,Other Race,262,132,394
78234,Arthralgia of the hand,racial,Unknown,259,135,394
443587,Diastolic heart failure,ethnic,Hispanic or Latino,264,128,392
440383,Depressive disorder,racial,Black or African American ,227,165,392
376707,Acute conjunctivitis,racial,Unknown,230,161,391
444070,Tachycardia,ethnic,Hispanic or Latino,320,71,391
313459,Sleep apnea,ethnic,Not Hispanic or Latino,121,270,391
4194160,Thyroid function tests abnormal,ethnic,Hispanic or Latino,286,104,390
377821,Neurological disorder associated with type I diabetes mellitus,ethnic,Hispanic or Latino,307,82,389
432526,Needs influenza immunisation,racial,Black or African American ,173,216,389
255573,Chronic obstructive lung disease,racial,Asian,135,253,388
437986,FTT - Failure to thrive,racial,White,185,202,387
440674,Gout,racial,Asian,44,344,388
78835,Palindromic rheumatism of the lower leg,racial,White,253,134,387
435515,Hypo-osmolality and or hyponatremia,ethnic,Hispanic or Latino,266,121,387
436466,Balanoposthitis,ethnic,Hispanic or Latino,0,385,385
258780,Chronic obstructive bronchitis,racial,Black or African American ,329,55,384
434169,Abnormal findings on diagnostic imaging of breast,racial,Unknown,384,0,384
440329,Herpes zoster without complication,racial,White,221,162,383
435171,Allergic state,racial,White,227,157,384
436077,Developmental delay,ethnic,Hispanic or Latino,145,239,384
444101,Hypertensive heart failure,ethnic,Not Hispanic or Latino,154,230,384
443597,Chronic kidney disease stage 3,racial,Asian,184,199,383
80767,Breast irregular nodularity,racial,Unknown,377,6,383
439795,Minimal cognitive impairment,racial,Unknown,151,232,383
443350,Lower urinary tract symptoms,ethnic,Not Hispanic or Latino,0,383,383
197988,General abdominal pain-symptom,racial,White,284,98,382
317009,Hyperreactive airway disease,racial,Filipino,241,141,382
140489,Acquired acanthosis nigricans,ethnic,Hispanic or Latino,212,169,381
440029,Viral disease,racial,Unknown,207,174,381
77965,Nodular tendinous disease of finger,ethnic,Hispanic or Latino,279,101,380
201927,Cellulitis and abscess of leg,racial,White,142,238,380
135033,Hair and hair follicle diseases,racial,White,187,193,380
321887,Disorder of artery,ethnic,Hispanic or Latino,215,164,379
375552,Pterygium,ethnic,Hispanic or Latino,210,169,379
195321,Postmenopausal bleeding,racial,White,377,2,379
318775,Venous embolism,ethnic,Hispanic or Latino,122,257,379
197925,Haemorrhage of rectum and anus,racial,White,189,189,378
74719,Foot ulcer,racial,White,120,257,377
200687,Renal disorder associated with type I diabetes mellitus,ethnic,Hispanic or Latino,233,143,376
437663,Fever,racial,Unknown,217,159,376
312349,Venous varices,racial,White,319,58,377
257012,Chronic rhinosinusitis,racial,Unknown,259,116,375
376979,Diabetic cataract,racial,Unknown,268,107,375
253797,Post-inflammatory pulmonary fibrosis,ethnic,Hispanic or Latino,113,260,373
432597,Schizoaffective schizophrenia,racial,Unknown,184,190,374
441407,Appetite loss - anorexia,ethnic,Hispanic or Latino,266,105,371
197381,Epigastric pain,racial,Unknown,290,80,370
318736,Migraine,ethnic,Not Hispanic or Latino,314,56,370
438398,Leukocytosis,ethnic,Hispanic or Latino,251,118,369
201914,Premenopausal menorrhagia,ethnic,Hispanic or Latino,369,0,369
77642,Arthralgia of the forearm,ethnic,Hispanic or Latino,262,107,369
24609,Hypoglycaemia,ethnic,Hispanic or Latino,257,112,369
4096215,"Hyperlipidemia, group A",racial,Other Race,283,85,368
439708,Disorders of initiating and maintaining sleep,ethnic,Not Hispanic or Latino,284,84,368
377290,Legal blindness USA,racial,White,125,243,368
4060985,BMI 30+ - obesity,racial,Black or African American ,224,143,367
195562,Hemorrhoids,racial,Unknown,253,114,367
314658,Cardiomegaly,racial,White,199,168,367
436972,Glaucoma associated with systemic syndromes,racial,Unknown,220,146,366
196168,Irregular menstrual bleeding,racial,Unknown,365,0,365
75576,Colon spasm,ethnic,Hispanic or Latino,278,87,365
79106,Arthralgia of the pelvic region and thigh,ethnic,Not Hispanic or Latino,231,134,365
436583,[X]Falls,racial,Unknown,238,127,365
441534,"Severe major depression, single episode, without psychotic features",racial,Unknown,217,148,365
29735,Candidiasis of mouth,ethnic,Hispanic or Latino,175,190,365
132466,Lumbar sprain,ethnic,Hispanic or Latino,233,131,364
137057,Paronychia,ethnic,Hispanic or Latino,215,149,364
31967,Nausea,racial,White,269,95,364
77630,Disease of shoulder,ethnic,Hispanic or Latino,217,147,364
315078,Palpitations,racial,Unknown,305,59,364
377091,Fits - convulsions,ethnic,Not Hispanic or Latino,68,295,363
195083,Left lower quadrant pain,racial,White,255,108,363
433316,Giddiness,racial,Asian,237,125,362
74464,Idiopathic scoliosis AND/OR kyphoscoliosis,ethnic,Not Hispanic or Latino,298,63,361
4154309,Severe recurrent major depression with psychotic features,ethnic,Hispanic or Latino,224,136,360
437833,Hypokalaemia,ethnic,Hispanic or Latino,260,100,360
257007,Allergic rhinitis,racial,Black or African American ,148,213,361
201603,Disease of teeth AND/OR supporting structures,racial,White,194,166,360
442067,Atopic dermatitis and related conditions,racial,Unknown,208,152,360
439147,Amnesia,racial,Asian,228,132,360
380403,External hordeolum,ethnic,Hispanic or Latino,202,158,360
73291,Palindromic rheumatism of the ankle and/or foot,racial,White,242,116,358
4195572,"Mild major depression, single episode",racial,Unknown,173,185,358
4064377,Depression screening,racial,Black or African American ,178,179,357
321052,Peripheral vascular disease,racial,Black or African American ,6,350,356
4079876,Familial combined hyperlipidemia,racial,Black or African American ,110,245,355
312664,Influenza with respiratory manifestation other than pneumonia,racial,White,175,181,356
440389,MR - Mental retardation,ethnic,Hispanic or Latino,187,168,355
197672,Urinary incontinence,racial,Asian,320,34,354
318775,Venous embolism,racial,Unknown,137,216,353
443257,Swellings and lumps,racial,White,232,122,354
377861,Disorder of refraction AND/OR accommodation,ethnic,Not Hispanic or Latino,185,168,353
373478,Presbyopia,ethnic,Hispanic or Latino,231,120,351
374022,Hemiplegia,racial,Asian,199,152,351
4110499,Allergic rhinitis NOS,ethnic,Hispanic or Latino,213,137,350
201061,Diaphragmatic hernia,ethnic,Hispanic or Latino,274,76,350
439795,Minimal cognitive impairment,racial,White,100,250,350
372309,Mononeuritis,ethnic,Hispanic or Latino,158,191,349
436070,Vitamin D deficiency,racial,White,217,131,348
77025,Diverticulitis of colon,ethnic,Hispanic or Latino,226,122,348
312950,IgE-mediated allergic asthma,ethnic,Not Hispanic or Latino,272,76,348
80502,Osteoporosis,racial,Other Race,319,28,347
432967,Anemia during pregnancy - baby not yet delivered,racial,White,347,0,347
436067,Schizophrenia simplex,racial,White,206,140,346
436972,Glaucoma associated with systemic syndromes,racial,White,195,151,346
200962,Primary malignant neoplasm of prostate,racial,Unknown,0,346,346
4049623,"Moderate major depression, single episode",racial,White,292,54,346
316139,HF - Heart failure,ethnic,Hispanic or Latino,215,130,345
30234,Cervical sprain,racial,White,241,104,345
4062495,Glaucoma screening,ethnic,Hispanic or Latino,281,63,344
4272867,General well-being finding,racial,White,163,182,345
444100,Mood disorder,racial,Unknown,220,124,344
140480,Impetigo,racial,White,143,200,343
4105880,Contact of sexually transmissible disorder,ethnic,Hispanic or Latino,230,113,343
4252735,Mourning,ethnic,Hispanic or Latino,312,31,343
258780,Chronic obstructive bronchitis,racial,White,205,137,342
199856,Varicose veins of lower extremity with inflammation,ethnic,Hispanic or Latino,257,86,343
259153,Throat soreness,ethnic,Not Hispanic or Latino,211,131,342
194411,Unilateral simple inguinal hernia,ethnic,Hispanic or Latino,88,254,342
442067,Atopic dermatitis and related conditions,ethnic,Not Hispanic or Latino,164,178,342
435516,Lipoprotein deficiency disorder,ethnic,Hispanic or Latino,206,135,341
194696,Menorrhalgia,racial,White,340,1,341
319835,Congestive cardiac failure,racial,Black or African American ,106,236,342
4201388,Gastrostomy present,ethnic,Hispanic or Latino,127,215,342
134118,Atrophic condition of skin,racial,White,181,160,341
195588,Cystitis,racial,White,324,17,341
377091,Fits - convulsions,racial,Other Race,8,332,340
443864,Multi-infarct dementia with depression,ethnic,Hispanic or Latino,269,71,340
436073,Psychotic disorder,racial,Unknown,274,65,339
134441,Chronic ulcer of skin,ethnic,Hispanic or Latino,151,187,338
201322,Internal hemorrhoids without complication,ethnic,Hispanic or Latino,220,117,337
74855,Genital herpes simplex,ethnic,Hispanic or Latino,224,113,337
375281,Acute suppurative otitis media - tympanic membrane intact,ethnic,Not Hispanic or Latino,130,206,336
312338,Benign hypertensive heart disease with congestive heart failure,racial,Black or African American ,237,99,336
381859,Infective OE,racial,Unknown,204,132,336
440704,Chronic pain syndrome,racial,Black or African American ,106,229,335
201613,Chronic nonalcoholic liver disease,racial,Unknown,244,91,335
73008,Enthesopathy,ethnic,Hispanic or Latino,228,106,334
135360,Fainting,racial,White,206,128,334
257683,Postnasal drip,racial,White,226,109,335
137379,Musculoskeletal symptom,ethnic,Hispanic or Latino,205,130,335
201620,Calculus of kidney,racial,Unknown,269,65,334
135473,Dermatophytosis,ethnic,Hispanic or Latino,169,164,333
436155,Redundant prepuce and phimosis,ethnic,Hispanic or Latino,0,333,333
136773,Rosacea,ethnic,Hispanic or Latino,226,107,333
196456,Cholecystolithiasis,racial,Unknown,235,98,333
439694,Hypertensive heart and renal disease with both (congestive) heart failure and renal failure,racial,White,251,81,332
80813,Lumbosacral spondylosis without myelopathy,ethnic,Hispanic or Latino,222,110,332
4144997,Osteoarthritis NOS,ethnic,Hispanic or Latino,249,83,332
140648,Onychomycosis due to dermatophyte,ethnic,Not Hispanic or Latino,157,175,332
4298697,Multiple open wounds without complication,ethnic,Hispanic or Latino,143,188,331
141323,Acute maxillary sinusitis,ethnic,Hispanic or Latino,248,82,330
195007,Female stress incontinence,racial,White,329,0,329
255848,Pneumonia,ethnic,Not Hispanic or Latino,157,173,330
372324,Eustachian tube disorder,ethnic,Hispanic or Latino,222,107,329
77638,Displacement of intervertebral disc without myelopathy,ethnic,Hispanic or Latino,291,38,329
80809,Rheumatoid arthritis,racial,Asian,320,7,327
441092,Advanced maternal age gravida,ethnic,Hispanic or Latino,327,0,327
193322,Right lower quadrant pain,racial,White,251,76,327
374060,Acute ill-defined cerebrovascular disease,racial,Asian,121,206,327
257004,Acute exacerbation of chronic obstructive airways disease,ethnic,Not Hispanic or Latino,182,145,327
380986,Senile dementia with delusion,ethnic,Hispanic or Latino,310,16,326
373852,Neuralgia,ethnic,Hispanic or Latino,261,65,326
377575,Tinnitus,racial,White,209,116,325
78234,Arthralgia of the hand,racial,White,251,74,325
81984,Sprain of shoulder and upper arm,ethnic,Hispanic or Latino,203,121,324
433069,Open wound of external genital organs with complication,racial,White,123,202,325
439125,T21 - Trisomy 21,racial,White,139,184,323
4092896,Stool contents abnormal,racial,White,196,127,323
436096,Chronic pain,racial,Unknown,211,112,323
74132,Degeneration of lumbosacral intervertebral disc,ethnic,Not Hispanic or Latino,235,88,323
444101,Hypertensive heart failure,racial,White,224,98,322
255848,Pneumonia,racial,Unknown,176,146,322
73553,Arthropathy,racial,Asian,124,197,321
195453,"Colitis, enteritis and gastroenteritis presumed infectious",ethnic,Hispanic or Latino,176,145,321
312934,Atherosclerosis of aorta,racial,White,224,95,319
439147,Amnesia,ethnic,Not Hispanic or Latino,158,161,319
77234,Benign tumour of colon,ethnic,Hispanic or Latino,169,149,318
438409,Attention deficit hyperactivity disorder,ethnic,Not Hispanic or Latino,68,248,316
4060985,BMI 30+ - obesity,racial,Asian,163,153,316
193016,Cystic disease of kidney,ethnic,Hispanic or Latino,224,92,316
434750,Feeding difficulties and mismanagement,racial,White,115,202,317
437643,Gait abnormality,racial,Other Race,184,133,317
441482,Administrative reason for encounter,racial,White,166,149,315
372906,Both eyes total visual impairment,racial,Unknown,278,37,315
80951,Candidiasis of urogenital site,ethnic,Hispanic or Latino,125,190,315
432284,Single major depressive episode,racial,Asian,91,223,314
435613,Cellulitis,racial,White,172,142,314
379019,Inflammation of conjunctiva,racial,Unknown,201,113,314
78517,Arthralgia of multiple joints,racial,Unknown,236,77,313
141095,Acne,ethnic,Not Hispanic or Latino,188,125,313
257011,Acute upper respiratory infection,racial,Asian,147,165,312
4308509,Impaired fasting glycaemia,ethnic,Not Hispanic or Latino,173,139,312
201131,Pelvic mass,ethnic,Hispanic or Latino,235,77,312
140949,Scabies,racial,White,170,142,312
4093344,Prostate observation,ethnic,Not Hispanic or Latino,1,310,311
138102,Benign tumour of skin,racial,White,178,133,311
78516,Arthralgia of the upper arm,racial,White,205,105,310
4064905,Venereal disease screening,ethnic,Not Hispanic or Latino,194,116,310
138278,Sprains and strains of joints and adjacent muscles,racial,White,169,140,309
4276723,Finding of child weight centiles,racial,White,148,160,308
201418,"Flatulence, eructation and gas pain",ethnic,Hispanic or Latino,203,104,307
78619,"Contusion, knee",ethnic,Hispanic or Latino,202,106,308
375415,Injury of head region,ethnic,Hispanic or Latino,152,155,307
73754,Restless legs,ethnic,Hispanic or Latino,234,73,307
440360,Pure hyperglyceridemia,racial,Other Race,130,177,307
438120,Opioid dependence,racial,White,145,161,306
377574,Presbycusis,racial,White,13,293,306
312437,Dyspnea,racial,Unknown,220,85,305
4293175,"Mental state, behaviour and/or psychosocial function finding",ethnic,Hispanic or Latino,97,208,305
436659,Iron deficiency anaemia,racial,Asian,188,116,304
319843,Mitral valve disorder,ethnic,Hispanic or Latino,241,64,305
198678,Intestinal infectious disease,racial,White,145,160,305
28457,Hypertrophy of tonsils,ethnic,Hispanic or Latino,152,152,304
133299,Swelling of limb,racial,Unknown,216,88,304
444382,Thoracic radiculitis,ethnic,Hispanic or Latino,210,94,304
4144997,Osteoarthritis NOS,racial,White,223,80,303
257011,Acute upper respiratory infection,racial,Black or African American ,151,151,302
4110499,Allergic rhinitis NOS,racial,White,169,133,302
443454,Cerebral infarction,racial,White,120,182,302
435928,Abnormal decrease in weight,racial,Unknown,201,101,302
194133,Low back pain,racial,Black or African American ,175,126,301
434613,Generalized anxiety disorder,ethnic,Not Hispanic or Latino,202,99,301
4252735,Mourning,racial,Unknown,280,22,302
133727,Thyrotoxicosis without goiter OR other cause,racial,White,234,67,301
4005823,Tobacco user,racial,White,91,210,301
4093344,Prostate observation,racial,Unknown,1,299,300
317302,Coronary sinus rhythm disorder,ethnic,Not Hispanic or Latino,116,185,301
73560,Calcaneal spur,ethnic,Hispanic or Latino,227,73,300
436682,Moderate mental handicap,racial,Unknown,22,277,299
141104,Intervertebral disc disorder of lumbar region with myelopathy,ethnic,Hispanic or Latino,128,170,298
443545,Nonvenomous insect bite,racial,White,154,144,298
197913,Disorder of function of stomach,ethnic,Not Hispanic or Latino,217,82,299
435171,Allergic state,ethnic,Not Hispanic or Latino,108,190,298
314666,Healed coronary,racial,White,101,196,297
133835,Dermatitis,racial,White,163,134,297
193251,Umbilical hernia without obstruction AND without gangrene,racial,White,164,132,296
4086918,Viral screening,racial,Other Race,176,120,296
444291,Cochlear hearing loss,racial,Unknown,263,33,296
315085,Enlargement of lymph nodes,racial,White,173,122,295
4311159,Midline cystocele,ethnic,Hispanic or Latino,295,0,295
441737,Bruising,racial,White,175,119,294
317302,Coronary sinus rhythm disorder,racial,Asian,117,177,294
140842,Changes in skin texture,ethnic,Hispanic or Latino,166,128,294
196738,Male genital organ disease,ethnic,Hispanic or Latino,0,293,293
374028,AAMD - Age related macular degeneration,racial,Unknown,202,91,293
72993,Primary localised osteoarthrosis,ethnic,Hispanic or Latino,184,109,293
372613,Flaccid hemiplegia,ethnic,Hispanic or Latino,107,185,292
75614,Acrodermatitis continua,ethnic,Not Hispanic or Latino,176,116,292
4051114,FH: Diabetes mellitus,racial,White,168,125,293
443732,Disorder associated with type II diabetes melliltus,racial,White,152,141,293
134057,Disease of cardiovascular system,ethnic,Hispanic or Latino,151,140,291
75576,Colon spasm,racial,Unknown,247,44,291
317898,Malignant essential hypertension,racial,White,250,40,290
314666,Healed coronary,racial,Unknown,148,142,290
380096,Proliferative diabetic retinopathy,racial,White,148,142,290
196456,Cholecystolithiasis,ethnic,Not Hispanic or Latino,245,45,290
437264,Tobacco dependence syndrome,racial,Black or African American ,103,187,290
132466,Lumbar sprain,racial,White,178,112,290
434165,Abnormal cervical smear,ethnic,Hispanic or Latino,289,1,290
438120,Opioid dependence,ethnic,Not Hispanic or Latino,134,154,288
76836,Sprain of knee and leg,racial,White,160,129,289
314059,Right bundle branch block,ethnic,Hispanic or Latino,155,133,288
257315,Bacterial pneumonia,ethnic,Hispanic or Latino,182,106,288
4088930,Confirmation of pregnancy,racial,White,285,3,288
4113027,Dietary intake observations,racial,White,134,154,288
140821,Spasm,ethnic,Not Hispanic or Latino,186,101,287
436077,Developmental delay,racial,White,112,175,287
437038,Blood in urine,racial,Unknown,184,102,286
200962,Primary malignant neoplasm of prostate,racial,White,0,286,286
4194160,Thyroid function tests abnormal,racial,White,204,82,286
199839,External haemorrhoids without complication,racial,White,177,108,285
261325,Pulmonary emphysema,ethnic,Hispanic or Latino,161,123,284
440389,MR - Mental retardation,racial,White,155,128,283
4245252,Raised prostate specific antigen,racial,Unknown,0,283,283
320128,Essential hypertension,racial,American Indian or Alaska Native ,200,82,282
198194,Female genital organ symptoms,racial,Unknown,283,0,283
198199,Pyelonephritis,ethnic,Hispanic or Latino,244,38,282
374013,Secondary Parkinson's disease,ethnic,Hispanic or Latino,187,96,283
438066,Chlamydial infection,ethnic,Hispanic or Latino,215,67,282
77968,Hallux valgus AND bunion,ethnic,Hispanic or Latino,220,62,282
139057,Disease of oral soft tissues,racial,Unknown,199,82,281
440029,Viral disease,ethnic,Not Hispanic or Latino,143,138,281
194175,Left upper quadrant pain,ethnic,Hispanic or Latino,216,64,280
374888,Dementia associated with another disease,racial,Asian,237,43,280
4062637,TB - Tuberculosis screening,racial,Other Race,158,121,279
195007,Female stress incontinence,racial,Unknown,280,0,280
201078,Senile atrophic vaginitis,ethnic,Hispanic or Latino,279,0,279
433753,Alcohol abuse,racial,White,32,247,279
381857,Impairment level: one eye: total impairment: other eye: not specified,ethnic,Hispanic or Latino,112,166,278
200174,Disease of skin AND/OR subcutaneous tissue,ethnic,Not Hispanic or Latino,163,115,278
138384,Acquired hypothyroidism,ethnic,Hispanic or Latino,218,59,277
195012,Metrorrhagia,ethnic,Hispanic or Latino,277,0,277
4096215,"Hyperlipidemia, group A",racial,Black or African American ,185,92,277
321052,Peripheral vascular disease,racial,Other Race,207,70,277
436583,[X]Falls,racial,White,196,81,277
4195572,"Mild major depression, single episode",racial,White,196,80,276
201627,Abnormal vaginal bleeding,ethnic,Hispanic or Latino,276,0,276
194406,Urinary tract obstruction,ethnic,Hispanic or Latino,7,268,275
441284,Open-angle glaucoma,racial,Unknown,214,61,275
373503,Intermittent cerebral ischaemia,racial,White,202,73,275
195306,Gastroduodenitis,racial,Asian,199,77,276
435796,Dehydration,ethnic,Hispanic or Latino,177,98,275
4088920,Womb absent,ethnic,Hispanic or Latino,274,1,275
4170576,Pressure ulcer,ethnic,Hispanic or Latino,225,50,275
4161977,Patient with cardiac pacemaker,ethnic,Not Hispanic or Latino,152,122,274
436230,Blood chemistry abnormal,racial,Unknown,180,94,274
376400,Combined form of senile cataract,ethnic,Hispanic or Latino,175,98,273
373499,Disorder of eye region,ethnic,Hispanic or Latino,170,103,273
197684,Dysuria,racial,Other Race,194,79,273
195847,Gastroparesis syndrome,ethnic,Hispanic or Latino,226,47,273
439147,Amnesia,racial,Other Race,266,7,273
195851,"Gastric ulcer without hemorrhage, without perforation AND without obstruction",ethnic,Hispanic or Latino,112,161,273
321052,Peripheral vascular disease,racial,Asian,134,138,272
141253,Disease of thyroid gland,ethnic,Hispanic or Latino,223,48,271
439297,Nuclear senile cataract,ethnic,Hispanic or Latino,186,84,270
4263370,R.I.N.D. syndrome,racial,White,142,127,269
256448,Chronic asthmatic bronchitis,racial,Unknown,205,65,270
379784,Senile dementia with depression,racial,White,229,41,270
253797,Post-inflammatory pulmonary fibrosis,racial,White,50,218,268
81379,Lateral epicondylitis,ethnic,Hispanic or Latino,174,95,269
443776,Brachial radiculitis,racial,Unknown,185,84,269
80189,Displacement of lumbar intervertebral disc without myelopathy,racial,White,162,106,268
437663,Fever,ethnic,Not Hispanic or Latino,116,151,267
137351,Epidermoid cyst of skin,racial,White,148,119,267
381270,Parkinson's disease,ethnic,Not Hispanic or Latino,137,129,266
314754,Wheezing,ethnic,Not Hispanic or Latino,149,116,265
4171430,Screening for malignant neoplasm of rectum,racial,Unknown,117,148,265
380986,Senile dementia with delusion,racial,White,257,8,265
256531,Head and neck swelling,racial,White,164,100,264
75617,Polyarticular osteoarthritis,racial,Black or African American ,187,77,264
312349,Venous varices,racial,Unknown,230,34,264
75337,Cellulitis and abscess of buttock,ethnic,Hispanic or Latino,134,128,262
141095,Acne,racial,Unknown,130,133,263
440021,Herpes simplex without complication,ethnic,Hispanic or Latino,173,89,262
76153,Low compliance bladder,ethnic,Not Hispanic or Latino,55,207,262
197500,Primary malignant neoplasm of colon,ethnic,Hispanic or Latino,107,155,262
137057,Paronychia,racial,White,154,107,261
77030,Disease of breast,ethnic,Hispanic or Latino,254,8,262
198263,Right upper quadrant pain,racial,Unknown,218,43,261
75650,Proteinuria,ethnic,Not Hispanic or Latino,117,144,261
135360,Fainting,racial,Unknown,205,56,261
321319,Cardiomyopathy,ethnic,Hispanic or Latino,171,90,261
76786,Derangement of knee,racial,White,119,142,261
4165091,Lack of exercise,racial,White,122,139,261
4064918,Diabetes mellitus screening,racial,Other Race,150,110,260
194081,Acute cystitis,racial,Unknown,243,17,260
77635,Disease of hand,ethnic,Hispanic or Latino,176,83,259
4141622,Asthma NOS,ethnic,Hispanic or Latino,164,94,258
440674,Gout,racial,Filipino,106,152,258
194686,Acquired renal cyst,ethnic,Hispanic or Latino,209,49,258
79908,Muscle strength reduced,racial,White,101,157,258
436940,Insulin resistance syndrome,ethnic,Hispanic or Latino,146,112,258
197913,Disorder of function of stomach,racial,Asian,245,13,258
136773,Rosacea,racial,White,173,84,257
140673,Hypothyroid,racial,Black or African American ,91,166,257
77644,Adhesive capsulitis of shoulder,ethnic,Hispanic or Latino,170,87,257
315833,Secondary cardiomyopathy,ethnic,Hispanic or Latino,185,71,256
373198,Unqualified visual loss of both eyes,ethnic,Hispanic or Latino,101,155,256
195873,Leukorrhagia,racial,White,249,7,256
436230,Blood chemistry abnormal,ethnic,Not Hispanic or Latino,154,102,256
140821,Spasm,racial,Unknown,193,62,255
77642,Arthralgia of the forearm,racial,White,170,85,255
255841,Chronic bronchitis,racial,White,152,102,254
379805,Myopia,racial,White,131,123,254
435516,Lipoprotein deficiency disorder,racial,White,151,103,254
439700,Inhibited sexual desire,racial,Unknown,0,254,254
377254,"Multi-infarct dementia, uncomplicated",ethnic,Not Hispanic or Latino,30,223,253
135360,Fainting,ethnic,Not Hispanic or Latino,205,47,252
198995,Type 1 diabetes mellitus - poor control,racial,Asian,88,164,252
432285,Recurrent major depressive episodes,racial,Other Race,208,45,253
198803,Nodular hyperplasia of prostate gland,racial,Other Race,0,253,253
196360,Primary malignant neoplasm of bladder,ethnic,Not Hispanic or Latino,1,252,253
376112,Diabetic polyneuropathy,racial,Asian,187,65,252
77074,Joint pain,ethnic,Not Hispanic or Latino,165,87,252
4101199,Hearing problem,ethnic,Hispanic or Latino,129,123,252
380096,Proliferative diabetic retinopathy,racial,Unknown,124,128,252
135772,Goiter,ethnic,Hispanic or Latino,240,11,251
137063,Corns and callus,racial,White,158,93,251
377527,Presenile dementia with depression,ethnic,Hispanic or Latino,113,138,251
443237,"Manic disorder, single episode",ethnic,Hispanic or Latino,80,170,250
141323,Acute maxillary sinusitis,racial,White,179,72,251
375252,Disorder of eye,ethnic,Hispanic or Latino,136,115,251
316999,Cardiac arrhythmia,racial,Asian,152,98,250
197032,Hyperplasia of prostate,racial,Unknown,0,250,250
312648,Benign essential hypertension,racial,American Indian or Alaska Native ,226,23,249
316822,Finding of heart murmur,racial,Unknown,178,72,250
312998,Pain in thoracic spine,ethnic,Hispanic or Latino,162,88,250
198194,Female genital organ symptoms,ethnic,Not Hispanic or Latino,249,1,250
443729,Peripheral circulatory disorder associated with type II diabetes mellitus,ethnic,Not Hispanic or Latino,62,187,249
442068,Cellulitis and abscess of forearm,ethnic,Hispanic or Latino,143,106,249
197236,Uterine fibroid,racial,Unknown,249,0,249
4090651,Dialysis observation,racial,White,113,136,249
318169,Varicose veins of lower extremity,ethnic,Hispanic or Latino,217,32,249
376382,Tension-type headache,racial,Unknown,202,47,249
440693,Continuous opioid dependence,ethnic,Hispanic or Latino,77,171,248
137682,Skin sensation disturbance,racial,Unknown,151,97,248
381292,Chronic allergic conjunctivitis,ethnic,Not Hispanic or Latino,178,70,248
442793,Diabetic complication,ethnic,Not Hispanic or Latino,139,108,247
440748,Interstitial emphysema of lung,ethnic,Hispanic or Latino,140,107,247
4298854,HIV seropositivity,ethnic,Not Hispanic or Latino,52,195,247
137053,Seborrheic dermatitis,racial,White,122,124,246
312922,Coronary bypass graft observation,racial,White,64,182,246
74855,Genital herpes simplex,racial,White,157,87,244
4062636,Bacterial disease screening,ethnic,Hispanic or Latino,219,25,244
196360,Primary malignant neoplasm of bladder,racial,Asian,0,244,244
197911,Hernia of anterior abdominal wall without obstruction AND without gangrene,racial,White,157,86,243
377091,Fits - convulsions,racial,Asian,4,240,244
4141622,Asthma NOS,racial,White,157,86,243
441840,Clinical finding,ethnic,Hispanic or Latino,160,83,243
132659,Acute apical periodontitis,ethnic,Hispanic or Latino,164,79,243
76786,Derangement of knee,racial,Unknown,114,129,243
317002,Hypopiesis,racial,White,196,47,243
378756,Conjunctival hemorrhage,ethnic,Hispanic or Latino,154,89,243
40479192,Chronic systolic heart failure,racial,Asian,158,85,243
134460,Plantar fascial fibromatosis,racial,Unknown,160,82,242
318712,Peripheral circulatory disorder associated with type I diabetes mellitus,racial,White,78,164,242
192286,Intestinal disaccharidase deficiency,ethnic,Hispanic or Latino,181,61,242
378743,Mild nonproliferative retinopathy,ethnic,Hispanic or Latino,125,117,242
74719,Foot ulcer,racial,Unknown,113,129,242
372324,Eustachian tube disorder,racial,White,158,83,241
377889,Hearing loss,racial,Asian,89,152,241
313236,Cough variant asthma,racial,Unknown,120,121,241
30437,Gastroesophageal reflux disease with esophagitis,racial,White,137,103,240
372634,Nonphysiologic vision loss,racial,White,128,112,240
432869,Hemorrhagic disorder due to circulating anticoagulants,racial,Unknown,50,190,240
199877,Mucous polyp of cervix,ethnic,Hispanic or Latino,240,0,240
138502,Vitiligo,ethnic,Hispanic or Latino,135,104,239
439846,LVF - Left ventricular failure,ethnic,Hispanic or Latino,140,99,239
78619,"Contusion, knee",racial,White,142,97,239
439141,Abnormal increase in weight,ethnic,Not Hispanic or Latino,131,108,239
376229,Abnormal involuntary movement,racial,White,112,127,239
443783,Chronic disease,racial,Asian,145,94,239
139850,Acute frontal sinusitis,ethnic,Hispanic or Latino,173,65,238
4105880,Contact of sexually transmissible disorder,racial,White,148,90,238
438867,Generalized body aches,racial,White,153,85,238
314754,Wheezing,racial,Unknown,133,104,237
433440,Dysthymia,ethnic,Not Hispanic or Latino,191,46,237
198075,Venereal wart,ethnic,Hispanic or Latino,114,123,237
439799,Leg cramps,racial,Unknown,227,9,236
4062495,Glaucoma screening,racial,White,187,49,236
438398,Leukocytosis,racial,White,165,70,235
195453,"Colitis, enteritis and gastroenteritis presumed infectious",racial,White,124,111,235
24660,Acute tonsillitis,racial,Unknown,150,85,235
374924,Generalized convulsive epilepsy,ethnic,Not Hispanic or Latino,77,157,234
4100857,Pickwickian syndrome,racial,Unknown,138,96,234
40479192,Chronic systolic heart failure,ethnic,Not Hispanic or Latino,89,145,234
197950,Cellulitis and abscess of trunk,ethnic,Hispanic or Latino,131,103,234
29735,Candidiasis of mouth,racial,White,101,133,234
380403,External hordeolum,racial,White,125,109,234
133280,Alopecia,ethnic,Hispanic or Latino,203,29,232
314054,Aortic valve disease,racial,White,74,159,233
132706,Nail disease,ethnic,Hispanic or Latino,146,87,233
432741,Abnormal immunology finding,ethnic,Hispanic or Latino,179,53,232
194984,Hepatopathy,ethnic,Hispanic or Latino,161,71,232
4158567,Post percutaneous transluminal coronary angioplasty,racial,White,76,156,232
433316,Giddiness,racial,Other Race,202,29,231
436940,Insulin resistance syndrome,racial,White,136,95,231
441628,Menopausal and postmenopausal disorders,ethnic,Hispanic or Latino,230,0,230
201826,Type 2 diabetes mellitus,racial,Native Hawaiian or Other Pacific Islander ,86,144,230
432284,Single major depressive episode,racial,Black or African American ,214,16,230
437382,Urine observation,racial,Unknown,186,44,230
435372,Underweight,racial,White,127,103,230
80767,Breast irregular nodularity,ethnic,Not Hispanic or Latino,215,15,230
77354,Primary localised osteoarthrosis of lower leg,ethnic,Not Hispanic or Latino,146,83,229
76194,Osteoarthrosis involving multiple sites but not designated as generalized,racial,White,119,110,229
77670,Chest pain,racial,Asian,153,76,229
201254,Insulin dependent diabetes mellitus,ethnic,Not Hispanic or Latino,104,125,229
4250023,Severe major depression with psychotic features,ethnic,Hispanic or Latino,139,90,229
440321,Helicobacter-associated disease,racial,Unknown,178,50,228
376406,"Impairment level: blindness, one eye - low vision other eye",ethnic,Not Hispanic or Latino,30,198,228
260134,Croup,ethnic,Hispanic or Latino,82,146,228
192279,Diabetic nephropathy,racial,Asian,88,139,227
434613,Generalized anxiety disorder,racial,Asian,216,11,227
437175,"Fall on same level from slipping, tripping or stumbling",ethnic,Hispanic or Latino,173,53,226
75911,Acquired hallux valgus,ethnic,Hispanic or Latino,93,133,226
316822,Finding of heart murmur,ethnic,Not Hispanic or Latino,152,74,226
198995,Type 1 diabetes mellitus - poor control,racial,Other Race,110,115,225
136184,Pruritic disorder,racial,White,130,96,226
140641,Verruca vulgaris,ethnic,Not Hispanic or Latino,106,119,225
201914,Premenopausal menorrhagia,racial,White,224,1,225
432867,Hyperlipidemia,racial,American Indian or Alaska Native ,173,52,225
440358,Lipoma,ethnic,Hispanic or Latino,124,101,225
76153,Low compliance bladder,racial,Unknown,176,49,225
4154309,Severe recurrent major depression with psychotic features,racial,White,94,131,225
78508,Arthralgia of the ankle and/or foot,racial,Unknown,137,87,224
432867,Hyperlipidemia,racial,Filipino,202,22,224
436072,Bipolar disorder in partial remission,ethnic,Hispanic or Latino,205,20,225
315078,Palpitations,ethnic,Not Hispanic or Latino,156,68,224
198363,Candidiasis of vagina,racial,Unknown,224,0,224
4115379,"Localised, primary osteoarthritis of the pelvic region and thigh",ethnic,Hispanic or Latino,143,80,223
436466,Balanoposthitis,racial,White,0,223,223
312723,Congenital heart disease,ethnic,Hispanic or Latino,108,115,223
256439,Allergic rhinitis due to pollen,racial,White,117,106,223
442615,Carotid artery stenosis,ethnic,Hispanic or Latino,110,113,223
80242,Current tear of medial cartilage AND/OR meniscus of knee,ethnic,Hispanic or Latino,143,79,222
198964,Chronic type C viral hepatitis,racial,Black or African American ,97,125,222
197320,ARF - Acute renal failure,ethnic,Hispanic or Latino,122,100,222
374923,Bell palsy,racial,White,114,107,221
380733,Otalgia,racial,Unknown,176,45,221
141216,MC - Molluscum contagiosum,ethnic,Hispanic or Latino,106,116,222
433599,Abnormal biochemistry finding,ethnic,Hispanic or Latino,135,86,221
437833,Hypokalaemia,racial,White,145,76,221
257907,Disorder of lung,ethnic,Hispanic or Latino,95,127,222
196463,Alcoholic cirrhosis,racial,White,69,152,221
4112525,Acute bronchiolitis NOS,ethnic,Hispanic or Latino,69,152,221
433811,Hydronephrosis,ethnic,Hispanic or Latino,120,101,221
195562,Hemorrhoids,ethnic,Not Hispanic or Latino,109,111,220
73008,Enthesopathy,racial,White,151,70,221
379019,Inflammation of conjunctiva,ethnic,Not Hispanic or Latino,127,92,219
77965,Nodular tendinous disease of finger,racial,White,161,58,219
200843,Observation of frequency of urination,racial,Unknown,146,73,219
139099,Ingrowing nail,racial,Unknown,127,93,220
137497,Dermatophytosis of the body,racial,Unknown,148,71,219
4133029,Primigravida,ethnic,Not Hispanic or Latino,206,13,219
377527,Presenile dementia with depression,racial,White,86,133,219
27674,N&V - Nausea and vomiting,racial,Unknown,160,59,219
320128,Essential hypertension,racial,Filipino,133,86,219
140489,Acquired acanthosis nigricans,racial,White,121,97,218
138825,Actinic keratosis,ethnic,Hispanic or Latino,155,63,218
73564,Complete rupture of rotator cuff,ethnic,Hispanic or Latino,67,150,217
378425,Eyelid inflammation,ethnic,Hispanic or Latino,134,83,217
197914,Chronic gastric ulcer with perforation but without obstruction,ethnic,Hispanic or Latino,213,4,217
256448,Chronic asthmatic bronchitis,racial,White,175,41,216
135473,Dermatophytosis,racial,White,103,113,216
40479192,Chronic systolic heart failure,racial,Unknown,198,18,216
441092,Advanced maternal age gravida,racial,White,213,3,216
442565,Gestational edema without hypertension,ethnic,Hispanic or Latino,216,0,216
443414,Chronic post-traumatic stress disorder,ethnic,Not Hispanic or Latino,59,157,216
136788,Spinal stenosis of lumbar region,racial,Unknown,150,65,215
440508,Congenital disease,ethnic,Hispanic or Latino,62,154,216
195501,Polycystic ovaries,ethnic,Hispanic or Latino,215,0,215
436962,Sleeplessness,racial,Black or African American ,172,44,216
374009,Organic mental disorder,ethnic,Hispanic or Latino,4,211,215
4293175,"Mental state, behaviour and/or psychosocial function finding",racial,White,67,148,215
443238,Diabetic - poor control,ethnic,Not Hispanic or Latino,108,107,215
192359,RF - Renal failure,ethnic,Hispanic or Latino,107,107,214
440389,MR - Mental retardation,racial,Unknown,18,196,214
193253,Nephritis,ethnic,Not Hispanic or Latino,97,117,214
72995,Joint contracture of hand,ethnic,Hispanic or Latino,8,206,214
198124,Disorder of kidney,ethnic,Not Hispanic or Latino,119,94,213
4149353,"Attention deficit hyperactivity disorder, predominantly inattentive type",racial,White,85,129,214
134898,Non-toxic single thyroid nodule,ethnic,Hispanic or Latino,184,29,213
80502,Osteoporosis,racial,Filipino,213,0,213
256439,Allergic rhinitis due to pollen,racial,Unknown,148,65,213
139902,Allergic urticaria,ethnic,Hispanic or Latino,133,80,213
4149353,"Attention deficit hyperactivity disorder, predominantly inattentive type",ethnic,Hispanic or Latino,71,141,212
81878,Benign paroxysmal positional vertigo,racial,Unknown,160,53,213
73840,Primary localised osteoarthrosis of shoulder region,ethnic,Hispanic or Latino,147,65,212
4154309,Severe recurrent major depression with psychotic features,ethnic,Not Hispanic or Latino,196,17,213
443350,Lower urinary tract symptoms,racial,Asian,0,212,212
132553,Herpangina,ethnic,Hispanic or Latino,90,122,212
439777,Anemia,racial,Black or African American ,154,58,212
4311591,Cramp in limb,ethnic,Not Hispanic or Latino,86,125,211
132408,Back problem,ethnic,Hispanic or Latino,174,37,211
78508,Arthralgia of the ankle and/or foot,ethnic,Not Hispanic or Latino,135,76,211
373503,Intermittent cerebral ischaemia,racial,Unknown,146,65,211
78497,Cellulitis and abscess of toe,ethnic,Hispanic or Latino,99,112,211
438480,"Abnormal glucose tolerance in mother complicating pregnancy, childbirth AND/OR puerperium",ethnic,Hispanic or Latino,211,0,211
433454,Adjustment disorder with mixed emotional features,ethnic,Hispanic or Latino,94,117,211
28060,Strept throat,racial,Unknown,129,82,211
437969,Acquired pes planus,ethnic,Hispanic or Latino,72,139,211
435220,Severe recurrent major depression without psychotic features,racial,Unknown,29,181,210
372309,Mononeuritis,racial,White,104,106,210
133141,Tinea pedis,ethnic,Not Hispanic or Latino,88,122,210
4201388,Gastrostomy present,racial,White,59,151,210
374009,Organic mental disorder,racial,Unknown,1,208,209
444101,Hypertensive heart failure,racial,Asian,148,61,209
4164770,Acute inflammatory demyelinating polyradiculoneuropathy,ethnic,Hispanic or Latino,0,209,209
78272,Sprain of wrist,ethnic,Hispanic or Latino,133,76,209
437643,Gait abnormality,racial,Asian,75,134,209
380094,Carpal tunnel syndrome,ethnic,Not Hispanic or Latino,157,51,208
4164770,Acute inflammatory demyelinating polyradiculoneuropathy,racial,Unknown,0,208,208
81893,Chronic ulcerative colitis,ethnic,Hispanic or Latino,105,103,208
375239,Cerebral degeneration,racial,Unknown,195,13,208
77670,Chest pain,racial,Other Race,89,119,208
22340,Esophageal varices without bleeding,ethnic,Hispanic or Latino,171,37,208
133436,Thyrotoxic crisis,racial,Unknown,190,17,207
443599,Paralytic syndrome of non-dominant side as late effect of stroke,racial,Unknown,0,207,207
73553,Arthropathy,racial,Other Race,141,66,207
197236,Uterine fibroid,ethnic,Not Hispanic or Latino,205,2,207
440426,Vertigo as late effect of stroke,racial,White,149,58,207
438557,Abnormal glucose level,racial,Asian,121,86,207
443599,Paralytic syndrome of non-dominant side as late effect of stroke,ethnic,Hispanic or Latino,0,207,207
133228,Dental caries,ethnic,Not Hispanic or Latino,106,101,207
74464,Idiopathic scoliosis AND/OR kyphoscoliosis,racial,Asian,198,8,206
441408,Vomiting,racial,Unknown,137,69,206
77630,Disease of shoulder,racial,White,123,83,206
439727,HIV - Human immunodeficiency virus infection,racial,Asian,26,180,206
443430,HPV - Human papillomavirus test positive,ethnic,Hispanic or Latino,204,2,206
196738,Male genital organ disease,racial,White,0,205,205
436070,Vitamin D deficiency,racial,Unknown,150,55,205
377575,Tinnitus,racial,Unknown,145,61,206
197988,General abdominal pain-symptom,racial,Unknown,157,47,204
195012,Metrorrhagia,racial,White,205,0,205
438066,Chlamydial infection,racial,White,136,69,205
76153,Low compliance bladder,racial,Asian,11,193,204
76161,Impotence of organic origin,racial,Unknown,0,204,204
75576,Colon spasm,racial,White,163,40,203
4112525,Acute bronchiolitis NOS,racial,White,62,142,204
256717,Bronchospasm,ethnic,Hispanic or Latino,126,77,203
437041,Mother not delivered,ethnic,Not Hispanic or Latino,196,8,204
444382,Thoracic radiculitis,racial,White,140,62,202
80951,Candidiasis of urogenital site,racial,White,86,117,203
443865,Non-infective colitis,ethnic,Not Hispanic or Latino,103,100,203
136788,Spinal stenosis of lumbar region,racial,White,140,62,202
133727,Thyrotoxicosis without goiter OR other cause,ethnic,Not Hispanic or Latino,75,127,202
201603,Disease of teeth AND/OR supporting structures,racial,Unknown,117,85,202
78232,Shoulder joint pain,racial,Asian,160,41,201
435656,Neonatal jaundice,ethnic,Hispanic or Latino,80,121,201
443729,Peripheral circulatory disorder associated with type II diabetes mellitus,racial,Black or African American ,5,197,202
437643,Gait abnormality,racial,Black or African American ,179,22,201
140641,Verruca vulgaris,racial,Unknown,128,73,201
437038,Blood in urine,ethnic,Not Hispanic or Latino,116,86,202
434056,Late effects of cerebrovascular disease,racial,Other Race,148,53,201
134441,Chronic ulcer of skin,racial,White,94,107,201
375415,Injury of head region,racial,White,91,110,201
433456,Acute pain,ethnic,Hispanic or Latino,124,77,201
201340,Gastritis,ethnic,Hispanic or Latino,148,53,201
432875,Anemia due to chronic blood loss,ethnic,Hispanic or Latino,193,8,201
40485064,Latent syphilis,ethnic,Hispanic or Latino,69,131,200
440021,Herpes simplex without complication,racial,White,119,82,201
81379,Lateral epicondylitis,racial,White,132,68,200
376979,Diabetic cataract,racial,White,137,62,199
440424,Aphasia,ethnic,Hispanic or Latino,61,139,200
200391,Peripheral autonomic neuropathy disease EC,ethnic,Hispanic or Latino,119,81,200
372906,Both eyes total visual impairment,racial,White,29,170,199
75614,Acrodermatitis continua,racial,Unknown,74,126,200
444132,Knee injury,ethnic,Hispanic or Latino,112,88,200
4100857,Pickwickian syndrome,ethnic,Not Hispanic or Latino,118,82,200
193782,End stage renal disease,ethnic,Not Hispanic or Latino,66,133,199
432870,Thrombocytopenia,racial,Other Race,192,7,199
444391,Pain around eye,ethnic,Hispanic or Latino,140,58,198
77234,Benign tumour of colon,racial,White,91,107,198
28060,Strept throat,ethnic,Not Hispanic or Latino,98,101,199
198803,Nodular hyperplasia of prostate gland,racial,Black or African American ,0,198,198
376117,Cataract in degenerative disorder,ethnic,Hispanic or Latino,122,76,198
136496,Cellulitis and abscess of face,ethnic,Hispanic or Latino,95,103,198
4211231,Panic disorder without agoraphobia,racial,White,111,87,198
28457,Hypertrophy of tonsils,racial,White,93,105,198
4062637,TB - Tuberculosis screening,racial,Black or African American ,86,112,198
436155,Redundant prepuce and phimosis,racial,White,0,198,198
26662,Testicular hypofunction,ethnic,Not Hispanic or Latino,1,196,197
440383,Depressive disorder,racial,Filipino,101,95,196
433031,Hallucinations,ethnic,Hispanic or Latino,130,66,196
199860,Hernia of abdominal cavity,ethnic,Hispanic or Latino,118,79,197
76161,Impotence of organic origin,ethnic,Not Hispanic or Latino,0,196,196
434073,Loss of teeth - acquired,ethnic,Hispanic or Latino,140,56,196
139906,Intervertebral disc disorder of cervical region with myelopathy,racial,Unknown,152,43,195
24609,Hypoglycaemia,racial,White,140,55,195
434610,Hyperkalemia,racial,Unknown,102,94,196
197494,Viral hepatitis C,ethnic,Hispanic or Latino,97,98,195
441264,Primary thrombocytopenia,ethnic,Hispanic or Latino,91,104,195
381859,Infective OE,ethnic,Not Hispanic or Latino,119,76,195
195321,Postmenopausal bleeding,racial,Unknown,195,0,195
434494,Closed fracture of the proximal humerus,ethnic,Hispanic or Latino,169,26,195
441836,Depressed bipolar I disorder,ethnic,Hispanic or Latino,84,111,195
436665,Manic-depressive psychosis,racial,Unknown,115,80,195
72748,Strain of rotator cuff of shoulder,ethnic,Hispanic or Latino,113,82,195
373503,Intermittent cerebral ischaemia,ethnic,Not Hispanic or Latino,38,156,194
441542,Anxiety,racial,Black or African American ,155,39,194
437655,Cryptorchism,ethnic,Hispanic or Latino,0,194,194
313459,Sleep apnea,racial,Unknown,85,110,195
443570,Cervicovaginal cytology: Low grade squamous intraepithelial lesion,racial,Unknown,194,0,194
254761,Cough,racial,Other Race,110,83,193
200845,Urinary precipitancy,ethnic,Hispanic or Latino,127,67,194
377888,CHL - Conductive hearing loss,racial,Unknown,132,62,194
259055,Extrinsic asthma with asthma attack,racial,Unknown,99,94,193
374034,Visual disturbance,racial,Unknown,116,77,193
4290927,Impairment level: low vision of both eyes,ethnic,Hispanic or Latino,109,85,194
75337,Cellulitis and abscess of buttock,racial,White,101,92,193
432738,Iceland disease,ethnic,Hispanic or Latino,131,62,193
197304,Ulcer of lower limb,racial,Unknown,113,80,193
443454,Cerebral infarction,ethnic,Not Hispanic or Latino,67,126,193
373999,Diabetic oculopathy associated with type I diabetes mellitus,racial,White,164,28,192
133727,Thyrotoxicosis without goiter OR other cause,racial,Unknown,173,19,192
76194,Osteoarthrosis involving multiple sites but not designated as generalized,racial,Unknown,149,43,192
4101660,Amputated below knee,ethnic,Hispanic or Latino,65,127,192
134057,Disease of cardiovascular system,racial,Unknown,60,132,192
81112,Arthralgia of the lower leg,racial,Other Race,131,60,191
260125,Acute bronchiolitis,ethnic,Not Hispanic or Latino,91,101,192
260427,Common cold,racial,Unknown,120,71,191
196456,Cholecystolithiasis,racial,Asian,175,17,192
380701,SDLT - Senile dementia of the Lewy body type,ethnic,Hispanic or Latino,55,137,192
444239,Postprocedural state finding,racial,Unknown,116,75,191
196168,Irregular menstrual bleeding,ethnic,Not Hispanic or Latino,189,2,191
193326,Urge incontinence of urine,racial,Unknown,161,29,190
195312,Functional voiding disorder,ethnic,Hispanic or Latino,149,41,190
23325,Heartburn,racial,Unknown,53,137,190
380701,SDLT - Senile dementia of the Lewy body type,racial,Unknown,55,136,191
140020,Viral exanthem,ethnic,Hispanic or Latino,70,120,190
4282684,Impairment level: low vision of one eye,ethnic,Hispanic or Latino,100,90,190
441874,Cerebral thrombosis,ethnic,Hispanic or Latino,177,12,189
137809,Primary malignant neoplasm of female breast,racial,Asian,189,0,189
198075,Venereal wart,racial,White,62,127,189
139906,Intervertebral disc disorder of cervical region with myelopathy,ethnic,Not Hispanic or Latino,167,22,189
441980,Closed fracture of foot,ethnic,Hispanic or Latino,34,155,189
432585,Blood coagulation disorder,ethnic,Hispanic or Latino,139,50,189
432661,Stomatitis,ethnic,Hispanic or Latino,102,87,189
134461,Tietze disease,racial,Unknown,143,45,188
444100,Mood disorder,racial,White,88,101,189
201621,Chronic cystitis,ethnic,Hispanic or Latino,168,20,188
254761,Cough,racial,Asian,108,80,188
437247,Anaemia of chronic disease,ethnic,Not Hispanic or Latino,107,81,188
201061,Diaphragmatic hernia,racial,Unknown,163,25,188
4050572,Implantation of automatic cardiac defibrillator,ethnic,Hispanic or Latino,67,121,188
443864,Multi-infarct dementia with depression,racial,Unknown,159,29,188
375545,Lens opacity,racial,Other Race,85,102,187
194175,Left upper quadrant pain,racial,White,143,44,187
433069,Open wound of external genital organs with complication,racial,Unknown,129,58,187
433968,Candidiasis,ethnic,Hispanic or Latino,115,72,187
4250023,Severe major depression with psychotic features,racial,White,116,71,187
139850,Acute frontal sinusitis,racial,White,130,56,186
375292,Perforation of tympanic membrane,ethnic,Hispanic or Latino,117,70,187
201927,Cellulitis and abscess of leg,racial,Unknown,96,90,186
4103642,Amputated toe,ethnic,Hispanic or Latino,34,151,185
4103471,Observation of body mass index,racial,American Indian or Alaska Native ,118,67,185
4094448,Pregnancy test negative,ethnic,Hispanic or Latino,185,0,185
137682,Skin sensation disturbance,ethnic,Not Hispanic or Latino,116,69,185
141104,Intervertebral disc disorder of lumbar region with myelopathy,racial,White,88,97,185
378427,Tear film insufficiency,racial,White,133,52,185
197032,Hyperplasia of prostate,ethnic,Not Hispanic or Latino,0,185,185
435928,Abnormal decrease in weight,ethnic,Not Hispanic or Latino,100,84,184
434165,Abnormal cervical smear,racial,White,184,1,185
435783,Schizophrenia,ethnic,Not Hispanic or Latino,94,89,183
254662,Pulmonary infarction,ethnic,Hispanic or Latino,98,86,184
192242,Acute hepatitis C,ethnic,Hispanic or Latino,50,134,184
74464,Idiopathic scoliosis AND/OR kyphoscoliosis,racial,Unknown,122,62,184
138825,Actinic keratosis,racial,White,121,63,184
4114314,Screening for osteoporosis,ethnic,Not Hispanic or Latino,170,14,184
198101,Lipoma of skin and subcutaneous tissue (excluding face),ethnic,Hispanic or Latino,119,65,184
433595,Interstitial edema,racial,Asian,61,123,184
197672,Urinary incontinence,racial,Other Race,155,28,183
314658,Cardiomegaly,racial,Black or African American ,179,4,183
135360,Fainting,racial,Asian,164,19,183
313236,Cough variant asthma,ethnic,Not Hispanic or Latino,106,77,183
31967,Nausea,racial,Unknown,145,38,183
376707,Acute conjunctivitis,ethnic,Not Hispanic or Latino,103,80,183
74635,Lumbosacral root lesion,ethnic,Hispanic or Latino,98,85,183
200031,Viral hepatitis B with hepatic coma,ethnic,Not Hispanic or Latino,181,1,182
200485,Decubitus ulcer of buttock,ethnic,Hispanic or Latino,131,50,181
321318,Angina,racial,Other Race,74,108,182
442588,OSA - Obstructive sleep apnoea,racial,Unknown,88,94,182
201131,Pelvic mass,racial,White,125,56,181
381549,Migraine with aura,ethnic,Hispanic or Latino,170,11,181
133810,Secondary hyperparathyroidism of renal origin,ethnic,Hispanic or Latino,104,77,181
134159,Precordial pain,ethnic,Hispanic or Latino,124,58,182
200031,Viral hepatitis B with hepatic coma,racial,Asian,181,0,181
381270,Parkinson's disease,racial,Asian,116,65,181
4167406,Eye disorder screening,ethnic,Hispanic or Latino,94,87,181
4152047,Lipid screening,ethnic,Hispanic or Latino,124,56,180
201078,Senile atrophic vaginitis,racial,White,178,2,180
4298697,Multiple open wounds without complication,racial,White,80,101,181
76786,Derangement of knee,ethnic,Not Hispanic or Latino,62,119,181
443431,Disorder of menstruation,racial,Unknown,181,0,181
74725,Displacement of cervical intervertebral disc without myelopathy,ethnic,Hispanic or Latino,133,47,180
444070,Tachycardia,racial,White,116,64,180
197607,Polymenorrhagia,racial,Unknown,180,0,180
260134,Croup,racial,White,61,119,180
135772,Goiter,racial,White,167,13,180
377279,"Profound impairment, one eye",ethnic,Hispanic or Latino,86,94,180
437382,Urine observation,ethnic,Not Hispanic or Latino,145,35,180
373995,Delirium,racial,White,76,104,180
254443,Sicca syndrome,ethnic,Hispanic or Latino,163,17,180
442588,OSA - Obstructive sleep apnoea,ethnic,Not Hispanic or Latino,62,118,180
75346,Disorder of meniscus of knee,ethnic,Not Hispanic or Latino,177,2,179
72993,Primary localised osteoarthrosis,racial,Unknown,85,94,179
435216,Disorder associated with type I diabetes mellitus,ethnic,Hispanic or Latino,112,68,180
4154309,Severe recurrent major depression with psychotic features,racial,Asian,179,0,179
434169,Abnormal findings on diagnostic imaging of breast,ethnic,Not Hispanic or Latino,178,1,179
433736,Obesity,racial,American Indian or Alaska Native ,132,47,179
201826,Type 2 diabetes mellitus,racial,American Indian or Alaska Native ,131,48,179
4311591,Cramp in limb,racial,Asian,63,116,179
201322,Internal hemorrhoids without complication,racial,White,107,71,178
197676,Hepatomegaly,ethnic,Hispanic or Latino,138,40,178
440360,Pure hyperglyceridemia,racial,Asian,59,119,178
133298,Musculoskeletal disorder of the neck,ethnic,Hispanic or Latino,129,49,178
4133029,Primigravida,racial,Unknown,178,0,178
30437,Gastroesophageal reflux disease with esophagitis,racial,Unknown,110,68,178
443587,Diastolic heart failure,racial,Unknown,104,73,177
432876,Bipolar I disorder,racial,White,116,61,177
138604,"Contusion of face, scalp and neck, excluding eye(s)",ethnic,Hispanic or Latino,88,89,177
74114,Cellulitis and abscess of foot excluding toe,ethnic,Hispanic or Latino,79,98,177
440693,Continuous opioid dependence,racial,White,62,115,177
374888,Dementia associated with another disease,racial,Other Race,167,10,177
4175226,Screening for malignant neoplasm of colon,racial,Black or African American ,94,82,176
260123,Acute inflammation of sinus,racial,Other Race,100,76,176
138384,Acquired hypothyroidism,racial,White,131,46,177
4029488,Hepatic encephalopathy,ethnic,Hispanic or Latino,8,168,176
80502,Osteoporosis,racial,Black or African American ,176,1,177
197610,Ovarian cyst,racial,Unknown,176,0,176
135287,Non-neoplastic naevus,ethnic,Hispanic or Latino,94,81,175
379801,Trigeminal neuralgia,ethnic,Hispanic or Latino,140,35,175
201418,"Flatulence, eructation and gas pain",racial,White,112,64,176
316084,Lymphadenitis,ethnic,Hispanic or Latino,97,77,174
444291,Cochlear hearing loss,ethnic,Hispanic or Latino,115,59,174
444239,Postprocedural state finding,ethnic,Not Hispanic or Latino,125,49,174
195596,Chronic pancreatitis,ethnic,Hispanic or Latino,103,71,174
194686,Acquired renal cyst,racial,Unknown,161,13,174
4311159,Midline cystocele,racial,White,174,0,174
377552,Moderate nonproliferative diabetic retinopathy,ethnic,Hispanic or Latino,117,57,174
80813,Lumbosacral spondylosis without myelopathy,racial,Unknown,119,55,174
81151,Sprain of ankle joint,racial,Unknown,114,60,174
380986,Senile dementia with delusion,ethnic,Not Hispanic or Latino,173,0,173
198199,Pyelonephritis,racial,White,148,26,174
373995,Delirium,racial,Other Race,28,146,174
442256,Disorder of bursae of shoulder region,racial,White,109,64,173
77968,Hallux valgus AND bunion,racial,White,131,41,172
199839,External haemorrhoids without complication,racial,Unknown,127,46,173
74396,TMJ - Temporomandibular joint disorder,ethnic,Hispanic or Latino,143,29,172
77642,Arthralgia of the forearm,ethnic,Not Hispanic or Latino,142,31,173
77030,Disease of breast,racial,White,170,2,172
319843,Mitral valve disorder,ethnic,Not Hispanic or Latino,74,98,172
193874,Bed wetting,ethnic,Hispanic or Latino,77,95,172
77025,Diverticulitis of colon,racial,White,128,43,171
4114314,Screening for osteoporosis,racial,Unknown,163,8,171
432571,Malignant lymphoma,ethnic,Hispanic or Latino,137,34,171
4059014,Spontaneous bruising,ethnic,Hispanic or Latino,111,60,171
441874,Cerebral thrombosis,racial,Unknown,167,4,171
377821,Neurological disorder associated with type I diabetes mellitus,racial,Unknown,136,35,171
4109880,Varicose veins of the leg with ulcer,ethnic,Hispanic or Latino,97,73,170
4088920,Womb absent,racial,White,170,0,170
444070,Tachycardia,racial,Unknown,148,22,170
375552,Pterygium,racial,White,86,83,169
140842,Changes in skin texture,racial,White,94,75,169
377821,Neurological disorder associated with type I diabetes mellitus,racial,White,144,25,169
197494,Viral hepatitis C,racial,White,73,96,169
134736,Backache,racial,Other Race,103,66,169
254662,Pulmonary infarction,racial,White,91,77,168
4171430,Screening for malignant neoplasm of rectum,ethnic,Not Hispanic or Latino,88,80,168
4086918,Viral screening,racial,Asian,89,79,168
4211231,Panic disorder without agoraphobia,racial,Unknown,110,58,168
4103471,Observation of body mass index,racial,Filipino,92,76,168
201620,Calculus of kidney,ethnic,Not Hispanic or Latino,89,79,168
201069,"Peptic ulcer without hemorrhage, without perforation AND without obstruction",ethnic,Not Hispanic or Latino,142,26,168
374948,Acute nonsuppurative otitis media,ethnic,Hispanic or Latino,63,105,168
4201387,Tracheostomy in situ,ethnic,Hispanic or Latino,65,102,167
73553,Arthropathy,racial,Black or African American ,154,13,167
138379,"Chronic lymphoid leukemia, disease",ethnic,Not Hispanic or Latino,60,107,167
138463,Oral aphthae,ethnic,Hispanic or Latino,98,70,168
199877,Mucous polyp of cervix,racial,White,167,1,168
442068,Cellulitis and abscess of forearm,racial,White,83,84,167
199856,Varicose veins of lower extremity with inflammation,racial,White,132,35,167
4096347,Gouty arthropathy,ethnic,Hispanic or Latino,48,119,167
78835,Palindromic rheumatism of the lower leg,racial,Unknown,109,58,167
4005823,Tobacco user,ethnic,Not Hispanic or Latino,52,115,167
195306,Gastroduodenitis,racial,Other Race,121,46,167
4245252,Raised prostate specific antigen,ethnic,Not Hispanic or Latino,0,166,166
435782,Chronic schizophrenic,ethnic,Hispanic or Latino,77,89,166
443729,Peripheral circulatory disorder associated with type II diabetes mellitus,racial,Other Race,160,7,167
319041,Orthostatic hypotension,ethnic,Hispanic or Latino,128,38,166
376406,"Impairment level: blindness, one eye - low vision other eye",racial,Asian,30,136,166
381295,Age-related cataract,racial,White,139,26,165
380415,Acute swimmer's ear,ethnic,Hispanic or Latino,95,70,165
435508,Adrenal cortical hypofunction,ethnic,Hispanic or Latino,143,22,165
432284,Single major depressive episode,racial,Other Race,135,31,166
317302,Coronary sinus rhythm disorder,racial,White,89,76,165
197381,Epigastric pain,ethnic,Not Hispanic or Latino,113,52,165
261325,Pulmonary emphysema,racial,Unknown,102,63,165
193809,Melena due to gastrointestinal hemorrhage,racial,Unknown,112,53,165
4168213,Chest pain on breathing,ethnic,Hispanic or Latino,106,59,165
440329,Herpes zoster without complication,racial,Unknown,126,39,165
436073,Psychotic disorder,ethnic,Not Hispanic or Latino,91,74,165
439082,Menopausal syndrome,ethnic,Not Hispanic or Latino,164,1,165
133727,Thyrotoxicosis without goiter OR other cause,racial,Asian,47,118,165
438406,"Major depressive disorder, single episode, severe with psychotic features",ethnic,Hispanic or Latino,46,119,165
320128,Essential hypertension,racial,Native Hawaiian or Other Pacific Islander ,92,73,165
439125,T21 - Trisomy 21,racial,Unknown,24,140,164
435023,Mild hyperemesis-not delivered,ethnic,Hispanic or Latino,164,0,164
75637,Acquired postural kyphosis,ethnic,Hispanic or Latino,155,8,163
432738,Iceland disease,racial,White,89,74,163
312922,Coronary bypass graft observation,racial,Unknown,42,122,164
132659,Acute apical periodontitis,racial,White,98,66,164
444112,Integumentary system finding,ethnic,Hispanic or Latino,104,60,164
312437,Dyspnea,ethnic,Not Hispanic or Latino,111,52,163
374060,Acute ill-defined cerebrovascular disease,racial,Black or African American ,58,106,164
134870,Pityriasis versicolor,ethnic,Hispanic or Latino,104,59,163
312723,Congenital heart disease,racial,White,77,85,162
312648,Benign essential hypertension,racial,Native Hawaiian or Other Pacific Islander ,40,123,163
381316,CVA - Cerebrovascular accident,ethnic,Hispanic or Latino,83,80,163
74138,Pathological fracture of vertebra,ethnic,Hispanic or Latino,158,4,162
312327,Acute myocardial infarction,racial,White,58,104,162
197925,Haemorrhage of rectum and anus,racial,Unknown,85,77,162
80816,Intervertebral disc degeneration,ethnic,Hispanic or Latino,85,77,162
439253,"Bipolar affective disorder, currently depressed, mild",racial,White,148,14,162
200962,Primary malignant neoplasm of prostate,ethnic,Not Hispanic or Latino,0,162,162
4049623,"Moderate major depression, single episode",racial,Other Race,56,105,161
133298,Musculoskeletal disorder of the neck,racial,White,104,58,162
437969,Acquired pes planus,racial,White,54,107,161
201899,Unilateral recurrent inguinal hernia,ethnic,Hispanic or Latino,10,152,162
318712,Peripheral circulatory disorder associated with type I diabetes mellitus,racial,Unknown,107,54,161
4084229,Primary gout,ethnic,Hispanic or Latino,30,131,161
434613,Generalized anxiety disorder,racial,Other Race,128,33,161
442013,Burn,ethnic,Hispanic or Latino,101,60,161
194411,Unilateral simple inguinal hernia,racial,White,17,143,160
79908,Muscle strength reduced,ethnic,Not Hispanic or Latino,19,142,161
381581,Chalazion,ethnic,Hispanic or Latino,94,67,161
193251,Umbilical hernia without obstruction AND without gangrene,racial,Unknown,92,68,160
442565,Gestational edema without hypertension,racial,White,160,0,160
192279,Diabetic nephropathy,racial,Other Race,110,50,160
80816,Intervertebral disc degeneration,racial,White,86,74,160
320536,Abnormal EKG finding,racial,Unknown,92,68,160
4062637,TB - Tuberculosis screening,racial,Asian,83,77,160
321588,Heart disease,racial,Unknown,152,8,160
443585,Abrasion AND/OR friction burn of multiple sites,ethnic,Hispanic or Latino,70,90,160
81984,Sprain of shoulder and upper arm,racial,White,93,67,160
373995,Delirium,racial,Black or African American ,148,12,160
377277,Impairment level: total impairment of both eyes,ethnic,Hispanic or Latino,103,57,160
374013,Secondary Parkinson's disease,racial,White,116,43,159
442604,Hypertensive heart disease,racial,White,95,64,159
138519,Spondylosis without myelopathy,ethnic,Hispanic or Latino,83,77,160
435515,Hypo-osmolality and or hyponatremia,racial,White,83,77,160
443414,Chronic post-traumatic stress disorder,racial,Asian,17,142,159
141253,Disease of thyroid gland,racial,White,127,32,159
200174,Disease of skin AND/OR subcutaneous tissue,racial,Unknown,112,47,159
197610,Ovarian cyst,ethnic,Not Hispanic or Latino,159,0,159
437264,Tobacco dependence syndrome,racial,Other Race,61,98,159
141932,Senile hyperkeratosis,ethnic,Hispanic or Latino,88,70,158
440076,SS - Short stature,ethnic,Hispanic or Latino,52,107,159
198363,Candidiasis of vagina,ethnic,Not Hispanic or Latino,154,4,158
443563,Arteriosclerosis in coronary artery bypass graft,ethnic,Hispanic or Latino,43,115,158
4185302,Chronic myocardial ischemia,ethnic,Hispanic or Latino,125,33,158
375545,Lens opacity,racial,Black or African American ,16,142,158
439253,"Bipolar affective disorder, currently depressed, mild",ethnic,Hispanic or Latino,145,13,158
321596,Peripheral venous insufficiency,racial,White,113,45,158
197320,ARF - Acute renal failure,racial,White,72,86,158
132553,Herpangina,racial,White,62,96,158
432869,Hemorrhagic disorder due to circulating anticoagulants,racial,White,155,2,157
4062484,Cervical neoplasia screening,racial,Other Race,157,0,157
442774,Intermittent claudication,ethnic,Hispanic or Latino,95,62,157
73560,Calcaneal spur,racial,White,127,30,157
375546,Combined nonsenile cataract,racial,White,157,0,157
4008683,Anxiety neurosis,ethnic,Hispanic or Latino,109,49,158
375239,Cerebral degeneration,ethnic,Hispanic or Latino,126,31,157
4046893,Lifestyle,ethnic,Hispanic or Latino,68,88,156
195771,Secondary diabetes mellitus,racial,White,97,60,157
4299535,Pregnancy confirmed,ethnic,Not Hispanic or Latino,149,8,157
436373,DSD - Developmental speech disorder,racial,Unknown,37,119,156
434752,Positive serological AND/OR viral culture findings for human immunodeficiency virus,ethnic,Hispanic or Latino,22,134,156
312998,Pain in thoracic spine,racial,White,99,58,157
198520,Lumbar spondylosis with myelopathy,ethnic,Hispanic or Latino,135,22,157
437092,Physiological development failure,racial,Unknown,104,52,156
260427,Common cold,ethnic,Not Hispanic or Latino,81,76,157
374028,AAMD - Age related macular degeneration,racial,White,91,66,157
435224,Leukopenia,ethnic,Hispanic or Latino,113,43,156
433456,Acute pain,racial,White,96,60,156
199866,Acute gastritis,ethnic,Not Hispanic or Latino,62,94,156
192606,Paraplegia,ethnic,Hispanic or Latino,75,81,156
437478,Bite of nonvenomous arthropod,ethnic,Hispanic or Latino,79,77,156
439297,Nuclear senile cataract,racial,Unknown,108,48,156
197500,Primary malignant neoplasm of colon,ethnic,Not Hispanic or Latino,100,56,156
73564,Complete rupture of rotator cuff,racial,Unknown,19,137,156
192676,Cervical intraepithelial neoplasia grade 1,ethnic,Hispanic or Latino,155,1,156
200219,Abdominal pain,racial,Other Race,99,56,155
443414,Chronic post-traumatic stress disorder,ethnic,Hispanic or Latino,118,38,156
373852,Neuralgia,racial,White,118,38,156
432876,Bipolar I disorder,ethnic,Hispanic or Latino,95,61,156
373198,Unqualified visual loss of both eyes,racial,Unknown,3,152,155
133444,Thyroiditis,ethnic,Hispanic or Latino,23,133,156
444101,Hypertensive heart failure,racial,Black or African American ,7,148,155
75860,Costiveness,racial,Black or African American ,91,64,155
320746,Cardiomyopathy associated with another disorder,ethnic,Hispanic or Latino,140,14,154
441840,Clinical finding,racial,White,106,49,155
75095,Closed fracture of ankle,ethnic,Hispanic or Latino,100,55,155
435782,Chronic schizophrenic,racial,White,29,125,154
81893,Chronic ulcerative colitis,racial,White,82,73,155
375791,Uncomplicated senile dementia,racial,Filipino,59,95,154
4103638,Amputated - transfemoral,ethnic,Not Hispanic or Latino,6,148,154
201627,Abnormal vaginal bleeding,racial,White,154,0,154
435524,Sleep disorder,ethnic,Hispanic or Latino,67,87,154
433811,Hydronephrosis,racial,White,71,82,153
432741,Abnormal immunology finding,racial,White,120,34,154
259848,Chronic rhinitis,ethnic,Not Hispanic or Latino,86,67,153
436072,Bipolar disorder in partial remission,racial,White,140,13,153
373999,Diabetic oculopathy associated with type I diabetes mellitus,racial,Unknown,41,113,154
314658,Cardiomegaly,racial,Asian,149,4,153
4110815,"Sensorineural hearing loss, bilateral",ethnic,Hispanic or Latino,95,58,153
435510,Hypocalcemia,ethnic,Hispanic or Latino,103,50,153
318556,Nosebleed,racial,Unknown,69,84,153
81251,Neoplasm of breast,ethnic,Hispanic or Latino,153,0,153
195306,Gastroduodenitis,racial,Black or African American ,91,62,153
4094448,Pregnancy test negative,racial,White,152,1,153
79936,Polyuria,ethnic,Hispanic or Latino,67,85,152
436682,Moderate mental handicap,racial,White,101,51,152
257315,Bacterial pneumonia,racial,White,94,58,152
378419,AD - Alzheimer's disease,racial,Other Race,6,146,152
198558,Nycturia,ethnic,Not Hispanic or Latino,126,26,152
259848,Chronic rhinitis,racial,Unknown,89,63,152
193809,Melena due to gastrointestinal hemorrhage,ethnic,Not Hispanic or Latino,72,80,152
443430,HPV - Human papillomavirus test positive,racial,White,149,2,151
436583,[X]Falls,ethnic,Not Hispanic or Latino,86,66,152
4113027,Dietary intake observations,racial,Unknown,93,59,152
443617,Conduct disorder,ethnic,Hispanic or Latino,40,112,152
74729,Ganglion and synovial cyst,ethnic,Hispanic or Latino,109,43,152
442286,Abscess of digit,ethnic,Hispanic or Latino,91,60,151
192450,Not passing urine,ethnic,Hispanic or Latino,58,94,152
138379,"Chronic lymphoid leukemia, disease",racial,Asian,56,95,151
74138,Pathological fracture of vertebra,racial,Unknown,151,0,151
4174977,Diabetic retinopathy,ethnic,Hispanic or Latino,84,67,151
443622,Aneurysm of thoracic aorta,ethnic,Not Hispanic or Latino,15,136,151
141216,MC - Molluscum contagiosum,racial,White,63,88,151
437902,Teeth development and eruption disorders,ethnic,Hispanic or Latino,74,76,150
436785,Spinal stenosis in cervical region,ethnic,Not Hispanic or Latino,94,57,151
375529,Infantile cerebral palsy,ethnic,Not Hispanic or Latino,71,80,151
312327,Acute myocardial infarction,racial,Black or African American ,146,4,150
319034,Hypertensive heart disease without congestive heart failure,racial,Unknown,146,5,151
4299535,Pregnancy confirmed,racial,Unknown,151,0,151
375827,Acute non-suppurative otitis media - serous,racial,Unknown,65,85,150
440685,"Nondependent alcohol abuse, episodic",ethnic,Hispanic or Latino,32,118,150
192359,RF - Renal failure,racial,White,69,81,150
197950,Cellulitis and abscess of trunk,racial,White,68,82,150
78497,Cellulitis and abscess of toe,racial,White,64,85,149
440358,Lipoma,racial,White,90,59,149
442282,Urinary casts,ethnic,Hispanic or Latino,121,28,149
133729,Hyperparathyroidism,racial,White,108,41,149
75036,Primary localized osteoarthrosis of hand,ethnic,Hispanic or Latino,134,15,149
441408,Vomiting,ethnic,Not Hispanic or Latino,76,73,149
378756,Conjunctival hemorrhage,racial,White,98,50,148
4103574,Chronic depression,ethnic,Hispanic or Latino,114,35,149
137379,Musculoskeletal symptom,racial,Unknown,85,63,148
374341,Huntington's chorea,ethnic,Hispanic or Latino,127,21,148
435534,"Nondependent alcohol abuse, continuous",ethnic,Hispanic or Latino,19,129,148
4171434,Immunization refused,ethnic,Hispanic or Latino,92,56,148
374034,Visual disturbance,ethnic,Not Hispanic or Latino,87,61,148
443587,Diastolic heart failure,racial,White,110,38,148
4064918,Diabetes mellitus screening,racial,Asian,80,68,148
4091532,Bowel observation,ethnic,Hispanic or Latino,78,70,148
319034,Hypertensive heart disease without congestive heart failure,ethnic,Hispanic or Latino,137,10,147
194092,Uterine prolapse without vaginal wall prolapse,ethnic,Hispanic or Latino,147,0,147
441407,Appetite loss - anorexia,racial,Unknown,114,33,147
433400,Emergency contraception,ethnic,Hispanic or Latino,146,1,147
73291,Palindromic rheumatism of the ankle and/or foot,racial,Unknown,104,43,147
316139,HF - Heart failure,racial,Unknown,116,31,147
4103471,Observation of body mass index,racial,Native Hawaiian or Other Pacific Islander ,91,56,147
435511,Hypercalcemia,racial,Unknown,113,33,146
80180,Osteoarthritis,racial,Filipino,143,3,146
133280,Alopecia,racial,White,121,26,147
443431,Disorder of menstruation,ethnic,Not Hispanic or Latino,145,1,146
435613,Cellulitis,racial,Unknown,85,61,146
192242,Acute hepatitis C,racial,White,49,97,146
40484513,Hemiplegia of nondominant side as late effect of cerebrovascular disease,racial,White,127,19,146
373499,Disorder of eye region,racial,Unknown,94,52,146
317309,Peripheral arterial occlusive disease,racial,White,81,64,145
435511,Hypercalcemia,ethnic,Not Hispanic or Latino,88,58,146
440693,Continuous opioid dependence,ethnic,Not Hispanic or Latino,67,78,145
443257,Swellings and lumps,racial,Unknown,103,42,145
4103638,Amputated - transfemoral,racial,Black or African American ,0,145,145
372634,Nonphysiologic vision loss,ethnic,Not Hispanic or Latino,125,20,145
435796,Dehydration,racial,White,86,59,145
440078,"Bipolar affective disorder, current episode manic",racial,White,43,102,145
24660,Acute tonsillitis,ethnic,Not Hispanic or Latino,79,67,146
78472,Microscopic haematuria,racial,Unknown,77,68,145
439799,Leg cramps,ethnic,Hispanic or Latino,120,25,145
192278,Type II diabetes mellitus - poor control,racial,American Indian or Alaska Native ,98,47,145
201093,Infection of skin AND/OR subcutaneous tissue,ethnic,Hispanic or Latino,80,64,144
433750,"Single major depressive episode, in full remission",ethnic,Hispanic or Latino,109,35,144
198520,Lumbar spondylosis with myelopathy,racial,White,139,5,144
136496,Cellulitis and abscess of face,racial,White,77,67,144
437541,Glaucoma,racial,Asian,73,71,144
375545,Lens opacity,racial,Asian,75,68,143
4079876,Familial combined hyperlipidemia,racial,American Indian or Alaska Native ,78,65,143
4263370,R.I.N.D. syndrome,racial,Unknown,97,47,144
199078,Vaginal wall prolapse,ethnic,Hispanic or Latino,143,0,143
432867,Hyperlipidemia,racial,Native Hawaiian or Other Pacific Islander ,33,110,143
72748,Strain of rotator cuff of shoulder,racial,White,87,56,143
132740,Positive skin test reaction,ethnic,Not Hispanic or Latino,86,56,142
314131,Degeneration of cervical intervertebral disc,ethnic,Hispanic or Latino,94,49,143
376085,Uncomplicated presenile dementia,racial,Asian,127,16,143
315831,Chronic pulmonary heart disease,ethnic,Hispanic or Latino,113,29,142
441544,Specific nonpsychotic mental disorders following organic brain damage,ethnic,Hispanic or Latino,95,47,142
437655,Cryptorchism,racial,White,0,142,142
4062636,Bacterial disease screening,racial,White,124,19,143
192360,Cyst and pseudocyst of pancreas,ethnic,Hispanic or Latino,128,14,142
25297,Acute pharyngitis,racial,Other Race,76,66,142
438867,Generalized body aches,racial,Unknown,97,45,142
77066,Derangement of medial meniscus,ethnic,Hispanic or Latino,31,112,143
435243,Alcohol dependence,ethnic,Hispanic or Latino,16,127,143
40480002,Aphasia as late effect of cerebrovascular disease,ethnic,Hispanic or Latino,78,64,142
134438,CD - Contact dermatitis,racial,Asian,59,83,142
73754,Restless legs,racial,White,108,34,142
319843,Mitral valve disorder,racial,Asian,46,95,141
439697,Hypertensive renal disease with renal failure,ethnic,Hispanic or Latino,129,13,142
75354,Osteochondropathy,ethnic,Not Hispanic or Latino,128,13,141
440525,Prematurity of fetus,ethnic,Hispanic or Latino,71,71,142
76836,Sprain of knee and leg,racial,Unknown,99,43,142
320536,Abnormal EKG finding,ethnic,Not Hispanic or Latino,71,70,141
381017,Ametropic amblyopia,ethnic,Hispanic or Latino,97,45,142
376085,Uncomplicated presenile dementia,ethnic,Not Hispanic or Latino,127,14,141
444100,Mood disorder,ethnic,Not Hispanic or Latino,82,60,142
434170,Atypical squamous cells of undetermined significance on cervical Papanicolaou smear,racial,Unknown,141,1,142
316084,Lymphadenitis,racial,White,75,67,142
74725,Displacement of cervical intervertebral disc without myelopathy,racial,Unknown,119,22,141
4064905,Venereal disease screening,racial,Other Race,70,71,141
436033,Syphilis,ethnic,Hispanic or Latino,49,92,141
201061,Diaphragmatic hernia,racial,White,98,43,141
81931,Psoriasis with arthropathy,ethnic,Hispanic or Latino,80,61,141
139900,Urticaria,racial,Unknown,86,55,141
373478,Presbyopia,racial,White,90,50,140
40484513,Hemiplegia of nondominant side as late effect of cerebrovascular disease,ethnic,Not Hispanic or Latino,33,107,140
437175,"Fall on same level from slipping, tripping or stumbling",racial,Unknown,109,31,140
141693,Elevated blood-pressure reading without diagnosis of hypertension,racial,Other Race,76,64,140
74458,Enthesopathy of knee region,ethnic,Hispanic or Latino,136,5,141
432870,Thrombocytopenia,ethnic,Not Hispanic or Latino,40,101,141
4080568,Problem behaviour,ethnic,Hispanic or Latino,41,99,140
40484522,Hemiplegia of dominant side as late effect of cerebrovascular disease,racial,Other Race,118,22,140
374022,Hemiplegia,racial,Filipino,140,0,140
435262,Primary open angle glaucoma,ethnic,Hispanic or Latino,100,40,140
437246,Vitamin B deficiency,ethnic,Hispanic or Latino,98,42,140
438557,Abnormal glucose level,racial,Other Race,89,51,140
435783,Schizophrenia,racial,Unknown,106,34,140
134438,CD - Contact dermatitis,racial,Black or African American ,67,73,140
432545,Bacterial disease,ethnic,Hispanic or Latino,109,31,140
440693,Continuous opioid dependence,racial,Unknown,53,86,139
443237,"Manic disorder, single episode",racial,Unknown,80,59,139
433985,Hypercarotinemia,ethnic,Hispanic or Latino,57,82,139
440083,Acute stress disorder,ethnic,Hispanic or Latino,105,34,139
378425,Eyelid inflammation,racial,White,76,63,139
441980,Closed fracture of foot,racial,Unknown,9,130,139
78473,Solitary cyst of breast,ethnic,Hispanic or Latino,139,0,139
437046,Complete abortion,ethnic,Hispanic or Latino,139,0,139
193874,Bed wetting,racial,White,61,77,138
79908,Muscle strength reduced,racial,Asian,7,131,138
78272,Sprain of wrist,racial,White,87,51,138
138502,Vitiligo,racial,White,76,62,138
137063,Corns and callus,racial,Unknown,80,58,138
137053,Seborrheic dermatitis,racial,Unknown,73,65,138
200843,Observation of frequency of urination,ethnic,Not Hispanic or Latino,73,64,137
321319,Cardiomyopathy,racial,White,95,43,138
200687,Renal disorder associated with type I diabetes mellitus,racial,White,71,66,137
74458,Enthesopathy of knee region,racial,White,132,5,137
437986,FTT - Failure to thrive,ethnic,Not Hispanic or Latino,44,92,136
195501,Polycystic ovaries,racial,White,136,1,137
443238,Diabetic - poor control,racial,Other Race,125,12,137
374366,Sensorineural hearing loss,ethnic,Not Hispanic or Latino,82,55,137
138176,Acute gingivitis,ethnic,Hispanic or Latino,78,59,137
194406,Urinary tract obstruction,racial,White,9,128,137
436096,Chronic pain,racial,Black or African American ,45,92,137
312327,Acute myocardial infarction,ethnic,Not Hispanic or Latino,97,40,137
139057,Disease of oral soft tissues,racial,White,92,44,136
4206460,Problem,ethnic,Hispanic or Latino,54,82,136
433577,Hammer toe,ethnic,Hispanic or Latino,78,58,136
318169,Varicose veins of lower extremity,ethnic,Not Hispanic or Latino,4,131,135
81611,Diverticular disease of colon,ethnic,Not Hispanic or Latino,40,96,136
375791,Uncomplicated senile dementia,racial,Asian,113,22,135
432285,Recurrent major depressive episodes,racial,Asian,90,46,136
439700,Inhibited sexual desire,ethnic,Not Hispanic or Latino,0,136,136
140673,Hypothyroid,racial,Filipino,118,17,135
444132,Knee injury,racial,White,68,67,135
200763,Chronic hepatitis,ethnic,Hispanic or Latino,62,73,135
201613,Chronic nonalcoholic liver disease,ethnic,Not Hispanic or Latino,82,53,135
4287544,Manic bipolar I disorder,ethnic,Not Hispanic or Latino,107,28,135
194997,Prostatitis,ethnic,Hispanic or Latino,0,135,135
24134,Nonspecific pain in the neck region,racial,Asian,104,31,135
315085,Enlargement of lymph nodes,racial,Unknown,111,24,135
440704,Chronic pain syndrome,racial,Unknown,68,66,134
140648,Onychomycosis due to dermatophyte,racial,Other Race,55,80,135
379769,Benign brain tumour,ethnic,Not Hispanic or Latino,133,1,134
192671,GI - Gastrointestinal haemorrhage,racial,White,71,64,135
374375,Impacted cerumen,racial,Asian,71,62,133
377802,Late effects of poliomyelitis,ethnic,Hispanic or Latino,102,32,134
197684,Dysuria,racial,Asian,88,46,134
194990,Inflammatory disorder of liver,ethnic,Hispanic or Latino,75,59,134
4302252,High risk pregnancy care,ethnic,Not Hispanic or Latino,133,1,134
4165091,Lack of exercise,racial,Unknown,77,56,133
40484522,Hemiplegia of dominant side as late effect of cerebrovascular disease,ethnic,Not Hispanic or Latino,65,68,133
199075,Neurogenic bladder,ethnic,Hispanic or Latino,76,58,134
77139,Open wound of finger without complication,ethnic,Hispanic or Latino,64,70,134
436067,Schizophrenia simplex,racial,Unknown,118,15,133
134159,Precordial pain,racial,White,91,43,134
4046500,Acute peptic ulcer with hemorrhage,ethnic,Not Hispanic or Latino,131,2,133
201069,"Peptic ulcer without hemorrhage, without perforation AND without obstruction",racial,Asian,113,20,133
376112,Diabetic polyneuropathy,racial,Other Race,65,68,133
379769,Benign brain tumour,racial,Asian,133,0,133
440748,Interstitial emphysema of lung,racial,White,44,89,133
77644,Adhesive capsulitis of shoulder,racial,White,78,55,133
194574,Chronic type B viral hepatitis,ethnic,Hispanic or Latino,104,28,132
31317,Can't get food down,ethnic,Not Hispanic or Latino,51,82,133
4139420,Foreign body in auditory canal,ethnic,Hispanic or Latino,67,65,132
433031,Hallucinations,racial,White,78,55,133
4008683,Anxiety neurosis,racial,White,89,43,132
374044,Droopy eyelid,ethnic,Hispanic or Latino,74,59,133
377885,Disorder of eye movements,ethnic,Hispanic or Latino,69,64,133
377254,"Multi-infarct dementia, uncomplicated",racial,White,79,53,132
197500,Primary malignant neoplasm of colon,racial,White,61,71,132
135852,Teething syndrome,ethnic,Hispanic or Latino,50,82,132
136788,Spinal stenosis of lumbar region,ethnic,Not Hispanic or Latino,118,14,132
196341,Dermatophytosis of the perianal area,racial,Unknown,42,89,131
321887,Disorder of artery,racial,Unknown,81,50,131
314665,Atrial flutter,ethnic,Hispanic or Latino,63,68,131
440508,Congenital disease,racial,White,58,74,132
141508,Dermatophytosis of scalp or beard,ethnic,Hispanic or Latino,46,85,131
318169,Varicose veins of lower extremity,racial,Asian,0,131,131
372634,Nonphysiologic vision loss,racial,Unknown,76,55,131
4046500,Acute peptic ulcer with hemorrhage,racial,Black or African American ,131,0,131
194406,Urinary tract obstruction,racial,Unknown,0,131,131
139902,Allergic urticaria,racial,White,79,52,131
141917,Balanitis xerotica obliterans,ethnic,Hispanic or Latino,0,131,131
4086918,Viral screening,racial,Black or African American ,70,61,131
4107655,Observations relating to psychosocial functioning,ethnic,Hispanic or Latino,89,42,131
30437,Gastroesophageal reflux disease with esophagitis,ethnic,Not Hispanic or Latino,74,56,130
314131,Degeneration of cervical intervertebral disc,racial,White,91,40,131
199074,Acute pancreatitis,ethnic,Hispanic or Latino,70,60,130
259055,Extrinsic asthma with asthma attack,ethnic,Not Hispanic or Latino,53,77,130
315558,Atherosclerosis of arteries of the extremities,racial,Unknown,64,67,131
257628,Systemic lupus erythematosus,racial,Unknown,102,28,130
437409,Intracranial injury,ethnic,Hispanic or Latino,7,123,130
379805,Myopia,racial,Unknown,80,50,130
4101199,Hearing problem,racial,White,58,71,129
260139,Acute bronchitis,racial,Other Race,76,53,129
198678,Intestinal infectious disease,racial,Unknown,81,49,130
139099,Ingrowing nail,ethnic,Not Hispanic or Latino,68,61,129
443728,Mass of chest wall,ethnic,Hispanic or Latino,58,72,130
79072,Inflammatory disorder of breast,ethnic,Hispanic or Latino,128,2,130
195596,Chronic pancreatitis,racial,White,82,48,130
377861,Disorder of refraction AND/OR accommodation,racial,Other Race,62,67,129
381292,Chronic allergic conjunctivitis,racial,Asian,115,14,129
140020,Viral exanthem,racial,White,47,82,129
196726,Cholelithiasis AND acute cholecystitis without obstruction,racial,Unknown,40,89,129
435243,Alcohol dependence,ethnic,Not Hispanic or Latino,7,122,129
194083,Vaginitis and vulvovaginitis,racial,Other Race,129,0,129
442752,Myalgia,racial,Asian,22,107,129
256440,Disorder of paranasal sinuses,ethnic,Not Hispanic or Latino,76,53,129
194984,Hepatopathy,racial,White,74,54,128
313217,Atrial fibrillation,racial,Other Race,42,86,128
132408,Back problem,racial,White,93,35,128
256448,Chronic asthmatic bronchitis,ethnic,Not Hispanic or Latino,61,67,128
435220,Severe recurrent major depression without psychotic features,racial,White,91,38,129
375252,Disorder of eye,racial,White,65,63,128
192606,Paraplegia,racial,White,50,79,129
257628,Systemic lupus erythematosus,ethnic,Not Hispanic or Latino,119,10,129
374341,Huntington's chorea,racial,White,107,22,129
440389,MR - Mental retardation,ethnic,Not Hispanic or Latino,100,28,128
376400,Combined form of senile cataract,racial,Unknown,80,48,128
435508,Adrenal cortical hypofunction,racial,White,104,24,128
198558,Nycturia,racial,Asian,124,5,129
4287544,Manic bipolar I disorder,racial,White,116,13,129
76191,Disease of upper arm,ethnic,Hispanic or Latino,98,29,127
432865,Acute exacerbation of subchronic schizoaffective schizophrenia,ethnic,Hispanic or Latino,128,0,128
434610,Hyperkalemia,ethnic,Not Hispanic or Latino,65,62,127
381549,Migraine with aura,racial,White,119,9,128
377279,"Profound impairment, one eye",racial,Unknown,110,17,127
380986,Senile dementia with delusion,racial,Filipino,128,0,128
201518,Primary malignant neoplasm of lower limb,racial,Asian,127,0,127
134460,Plantar fascial fibromatosis,ethnic,Not Hispanic or Latino,81,46,127
373747,Extrapyramidal disease,ethnic,Hispanic or Latino,28,100,128
432838,Primary malignant neoplasm of cardia of stomach,ethnic,Hispanic or Latino,127,0,127
436954,Drug abuse,racial,White,45,82,127
200845,Urinary precipitancy,racial,White,78,49,127
316437,Cerebral atherosclerosis,ethnic,Hispanic or Latino,79,49,128
77638,Displacement of intervertebral disc without myelopathy,racial,Unknown,110,17,127
201518,Primary malignant neoplasm of lower limb,ethnic,Not Hispanic or Latino,127,0,127
440748,Interstitial emphysema of lung,racial,Unknown,95,32,127
197684,Dysuria,racial,Black or African American ,85,42,127
434752,Positive serological AND/OR viral culture findings for human immunodeficiency virus,racial,White,19,109,128
4340380,Hepatitis C carrier,ethnic,Hispanic or Latino,43,84,127
317898,Malignant essential hypertension,ethnic,Not Hispanic or Latino,25,103,128
432838,Primary malignant neoplasm of cardia of stomach,racial,White,127,0,127
195083,Left lower quadrant pain,racial,Unknown,100,26,126
193782,End stage renal disease,racial,Other Race,47,80,127
4171556,Ankle ulcer,ethnic,Hispanic or Latino,84,43,127
436067,Schizophrenia simplex,ethnic,Not Hispanic or Latino,35,91,126
443622,Aneurysm of thoracic aorta,racial,Asian,0,127,127
260125,Acute bronchiolitis,racial,Unknown,59,68,127
4051114,FH: Diabetes mellitus,racial,Unknown,86,40,126
197607,Polymenorrhagia,ethnic,Not Hispanic or Latino,127,0,127
374366,Sensorineural hearing loss,racial,Asian,73,54,127
134870,Pityriasis versicolor,racial,White,76,50,126
137497,Dermatophytosis of the body,ethnic,Not Hispanic or Latino,70,56,126
200528,Ascites,ethnic,Hispanic or Latino,74,52,126
376683,Non proliferative diabetic retinopathy,ethnic,Not Hispanic or Latino,102,24,126
440076,SS - Short stature,racial,White,36,90,126
320746,Cardiomyopathy associated with another disorder,racial,Unknown,123,3,126
443344,Barrett esophagus,ethnic,Hispanic or Latino,45,80,125
315833,Secondary cardiomyopathy,racial,Other Race,125,1,126
4311591,Cramp in limb,racial,White,88,37,125
314666,Healed coronary,ethnic,Not Hispanic or Latino,49,76,125
4070671,"Middle ear anomaly, excluding ossicles",ethnic,Hispanic or Latino,0,125,125
435171,Allergic state,racial,Unknown,73,52,125
440238,Closed fracture of metatarsal bone,ethnic,Hispanic or Latino,83,42,125
4091532,Bowel observation,racial,White,73,53,126
200485,Decubitus ulcer of buttock,racial,Unknown,97,28,125
198263,Right upper quadrant pain,ethnic,Not Hispanic or Latino,98,27,125
4079876,Familial combined hyperlipidemia,racial,Filipino,70,55,125
317898,Malignant essential hypertension,racial,Unknown,97,28,125
78517,Arthralgia of multiple joints,ethnic,Not Hispanic or Latino,93,32,125
372309,Mononeuritis,racial,Unknown,46,79,125
73840,Primary localised osteoarthrosis of shoulder region,racial,Unknown,79,46,125
4152047,Lipid screening,racial,White,84,40,124
317002,Hypopiesis,racial,Unknown,84,40,124
73819,Painful breasts,racial,Unknown,124,0,124
136184,Pruritic disorder,racial,Unknown,85,40,125
80242,Current tear of medial cartilage AND/OR meniscus of knee,racial,White,67,58,125
438480,"Abnormal glucose tolerance in mother complicating pregnancy, childbirth AND/OR puerperium",racial,White,124,0,124
201322,Internal hemorrhoids without complication,racial,Unknown,91,33,124
257004,Acute exacerbation of chronic obstructive airways disease,racial,Other Race,116,8,124
438332,Disease of possible viral origin,racial,Other Race,59,65,124
72465,Closed fracture of one or more phalanges of hand,ethnic,Hispanic or Latino,51,73,124
436785,Spinal stenosis in cervical region,racial,Asian,83,41,124
434467,Ostium secundum type atrial septal defect,ethnic,Hispanic or Latino,77,47,124
4170137,Non-suppurative otitis media,ethnic,Hispanic or Latino,73,50,123
193782,End stage renal disease,racial,Asian,40,83,123
4064375,Iron deficiency screening,racial,Other Race,68,55,123
313502,Benign hypertensive heart disease without congestive heart failure,ethnic,Hispanic or Latino,83,40,123
260139,Acute bronchitis,racial,Asian,85,38,123
26662,Testicular hypofunction,racial,Unknown,0,123,123
316535,Closed fracture of dorsal vertebra without spinal cord injury,ethnic,Hispanic or Latino,115,7,122
260123,Acute inflammation of sinus,racial,Black or African American ,59,63,122
4092896,Stool contents abnormal,racial,Unknown,75,47,122
443776,Brachial radiculitis,racial,White,93,29,122
312950,IgE-mediated allergic asthma,racial,Black or African American ,106,17,123
437264,Tobacco dependence syndrome,racial,Asian,28,95,123
372903,Retinal edema,ethnic,Hispanic or Latino,95,27,122
27674,N&V - Nausea and vomiting,ethnic,Not Hispanic or Latino,80,41,121
195847,Gastroparesis syndrome,racial,Unknown,93,29,122
4087756,Late latent syphilis,ethnic,Hispanic or Latino,16,106,122
4147961,Screening for malignant neoplasm of breast,racial,Other Race,121,0,121
443597,Chronic kidney disease stage 3,racial,Black or African American ,64,57,121
30234,Cervical sprain,racial,Unknown,81,40,121
76153,Low compliance bladder,racial,White,112,9,121
193016,Cystic disease of kidney,racial,Unknown,92,29,121
314971,Chronic respiratory failure,ethnic,Hispanic or Latino,65,56,121
4141481,"Hand, foot and mouth disease",ethnic,Hispanic or Latino,46,75,121
142026,Disorder of cardiovascular prostheses and implants,ethnic,Hispanic or Latino,119,2,121
317898,Malignant essential hypertension,racial,Other Race,121,0,121
137379,Musculoskeletal symptom,racial,White,71,50,121
438878,Abnormal results of liver function studies,ethnic,Not Hispanic or Latino,53,68,121
4252735,Mourning,racial,White,115,6,121
138479,Thyroid dysfunction during pregnancy - baby not yet delivered,ethnic,Hispanic or Latino,121,0,121
432895,Cortical senile cataract,ethnic,Hispanic or Latino,88,33,121
434902,Autistic disorder of childhood onset,ethnic,Not Hispanic or Latino,13,109,122
436665,Manic-depressive psychosis,racial,Black or African American ,18,103,121
442077,Anxiety disorder,ethnic,Hispanic or Latino,100,20,120
434170,Atypical squamous cells of undetermined significance on cervical Papanicolaou smear,ethnic,Not Hispanic or Latino,117,4,121
133299,Swelling of limb,racial,White,79,41,120
313459,Sleep apnea,racial,Asian,2,119,121
138463,Oral aphthae,racial,White,59,61,120
443767,Diabetic oculopathy,racial,Asian,70,50,120
192731,Digestive symptom,ethnic,Hispanic or Latino,65,55,120
4150307,Dental restoration observation,ethnic,Hispanic or Latino,88,32,120
441628,Menopausal and postmenopausal disorders,racial,White,120,0,120
440674,Gout,racial,Other Race,19,101,120
378253,HA - Headache,racial,Other Race,88,32,120
314059,Right bundle branch block,racial,Unknown,55,65,120
195771,Secondary diabetes mellitus,racial,Unknown,85,35,120
138525,Pain in limb,racial,Asian,52,68,120
4171434,Immunization refused,racial,White,73,47,120
80824,Senile osteoporosis,racial,Other Race,73,47,120
433440,Dysthymia,racial,Asian,119,1,120
316994,Malignant hypertensive heart disease with congestive cardiac failure,ethnic,Hispanic or Latino,100,20,120
138604,"Contusion of face, scalp and neck, excluding eye(s)",racial,White,61,58,119
201927,Cellulitis and abscess of leg,ethnic,Not Hispanic or Latino,53,67,120
432881,Pancytopenia,ethnic,Hispanic or Latino,79,41,120
4115379,"Localised, primary osteoarthritis of the pelvic region and thigh",racial,White,89,30,119
257012,Chronic rhinosinusitis,racial,Black or African American ,95,24,119
436233,Delayed milestone,ethnic,Hispanic or Latino,50,68,118
81723,Contusion of hand,ethnic,Hispanic or Latino,62,56,118
201603,Disease of teeth AND/OR supporting structures,ethnic,Not Hispanic or Latino,64,55,119
75004,Frank hematuria,ethnic,Hispanic or Latino,27,92,119
376114,Severe nonproliferative diabetic retinopathy,ethnic,Hispanic or Latino,48,70,118
4116452,Generalized osteoarthritis NOS,ethnic,Hispanic or Latino,91,28,119
377290,Legal blindness USA,racial,Unknown,28,91,119
436954,Drug abuse,ethnic,Hispanic or Latino,39,79,118
80189,Displacement of lumbar intervertebral disc without myelopathy,ethnic,Not Hispanic or Latino,70,49,119
443776,Brachial radiculitis,ethnic,Not Hispanic or Latino,34,85,119
441407,Appetite loss - anorexia,racial,White,61,58,119
432875,Anemia due to chronic blood loss,racial,White,115,3,118
443454,Cerebral infarction,racial,Asian,10,108,118
378743,Mild nonproliferative retinopathy,racial,White,52,66,118
440069,Drug dependence,ethnic,Hispanic or Latino,67,50,117
80800,Polymyositis,ethnic,Hispanic or Latino,118,0,118
443537,Deep venous thrombosis of lower extremity,racial,Asian,114,4,118
78804,Schimmelbusch's disease,ethnic,Hispanic or Latino,117,1,118
197914,Chronic gastric ulcer with perforation but without obstruction,racial,White,118,0,118
443597,Chronic kidney disease stage 3,racial,Other Race,73,45,118
253009,Thoracogenic scoliosis,ethnic,Hispanic or Latino,1,117,118
196463,Alcoholic cirrhosis,racial,Unknown,47,71,118
433163,Deficiency of macronutrients,ethnic,Hispanic or Latino,83,34,117
4185302,Chronic myocardial ischemia,racial,Unknown,112,5,117
80189,Displacement of lumbar intervertebral disc without myelopathy,racial,Unknown,65,52,117
437525,Overweight,racial,American Indian or Alaska Native ,86,31,117
253009,Thoracogenic scoliosis,racial,Unknown,0,117,117
4206460,Problem,racial,White,46,71,117
137977,Icteric,ethnic,Hispanic or Latino,48,69,117
255573,Chronic obstructive lung disease,racial,Other Race,96,21,117
255841,Chronic bronchitis,ethnic,Not Hispanic or Latino,83,34,117
443617,Conduct disorder,racial,White,29,88,117
375528,Spastic hemiplegia,ethnic,Hispanic or Latino,52,65,117
439795,Minimal cognitive impairment,ethnic,Not Hispanic or Latino,41,76,117
373478,Presbyopia,racial,Unknown,75,41,116
254761,Cough,racial,Black or African American ,66,50,116
142026,Disorder of cardiovascular prostheses and implants,racial,Unknown,116,1,117
138525,Pain in limb,racial,Black or African American ,49,67,116
444129,Wrist injury,ethnic,Hispanic or Latino,59,58,117
444391,Pain around eye,racial,White,82,34,116
4290927,Impairment level: low vision of both eyes,racial,White,49,67,116
375529,Infantile cerebral palsy,racial,Unknown,79,38,117
443454,Cerebral infarction,racial,Unknown,69,47,116
380415,Acute swimmer's ear,racial,White,65,51,116
4263748,Recurrent major depression in complete remission,ethnic,Hispanic or Latino,56,60,116
433968,Candidiasis,racial,White,76,39,115
132706,Nail disease,racial,White,67,48,115
193522,Acute prostatitis,ethnic,Hispanic or Latino,0,115,115
260123,Acute inflammation of sinus,racial,Asian,60,55,115
432453,General clinical state finding,ethnic,Hispanic or Latino,87,28,115
135287,Non-neoplastic naevus,racial,White,62,53,115
432661,Stomatitis,racial,White,71,44,115
81151,Sprain of ankle joint,ethnic,Not Hispanic or Latino,72,43,115
40485064,Latent syphilis,racial,White,15,100,115
257581,Exacerbation of asthma,racial,Black or African American ,52,63,115
320128,Essential hypertension,racial,Asian Indian,97,17,114
435023,Mild hyperemesis-not delivered,racial,White,114,0,114
381857,Impairment level: one eye: total impairment: other eye: not specified,racial,Unknown,41,73,114
74396,TMJ - Temporomandibular joint disorder,racial,White,97,17,114
377889,Hearing loss,racial,Other Race,63,51,114
377527,Presenile dementia with depression,racial,Unknown,107,6,113
256440,Disorder of paranasal sinuses,racial,Unknown,67,46,113
435656,Neonatal jaundice,racial,White,47,66,113
78516,Arthralgia of the upper arm,racial,Unknown,85,28,113
134736,Backache,racial,Black or African American ,57,56,113
197795,Acute hepatitis B,ethnic,Not Hispanic or Latino,109,5,114
197304,Ulcer of lower limb,racial,White,67,46,113
436033,Syphilis,racial,White,31,83,114
442615,Carotid artery stenosis,racial,Unknown,76,38,114
444093,Patient status finding,ethnic,Hispanic or Latino,73,40,113
374013,Secondary Parkinson's disease,racial,Unknown,70,43,113
312922,Coronary bypass graft observation,ethnic,Not Hispanic or Latino,28,85,113
196726,Cholelithiasis AND acute cholecystitis without obstruction,ethnic,Hispanic or Latino,112,1,113
442604,Hypertensive heart disease,ethnic,Not Hispanic or Latino,96,17,113
439221,"Adverse effect, due to correct medicinal substance properly administered",ethnic,Hispanic or Latino,63,50,113
80495,Palindromic rheumatism of the pelvic region and thigh,ethnic,Hispanic or Latino,93,20,113
432795,Traumatic AND/OR non-traumatic injury,ethnic,Hispanic or Latino,55,58,113
435534,"Nondependent alcohol abuse, continuous",racial,White,25,88,113
440465,Postpartum state,ethnic,Hispanic or Latino,110,2,112
133835,Dermatitis,racial,Unknown,70,43,113
4096215,"Hyperlipidemia, group A",racial,Filipino,97,15,112
77635,Disease of hand,racial,White,85,28,113
4090651,Dialysis observation,racial,Unknown,78,34,112
40479192,Chronic systolic heart failure,racial,Other Race,53,59,112
437409,Intracranial injury,racial,Unknown,0,112,112
195851,"Gastric ulcer without hemorrhage, without perforation AND without obstruction",racial,White,20,92,112
4292726,Contact - infectious disease,ethnic,Hispanic or Latino,67,46,113
197500,Primary malignant neoplasm of colon,racial,Asian,71,41,112
76611,Injury of shoulder region,ethnic,Hispanic or Latino,64,48,112
444246,Cirrhosis of liver not due to alcohol,racial,Asian,107,5,112
134438,CD - Contact dermatitis,racial,Other Race,61,50,111
319843,Mitral valve disorder,racial,Unknown,84,28,112
256717,Bronchospasm,racial,White,67,45,112
317890,Mitral and aortic stenosis,ethnic,Hispanic or Latino,102,10,112
197911,Hernia of anterior abdominal wall without obstruction AND without gangrene,racial,Unknown,65,46,111
192360,Cyst and pseudocyst of pancreas,racial,White,111,1,112
433595,Interstitial edema,racial,Other Race,91,20,111
197795,Acute hepatitis B,racial,Asian,110,2,112
317890,Mitral and aortic stenosis,racial,Unknown,102,10,112
79864,Hematuria syndrome,ethnic,Hispanic or Latino,45,67,112
438409,Attention deficit hyperactivity disorder,racial,Unknown,19,92,111
441284,Open-angle glaucoma,ethnic,Not Hispanic or Latino,85,27,112
441835,Chronic schizoaffective schizophrenia,racial,White,94,18,112
200687,Renal disorder associated with type I diabetes mellitus,racial,Unknown,48,63,111
74635,Lumbosacral root lesion,racial,White,73,38,111
435510,Hypocalcemia,racial,White,66,44,110
254443,Sicca syndrome,racial,White,108,2,110
433736,Obesity,racial,Native Hawaiian or Other Pacific Islander ,51,59,110
441264,Primary thrombocytopenia,racial,White,44,67,111
442256,Disorder of bursae of shoulder region,racial,Unknown,61,49,110
194574,Chronic type B viral hepatitis,racial,White,75,35,110
432612,Mild mental handicap,ethnic,Hispanic or Latino,41,69,110
372906,Both eyes total visual impairment,ethnic,Not Hispanic or Latino,99,11,110
139900,Urticaria,ethnic,Not Hispanic or Latino,67,43,110
200962,Primary malignant neoplasm of prostate,racial,Other Race,0,110,110
433195,Transient arterial retinal occlusion,ethnic,Hispanic or Latino,1,109,110
257004,Acute exacerbation of chronic obstructive airways disease,racial,Black or African American ,70,40,110
437478,Bite of nonvenomous arthropod,racial,White,59,51,110
78232,Shoulder joint pain,racial,Other Race,74,36,110
443237,"Manic disorder, single episode",racial,Other Race,0,110,110
192671,GI - Gastrointestinal haemorrhage,racial,Unknown,66,44,110
435839,Lymphatic oedema,ethnic,Hispanic or Latino,76,34,110
377527,Presenile dementia with depression,ethnic,Not Hispanic or Latino,109,1,110
193016,Cystic disease of kidney,racial,White,70,40,110
192286,Intestinal disaccharidase deficiency,racial,White,80,29,109
376683,Non proliferative diabetic retinopathy,racial,Asian,94,15,109
442764,Anal pain,ethnic,Hispanic or Latino,60,49,109
437233,Plasmacytic myeloma,ethnic,Hispanic or Latino,91,19,110
440424,Aphasia,racial,Unknown,25,84,109
374948,Acute nonsuppurative otitis media,racial,White,38,71,109
4105330,Chronic undifferentiated schizophrenia,ethnic,Hispanic or Latino,36,73,109
76482,MA - Missed abortion,ethnic,Hispanic or Latino,109,0,109
434056,Late effects of cerebrovascular disease,racial,Black or African American ,58,50,108
442013,Burn,racial,White,64,45,109
195867,Noninflammatory vaginal disorders,ethnic,Hispanic or Latino,109,0,109
194696,Menorrhalgia,racial,Unknown,109,0,109
321887,Disorder of artery,racial,White,65,43,108
196158,Disease of penis,ethnic,Hispanic or Latino,0,109,109
137213,Fungal dermatosis,ethnic,Hispanic or Latino,67,41,108
4295261,Postmenopausal state,ethnic,Hispanic or Latino,109,0,109
435535,Aggressive type unsocialized behavior disorder,racial,White,95,13,108
4060985,BMI 30+ - obesity,racial,American Indian or Alaska Native ,89,19,108
4319325,Acquired deformity of trunk,ethnic,Hispanic or Latino,80,28,108
316139,HF - Heart failure,racial,White,53,55,108
380733,Otalgia,ethnic,Not Hispanic or Latino,82,26,108
4108817,"Tricuspid valve disorders, non-rheumatic",ethnic,Hispanic or Latino,105,3,108
81902,Urinary tract infectious disease,racial,Other Race,89,19,108
4049623,"Moderate major depression, single episode",racial,Unknown,61,47,108
135615,Pityriasis,ethnic,Hispanic or Latino,55,53,108
140821,Spasm,racial,Other Race,17,91,108
433400,Emergency contraception,racial,White,107,1,108
79884,Galactorrhea not associated with childbirth,ethnic,Hispanic or Latino,108,0,108
135030,Discoloration of skin,ethnic,Hispanic or Latino,74,34,108
135033,Hair and hair follicle diseases,ethnic,Not Hispanic or Latino,49,59,108
200962,Primary malignant neoplasm of prostate,racial,Asian,0,108,108
372328,Otitis media,racial,Other Race,52,56,108
440078,"Bipolar affective disorder, current episode manic",ethnic,Hispanic or Latino,9,98,107
319845,Pulmonary valve disease,ethnic,Hispanic or Latino,103,5,108
433195,Transient arterial retinal occlusion,racial,Unknown,0,107,107
134898,Non-toxic single thyroid nodule,racial,White,92,16,108
22340,Esophageal varices without bleeding,racial,Asian,107,0,107
4104864,Migraine NOS,ethnic,Hispanic or Latino,92,15,107
198185,Chronic renal failure syndrome,ethnic,Hispanic or Latino,52,55,107
315947,Thoracic back sprain,ethnic,Hispanic or Latino,71,36,107
133729,Hyperparathyroidism,racial,Unknown,72,35,107
193552,Furuncle of skin AND/OR subcutaneous tissue,ethnic,Hispanic or Latino,61,46,107
440438,Anodontia,ethnic,Hispanic or Latino,94,13,107
442286,Abscess of digit,racial,White,60,46,106
197925,Haemorrhage of rectum and anus,ethnic,Not Hispanic or Latino,48,58,106
198995,Type 1 diabetes mellitus - poor control,racial,Black or African American ,62,44,106
439080,Dyspareunia,ethnic,Hispanic or Latino,105,1,106
193251,Umbilical hernia without obstruction AND without gangrene,ethnic,Not Hispanic or Latino,49,58,107
4158567,Post percutaneous transluminal coronary angioplasty,ethnic,Not Hispanic or Latino,38,67,105
4096215,"Hyperlipidemia, group A",racial,American Indian or Alaska Native ,98,8,106
433599,Abnormal biochemistry finding,racial,White,52,54,106
440382,LD - Learning difficulties,ethnic,Hispanic or Latino,46,59,105
376117,Cataract in degenerative disorder,racial,Unknown,79,27,106
441628,Menopausal and postmenopausal disorders,racial,Unknown,106,0,106
133299,Swelling of limb,ethnic,Not Hispanic or Latino,36,70,106
201914,Premenopausal menorrhagia,racial,Unknown,106,0,106
443864,Multi-infarct dementia with depression,racial,White,86,20,106
74729,Ganglion and synovial cyst,racial,White,77,29,106
138479,Thyroid dysfunction during pregnancy - baby not yet delivered,racial,White,104,1,105
198101,Lipoma of skin and subcutaneous tissue (excluding face),racial,White,67,38,105
192676,Cervical intraepithelial neoplasia grade 1,racial,White,104,1,105
312664,Influenza with respiratory manifestation other than pneumonia,racial,Unknown,68,37,105
137053,Seborrheic dermatitis,ethnic,Not Hispanic or Latino,50,55,105
373499,Disorder of eye region,racial,White,62,43,105
433942,Accident whilst engaged in household activity,ethnic,Hispanic or Latino,75,30,105
75346,Disorder of meniscus of knee,racial,Black or African American ,105,0,105
134118,Atrophic condition of skin,racial,Unknown,58,47,105
442615,Carotid artery stenosis,racial,White,40,65,105
195007,Female stress incontinence,ethnic,Not Hispanic or Latino,104,0,104
375552,Pterygium,racial,Unknown,53,51,104
432571,Malignant lymphoma,racial,Unknown,97,8,105
133794,Chronic gingivitis,ethnic,Hispanic or Latino,56,48,104
199860,Hernia of abdominal cavity,racial,White,41,64,105
437677,Abnormal findings on diagnostic imaging of lung,ethnic,Hispanic or Latino,57,47,104
136184,Pruritic disorder,ethnic,Not Hispanic or Latino,61,43,104
373475,Impairment level: one eye: moderate impairment: other eye: not specified,ethnic,Not Hispanic or Latino,104,0,104
140027,Herpetic gingivostomatitis,ethnic,Hispanic or Latino,71,33,104
315558,Atherosclerosis of arteries of the extremities,racial,White,43,61,104
138525,Pain in limb,racial,Other Race,71,33,104
443585,Abrasion AND/OR friction burn of multiple sites,racial,White,46,58,104
443570,Cervicovaginal cytology: Low grade squamous intraepithelial lesion,ethnic,Not Hispanic or Latino,101,2,103
73649,Contusion of finger,ethnic,Hispanic or Latino,64,40,104
435524,Sleep disorder,racial,White,39,65,104
440383,Depressive disorder,racial,American Indian or Alaska Native ,88,16,104
77066,Derangement of medial meniscus,racial,Unknown,10,94,104
438406,"Major depressive disorder, single episode, severe with psychotic features",racial,Unknown,104,0,104
436222,Altered mental status,ethnic,Hispanic or Latino,71,32,103
435535,Aggressive type unsocialized behavior disorder,ethnic,Not Hispanic or Latino,94,10,104
198124,Disorder of kidney,racial,Asian,39,64,103
439858,"Gastrojejunal ulcer without hemorrhage, without perforation AND without obstruction",ethnic,Hispanic or Latino,0,103,103
199913,Acquired deformity of ankle AND/OR foot,ethnic,Hispanic or Latino,25,78,103
4064381,Nephropathy screening,ethnic,Hispanic or Latino,61,42,103
81931,Psoriasis with arthropathy,racial,Unknown,55,48,103
321314,Abdominal aortic aneurysm without rupture,ethnic,Hispanic or Latino,16,88,104
4005823,Tobacco user,racial,Unknown,43,61,104
439926,Malaise and fatigue,racial,Other Race,76,28,104
4053045,Dog bite,ethnic,Hispanic or Latino,68,35,103
195306,Gastroduodenitis,racial,Filipino,101,2,103
435243,Alcohol dependence,racial,White,13,89,102
194081,Acute cystitis,ethnic,Not Hispanic or Latino,80,22,102
439697,Hypertensive renal disease with renal failure,racial,Unknown,99,4,103
4096347,Gouty arthropathy,ethnic,Not Hispanic or Latino,32,70,102
4201390,Colostomy present,ethnic,Hispanic or Latino,69,34,103
4088930,Confirmation of pregnancy,racial,Unknown,103,0,103
30133,Acute laryngitis,ethnic,Hispanic or Latino,80,22,102
256449,Bronchiectasis,ethnic,Not Hispanic or Latino,103,0,103
439005,Chronic alcoholism in remission,ethnic,Hispanic or Latino,25,78,103
317309,Peripheral arterial occlusive disease,racial,Unknown,64,38,102
75911,Acquired hallux valgus,racial,Other Race,1,101,102
201069,"Peptic ulcer without hemorrhage, without perforation AND without obstruction",racial,White,35,68,103
197914,Chronic gastric ulcer with perforation but without obstruction,racial,Unknown,103,0,103
440748,Interstitial emphysema of lung,ethnic,Not Hispanic or Latino,37,65,102
137626,Seborrhoeic eczema of scalp,ethnic,Hispanic or Latino,52,50,102
436073,Psychotic disorder,racial,White,52,50,102
256449,Bronchiectasis,racial,Asian,102,0,102
432876,Bipolar I disorder,ethnic,Not Hispanic or Latino,60,42,102
314059,Right bundle branch block,racial,White,50,52,102
257907,Disorder of lung,racial,White,50,52,102
439926,Malaise and fatigue,racial,Asian,58,44,102
138239,Observation of limb structure,ethnic,Hispanic or Latino,57,45,102
4149353,"Attention deficit hyperactivity disorder, predominantly inattentive type",ethnic,Not Hispanic or Latino,61,41,102
200445,Chronic prostatitis,ethnic,Hispanic or Latino,0,102,102
133414,Candidiasis of skin and nails,ethnic,Hispanic or Latino,74,28,102
435515,Hypo-osmolality and or hyponatremia,racial,Unknown,82,20,102
192279,Diabetic nephropathy,racial,Black or African American ,43,59,102
373198,Unqualified visual loss of both eyes,racial,White,98,4,102
441284,Open-angle glaucoma,racial,Asian,77,25,102
372613,Flaccid hemiplegia,racial,Unknown,98,4,102
257315,Bacterial pneumonia,racial,Unknown,62,40,102
79908,Muscle strength reduced,racial,Other Race,37,64,101
138102,Benign tumour of skin,ethnic,Not Hispanic or Latino,53,48,101
435243,Alcohol dependence,racial,Black or African American ,0,101,101
257581,Exacerbation of asthma,racial,Other Race,56,46,102
438727,Atypical depressive disorder,ethnic,Hispanic or Latino,71,29,100
196991,Chronic renal disease,racial,Other Race,60,41,101
315286,Chronic ischemic heart disease,ethnic,Hispanic or Latino,13,88,101
375292,Perforation of tympanic membrane,racial,White,63,38,101
441482,Administrative reason for encounter,ethnic,Not Hispanic or Latino,52,49,101
255573,Chronic obstructive lung disease,racial,Black or African American ,36,65,101
4263370,R.I.N.D. syndrome,ethnic,Not Hispanic or Latino,53,48,101
4195572,"Mild major depression, single episode",ethnic,Not Hispanic or Latino,58,43,101
135893,Decubitus ulcer of heel,ethnic,Hispanic or Latino,71,30,101
372309,Mononeuritis,ethnic,Not Hispanic or Latino,31,70,101
81175,Contusion of chest,ethnic,Hispanic or Latino,51,50,101
201909,Female infertility,ethnic,Hispanic or Latino,101,0,101
77965,Nodular tendinous disease of finger,racial,Unknown,67,34,101
444112,Integumentary system finding,racial,White,58,42,100
78193,Epididymo-orchitis,ethnic,Hispanic or Latino,0,100,100
201826,Type 2 diabetes mellitus,racial,Filipino,65,35,100
140214,Eruption of skin,racial,Asian,51,49,100
78236,Muscle wasting disorder,ethnic,Hispanic or Latino,13,87,100
312338,Benign hypertensive heart disease with congestive heart failure,racial,Other Race,99,1,100
317898,Malignant essential hypertension,racial,Asian,7,94,101
4084229,Primary gout,racial,White,16,84,100
434887,Disorders of bilirubin excretion,ethnic,Hispanic or Latino,17,82,99
141253,Disease of thyroid gland,racial,Unknown,82,18,100
436245,Atypical glandular cells on vaginal Papanicolaou smear,ethnic,Hispanic or Latino,100,0,100
75614,Acrodermatitis continua,racial,Asian,86,14,100
312664,Influenza with respiratory manifestation other than pneumonia,ethnic,Not Hispanic or Latino,35,65,100
438398,Leukocytosis,racial,Unknown,65,35,100
201093,Infection of skin AND/OR subcutaneous tissue,racial,White,55,44,99
434750,Feeding difficulties and mismanagement,ethnic,Not Hispanic or Latino,46,54,100
4096347,Gouty arthropathy,racial,Unknown,35,64,99
439858,"Gastrojejunal ulcer without hemorrhage, without perforation AND without obstruction",racial,Unknown,0,100,100
200219,Abdominal pain,racial,Black or African American ,59,41,100
381028,Acute suppurative otitis media - tympanic membrane ruptured,ethnic,Hispanic or Latino,46,53,99
194990,Inflammatory disorder of liver,ethnic,Not Hispanic or Latino,20,79,99
137351,Epidermoid cyst of skin,racial,Unknown,59,40,99
81984,Sprain of shoulder and upper arm,racial,Unknown,65,34,99
436238,Elevated levels of transaminase and lactic acid dehydrogenase,racial,Other Race,55,44,99
377877,Convergent squint,ethnic,Hispanic or Latino,55,44,99
380111,Acute atopic conjunctivitis,ethnic,Hispanic or Latino,66,33,99
433736,Obesity,racial,Filipino,67,32,99
436785,Spinal stenosis in cervical region,ethnic,Hispanic or Latino,58,41,99
81902,Urinary tract infectious disease,racial,Asian,90,9,99
436070,Vitamin D deficiency,ethnic,Not Hispanic or Latino,73,26,99
75344,Intervertebral disc disorder,ethnic,Hispanic or Latino,41,58,99
433454,Adjustment disorder with mixed emotional features,racial,White,40,59,99
433751,Prolonged depressive adjustment reaction,ethnic,Hispanic or Latino,91,8,99
440076,SS - Short stature,ethnic,Not Hispanic or Latino,84,14,98
81390,Idiopathic osteoporosis,ethnic,Hispanic or Latino,98,1,99
314054,Aortic valve disease,ethnic,Not Hispanic or Latino,80,18,98
76191,Disease of upper arm,racial,White,68,30,98
376961,Disturbance of consciousness,ethnic,Hispanic or Latino,55,44,99
444247,Venous thrombosis,ethnic,Hispanic or Latino,43,56,99
381857,Impairment level: one eye: total impairment: other eye: not specified,racial,White,50,47,97
4276723,Finding of child weight centiles,ethnic,Not Hispanic or Latino,54,44,98
318169,Varicose veins of lower extremity,racial,Unknown,95,2,97
74582,Primary malignant neoplasm of rectum,ethnic,Hispanic or Latino,73,25,98
73045,Hand sprain,ethnic,Hispanic or Latino,62,36,98
138176,Acute gingivitis,racial,White,58,40,98
440674,Gout,racial,Black or African American ,72,26,98
4167406,Eye disorder screening,racial,White,53,45,98
192731,Digestive symptom,racial,White,59,38,97
441276,Nondependent alcohol abuse in remission,ethnic,Hispanic or Latino,7,91,98
436373,DSD - Developmental speech disorder,ethnic,Not Hispanic or Latino,26,72,98
80813,Lumbosacral spondylosis without myelopathy,racial,White,63,35,98
134118,Atrophic condition of skin,ethnic,Not Hispanic or Latino,54,44,98
376686,Polyneuropathy associated with another disorder,ethnic,Hispanic or Latino,55,43,98
316999,Cardiac arrhythmia,racial,Filipino,2,95,97
4201387,Tracheostomy in situ,racial,White,24,73,97
376422,Mucopurulent conjunctivitis,ethnic,Hispanic or Latino,59,38,97
194092,Uterine prolapse without vaginal wall prolapse,racial,White,97,0,97
435224,Leukopenia,racial,White,67,31,98
140949,Scabies,racial,Unknown,64,34,98
195079,Functional urinary incontinence,ethnic,Hispanic or Latino,50,47,97
4168217,Generalized hyperhidrosis,ethnic,Hispanic or Latino,70,28,98
4168213,Chest pain on breathing,racial,White,62,35,97
137785,Verruca plantaris,ethnic,Hispanic or Latino,64,34,98
193322,Right lower quadrant pain,racial,Unknown,75,22,97
4018734,Sprain of costal cartilage,ethnic,Hispanic or Latino,57,40,97
373724,Neoplasm of brain,ethnic,Hispanic or Latino,57,40,97
77403,Closed fracture of vertebral column without spinal cord injury,ethnic,Hispanic or Latino,55,41,96
441835,Chronic schizoaffective schizophrenia,ethnic,Hispanic or Latino,86,10,96
437390,Hypoxaemia,ethnic,Hispanic or Latino,54,43,97
433454,Adjustment disorder with mixed emotional features,racial,Unknown,50,46,96
381581,Chalazion,racial,White,57,40,97
78835,Palindromic rheumatism of the lower leg,ethnic,Not Hispanic or Latino,67,30,97
77079,SS - Spinal stenosis,racial,Unknown,78,19,97
74114,Cellulitis and abscess of foot excluding toe,racial,White,43,54,97
434172,Insomnia with sleep apnoea,ethnic,Hispanic or Latino,0,97,97
201069,"Peptic ulcer without hemorrhage, without perforation AND without obstruction",racial,Other Race,62,34,96
439082,Menopausal syndrome,racial,Unknown,97,0,97
75095,Closed fracture of ankle,racial,White,63,33,96
435171,Allergic state,racial,Filipino,1,95,96
374357,Acquired stenosis of nasolacrimal duct,ethnic,Hispanic or Latino,45,51,96
133436,Thyrotoxic crisis,ethnic,Not Hispanic or Latino,88,8,96
440329,Herpes zoster without complication,ethnic,Not Hispanic or Latino,40,56,96
381017,Ametropic amblyopia,racial,White,72,24,96
139906,Intervertebral disc disorder of cervical region with myelopathy,ethnic,Hispanic or Latino,43,53,96
376103,Retinopathy,ethnic,Hispanic or Latino,57,39,96
198803,Nodular hyperplasia of prostate gland,racial,Filipino,0,95,95
75004,Frank hematuria,racial,White,23,72,95
194997,Prostatitis,racial,White,0,95,95
442306,Adjustment disorder with depressed mood,racial,Unknown,76,19,95
377552,Moderate nonproliferative diabetic retinopathy,racial,Unknown,78,17,95
140489,Acquired acanthosis nigricans,racial,Unknown,62,34,96
77025,Diverticulitis of colon,racial,Unknown,62,34,96
376382,Tension-type headache,ethnic,Not Hispanic or Latino,67,28,95
140842,Changes in skin texture,racial,Unknown,55,40,95
74719,Foot ulcer,ethnic,Not Hispanic or Latino,38,57,95
437833,Hypokalaemia,ethnic,Not Hispanic or Latino,76,19,95
25297,Acute pharyngitis,racial,Asian,45,50,95
443422,Scleroderma,ethnic,Hispanic or Latino,43,52,95
40481920,Periumbilical pain,ethnic,Hispanic or Latino,71,23,94
442306,Adjustment disorder with depressed mood,racial,White,64,31,95
318169,Varicose veins of lower extremity,racial,White,70,24,94
4028716,Idiopathic thrombocythemia,ethnic,Hispanic or Latino,71,23,94
377802,Late effects of poliomyelitis,racial,Unknown,70,24,94
4046893,Lifestyle,racial,White,32,62,94
4064375,Iron deficiency screening,racial,Asian,44,50,94
374888,Dementia associated with another disease,racial,Black or African American ,91,4,95
440083,Acute stress disorder,racial,White,74,20,94
432597,Schizoaffective schizophrenia,ethnic,Not Hispanic or Latino,74,20,94
134453,Inflammation of bursa,ethnic,Hispanic or Latino,52,42,94
261889,Simple chronic bronchitis,racial,White,53,41,94
4056329,Vaginitis and vulvovaginitis NOS,ethnic,Hispanic or Latino,94,0,94
4022073,Dependance on wheel chair,racial,White,37,56,93
256531,Head and neck swelling,racial,Unknown,70,23,93
443801,Exercise-induced asthma,racial,Unknown,55,38,93
256531,Head and neck swelling,ethnic,Not Hispanic or Latino,58,35,93
4066163,Ureteric colic,ethnic,Hispanic or Latino,49,44,93
435782,Chronic schizophrenic,ethnic,Not Hispanic or Latino,32,61,93
379012,Monoplegia of upper limb,ethnic,Hispanic or Latino,13,80,93
31967,Nausea,ethnic,Not Hispanic or Latino,73,20,93
194700,"Diabetes mellitus in mother complicating pregnancy, childbirth AND/OR puerperium",ethnic,Hispanic or Latino,93,0,93
434467,Ostium secundum type atrial septal defect,racial,White,53,40,93
441207,Drug reaction,ethnic,Hispanic or Latino,62,31,93
4161978,Patient on oxygen,ethnic,Hispanic or Latino,59,34,93
435171,Allergic state,racial,Asian,32,61,93
141038,Diastolic dysfunction,ethnic,Hispanic or Latino,44,49,93
4307254,Closed fracture,ethnic,Hispanic or Latino,61,32,93
433985,Hypercarotinemia,racial,White,39,53,92
4139420,Foreign body in auditory canal,racial,White,42,50,92
443801,Exercise-induced asthma,ethnic,Not Hispanic or Latino,52,40,92
195312,Functional voiding disorder,racial,White,70,22,92
77079,SS - Spinal stenosis,racial,White,31,61,92
141104,Intervertebral disc disorder of lumbar region with myelopathy,ethnic,Not Hispanic or Latino,50,41,91
192278,Type II diabetes mellitus - poor control,racial,Native Hawaiian or Other Pacific Islander ,30,62,92
437165,Motor vehicle traffic accident,ethnic,Hispanic or Latino,58,34,92
133810,Secondary hyperparathyroidism of renal origin,racial,Unknown,56,35,91
440321,Helicobacter-associated disease,ethnic,Not Hispanic or Latino,60,32,92
4107655,Observations relating to psychosocial functioning,racial,White,64,28,92
73008,Enthesopathy,racial,Unknown,65,27,92
201131,Pelvic mass,racial,Unknown,82,10,92
375415,Injury of head region,ethnic,Not Hispanic or Latino,19,73,92
80816,Intervertebral disc degeneration,ethnic,Not Hispanic or Latino,56,35,91
373747,Extrapyramidal disease,racial,Unknown,6,85,91
4175028,Irritant gastritis,ethnic,Hispanic or Latino,58,33,91
140214,Eruption of skin,racial,Other Race,62,29,91
132466,Lumbar sprain,ethnic,Not Hispanic or Latino,54,37,91
194083,Vaginitis and vulvovaginitis,racial,Black or African American ,91,0,91
375791,Uncomplicated senile dementia,racial,Other Race,35,56,91
440216,Abnormal glucose tolerance test,racial,Unknown,60,31,91
439708,Disorders of initiating and maintaining sleep,racial,Black or African American ,88,4,92
4340380,Hepatitis C carrier,racial,White,39,52,91
432612,Mild mental handicap,racial,White,29,62,91
4174977,Diabetic retinopathy,racial,Unknown,57,34,91
254058,Acute bronchiolitis due to respiratory syncytial virus,ethnic,Hispanic or Latino,35,56,91
200169,Pruritus ani,ethnic,Hispanic or Latino,44,47,91
441534,"Severe major depression, single episode, without psychotic features",ethnic,Not Hispanic or Latino,91,0,91
321319,Cardiomyopathy,racial,Unknown,52,38,90
4194895,Screening for disorder,racial,Unknown,49,41,90
443782,Tremor,ethnic,Not Hispanic or Latino,20,71,91
140842,Changes in skin texture,ethnic,Not Hispanic or Latino,14,77,91
4161977,Patient with cardiac pacemaker,racial,Asian,42,48,90
376713,Cerebral hemorrhage,ethnic,Not Hispanic or Latino,88,2,90
133424,Primary malignant neoplasm of thyroid gland,ethnic,Hispanic or Latino,62,28,90
135777,Neoplasm of uncertain behaviour of skin,ethnic,Hispanic or Latino,70,20,90
141941,Cervical spondylosis without myelopathy,ethnic,Hispanic or Latino,62,28,90
79864,Hematuria syndrome,racial,White,37,53,90
200219,Abdominal pain,racial,Asian,67,22,89
136788,Spinal stenosis of lumbar region,racial,Asian,89,1,90
4185471,Disorder of pigmentation,ethnic,Hispanic or Latino,58,31,89
436583,[X]Falls,racial,Asian,41,48,89
30234,Cervical sprain,ethnic,Not Hispanic or Latino,64,25,89
40484028,Dental caries extending into dentine,ethnic,Hispanic or Latino,65,25,90
198185,Chronic renal failure syndrome,racial,White,46,43,89
199856,Varicose veins of lower extremity with inflammation,racial,Unknown,49,41,90
441737,Bruising,racial,Unknown,61,28,89
437528,"Bipolar affective disorder, currently depressed, moderate",racial,White,41,48,89
72465,Closed fracture of one or more phalanges of hand,racial,White,34,55,89
77310,Deep vein phlebitis and thrombophlebitis of the leg,ethnic,Hispanic or Latino,35,54,89
4059014,Spontaneous bruising,racial,White,57,32,89
436253,Sprain of foot,ethnic,Hispanic or Latino,55,34,89
4256640,Body mass index 40+ - severely obese,racial,White,62,26,88
74719,Foot ulcer,racial,Other Race,42,47,89
196359,Primary malignant neoplasm of uterine cervix,ethnic,Hispanic or Latino,89,0,89
442774,Intermittent claudication,ethnic,Not Hispanic or Latino,13,76,89
4057825,Constipation NOS,ethnic,Hispanic or Latino,56,33,89
135473,Dermatophytosis,racial,Unknown,59,30,89
434005,Morbid obesity,racial,Asian,45,44,89
444129,Wrist injury,racial,White,51,38,89
318800,GERD - Gastro-esophageal reflux disease,racial,Asian Indian,80,8,88
379801,Trigeminal neuralgia,racial,White,64,25,89
26823,Oral phase dysphagia,ethnic,Hispanic or Latino,10,78,88
377559,Vernal conjunctivitis,ethnic,Hispanic or Latino,79,9,88
315947,Thoracic back sprain,racial,White,51,37,88
380986,Senile dementia with delusion,racial,Unknown,86,2,88
4050572,Implantation of automatic cardiac defibrillator,racial,Unknown,23,65,88
377885,Disorder of eye movements,racial,White,43,46,89
4012570,High risk sexual behavior,ethnic,Hispanic or Latino,44,44,88
25297,Acute pharyngitis,racial,Black or African American ,49,40,89
137945,Pressure ulcer stage 2,ethnic,Hispanic or Latino,82,7,89
443732,Disorder associated with type II diabetes melliltus,racial,Unknown,68,20,88
432447,Atypical glandular cells on cervical Papanicolaou smear,ethnic,Hispanic or Latino,88,0,88
434742,Congenital abnormality of skull and face bones,ethnic,Hispanic or Latino,58,30,88
137626,Seborrhoeic eczema of scalp,racial,White,40,47,87
442139,Primary bronchial cancer,ethnic,Hispanic or Latino,41,46,87
4170137,Non-suppurative otitis media,racial,White,53,34,87
4087756,Late latent syphilis,racial,White,12,76,88
4088777,Vagina observation,ethnic,Hispanic or Latino,88,0,88
77079,SS - Spinal stenosis,ethnic,Not Hispanic or Latino,87,1,88
141932,Senile hyperkeratosis,racial,White,47,41,88
133141,Tinea pedis,racial,Other Race,35,52,87
437251,Benign neoplasm of pituitary gland and craniopharyngeal duct,ethnic,Hispanic or Latino,43,45,88
79898,Cellulitis and abscess of finger,ethnic,Hispanic or Latino,40,48,88
77642,Arthralgia of the forearm,racial,Asian,85,2,87
4050572,Implantation of automatic cardiac defibrillator,racial,White,47,40,87
437092,Physiological development failure,ethnic,Not Hispanic or Latino,22,65,87
192854,Interstitial uterine fibroid,ethnic,Hispanic or Latino,87,0,87
80809,Rheumatoid arthritis,racial,Other Race,83,4,87
135033,Hair and hair follicle diseases,racial,Unknown,59,28,87
375826,Central hearing loss,ethnic,Hispanic or Latino,53,34,87
442793,Diabetic complication,racial,Other Race,22,65,87
4022073,Dependance on wheel chair,ethnic,Hispanic or Latino,56,31,87
318712,Peripheral circulatory disorder associated with type I diabetes mellitus,ethnic,Not Hispanic or Latino,3,84,87
443732,Disorder associated with type II diabetes melliltus,ethnic,Not Hispanic or Latino,26,61,87
380403,External hordeolum,racial,Unknown,55,32,87
444382,Thoracic radiculitis,ethnic,Not Hispanic or Latino,59,28,87
320752,Influenza with non-respiratory manifestation,ethnic,Hispanic or Latino,48,39,87
440383,Depressive disorder,racial,Native Hawaiian or Other Pacific Islander ,8,79,87
40484522,Hemiplegia of dominant side as late effect of cerebrovascular disease,racial,White,26,60,86
437833,Hypokalaemia,racial,Other Race,86,0,86
320073,Neutrophil count below reference range,ethnic,Hispanic or Latino,65,21,86
4064918,Diabetes mellitus screening,racial,Black or African American ,40,46,86
195873,Leukorrhagia,racial,Unknown,85,2,87
197500,Primary malignant neoplasm of colon,racial,Unknown,11,76,87
372328,Otitis media,racial,Black or African American ,48,38,86
75344,Intervertebral disc disorder,racial,White,34,53,87
135892,Erythematous condition,ethnic,Hispanic or Latino,62,25,87
318222,Acute adenitis,ethnic,Hispanic or Latino,52,35,87
4256640,Body mass index 40+ - severely obese,ethnic,Hispanic or Latino,63,23,86
434502,Closed fracture of phalanx of toe,ethnic,Hispanic or Latino,61,26,87
440360,Pure hyperglyceridemia,racial,American Indian or Alaska Native ,61,25,86
76836,Sprain of knee and leg,ethnic,Not Hispanic or Latino,53,33,86
140480,Impetigo,ethnic,Not Hispanic or Latino,39,47,86
72993,Primary localised osteoarthrosis,racial,White,74,12,86
440076,SS - Short stature,racial,Asian,82,4,86
4092896,Stool contents abnormal,ethnic,Not Hispanic or Latino,53,32,85
437525,Overweight,racial,Native Hawaiian or Other Pacific Islander ,63,23,86
437394,Closed fracture of lower end of forearm,ethnic,Hispanic or Latino,46,40,86
4080568,Problem behaviour,racial,White,19,67,86
437525,Overweight,racial,Filipino,53,33,86
380734,External ear conductive hearing loss,ethnic,Hispanic or Latino,8,77,85
380941,Herpetic meningoencephalitis,ethnic,Hispanic or Latino,1,85,86
137785,Verruca plantaris,racial,White,48,38,86
197675,Bowel incontinence,ethnic,Hispanic or Latino,78,8,86
140190,Disorder of back,ethnic,Hispanic or Latino,79,7,86
4298697,Multiple open wounds without complication,racial,Unknown,44,41,85
78232,Shoulder joint pain,racial,Black or African American ,29,56,85
377560,Internal hordeolum,ethnic,Hispanic or Latino,49,37,86
435227,Nutritional deficiency,ethnic,Hispanic or Latino,44,41,85
377559,Vernal conjunctivitis,racial,Unknown,83,2,85
139888,Threatened premature labor - not delivered,ethnic,Hispanic or Latino,85,0,85
4292726,Contact - infectious disease,racial,White,50,35,85
318556,Nosebleed,ethnic,Not Hispanic or Latino,29,56,85
443677,Open wound of knee and/or leg and/or ankle,ethnic,Hispanic or Latino,49,36,85
132408,Back problem,racial,Unknown,82,4,86
443414,Chronic post-traumatic stress disorder,racial,White,61,25,86
376713,Cerebral hemorrhage,racial,Black or African American ,83,2,85
441946,Calcific tendinitis of shoulder,ethnic,Hispanic or Latino,79,7,86
321882,Generalised atherosclerosis,racial,Other Race,85,0,85
252658,Intrinsic asthma without status asthmaticus,ethnic,Hispanic or Latino,59,26,85
435220,Severe recurrent major depression without psychotic features,ethnic,Not Hispanic or Latino,65,20,85
75576,Colon spasm,ethnic,Not Hispanic or Latino,68,17,85
435515,Hypo-osmolality and or hyponatremia,racial,Other Race,83,1,84
434902,Autistic disorder of childhood onset,racial,Unknown,20,65,85
254443,Sicca syndrome,racial,Asian,85,0,85
444246,Cirrhosis of liver not due to alcohol,ethnic,Not Hispanic or Latino,16,69,85
195321,Postmenopausal bleeding,ethnic,Not Hispanic or Latino,83,2,85
132835,Pediculosis capitis,ethnic,Hispanic or Latino,75,10,85
433595,Interstitial edema,racial,Black or African American ,56,29,85
40484522,Hemiplegia of dominant side as late effect of cerebrovascular disease,racial,Asian,65,19,84
443767,Diabetic oculopathy,racial,Black or African American ,23,62,85
200763,Chronic hepatitis,racial,White,35,49,84
433516,Duodenitis,ethnic,Hispanic or Latino,83,2,85
257581,Exacerbation of asthma,racial,Asian,35,50,85
4062495,Glaucoma screening,ethnic,Not Hispanic or Latino,67,17,84
74513,Open wound of foot without mention of complication,ethnic,Hispanic or Latino,27,58,85
443564,Malignant neoplasm of bone,ethnic,Hispanic or Latino,68,16,84
81454,Injury of finger,ethnic,Hispanic or Latino,40,44,84
4103722,Cataract NOS,ethnic,Hispanic or Latino,44,40,84
139850,Acute frontal sinusitis,ethnic,Not Hispanic or Latino,59,25,84
4282684,Impairment level: low vision of one eye,racial,Unknown,2,82,84
260139,Acute bronchitis,racial,Black or African American ,44,40,84
434073,Loss of teeth - acquired,racial,Unknown,68,16,84
440238,Closed fracture of metatarsal bone,racial,White,61,23,84
441544,Specific nonpsychotic mental disorders following organic brain damage,racial,Asian,84,0,84
254443,Sicca syndrome,ethnic,Not Hispanic or Latino,84,0,84
4064375,Iron deficiency screening,racial,Black or African American ,40,44,84
438878,Abnormal results of liver function studies,racial,Unknown,57,27,84
441544,Specific nonpsychotic mental disorders following organic brain damage,ethnic,Not Hispanic or Latino,84,0,84
438332,Disease of possible viral origin,racial,Black or African American ,40,44,84
435262,Primary open angle glaucoma,racial,Unknown,64,19,83
433751,Prolonged depressive adjustment reaction,racial,White,80,4,84
201340,Gastritis,racial,White,57,26,83
198062,"Infectious colitis, enteritis and gastroenteritis",ethnic,Hispanic or Latino,49,34,83
439777,Anemia,racial,Filipino,4,80,84
380941,Herpetic meningoencephalitis,racial,Unknown,0,83,83
377277,Impairment level: total impairment of both eyes,racial,Unknown,65,18,83
198964,Chronic type C viral hepatitis,racial,Asian,3,80,83
315276,Vitreous hemorrhage,ethnic,Hispanic or Latino,70,13,83
198985,Primary malignant neoplasm of kidney,ethnic,Hispanic or Latino,45,38,83
434056,Late effects of cerebrovascular disease,racial,Asian,36,47,83
437046,Complete abortion,racial,White,83,0,83
4276723,Finding of child weight centiles,racial,Unknown,53,30,83
436298,Adverse reaction to food,ethnic,Hispanic or Latino,35,48,83
194686,Acquired renal cyst,racial,White,43,40,83
254068,Upper respiratory disease,ethnic,Hispanic or Latino,52,31,83
192278,Type II diabetes mellitus - poor control,racial,Filipino,68,14,82
434016,"Nondependent opioid abuse, continuous",ethnic,Hispanic or Latino,34,49,83
439297,Nuclear senile cataract,racial,White,58,25,83
313878,Respiratory symptoms,racial,Other Race,52,31,83
132706,Nail disease,racial,Unknown,50,32,82
315085,Enlargement of lymph nodes,ethnic,Not Hispanic or Latino,53,29,82
436073,Psychotic disorder,racial,Black or African American ,77,5,82
4201388,Gastrostomy present,ethnic,Not Hispanic or Latino,32,50,82
435216,Disorder associated with type I diabetes mellitus,racial,White,32,50,82
141323,Acute maxillary sinusitis,ethnic,Not Hispanic or Latino,61,21,82
81670,Congenital anomaly of spine,ethnic,Not Hispanic or Latino,79,4,83
4112831,Extrinsic asthma NOS,ethnic,Hispanic or Latino,54,28,82
197928,Menstruation absent,racial,Other Race,82,0,82
314665,Atrial flutter,racial,White,35,47,82
381312,Neural hearing loss,ethnic,Hispanic or Latino,26,56,82
4308509,Impaired fasting glycaemia,racial,Asian,58,24,82
440530,Oropharyngeal dysphagia,ethnic,Hispanic or Latino,23,59,82
81723,Contusion of hand,racial,White,41,41,82
436944,Chronic paranoid schizophrenia,ethnic,Hispanic or Latino,37,45,82
373503,Intermittent cerebral ischaemia,racial,Asian,2,79,81
317248,Disorder of hematopoietic structure,ethnic,Hispanic or Latino,46,35,81
80815,Mucous cyst of skin,ethnic,Hispanic or Latino,62,20,82
4103574,Chronic depression,racial,White,64,17,81
4116452,Generalized osteoarthritis NOS,racial,White,52,29,81
254058,Acute bronchiolitis due to respiratory syncytial virus,racial,White,28,53,81
436155,Redundant prepuce and phimosis,racial,Unknown,0,82,82
4161977,Patient with cardiac pacemaker,racial,Black or African American ,49,33,82
437584,Ataxia,ethnic,Hispanic or Latino,41,41,82
4112831,Extrinsic asthma NOS,racial,White,55,26,81
77395,Current tear of semilunar cartilage,ethnic,Hispanic or Latino,49,32,81
4103642,Amputated toe,racial,Unknown,7,74,81
136516,Congenital pes planus,ethnic,Hispanic or Latino,34,47,81
4146239,Pruritus of genital organs,ethnic,Hispanic or Latino,74,7,81
80824,Senile osteoporosis,racial,American Indian or Alaska Native ,81,0,81
4204904,Education about sexually transmitted disease prevention,ethnic,Hispanic or Latino,71,10,81
377861,Disorder of refraction AND/OR accommodation,racial,Asian,35,46,81
437246,Vitamin B deficiency,racial,White,57,24,81
442774,Intermittent claudication,racial,White,38,43,81
134461,Tietze disease,ethnic,Not Hispanic or Latino,53,28,81
72737,Microcalcifications of the breast,ethnic,Hispanic or Latino,81,0,81
198400,Haemangioma of skin and subcutaneous tissue,ethnic,Hispanic or Latino,56,25,81
377279,"Profound impairment, one eye",racial,White,26,55,81
4115379,"Localised, primary osteoarthritis of the pelvic region and thigh",racial,Unknown,45,36,81
4287544,Manic bipolar I disorder,ethnic,Hispanic or Latino,59,22,81
140673,Hypothyroid,racial,American Indian or Alaska Native ,75,5,80
77630,Disease of shoulder,racial,Unknown,54,26,80
4175028,Irritant gastritis,racial,White,49,31,80
440382,LD - Learning difficulties,racial,White,40,40,80
379012,Monoplegia of upper limb,racial,White,3,77,80
380038,Viral conjunctivitis,ethnic,Hispanic or Latino,45,35,80
74855,Genital herpes simplex,ethnic,Not Hispanic or Latino,55,25,80
372409,Sciatica neuralgia,racial,Other Race,61,19,80
77234,Benign tumour of colon,racial,Unknown,39,41,80
436882,[X]Fall involving bed,ethnic,Hispanic or Latino,60,20,80
443728,Mass of chest wall,racial,White,26,53,79
196341,Dermatophytosis of the perianal area,ethnic,Not Hispanic or Latino,34,46,80
432517,Posttraumatic wound infection,ethnic,Hispanic or Latino,33,47,80
381301,Chronic serous otitis media,ethnic,Hispanic or Latino,42,38,80
193552,Furuncle of skin AND/OR subcutaneous tissue,racial,White,44,36,80
314131,Degeneration of cervical intervertebral disc,ethnic,Not Hispanic or Latino,53,27,80
140214,Eruption of skin,racial,Black or African American ,33,47,80
316437,Cerebral atherosclerosis,racial,Unknown,47,33,80
200528,Ascites,racial,White,44,35,79
200164,Urine-induced contact dermatitis,ethnic,Not Hispanic or Latino,46,34,80
437677,Abnormal findings on diagnostic imaging of lung,racial,White,50,30,80
201899,Unilateral recurrent inguinal hernia,racial,White,8,71,79
255919,Finding of head and neck region,ethnic,Hispanic or Latino,40,39,79
4105880,Contact of sexually transmissible disorder,racial,Unknown,63,16,79
133835,Dermatitis,ethnic,Not Hispanic or Latino,38,41,79
439654,Partial epilepsy with impairment of consciousness,ethnic,Hispanic or Latino,23,56,79
437247,Anaemia of chronic disease,racial,Asian,35,44,79
438867,Generalized body aches,ethnic,Not Hispanic or Latino,43,37,80
375827,Acute non-suppurative otitis media - serous,ethnic,Not Hispanic or Latino,47,32,79
133299,Swelling of limb,racial,Asian,12,67,79
439654,Partial epilepsy with impairment of consciousness,racial,White,29,50,79
137548,Cervical root lesion,ethnic,Hispanic or Latino,58,21,79
75091,Closed fracture of carpal bone,ethnic,Hispanic or Latino,49,30,79
434005,Morbid obesity,racial,Filipino,38,40,78
192242,Acute hepatitis C,ethnic,Not Hispanic or Latino,27,52,79
196523,Diarrhea,racial,Black or African American ,23,55,78
141693,Elevated blood-pressure reading without diagnosis of hypertension,racial,Asian,40,39,79
257683,Postnasal drip,ethnic,Not Hispanic or Latino,59,20,79
4250023,Severe major depression with psychotic features,racial,Unknown,76,2,78
437541,Glaucoma,racial,Native Hawaiian or Other Pacific Islander ,0,79,79
439937,C-reactive protein abnormal,ethnic,Hispanic or Latino,53,26,79
375545,Lens opacity,racial,Filipino,3,76,79
436665,Manic-depressive psychosis,racial,Other Race,76,2,78
380097,Diabetic macular edema,ethnic,Hispanic or Latino,42,36,78
434622,Deficiency anemias,ethnic,Hispanic or Latino,52,26,78
443545,Nonvenomous insect bite,racial,Unknown,41,37,78
378743,Mild nonproliferative retinopathy,racial,Unknown,48,30,78
441974,Closed fracture of forearm,ethnic,Hispanic or Latino,37,41,78
441542,Anxiety,racial,Asian Indian,77,1,78
140949,Scabies,ethnic,Not Hispanic or Latino,39,39,78
195867,Noninflammatory vaginal disorders,racial,White,77,1,78
439777,Anemia,racial,American Indian or Alaska Native ,75,3,78
77635,Disease of hand,racial,Unknown,44,34,78
77139,Open wound of finger without complication,racial,White,31,47,78
433516,Duodenitis,racial,American Indian or Alaska Native ,78,0,78
197494,Viral hepatitis C,ethnic,Not Hispanic or Latino,31,47,78
76725,Fissure in ano,ethnic,Hispanic or Latino,47,31,78
378253,HA - Headache,racial,Black or African American ,42,36,78
443571,Cervicovaginal cytology: High grade squamous intraepithelial lesion or carcinoma,ethnic,Hispanic or Latino,77,1,78
444211,Disease of thigh,ethnic,Hispanic or Latino,49,29,78
81670,Congenital anomaly of spine,racial,Asian,77,1,78
77963,Achilles tendinitis,ethnic,Hispanic or Latino,52,26,78
141104,Intervertebral disc disorder of lumbar region with myelopathy,racial,Unknown,28,50,78
80809,Rheumatoid arthritis,racial,Asian Indian,77,0,77
79106,Arthralgia of the pelvic region and thigh,racial,Black or African American ,58,19,77
436972,Glaucoma associated with systemic syndromes,ethnic,Not Hispanic or Latino,37,40,77
195771,Secondary diabetes mellitus,racial,Other Race,74,3,77
376425,Chronic non-suppurative otitis media,ethnic,Hispanic or Latino,68,10,78
81175,Contusion of chest,racial,White,46,32,78
4105880,Contact of sexually transmissible disorder,ethnic,Not Hispanic or Latino,53,24,77
434005,Morbid obesity,racial,American Indian or Alaska Native ,67,11,78
30753,Esophagitis,ethnic,Hispanic or Latino,52,25,77
139906,Intervertebral disc disorder of cervical region with myelopathy,racial,White,54,23,77
436075,Adjustment disorder with anxious mood,ethnic,Hispanic or Latino,52,25,77
30770,Chronic peptic ulcer with hemorrhage but without obstruction,ethnic,Not Hispanic or Latino,77,1,78
439926,Malaise and fatigue,racial,Black or African American ,36,41,77
434500,Closed fracture of neck of femur,ethnic,Hispanic or Latino,41,37,78
136575,Nonvenomous insect bite with infection,ethnic,Hispanic or Latino,35,42,77
78474,Hypertrophy of breast,ethnic,Hispanic or Latino,9,68,77
443767,Diabetic oculopathy,racial,Other Race,25,52,77
372634,Nonphysiologic vision loss,racial,Black or African American ,69,8,77
200391,Peripheral autonomic neuropathy disease EC,racial,Unknown,45,32,77
437833,Hypokalaemia,racial,Unknown,58,19,77
261325,Pulmonary emphysema,ethnic,Not Hispanic or Latino,27,50,77
4175226,Screening for malignant neoplasm of colon,racial,American Indian or Alaska Native ,49,28,77
441534,"Severe major depression, single episode, without psychotic features",racial,Asian,77,0,77
444093,Patient status finding,racial,White,43,34,77
436233,Delayed milestone,racial,White,32,44,76
40484513,Hemiplegia of nondominant side as late effect of cerebrovascular disease,racial,Black or African American ,14,62,76
316211,Acquired spondylolisthesis,ethnic,Hispanic or Latino,47,30,77
30770,Chronic peptic ulcer with hemorrhage but without obstruction,racial,Black or African American ,77,0,77
75346,Disorder of meniscus of knee,racial,Unknown,73,4,77
436336,Herpes zoster with nervous system complication,ethnic,Hispanic or Latino,28,49,77
24818,Neck injury,ethnic,Hispanic or Latino,38,38,76
441422,Closed fracture of humerus,ethnic,Hispanic or Latino,66,10,76
441838,Personality disorder,ethnic,Hispanic or Latino,55,21,76
79936,Polyuria,racial,White,31,46,77
192671,GI - Gastrointestinal haemorrhage,racial,Filipino,0,76,76
4308509,Impaired fasting glycaemia,racial,Other Race,33,43,76
443344,Barrett esophagus,racial,White,29,47,76
4079876,Familial combined hyperlipidemia,racial,Native Hawaiian or Other Pacific Islander ,44,32,76
137809,Primary malignant neoplasm of female breast,racial,Black or African American ,76,0,76
442068,Cellulitis and abscess of forearm,racial,Unknown,58,19,77
376425,Chronic non-suppurative otitis media,racial,White,68,8,76
440216,Abnormal glucose tolerance test,ethnic,Not Hispanic or Latino,38,38,76
443782,Tremor,racial,White,41,35,76
136760,Transient hypertension of pregnancy - not delivered,ethnic,Hispanic or Latino,76,0,76
442067,Atopic dermatitis and related conditions,racial,Asian,28,48,76
192450,Not passing urine,racial,White,23,53,76
74188,Closed fracture of rib,ethnic,Hispanic or Latino,47,29,76
196044,Primary malignant neoplasm of stomach,ethnic,Hispanic or Latino,17,59,76
74451,Palindromic rheumatism of the forearm,ethnic,Hispanic or Latino,58,18,76
76725,Fissure in ano,racial,White,41,35,76
436659,Iron deficiency anaemia,racial,Black or African American ,65,10,75
74582,Primary malignant neoplasm of rectum,racial,White,65,11,76
140190,Disorder of back,racial,Unknown,73,2,75
135858,Disorder of lip,ethnic,Hispanic or Latino,48,28,76
441836,Depressed bipolar I disorder,racial,Other Race,0,76,76
195083,Left lower quadrant pain,ethnic,Not Hispanic or Latino,46,29,75
196360,Primary malignant neoplasm of bladder,ethnic,Hispanic or Latino,4,71,75
4201388,Gastrostomy present,racial,Unknown,28,47,75
132446,Congenital anomaly of skin,ethnic,Hispanic or Latino,42,33,75
4272867,General well-being finding,ethnic,Not Hispanic or Latino,38,37,75
81611,Diverticular disease of colon,racial,Asian,2,73,75
440360,Pure hyperglyceridemia,racial,Black or African American ,29,46,75
193522,Acute prostatitis,racial,White,0,75,75
432967,Anemia during pregnancy - baby not yet delivered,racial,Unknown,75,0,75
4096347,Gouty arthropathy,racial,White,2,73,75
81251,Neoplasm of breast,racial,Other Race,75,0,75
443257,Swellings and lumps,ethnic,Not Hispanic or Latino,48,27,75
442604,Hypertensive heart disease,racial,Asian,66,9,75
141508,Dermatophytosis of scalp or beard,racial,White,26,49,75
313007,MR - Congenital mitral regurgitation,ethnic,Not Hispanic or Latino,74,1,75
136368,Non-toxic multinodular goiter,ethnic,Hispanic or Latino,68,7,75
196523,Diarrhea,racial,Other Race,39,36,75
433753,Alcohol abuse,racial,Unknown,20,54,74
317009,Hyperreactive airway disease,racial,Native Hawaiian or Other Pacific Islander ,23,52,75
4077577,Moderate recurrent major depression,ethnic,Not Hispanic or Latino,47,27,74
443783,Chronic disease,racial,Black or African American ,31,44,75
435372,Underweight,racial,Unknown,49,25,74
317893,Paroxysmal supraventricular tachycardia,ethnic,Hispanic or Latino,65,9,74
436659,Iron deficiency anaemia,racial,Other Race,73,2,75
436445,Abrasion of teeth,ethnic,Hispanic or Latino,40,35,75
439846,LVF - Left ventricular failure,racial,Unknown,16,58,74
439224,Drug allergy,ethnic,Hispanic or Latino,39,35,74
442282,Urinary casts,racial,White,59,16,75
442308,Abrasion AND/OR friction burn of thigh without infection,ethnic,Hispanic or Latino,47,28,75
434097,Twin pregnancy with antenatal problem,ethnic,Hispanic or Latino,74,0,74
313007,MR - Congenital mitral regurgitation,racial,Asian,74,0,74
140027,Herpetic gingivostomatitis,racial,White,45,29,74
194093,Postcoital bleeding,ethnic,Hispanic or Latino,72,2,74
197913,Disorder of function of stomach,racial,Other Race,41,33,74
137820,Postoperative hypothyroidism,ethnic,Hispanic or Latino,59,15,74
4298854,HIV seropositivity,racial,Black or African American ,16,59,75
201418,"Flatulence, eructation and gas pain",racial,Unknown,57,17,74
381028,Acute suppurative otitis media - tympanic membrane ruptured,racial,White,34,41,75
77965,Nodular tendinous disease of finger,ethnic,Not Hispanic or Latino,43,31,74
316998,Left bundle branch block,ethnic,Hispanic or Latino,55,19,74
381301,Chronic serous otitis media,racial,White,38,36,74
138278,Sprains and strains of joints and adjacent muscles,racial,Unknown,44,30,74
78804,Schimmelbusch's disease,racial,White,73,1,74
138102,Benign tumour of skin,racial,Unknown,48,26,74
441918,"Emotional AND/OR mental disease in mother complicating pregnancy, childbirth AND/OR puerperium",ethnic,Hispanic or Latino,70,4,74
199074,Acute pancreatitis,racial,White,43,31,74
432795,Traumatic AND/OR non-traumatic injury,racial,White,34,40,74
135852,Teething syndrome,racial,White,31,43,74
4103574,Chronic depression,racial,Unknown,48,26,74
381445,Avulsion of eye,ethnic,Hispanic or Latino,74,0,74
381445,Avulsion of eye,racial,Unknown,74,0,74
313217,Atrial fibrillation,racial,Filipino,8,66,74
74855,Genital herpes simplex,racial,Unknown,53,20,73
438727,Atypical depressive disorder,racial,White,47,26,73
434462,VSD - Ventricular septal defect,ethnic,Hispanic or Latino,35,38,73
77079,SS - Spinal stenosis,racial,Asian,73,0,73
4272867,General well-being finding,racial,Unknown,42,31,73
374919,Disseminated sclerosis,ethnic,Not Hispanic or Latino,51,22,73
434119,Hidradenitis,ethnic,Hispanic or Latino,59,14,73
78235,Disorder of coccyx,ethnic,Hispanic or Latino,62,11,73
440078,"Bipolar affective disorder, current episode manic",ethnic,Not Hispanic or Latino,38,35,73
254061,Pleural effusion,ethnic,Hispanic or Latino,29,44,73
441482,Administrative reason for encounter,racial,Unknown,31,42,73
438536,Congenital anomaly of jaw,ethnic,Hispanic or Latino,18,55,73
375806,Idiopathic peripheral neuropathy,racial,Other Race,52,21,73
81454,Injury of finger,racial,White,29,44,73
4088777,Vagina observation,racial,White,73,0,73
4158567,Post percutaneous transluminal coronary angioplasty,racial,Unknown,39,34,73
134441,Chronic ulcer of skin,racial,Unknown,43,31,74
194175,Left upper quadrant pain,racial,Unknown,53,20,73
4062636,Bacterial disease screening,racial,Unknown,66,7,73
30133,Acute laryngitis,racial,White,56,17,73
199878,Light and infrequent menstruation,ethnic,Hispanic or Latino,73,0,73
4194895,Screening for disorder,ethnic,Not Hispanic or Latino,29,43,72
194475,Singultus,ethnic,Hispanic or Latino,0,73,73
80495,Palindromic rheumatism of the pelvic region and thigh,racial,White,61,11,72
73045,Hand sprain,racial,White,42,31,73
73301,Synovitis/tenosynovitis - wrist,ethnic,Hispanic or Latino,63,10,73
132835,Pediculosis capitis,racial,White,66,7,73
318800,GERD - Gastro-esophageal reflux disease,racial,American Indian or Alaska Native ,46,26,72
313878,Respiratory symptoms,racial,Asian,27,46,73
314423,"Benign essential hypertension complicating pregnancy, childbirth and the puerperium - not delivered",ethnic,Hispanic or Latino,73,0,73
378419,AD - Alzheimer's disease,racial,Black or African American ,73,0,73
133729,Hyperparathyroidism,racial,Other Race,70,2,72
4093344,Prostate observation,racial,Asian,1,71,72
374060,Acute ill-defined cerebrovascular disease,racial,Filipino,72,0,72
81459,Unilateral traumatic amputation of foot with complication,ethnic,Hispanic or Latino,0,72,72
4228802,Mild recurrent major depression,ethnic,Not Hispanic or Latino,62,10,72
201340,Gastritis,racial,Unknown,59,13,72
253788,Nasal polyp,ethnic,Hispanic or Latino,46,26,72
432881,Pancytopenia,racial,White,34,38,72
440438,Anodontia,racial,White,67,5,72
320420,Vitreous degeneration,ethnic,Hispanic or Latino,50,22,72
433315,Feeding difficulties in newborn,ethnic,Hispanic or Latino,28,44,72
195314,Nephrotic syndrome,ethnic,Hispanic or Latino,36,36,72
4141481,"Hand, foot and mouth disease",racial,White,28,44,72
76503,Joint contracture of shoulder,ethnic,Hispanic or Latino,72,0,72
435613,Cellulitis,ethnic,Not Hispanic or Latino,37,35,72
436077,Developmental delay,ethnic,Not Hispanic or Latino,29,43,72
77354,Primary localised osteoarthrosis of lower leg,racial,Other Race,48,24,72
434073,Loss of teeth - acquired,racial,White,50,22,72
4295261,Postmenopausal state,racial,White,72,0,72
198964,Chronic type C viral hepatitis,racial,Other Race,33,39,72
435237,Reactive psychoses,ethnic,Not Hispanic or Latino,72,0,72
194696,Menorrhalgia,ethnic,Not Hispanic or Latino,71,1,72
4282684,Impairment level: low vision of one eye,racial,White,67,5,72
40480002,Aphasia as late effect of cerebrovascular disease,racial,Unknown,37,35,72
440129,Hypertrophy of nasal turbinates,ethnic,Hispanic or Latino,30,42,72
199078,Vaginal wall prolapse,racial,White,72,0,72
141253,Disease of thyroid gland,ethnic,Not Hispanic or Latino,53,19,72
138278,Sprains and strains of joints and adjacent muscles,ethnic,Not Hispanic or Latino,38,34,72
194990,Inflammatory disorder of liver,racial,White,35,37,72
138825,Actinic keratosis,ethnic,Not Hispanic or Latino,33,38,71
4164707,Canceled operative procedure,ethnic,Hispanic or Latino,38,34,72
4298854,HIV seropositivity,racial,Unknown,13,58,71
438066,Chlamydial infection,ethnic,Not Hispanic or Latino,45,26,71
257012,Chronic rhinosinusitis,racial,Other Race,52,19,71
81426,Closed fracture of clavicle,ethnic,Hispanic or Latino,35,36,71
4086928,IUCD status,ethnic,Hispanic or Latino,71,0,71
442077,Anxiety disorder,racial,White,43,29,72
319041,Orthostatic hypotension,racial,White,47,24,71
436658,Vitamin deficiency,ethnic,Hispanic or Latino,60,11,71
136773,Rosacea,ethnic,Not Hispanic or Latino,43,29,72
376406,"Impairment level: blindness, one eye - low vision other eye",racial,Other Race,0,71,71
321315,Trifascicular block,ethnic,Not Hispanic or Latino,0,71,71
321315,Trifascicular block,racial,Asian,0,71,71
139850,Acute frontal sinusitis,racial,Unknown,61,10,71
319843,Mitral valve disorder,racial,White,50,20,70
435237,Reactive psychoses,racial,Asian,71,0,71
432526,Needs influenza immunisation,racial,American Indian or Alaska Native ,44,26,70
77644,Adhesive capsulitis of shoulder,racial,Unknown,53,18,71
319835,Congestive cardiac failure,racial,Other Race,43,28,71
440525,Prematurity of fetus,racial,White,37,34,71
26823,Oral phase dysphagia,racial,Unknown,2,69,71
379832,Mixed conductive and sensorineural deafness,ethnic,Hispanic or Latino,44,27,71
78516,Arthralgia of the upper arm,ethnic,Not Hispanic or Latino,34,37,71
78193,Epididymo-orchitis,racial,White,0,71,71
437902,Teeth development and eruption disorders,racial,White,37,34,71
381591,Cerebrovascular disease,racial,Other Race,0,71,71
40479192,Chronic systolic heart failure,racial,Black or African American ,11,59,70
4109880,Varicose veins of the leg with ulcer,racial,White,41,29,70
77642,Arthralgia of the forearm,racial,Unknown,50,20,70
28457,Hypertrophy of tonsils,racial,Unknown,43,28,71
4147961,Screening for malignant neoplasm of breast,racial,Asian,71,0,71
4105330,Chronic undifferentiated schizophrenia,racial,White,2,69,71
439183,Concussion,ethnic,Hispanic or Latino,33,37,70
320073,Neutrophil count below reference range,racial,White,47,23,70
372423,Reduction deformities of brain,ethnic,Hispanic or Latino,54,16,70
197988,General abdominal pain-symptom,ethnic,Not Hispanic or Latino,52,18,70
256439,Allergic rhinitis due to pollen,ethnic,Not Hispanic or Latino,41,29,70
199075,Neurogenic bladder,racial,White,24,46,70
317009,Hyperreactive airway disease,racial,American Indian or Alaska Native ,38,32,70
201627,Abnormal vaginal bleeding,racial,Unknown,70,0,70
435796,Dehydration,racial,Unknown,46,25,71
435839,Lymphatic oedema,racial,White,36,34,70
257907,Disorder of lung,racial,Unknown,20,50,70
440426,Vertigo as late effect of stroke,ethnic,Not Hispanic or Latino,61,9,70
4012491,Difficulty chewing,ethnic,Hispanic or Latino,52,17,69
318222,Acute adenitis,racial,White,42,28,70
376112,Diabetic polyneuropathy,racial,Black or African American ,49,21,70
193322,Right lower quadrant pain,ethnic,Not Hispanic or Latino,50,19,69
440069,Drug dependence,racial,White,34,35,69
443545,Nonvenomous insect bite,ethnic,Not Hispanic or Latino,35,35,70
438733,Profound mental handicap,racial,White,19,50,69
75863,Chronic interstitial cystitis,ethnic,Hispanic or Latino,66,4,70
375246,Mononeuritis of upper limb,ethnic,Hispanic or Latino,29,40,69
138384,Acquired hypothyroidism,racial,Unknown,47,22,69
192450,Not passing urine,racial,Unknown,30,40,70
77234,Benign tumour of colon,ethnic,Not Hispanic or Latino,34,35,69
439125,T21 - Trisomy 21,ethnic,Not Hispanic or Latino,41,28,69
28385,Disorder of posterior pituitary,ethnic,Hispanic or Latino,43,26,69
4110815,"Sensorineural hearing loss, bilateral",racial,Unknown,41,28,69
80187,Medial epicondylitis,ethnic,Hispanic or Latino,43,26,69
438409,Attention deficit hyperactivity disorder,racial,Black or African American ,11,58,69
314369,Malignant hypertensive heart disease without congestive heart failure,ethnic,Hispanic or Latino,38,31,69
313023,Neonatal chronic respiratory disease,ethnic,Hispanic or Latino,37,32,69
73754,Restless legs,racial,Unknown,38,31,69
432875,Anemia due to chronic blood loss,racial,Unknown,66,3,69
40490423,Incontinence without sensory awareness,ethnic,Hispanic or Latino,62,7,69
197236,Uterine fibroid,racial,Black or African American ,69,0,69
4088930,Confirmation of pregnancy,ethnic,Not Hispanic or Latino,66,3,69
377001,Unruptured cerebral aneurysm,ethnic,Hispanic or Latino,37,32,69
436246,Low libido,ethnic,Hispanic or Latino,25,44,69
443537,Deep venous thrombosis of lower extremity,racial,American Indian or Alaska Native ,41,28,69
73819,Painful breasts,ethnic,Not Hispanic or Latino,67,2,69
4018734,Sprain of costal cartilage,racial,White,34,35,69
374375,Impacted cerumen,racial,Other Race,34,35,69
376946,Senile delirium,ethnic,Not Hispanic or Latino,68,0,68
141917,Balanitis xerotica obliterans,racial,White,0,68,68
141663,Osteomyelitis,ethnic,Hispanic or Latino,21,47,68
321596,Peripheral venous insufficiency,ethnic,Not Hispanic or Latino,44,24,68
442256,Disorder of bursae of shoulder region,racial,Other Race,64,4,68
376229,Abnormal involuntary movement,racial,Unknown,45,23,68
77340,Genitourinary tract infection in pregnancy,ethnic,Hispanic or Latino,68,0,68
137057,Paronychia,racial,Unknown,40,28,68
134603,CML - Chronic myeloid leukaemia,ethnic,Hispanic or Latino,20,49,69
4147497,Nervous system and sense organ diseases,ethnic,Hispanic or Latino,41,27,68
436245,Atypical glandular cells on vaginal Papanicolaou smear,racial,White,68,0,68
434165,Abnormal cervical smear,racial,Unknown,68,0,68
4093344,Prostate observation,racial,Other Race,0,68,68
138113,Cyst of thyroid,ethnic,Hispanic or Latino,64,4,68
443524,Mixed incontinence,ethnic,Not Hispanic or Latino,66,2,68
79804,Myotonic dystrophy,ethnic,Hispanic or Latino,11,57,68
377888,CHL - Conductive hearing loss,racial,White,31,37,68
438332,Disease of possible viral origin,racial,Asian,27,41,68
442067,Atopic dermatitis and related conditions,racial,Black or African American ,43,25,68
441737,Bruising,ethnic,Not Hispanic or Latino,40,28,68
261325,Pulmonary emphysema,racial,White,37,31,68
4030270,Proliferative polycythemia,ethnic,Hispanic or Latino,29,38,67
438567,Adult failure to thrive syndrome,ethnic,Hispanic or Latino,60,8,68
312349,Venous varices,ethnic,Not Hispanic or Latino,44,24,68
442752,Myalgia,racial,Other Race,62,6,68
196473,Hypertrophy of uterus,ethnic,Hispanic or Latino,68,0,68
440465,Postpartum state,racial,White,65,2,67
78472,Microscopic haematuria,ethnic,Not Hispanic or Latino,43,24,67
442764,Anal pain,racial,White,30,37,67
432295,Pernicious anemia,ethnic,Hispanic or Latino,35,32,67
440525,Prematurity of fetus,ethnic,Not Hispanic or Latino,26,41,67
197676,Hepatomegaly,racial,Asian,67,0,67
74725,Displacement of cervical intervertebral disc without myelopathy,racial,White,21,46,67
443732,Disorder associated with type II diabetes melliltus,racial,Asian,10,57,67
78219,Cellulitis and abscess of hand excluding digits,ethnic,Hispanic or Latino,29,38,67
77670,Chest pain,racial,Black or African American ,31,37,68
79072,Inflammatory disorder of breast,racial,White,65,2,67
439706,Psychosis with origin in childhood,ethnic,Hispanic or Latino,13,54,67
434164,Glycosuria,ethnic,Hispanic or Latino,44,23,67
135772,Goiter,ethnic,Not Hispanic or Latino,56,11,67
436466,Balanoposthitis,racial,Unknown,0,67,67
4311159,Midline cystocele,racial,Unknown,67,0,67
195906,Disorder of lumbar spine,ethnic,Hispanic or Latino,29,37,66
439846,LVF - Left ventricular failure,racial,White,35,31,66
194984,Hepatopathy,racial,Unknown,44,22,66
76482,MA - Missed abortion,racial,White,65,1,66
444070,Tachycardia,ethnic,Not Hispanic or Latino,35,31,66
197676,Hepatomegaly,racial,White,34,32,66
372328,Otitis media,racial,Asian,29,37,66
4194160,Thyroid function tests abnormal,ethnic,Not Hispanic or Latino,32,35,67
434622,Deficiency anemias,racial,White,44,22,66
196158,Disease of penis,racial,White,0,67,67
4093048,Reduction deformity of leg,ethnic,Hispanic or Latino,50,17,67
433456,Acute pain,ethnic,Not Hispanic or Latino,42,25,67
137213,Fungal dermatosis,racial,White,37,30,67
78473,Solitary cyst of breast,racial,White,66,1,67
4096347,Gouty arthropathy,racial,Asian,23,43,66
437902,Teeth development and eruption disorders,racial,Unknown,28,38,66
440685,"Nondependent alcohol abuse, episodic",racial,White,13,54,67
320752,Influenza with non-respiratory manifestation,racial,White,31,36,67
440071,Gout associated problems,ethnic,Hispanic or Latino,1,66,67
436298,Adverse reaction to food,racial,White,29,37,66
81878,Benign paroxysmal positional vertigo,ethnic,Not Hispanic or Latino,47,19,66
257011,Acute upper respiratory infection,racial,Filipino,33,33,66
436075,Adjustment disorder with anxious mood,racial,White,45,21,66
254387,Upper respiratory tract hypersensitivity reaction,racial,Unknown,46,20,66
440922,Diabetic on insulin,ethnic,Hispanic or Latino,42,24,66
377560,Internal hordeolum,racial,White,35,31,66
4210149,Substance abuse counseling,racial,White,41,25,66
80242,Current tear of medial cartilage AND/OR meniscus of knee,racial,Unknown,53,13,66
134312,Iatrogenic hypothyroidism,ethnic,Hispanic or Latino,65,1,66
29735,Candidiasis of mouth,ethnic,Not Hispanic or Latino,31,35,66
253788,Nasal polyp,racial,White,44,22,66
24609,Hypoglycaemia,racial,Unknown,32,34,66
134057,Disease of cardiovascular system,racial,White,36,30,66
78619,"Contusion, knee",racial,Unknown,50,16,66
4186238,Louse infestation,ethnic,Hispanic or Latino,52,14,66
194411,Unilateral simple inguinal hernia,ethnic,Not Hispanic or Latino,2,64,66
81459,Unilateral traumatic amputation of foot with complication,racial,Unknown,0,66,66
378425,Eyelid inflammation,racial,Unknown,47,19,66
75036,Primary localized osteoarthrosis of hand,racial,Unknown,58,7,65
439141,Abnormal increase in weight,racial,Other Race,34,31,65
436677,"Brief situational non-psychotic disorder, NOS",ethnic,Hispanic or Latino,41,24,65
443580,Systolic heart failure,ethnic,Hispanic or Latino,25,40,65
194133,Low back pain,racial,American Indian or Alaska Native ,40,25,65
437113,Asthenia,ethnic,Hispanic or Latino,38,28,66
378253,HA - Headache,racial,Asian,49,17,66
438733,Profound mental handicap,ethnic,Hispanic or Latino,16,50,66
197320,ARF - Acute renal failure,ethnic,Not Hispanic or Latino,26,39,65
434119,Hidradenitis,racial,White,54,11,65
442139,Primary bronchial cancer,racial,White,40,25,65
435933,Closed fracture of lumbar vertebra without spinal cord injury,ethnic,Hispanic or Latino,45,20,65
79884,Galactorrhea not associated with childbirth,racial,White,65,0,65
137627,Prickly heat,ethnic,Hispanic or Latino,30,35,65
4025514,Unspecified peptic ulcer,ethnic,Hispanic or Latino,32,34,66
432545,Bacterial disease,racial,White,52,13,65
141095,Acne,racial,Asian,40,25,65
4048191,Enlargement of tonsil or adenoid,ethnic,Hispanic or Latino,23,41,64
135615,Pityriasis,racial,White,37,28,65
194411,Unilateral simple inguinal hernia,racial,Unknown,10,55,65
81379,Lateral epicondylitis,ethnic,Not Hispanic or Latino,38,26,64
80578,Superficial injury of finger with infection,racial,Unknown,65,0,65
437579,Paroxysmal ventricular tachycardia,ethnic,Hispanic or Latino,53,12,65
316429,Ectopics,ethnic,Hispanic or Latino,35,29,64
436919,Primary malignant neoplasm of unspecified site,racial,White,59,6,65
317302,Coronary sinus rhythm disorder,racial,Other Race,7,58,65
198400,Haemangioma of skin and subcutaneous tissue,racial,White,41,24,65
137548,Cervical root lesion,racial,White,34,31,65
4101660,Amputated below knee,ethnic,Not Hispanic or Latino,1,64,65
441974,Closed fracture of forearm,racial,White,33,32,65
441207,Drug reaction,racial,White,38,26,64
141323,Acute maxillary sinusitis,racial,Unknown,48,17,65
376946,Senile delirium,racial,Black or African American ,65,0,65
195588,Cystitis,ethnic,Not Hispanic or Latino,56,9,65
40484028,Dental caries extending into dentine,racial,Unknown,49,16,65
376229,Abnormal involuntary movement,ethnic,Not Hispanic or Latino,32,33,65
437528,"Bipolar affective disorder, currently depressed, moderate",ethnic,Hispanic or Latino,37,28,65
313878,Respiratory symptoms,racial,Black or African American ,44,20,64
135030,Discoloration of skin,racial,White,41,23,64
74816,Contusion of toe,ethnic,Hispanic or Latino,41,23,64
434097,Twin pregnancy with antenatal problem,racial,White,64,1,65
4064377,Depression screening,racial,American Indian or Alaska Native ,41,23,64
436839,Closed fracture of metacarpal bone,ethnic,Hispanic or Latino,25,40,65
316428,Hypertrophic obstructive cardiomyopathy,ethnic,Hispanic or Latino,23,41,64
140480,Impetigo,racial,Unknown,32,32,64
378679,Acute poliomyelitis,racial,Unknown,64,0,64
436073,Psychotic disorder,racial,Other Race,15,49,64
443571,Cervicovaginal cytology: High grade squamous intraepithelial lesion or carcinoma,racial,White,60,4,64
439013,Insomnia disorder related to another mental disorder,ethnic,Hispanic or Latino,58,6,64
434742,Congenital abnormality of skull and face bones,racial,White,37,27,64
194018,"Functional enuresis, NOS",ethnic,Hispanic or Latino,22,41,63
442068,Cellulitis and abscess of forearm,ethnic,Not Hispanic or Latino,36,28,64
201078,Senile atrophic vaginitis,racial,Unknown,64,0,64
192687,Vulvovaginitis associated with another disease,ethnic,Hispanic or Latino,64,0,64
314054,Aortic valve disease,racial,Black or African American ,64,0,64
4059014,Spontaneous bruising,racial,Unknown,45,19,64
439080,Dyspareunia,racial,White,62,1,63
137063,Corns and callus,ethnic,Not Hispanic or Latino,34,30,64
441838,Personality disorder,racial,Unknown,55,8,63
442067,Atopic dermatitis and related conditions,racial,Other Race,20,43,63
444413,Pyrexial convulsion,ethnic,Hispanic or Latino,30,33,63
317248,Disorder of hematopoietic structure,racial,White,32,31,63
440129,Hypertrophy of nasal turbinates,racial,White,25,38,63
199866,Acute gastritis,racial,Black or African American ,12,51,63
196738,Male genital organ disease,ethnic,Not Hispanic or Latino,0,63,63
435651,Atypical squamous cells on cervical Papanicolaou smear cannot exclude high grade squamous intraepithelial lesion,ethnic,Hispanic or Latino,63,0,63
194990,Inflammatory disorder of liver,racial,Unknown,27,36,63
4090651,Dialysis observation,ethnic,Not Hispanic or Latino,54,9,63
4096665,Diabetes mellitus with no mention of complication,ethnic,Hispanic or Latino,34,29,63
4053045,Dog bite,racial,White,38,25,63
195562,Hemorrhoids,racial,Asian,28,35,63
198199,Pyelonephritis,racial,Unknown,54,9,63
136773,Rosacea,racial,Unknown,45,18,63
194611,CIN 3 - Cervical intraepithelial neoplasia grade 3,ethnic,Hispanic or Latino,63,0,63
73090,Superficial bruising of foot,ethnic,Hispanic or Latino,42,21,63
433736,Obesity,racial,American Indian,28,35,63
443782,Tremor,racial,Unknown,34,29,63
377277,Impairment level: total impairment of both eyes,racial,White,32,30,62
372324,Eustachian tube disorder,racial,Unknown,43,19,62
197950,Cellulitis and abscess of trunk,racial,Unknown,41,22,63
436253,Sprain of foot,racial,White,38,25,63
132466,Lumbar sprain,racial,Unknown,46,17,63
73560,Calcaneal spur,racial,Unknown,47,16,63
79898,Cellulitis and abscess of finger,racial,White,32,31,63
440685,"Nondependent alcohol abuse, episodic",racial,Unknown,19,43,62
379784,Senile dementia with depression,racial,Other Race,0,62,62
441276,Nondependent alcohol abuse in remission,racial,White,11,52,63
192854,Interstitial uterine fibroid,racial,White,62,0,62
443782,Tremor,racial,Asian,1,61,62
318775,Venous embolism,racial,White,41,21,62
192367,Dysplasia of cervix,ethnic,Hispanic or Latino,62,0,62
4062484,Cervical neoplasia screening,racial,Asian,62,0,62
432308,Mononeuritis of lower limb,ethnic,Hispanic or Latino,42,20,62
432285,Recurrent major depressive episodes,racial,Black or African American ,48,14,62
378414,Separation of retinal layers,ethnic,Hispanic or Latino,36,26,62
4230642,Acquired deformity of chest,ethnic,Hispanic or Latino,61,1,62
434887,Disorders of bilirubin excretion,racial,White,14,48,62
4108533,Unspecified otalgia,ethnic,Hispanic or Latino,44,17,61
77074,Joint pain,racial,Other Race,32,30,62
80815,Mucous cyst of skin,racial,White,48,14,62
78474,Hypertrophy of breast,racial,White,4,58,62
376406,"Impairment level: blindness, one eye - low vision other eye",racial,Black or African American ,0,62,62
377877,Convergent squint,racial,White,34,28,62
435790,Spurious polycythaemia,ethnic,Hispanic or Latino,18,44,62
434153,Chromosomopathy,ethnic,Hispanic or Latino,23,38,61
374905,Non-organic sleep disorder,ethnic,Hispanic or Latino,32,29,61
4305589,"Neoplasm, benign",ethnic,Hispanic or Latino,42,20,62
78236,Muscle wasting disorder,racial,Unknown,1,61,62
80573,Contusion of ankle,ethnic,Hispanic or Latino,34,28,62
4326601,Anorectal abscess,ethnic,Hispanic or Latino,22,39,61
315286,Chronic ischemic heart disease,racial,Unknown,5,56,61
140966,Benign neoplasm of skin of face,ethnic,Hispanic or Latino,37,25,62
443350,Lower urinary tract symptoms,racial,Other Race,0,61,61
4171556,Ankle ulcer,racial,White,31,30,61
80813,Lumbosacral spondylosis without myelopathy,ethnic,Not Hispanic or Latino,35,26,61
196738,Male genital organ disease,racial,Unknown,0,61,61
261687,Hemoptysis,ethnic,Hispanic or Latino,37,24,61
443913,Congenital anomaly of trachea,ethnic,Hispanic or Latino,11,50,61
78237,Bicipital tenosynovitis,ethnic,Hispanic or Latino,36,25,61
137977,Icteric,racial,White,32,29,61
436659,Iron deficiency anaemia,racial,American Indian or Alaska Native ,56,5,61
440021,Herpes simplex without complication,ethnic,Not Hispanic or Latino,37,24,61
137548,Cervical root lesion,ethnic,Not Hispanic or Latino,17,44,61
4263748,Recurrent major depression in complete remission,racial,White,37,24,61
436919,Primary malignant neoplasm of unspecified site,ethnic,Hispanic or Latino,45,16,61
4096215,"Hyperlipidemia, group A",racial,Native Hawaiian or Other Pacific Islander ,34,27,61
200164,Urine-induced contact dermatitis,racial,Unknown,32,28,60
4101660,Amputated below knee,racial,White,13,47,60
442774,Intermittent claudication,racial,Unknown,46,15,61
439251,"Bipolar affective disorder, currently depressed, in full remission",ethnic,Hispanic or Latino,61,0,61
199075,Neurogenic bladder,racial,Unknown,53,8,61
81670,Congenital anomaly of spine,ethnic,Hispanic or Latino,44,17,61
372914,Optic atrophy,ethnic,Hispanic or Latino,34,26,60
73291,Palindromic rheumatism of the ankle and/or foot,ethnic,Not Hispanic or Latino,44,17,61
4103471,Observation of body mass index,racial,American Indian,42,19,61
4092879,Absent kidney,ethnic,Hispanic or Latino,39,22,61
377910,Deviated nasal septum,ethnic,Hispanic or Latino,22,39,61
433740,Immunodeficiency disorder,ethnic,Hispanic or Latino,5,55,60
433577,Hammer toe,racial,White,34,27,61
437264,Tobacco dependence syndrome,racial,American Indian or Alaska Native ,35,26,61
200169,Pruritus ani,racial,White,29,32,61
381316,CVA - Cerebrovascular accident,racial,White,38,23,61
4188027,Food allergy,ethnic,Hispanic or Latino,35,25,60
437394,Closed fracture of lower end of forearm,racial,White,35,26,61
434821,SIRS - System inflammatory response syndrome,ethnic,Hispanic or Latino,37,24,61
257907,Disorder of lung,ethnic,Not Hispanic or Latino,24,37,61
30437,Gastroesophageal reflux disease with esophagitis,racial,Asian,29,32,61
436298,Adverse reaction to food,ethnic,Not Hispanic or Latino,23,37,60
315564,Aortic valve regurgitation,ethnic,Not Hispanic or Latino,58,2,60
76506,Effusion of joint of lower leg,ethnic,Hispanic or Latino,37,24,61
73649,Contusion of finger,racial,White,42,19,61
195851,"Gastric ulcer without hemorrhage, without perforation AND without obstruction",racial,Unknown,56,5,61
381316,CVA - Cerebrovascular accident,racial,Unknown,26,34,60
135892,Erythematous condition,racial,White,43,17,60
443564,Malignant neoplasm of bone,racial,Other Race,60,0,60
140842,Changes in skin texture,racial,Black or African American ,1,59,60
432738,Iceland disease,racial,Unknown,45,15,60
374639,Chronic headache disorder,ethnic,Hispanic or Latino,9,51,60
4305080,Abnormal breathing,ethnic,Not Hispanic or Latino,58,2,60
441092,Advanced maternal age gravida,ethnic,Not Hispanic or Latino,57,3,60
81902,Urinary tract infectious disease,racial,Black or African American ,53,7,60
254662,Pulmonary infarction,ethnic,Not Hispanic or Latino,22,38,60
376400,Combined form of senile cataract,racial,White,35,25,60
195603,Vulval and/or perineal noninflammatory disorders,ethnic,Hispanic or Latino,59,1,60
435262,Primary open angle glaucoma,ethnic,Not Hispanic or Latino,55,5,60
377574,Presbycusis,ethnic,Not Hispanic or Latino,8,52,60
76611,Injury of shoulder region,racial,White,26,34,60
132446,Congenital anomaly of skin,racial,White,25,35,60
4066163,Ureteric colic,racial,White,49,11,60
80045,Primary malignant neoplasm of anus,ethnic,Hispanic or Latino,55,5,60
4293175,"Mental state, behaviour and/or psychosocial function finding",ethnic,Not Hispanic or Latino,10,50,60
196523,Diarrhea,racial,Asian,19,41,60
254068,Upper respiratory disease,racial,White,37,23,60
4057825,Constipation NOS,racial,White,34,25,59
134898,Non-toxic single thyroid nodule,ethnic,Not Hispanic or Latino,46,13,59
432597,Schizoaffective schizophrenia,racial,White,40,19,59
321882,Generalised atherosclerosis,racial,White,41,18,59
132659,Acute apical periodontitis,ethnic,Not Hispanic or Latino,30,29,59
77030,Disease of breast,racial,Unknown,59,0,59
137351,Epidermoid cyst of skin,ethnic,Not Hispanic or Latino,29,31,60
436238,Elevated levels of transaminase and lactic acid dehydrogenase,racial,Asian,41,18,59
75337,Cellulitis and abscess of buttock,racial,Unknown,28,31,59
441417,Lack of coordination,ethnic,Not Hispanic or Latino,2,58,60
438066,Chlamydial infection,racial,Unknown,52,7,59
197023,Bilateral inguinal hernia,ethnic,Hispanic or Latino,1,58,59
432526,Needs influenza immunisation,racial,Filipino,30,29,59
437671,Abnormal feces,ethnic,Hispanic or Latino,50,9,59
4103723,Other refraction and accommodation disorders,ethnic,Hispanic or Latino,43,17,60
313502,Benign hypertensive heart disease without congestive heart failure,racial,White,39,20,59
4103642,Amputated toe,racial,White,18,41,59
443442,Finding of vaginal vault smear result,ethnic,Hispanic or Latino,59,0,59
73562,Solitary sacroiliitis,ethnic,Hispanic or Latino,17,43,60
376117,Cataract in degenerative disorder,racial,White,31,28,59
133298,Musculoskeletal disorder of the neck,ethnic,Not Hispanic or Latino,26,33,59
196473,Hypertrophy of uterus,racial,White,59,0,59
320128,Essential hypertension,racial,American Indian,47,13,60
378735,Migraine without aura,ethnic,Hispanic or Latino,46,13,59
257683,Postnasal drip,racial,Unknown,46,13,59
441407,Appetite loss - anorexia,ethnic,Not Hispanic or Latino,31,28,59
138825,Actinic keratosis,racial,Unknown,43,16,59
377886,Chronic purulent otitis media,ethnic,Hispanic or Latino,23,35,58
195873,Leukorrhagia,ethnic,Not Hispanic or Latino,57,2,59
432791,Urticaria-angio-oedema,ethnic,Hispanic or Latino,36,23,59
194913,Idiopathic peripheral autonomic neuropathy,ethnic,Hispanic or Latino,35,24,59
443422,Scleroderma,racial,Unknown,5,54,59
259153,Throat soreness,racial,Other Race,28,31,59
73754,Restless legs,ethnic,Not Hispanic or Latino,46,13,59
376085,Uncomplicated presenile dementia,racial,White,41,17,58
4025514,Unspecified peptic ulcer,racial,Unknown,29,30,59
373503,Intermittent cerebral ischaemia,racial,Black or African American ,0,59,59
435515,Hypo-osmolality and or hyponatremia,ethnic,Not Hispanic or Latino,34,25,59
440071,Gout associated problems,racial,Unknown,1,58,59
433968,Candidiasis,racial,Unknown,45,14,59
78234,Arthralgia of the hand,ethnic,Not Hispanic or Latino,39,20,59
376709,Discharge of eye,ethnic,Hispanic or Latino,33,26,59
255848,Pneumonia,racial,Asian,22,37,59
373475,Impairment level: one eye: moderate impairment: other eye: not specified,racial,Black or African American ,58,0,58
373478,Presbyopia,ethnic,Not Hispanic or Latino,33,25,58
314963,Giant cell arteritis,ethnic,Hispanic or Latino,53,5,58
4104864,Migraine NOS,racial,Unknown,51,7,58
315078,Palpitations,racial,Asian,38,20,58
312998,Pain in thoracic spine,racial,Unknown,38,20,58
201914,Premenopausal menorrhagia,ethnic,Not Hispanic or Latino,57,1,58
442774,Intermittent claudication,racial,Asian,8,50,58
77968,Hallux valgus AND bunion,racial,Unknown,49,10,59
192956,Cholecystitis,ethnic,Hispanic or Latino,43,16,59
315564,Aortic valve regurgitation,racial,Black or African American ,58,0,58
440426,Vertigo as late effect of stroke,racial,Other Race,55,4,59
200763,Chronic hepatitis,racial,Unknown,35,23,58
75911,Acquired hallux valgus,racial,White,41,17,58
441701,Sprain of hip joint,ethnic,Hispanic or Latino,37,22,59
74513,Open wound of foot without mention of complication,racial,White,14,44,58
77421,Open wound of hand except fingers without complication,ethnic,Hispanic or Latino,28,30,58
40479575,Dysphasia as late effect of cerebrovascular disease,ethnic,Hispanic or Latino,49,10,59
74132,Degeneration of lumbosacral intervertebral disc,racial,Asian,7,52,59
197032,Hyperplasia of prostate,racial,Asian,0,58,58
436539,Closed fracture of patella,ethnic,Hispanic or Latino,49,9,58
374919,Disseminated sclerosis,ethnic,Hispanic or Latino,53,5,58
197320,ARF - Acute renal failure,racial,Unknown,37,21,58
439221,"Adverse effect, due to correct medicinal substance properly administered",racial,White,35,23,58
139188,Open wound of scalp without complication,ethnic,Hispanic or Latino,20,37,57
193253,Nephritis,racial,Black or African American ,21,37,58
432571,Malignant lymphoma,racial,White,32,25,57
141932,Senile hyperkeratosis,racial,Unknown,35,22,57
40480431,Speech and language developmental delay due to hearing loss,ethnic,Hispanic or Latino,11,47,58
316822,Finding of heart murmur,racial,Asian,40,18,58
257007,Allergic rhinitis,racial,American Indian or Alaska Native ,47,10,57
4210149,Substance abuse counseling,ethnic,Hispanic or Latino,34,23,57
4305080,Abnormal breathing,racial,Asian,56,2,58
78619,"Contusion, knee",ethnic,Not Hispanic or Latino,31,26,57
435783,Schizophrenia,racial,Black or African American ,41,17,58
4211231,Panic disorder without agoraphobia,ethnic,Not Hispanic or Latino,39,19,58
195453,"Colitis, enteritis and gastroenteritis presumed infectious",racial,Unknown,34,24,58
26662,Testicular hypofunction,racial,Black or African American ,1,56,57
313502,Benign hypertensive heart disease without congestive heart failure,racial,Unknown,37,21,58
192680,Portal hypertension,ethnic,Hispanic or Latino,38,19,57
134159,Precordial pain,ethnic,Not Hispanic or Latino,15,43,58
197911,Hernia of anterior abdominal wall without obstruction AND without gangrene,ethnic,Not Hispanic or Latino,25,32,57
432738,Iceland disease,ethnic,Not Hispanic or Latino,25,32,57
441507,"Early latent syphilis, positive serology, negative cerebrospinal fluid, less than 2 years after infection",ethnic,Hispanic or Latino,9,48,57
27587,Disturbance of salivary secretion,ethnic,Hispanic or Latino,43,14,57
137379,Musculoskeletal symptom,ethnic,Not Hispanic or Latino,38,19,57
320136,Disease of respiratory system,ethnic,Hispanic or Latino,28,29,57
437256,Hereditary factor XI deficiency disease,ethnic,Hispanic or Latino,57,0,57
440905,Toxic effect of venom,ethnic,Hispanic or Latino,34,23,57
440529,Abnormal findings on diagnostic imaging of urinary organs,ethnic,Hispanic or Latino,42,15,57
437256,Hereditary factor XI deficiency disease,racial,Other Race,57,0,57
195906,Disorder of lumbar spine,racial,White,18,39,57
132740,Positive skin test reaction,racial,Asian,43,14,57
315833,Secondary cardiomyopathy,racial,Unknown,27,30,57
133280,Alopecia,racial,Unknown,48,9,57
192239,Post-herpetic polyneuropathy,ethnic,Hispanic or Latino,27,30,57
377574,Presbycusis,racial,Asian,7,50,57
77630,Disease of shoulder,ethnic,Not Hispanic or Latino,39,18,57
378427,Tear film insufficiency,ethnic,Not Hispanic or Latino,44,13,57
77403,Closed fracture of vertebral column without spinal cord injury,racial,Unknown,32,25,57
440530,Oropharyngeal dysphagia,racial,Unknown,5,52,57
438244,Congenital hydrocephalus,ethnic,Hispanic or Latino,32,25,57
198528,Acquired unequal leg length,ethnic,Hispanic or Latino,19,38,57
438469,"Duodenal ulcer without hemorrhage, without perforation AND without obstruction",racial,Unknown,3,54,57
4064905,Venereal disease screening,racial,Black or African American ,43,14,57
374919,Disseminated sclerosis,racial,White,45,11,56
4056329,Vaginitis and vulvovaginitis NOS,racial,White,56,1,57
28385,Disorder of posterior pituitary,racial,White,39,17,56
256451,Bronchitis,racial,Other Race,38,19,57
439183,Concussion,racial,White,33,23,56
132659,Acute apical periodontitis,racial,Unknown,41,16,57
435216,Disorder associated with type I diabetes mellitus,racial,Unknown,12,44,56
141933,Alopecia areata,ethnic,Hispanic or Latino,35,22,57
312358,CGN - Chronic glomerulonephritis,ethnic,Hispanic or Latino,31,26,57
380378,Epilepsy,racial,Asian,5,51,56
4101660,Amputated below knee,racial,Black or African American ,0,56,56
73843,Synovial cyst of popliteal space,ethnic,Hispanic or Latino,42,14,56
40481920,Periumbilical pain,racial,White,42,14,56
374060,Acute ill-defined cerebrovascular disease,racial,Native Hawaiian or Other Pacific Islander ,0,56,56
4179963,Family history of malignant neoplasm of breast,ethnic,Hispanic or Latino,56,0,56
439120,Aseptic necrosis of head AND/OR neck of femur,ethnic,Hispanic or Latino,23,34,57
380111,Acute atopic conjunctivitis,racial,White,32,25,57
4051114,FH: Diabetes mellitus,ethnic,Not Hispanic or Latino,25,31,56
141213,Scarlet fever,ethnic,Hispanic or Latino,31,26,57
436785,Spinal stenosis in cervical region,racial,White,35,22,57
436118,After-cataract with vision obscured,ethnic,Hispanic or Latino,38,19,57
4164707,Canceled operative procedure,racial,White,34,23,57
438527,"Juvenile osteochondrosis of lower extremity, excluding foot",ethnic,Hispanic or Latino,11,46,57
135777,Neoplasm of uncertain behaviour of skin,racial,White,37,19,56
78272,Sprain of wrist,racial,Unknown,29,27,56
73301,Synovitis/tenosynovitis - wrist,racial,White,50,6,56
381308,Abscess of eyelid,ethnic,Hispanic or Latino,32,23,55
318736,Migraine,racial,Other Race,50,5,55
192667,Atrophic gastritis,ethnic,Not Hispanic or Latino,31,25,56
442282,Urinary casts,racial,Unknown,46,10,56
4204904,Education about sexually transmitted disease prevention,racial,White,46,10,56
440009,Complication of implant,ethnic,Hispanic or Latino,14,41,55
372629,Nonexudative age-related macular degeneration,ethnic,Hispanic or Latino,44,12,56
377294,Exotropia,ethnic,Hispanic or Latino,26,30,56
441980,Closed fracture of foot,racial,White,29,26,55
4064381,Nephropathy screening,racial,White,29,26,55
75860,Costiveness,racial,Filipino,43,13,56
133228,Dental caries,racial,Asian,29,27,56
374924,Generalized convulsive epilepsy,racial,Other Race,22,34,56
136237,Cardiovascular system problem,ethnic,Hispanic or Latino,39,17,56
260125,Acute bronchiolitis,racial,Other Race,38,18,56
435220,Severe recurrent major depression without psychotic features,racial,Asian,46,10,56
4147466,Panic disorder with agoraphobia,racial,White,43,13,56
442308,Abrasion AND/OR friction burn of thigh without infection,racial,White,38,18,56
200445,Chronic prostatitis,racial,White,0,55,55
134718,Hirsutism,ethnic,Hispanic or Latino,55,0,55
374044,Droopy eyelid,racial,Unknown,38,17,55
77968,Hallux valgus AND bunion,ethnic,Not Hispanic or Latino,40,15,55
4101199,Hearing problem,racial,Unknown,32,23,55
40490423,Incontinence without sensory awareness,racial,White,49,6,55
74194,Back sprain,ethnic,Hispanic or Latino,35,20,55
4110499,Allergic rhinitis NOS,racial,Unknown,48,7,55
315831,Chronic pulmonary heart disease,racial,Unknown,47,8,55
136057,Benign neoplasm of skin of trunk,racial,White,26,29,55
436230,Blood chemistry abnormal,racial,Asian,34,21,55
74725,Displacement of cervical intervertebral disc without myelopathy,ethnic,Not Hispanic or Latino,29,26,55
134453,Inflammation of bursa,racial,White,25,31,56
317585,Aortic aneurysm,ethnic,Hispanic or Latino,12,43,55
321314,Abdominal aortic aneurysm without rupture,racial,Unknown,5,50,55
133794,Chronic gingivitis,racial,White,33,22,55
372903,Retinal edema,racial,Unknown,43,12,55
196735,Acute pyelonephritis without medullary necrosis,ethnic,Hispanic or Latino,38,17,55
373638,Superficial injury of cornea,ethnic,Hispanic or Latino,25,31,56
432526,Needs influenza immunisation,racial,Native Hawaiian or Other Pacific Islander ,26,29,55
439406,Allergy to animal,ethnic,Hispanic or Latino,29,26,55
314754,Wheezing,racial,Other Race,26,29,55
194611,CIN 3 - Cervical intraepithelial neoplasia grade 3,racial,White,55,0,55
192438,Abdominal mass,ethnic,Hispanic or Latino,52,3,55
136184,Pruritic disorder,racial,Asian,29,25,54
436730,"Appendicitis, unqualified",ethnic,Hispanic or Latino,19,36,55
135473,Dermatophytosis,ethnic,Not Hispanic or Latino,34,20,54
436670,MD - Metabolic disorders,ethnic,Hispanic or Latino,25,30,55
79804,Myotonic dystrophy,racial,Unknown,0,55,55
437528,"Bipolar affective disorder, currently depressed, moderate",ethnic,Not Hispanic or Latino,13,41,54
30753,Esophagitis,racial,White,37,17,54
4250023,Severe major depression with psychotic features,ethnic,Not Hispanic or Latino,34,21,55
200687,Renal disorder associated with type I diabetes mellitus,ethnic,Not Hispanic or Latino,29,26,55
194093,Postcoital bleeding,racial,White,50,4,54
197928,Menstruation absent,racial,Black or African American ,55,0,55
374060,Acute ill-defined cerebrovascular disease,racial,Other Race,1,53,54
73241,Anal and rectal polyp,ethnic,Hispanic or Latino,22,33,55
376406,"Impairment level: blindness, one eye - low vision other eye",racial,White,47,7,54
4088920,Womb absent,racial,Unknown,55,0,55
26935,Disorder of endocrine testis,ethnic,Hispanic or Latino,0,55,55
138821,Seborrhea,ethnic,Hispanic or Latino,22,32,54
135215,Hashimoto thyroiditis,ethnic,Hispanic or Latino,55,0,55
134603,CML - Chronic myeloid leukaemia,racial,Unknown,8,46,54
441274,Developmental expressive language disorder,racial,White,23,31,54
315523,Hemoglobin S-F disease,racial,Asian,54,0,54
432588,Megaloblastic anemia due to vitamin B>12< deficiency,ethnic,Hispanic or Latino,37,17,54
197032,Hyperplasia of prostate,racial,Other Race,0,54,54
432590,Delusional disorder,ethnic,Hispanic or Latino,31,23,54
133414,Candidiasis of skin and nails,racial,White,38,16,54
437233,Plasmacytic myeloma,racial,Unknown,47,7,54
440088,Academic underachievement disorder,ethnic,Hispanic or Latino,18,36,54
136575,Nonvenomous insect bite with infection,racial,White,28,26,54
444382,Thoracic radiculitis,racial,Unknown,27,27,54
433811,Hydronephrosis,ethnic,Not Hispanic or Latino,23,31,54
141941,Cervical spondylosis without myelopathy,racial,White,35,19,54
314971,Chronic respiratory failure,racial,Unknown,28,26,54
134671,Dental abscess without a sinus,ethnic,Hispanic or Latino,26,28,54
257011,Acute upper respiratory infection,racial,American Indian or Alaska Native ,37,17,54
74635,Lumbosacral root lesion,racial,Unknown,19,35,54
29735,Candidiasis of mouth,racial,Unknown,39,15,54
434502,Closed fracture of phalanx of toe,racial,White,34,20,54
432585,Blood coagulation disorder,ethnic,Not Hispanic or Latino,8,46,54
315523,Hemoglobin S-F disease,ethnic,Not Hispanic or Latino,54,0,54
200763,Chronic hepatitis,ethnic,Not Hispanic or Latino,22,32,54
194990,Inflammatory disorder of liver,racial,Asian,1,53,54
133810,Secondary hyperparathyroidism of renal origin,racial,White,26,28,54
434172,Insomnia with sleep apnoea,ethnic,Not Hispanic or Latino,23,31,54
201254,Insulin dependent diabetes mellitus,racial,Other Race,47,6,53
380403,External hordeolum,ethnic,Not Hispanic or Latino,26,27,53
193170,Renal glycosuria,ethnic,Hispanic or Latino,53,0,53
134898,Non-toxic single thyroid nodule,racial,Unknown,46,7,53
197928,Menstruation absent,racial,Asian,53,1,54
140362,Hypoparathyroidism,ethnic,Hispanic or Latino,34,20,54
194574,Chronic type B viral hepatitis,ethnic,Not Hispanic or Latino,9,44,53
441274,Developmental expressive language disorder,ethnic,Not Hispanic or Latino,47,7,54
134718,Hirsutism,racial,White,53,0,53
198985,Primary malignant neoplasm of kidney,ethnic,Not Hispanic or Latino,27,26,53
435790,Spurious polycythaemia,racial,White,11,43,54
434016,"Nondependent opioid abuse, continuous",racial,Unknown,31,23,54
375252,Disorder of eye,racial,Unknown,35,19,54
443238,Diabetic - poor control,racial,Asian,13,41,54
437688,Abnormal findings on antenatal screening of mother,ethnic,Hispanic or Latino,53,0,53
437390,Hypoxaemia,racial,White,27,26,53
435262,Primary open angle glaucoma,racial,Black or African American ,52,1,53
4319325,Acquired deformity of trunk,racial,White,42,11,53
193170,Renal glycosuria,racial,Unknown,53,0,53
79873,Urolith,ethnic,Hispanic or Latino,34,19,53
4298697,Multiple open wounds without complication,ethnic,Not Hispanic or Latino,28,26,54
196359,Primary malignant neoplasm of uterine cervix,racial,White,53,0,53
4174977,Diabetic retinopathy,racial,White,25,28,53
432661,Stomatitis,racial,Unknown,23,29,52
138502,Vitiligo,racial,Unknown,40,13,53
81390,Idiopathic osteoporosis,racial,Unknown,53,0,53
441274,Developmental expressive language disorder,racial,Black or African American ,47,6,53
436222,Altered mental status,racial,White,30,23,53
194382,External haemorrhoid,ethnic,Hispanic or Latino,40,13,53
442262,Blister of toe without infection,ethnic,Hispanic or Latino,24,29,53
440021,Herpes simplex without complication,racial,Unknown,37,16,53
321689,Apneic,ethnic,Hispanic or Latino,29,23,52
377286,VFD - Visual field defect,ethnic,Hispanic or Latino,10,43,53
373766,Retinopathy of prematurity,ethnic,Hispanic or Latino,23,29,52
375528,Spastic hemiplegia,racial,Unknown,51,2,53
77963,Achilles tendinitis,racial,White,27,26,53
439013,Insomnia disorder related to another mental disorder,racial,White,50,3,53
435082,Closed fracture nasal bone,ethnic,Hispanic or Latino,29,23,52
439696,Hypertensive heart and renal disease with (congestive) heart failure,ethnic,Hispanic or Latino,11,41,52
4170576,Pressure ulcer,racial,White,34,19,53
136057,Benign neoplasm of skin of trunk,ethnic,Hispanic or Latino,23,29,52
432870,Thrombocytopenia,racial,Asian,7,45,52
136516,Congenital pes planus,racial,White,25,28,53
133857,Acquired deformity of limb,ethnic,Hispanic or Latino,23,29,52
4173811,Congenital quadriplegia,ethnic,Hispanic or Latino,12,40,52
196463,Alcoholic cirrhosis,ethnic,Not Hispanic or Latino,32,20,52
436954,Drug abuse,ethnic,Not Hispanic or Latino,22,31,53
194406,Urinary tract obstruction,ethnic,Not Hispanic or Latino,2,50,52
201519,Ca liver - primary,ethnic,Hispanic or Latino,5,47,52
196734,Disease of prostate,ethnic,Hispanic or Latino,0,52,52
375415,Injury of head region,racial,Asian,1,51,52
4116452,Generalized osteoarthritis NOS,racial,Unknown,49,3,52
193016,Cystic disease of kidney,racial,Asian,47,5,52
199839,External haemorrhoids without complication,ethnic,Not Hispanic or Latino,32,20,52
132344,Gingival and periodontal disease,ethnic,Hispanic or Latino,26,26,52
201820,Diabetes mellitus,racial,Unknown,31,22,53
443729,Peripheral circulatory disorder associated with type II diabetes mellitus,racial,Asian,13,40,53
443414,Chronic post-traumatic stress disorder,racial,Other Race,51,1,52
4239301,Unwanted pregnancy,ethnic,Hispanic or Latino,52,0,52
433456,Acute pain,racial,Unknown,29,23,52
141693,Elevated blood-pressure reading without diagnosis of hypertension,racial,Black or African American ,24,28,52
24966,OV - Oesophageal varices,ethnic,Hispanic or Latino,40,12,52
4293175,"Mental state, behaviour and/or psychosocial function finding",racial,Unknown,19,32,51
140673,Hypothyroid,racial,Native Hawaiian or Other Pacific Islander ,41,10,51
75389,Current tear of lateral cartilage AND/OR meniscus of knee,ethnic,Hispanic or Latino,32,20,52
442425,Lumbar post-laminectomy syndrome,ethnic,Hispanic or Latino,2,50,52
312998,Pain in thoracic spine,ethnic,Not Hispanic or Latino,35,17,52
433753,Alcohol abuse,ethnic,Not Hispanic or Latino,8,43,51
435657,Sleep problem,ethnic,Hispanic or Latino,41,11,52
438460,Edentulous alveolar ridge atrophy,ethnic,Hispanic or Latino,37,15,52
139888,Threatened premature labor - not delivered,racial,White,52,0,52
437251,Benign neoplasm of pituitary gland and craniopharyngeal duct,racial,White,22,30,52
81144,Sprain of medial collateral ligament of knee,ethnic,Hispanic or Latino,31,20,51
81670,Congenital anomaly of spine,racial,White,39,13,52
195771,Secondary diabetes mellitus,ethnic,Not Hispanic or Latino,20,31,51
444100,Mood disorder,racial,Asian,43,8,51
4186238,Louse infestation,racial,White,43,9,52
24818,Neck injury,racial,White,24,28,52
375292,Perforation of tympanic membrane,racial,Unknown,35,16,51
444239,Postprocedural state finding,racial,Other Race,31,21,52
314423,"Benign essential hypertension complicating pregnancy, childbirth and the puerperium - not delivered",racial,White,52,0,52
141232,MM - Malignant melanoma of skin,ethnic,Hispanic or Latino,37,14,51
252658,Intrinsic asthma without status asthmaticus,racial,Unknown,40,11,51
72418,Scoliosis deformity of spine,ethnic,Hispanic or Latino,27,24,51
440424,Aphasia,ethnic,Not Hispanic or Latino,32,19,51
138239,Observation of limb structure,racial,White,28,23,51
438557,Abnormal glucose level,racial,Black or African American ,28,23,51
4022073,Dependance on wheel chair,ethnic,Not Hispanic or Latino,9,42,51
312934,Atherosclerosis of aorta,ethnic,Not Hispanic or Latino,31,20,51
196991,Chronic renal disease,racial,Black or African American ,11,40,51
439799,Leg cramps,racial,White,35,16,51
24134,Nonspecific pain in the neck region,racial,Other Race,35,16,51
132408,Back problem,ethnic,Not Hispanic or Latino,33,18,51
374044,Droopy eyelid,racial,White,28,23,51
192286,Intestinal disaccharidase deficiency,racial,Unknown,35,16,51
4103722,Cataract NOS,racial,White,25,26,51
81186,Contusion of wrist,ethnic,Hispanic or Latino,36,15,51
192671,GI - Gastrointestinal haemorrhage,ethnic,Not Hispanic or Latino,25,26,51
4096665,Diabetes mellitus with no mention of complication,racial,White,29,22,51
441836,Depressed bipolar I disorder,racial,White,37,14,51
378756,Conjunctival hemorrhage,racial,Unknown,31,20,51
439695,Hypertensive heart and renal disease with renal failure,ethnic,Hispanic or Latino,24,27,51
443790,Multi-infarct dementia with delusions,ethnic,Hispanic or Latino,41,10,51
198985,Primary malignant neoplasm of kidney,racial,White,38,13,51
74816,Contusion of toe,racial,White,32,19,51
141095,Acne,racial,Other Race,24,27,51
196360,Primary malignant neoplasm of bladder,racial,Unknown,1,50,51
4201390,Colostomy present,racial,White,35,16,51
376400,Combined form of senile cataract,racial,Asian,23,28,51
381592,Chronic mucoid otitis media,ethnic,Hispanic or Latino,29,22,51
441417,Lack of coordination,racial,Asian,1,50,51
435093,Closed fracture of femur,ethnic,Hispanic or Latino,32,19,51
316428,Hypertrophic obstructive cardiomyopathy,racial,White,21,30,51
441428,Closed fracture of lateral malleolus,ethnic,Hispanic or Latino,42,8,50
372324,Eustachian tube disorder,ethnic,Not Hispanic or Latino,31,19,50
4280828,"Carrier, infectious agent",ethnic,Hispanic or Latino,39,11,50
257012,Chronic rhinosinusitis,racial,Asian,39,11,50
141090,PG - Pyogenic granuloma,ethnic,Hispanic or Latino,22,28,50
436677,"Brief situational non-psychotic disorder, NOS",ethnic,Not Hispanic or Latino,5,46,51
200391,Peripheral autonomic neuropathy disease EC,racial,White,25,26,51
441422,Closed fracture of humerus,racial,White,38,13,51
195314,Nephrotic syndrome,racial,White,29,22,51
74451,Palindromic rheumatism of the forearm,racial,White,41,9,50
72748,Strain of rotator cuff of shoulder,ethnic,Not Hispanic or Latino,25,26,51
439708,Disorders of initiating and maintaining sleep,racial,Asian,38,13,51
198464,Incisional hernia,ethnic,Hispanic or Latino,35,16,51
24134,Nonspecific pain in the neck region,racial,Black or African American ,46,5,51
40484513,Hemiplegia of nondominant side as late effect of cerebrovascular disease,racial,Asian,5,45,50
26711,Chronic pharyngitis,ethnic,Hispanic or Latino,28,23,51
200527,Splenomegaly,ethnic,Hispanic or Latino,29,21,50
30978,Hereditary leptocytosis,ethnic,Hispanic or Latino,34,17,51
4114314,Screening for osteoporosis,racial,Asian,44,7,51
195847,Gastroparesis syndrome,racial,White,40,10,50
195079,Functional urinary incontinence,racial,Unknown,10,40,50
444211,Disease of thigh,racial,White,37,13,50
141038,Diastolic dysfunction,racial,Unknown,21,29,50
195501,Polycystic ovaries,racial,Unknown,50,0,50
4146239,Pruritus of genital organs,racial,White,46,5,51
321319,Cardiomyopathy,ethnic,Not Hispanic or Latino,19,32,51
137809,Primary malignant neoplasm of female breast,racial,Other Race,50,0,50
194700,"Diabetes mellitus in mother complicating pregnancy, childbirth AND/OR puerperium",racial,White,50,0,50
379805,Myopia,ethnic,Not Hispanic or Latino,22,28,50
135858,Disorder of lip,racial,White,34,16,50
432895,Cortical senile cataract,racial,White,29,21,50
77673,Sign or symptom of the urinary system,ethnic,Hispanic or Latino,23,26,49
435928,Abnormal decrease in weight,racial,Black or African American ,25,25,50
441818,Haemangioma,ethnic,Hispanic or Latino,36,14,50
74728,Synovitis and tenosynovitis,ethnic,Hispanic or Latino,31,19,50
4093048,Reduction deformity of leg,racial,Unknown,50,0,50
141232,MM - Malignant melanoma of skin,racial,White,34,16,50
73231,Arthralgia of temporomandibular joint,ethnic,Hispanic or Latino,40,10,50
77310,Deep vein phlebitis and thrombophlebitis of the leg,racial,White,13,37,50
376683,Non proliferative diabetic retinopathy,racial,Other Race,26,24,50
4049623,"Moderate major depression, single episode",ethnic,Not Hispanic or Latino,38,12,50
197236,Uterine fibroid,racial,Other Race,50,0,50
435796,Dehydration,ethnic,Not Hispanic or Latino,20,30,50
434376,Acute myocardial infarction of anterior wall,ethnic,Not Hispanic or Latino,45,5,50
433577,Hammer toe,racial,Unknown,25,25,50
255848,Pneumonia,racial,Black or African American ,19,31,50
192367,Dysplasia of cervix,racial,White,50,0,50
193530,Follicular cyst of ovary,ethnic,Hispanic or Latino,50,0,50
138389,Benign neoplasm of scalp and skin of neck,ethnic,Hispanic or Latino,31,19,50
4326601,Anorectal abscess,racial,White,19,31,50
4066376,Pilonidal sinus with abscess,ethnic,Hispanic or Latino,26,24,50
4228802,Mild recurrent major depression,racial,Other Race,47,3,50
374040,Ill-defined disorder of eye,ethnic,Hispanic or Latino,32,18,50
432741,Abnormal immunology finding,racial,Unknown,41,9,50
434494,Closed fracture of the proximal humerus,racial,White,28,22,50
75091,Closed fracture of carpal bone,racial,White,30,20,50
435534,"Nondependent alcohol abuse, continuous",ethnic,Not Hispanic or Latino,19,31,50
194913,Idiopathic peripheral autonomic neuropathy,racial,Asian,49,0,49
4161978,Patient on oxygen,racial,Unknown,28,22,50
443783,Chronic disease,racial,Other Race,31,19,50
373503,Intermittent cerebral ischaemia,racial,Other Race,47,2,49
256717,Bronchospasm,racial,Unknown,38,11,49
201894,Acute intestinal vascular insufficiency,ethnic,Hispanic or Latino,1,49,50
78219,Cellulitis and abscess of hand excluding digits,racial,White,19,31,50
4194160,Thyroid function tests abnormal,racial,Unknown,39,10,49
76685,MG - Myasthenia gravis,racial,White,18,31,49
378135,Facial nerve disorder,ethnic,Hispanic or Latino,44,5,49
319041,Orthostatic hypotension,racial,Unknown,40,10,50
72778,Open wound of toe(s) without mention of complication,ethnic,Hispanic or Latino,28,21,49
375826,Central hearing loss,racial,White,31,19,50
256448,Chronic asthmatic bronchitis,racial,Black or African American ,4,46,50
437663,Fever,racial,Other Race,30,19,49
376979,Diabetic cataract,ethnic,Not Hispanic or Latino,28,21,49
77734,Contusion of lower leg,ethnic,Hispanic or Latino,37,12,49
75095,Closed fracture of ankle,racial,Unknown,31,19,50
81539,Mitochondrial disease,ethnic,Hispanic or Latino,22,27,49
255891,Lupus erythematosus,racial,White,43,6,49
194913,Idiopathic peripheral autonomic neuropathy,ethnic,Not Hispanic or Latino,49,0,49
440814,Torticollis,ethnic,Hispanic or Latino,23,26,49
192675,Biliary cirrhosis,ethnic,Hispanic or Latino,41,8,49
4062484,Cervical neoplasia screening,racial,Black or African American ,49,0,49
194995,Disorder of ureter,ethnic,Hispanic or Latino,36,13,49
443537,Deep venous thrombosis of lower extremity,racial,Other Race,26,23,49
192359,RF - Renal failure,racial,Unknown,28,20,48
40479575,Dysphasia as late effect of cerebrovascular disease,racial,Unknown,41,8,49
443238,Diabetic - poor control,racial,Black or African American ,19,30,49
40484522,Hemiplegia of dominant side as late effect of cerebrovascular disease,racial,Black or African American ,0,49,49
4173811,Congenital quadriplegia,racial,White,10,39,49
78237,Bicipital tenosynovitis,racial,White,28,20,48
196165,Cervical intraepithelial neoplasia grade 2,ethnic,Hispanic or Latino,49,0,49
433095,Fall on or from steps,ethnic,Hispanic or Latino,32,17,49
135893,Decubitus ulcer of heel,racial,Unknown,31,17,48
197378,Overflow incontinence of urine,ethnic,Hispanic or Latino,36,13,49
78497,Cellulitis and abscess of toe,racial,Unknown,31,18,49
377279,"Profound impairment, one eye",ethnic,Not Hispanic or Latino,16,32,48
432923,SAH - Subarachnoid haemorrhage,ethnic,Hispanic or Latino,41,7,48
200485,Decubitus ulcer of buttock,racial,White,26,23,49
4201390,Colostomy present,racial,Unknown,35,14,49
438536,Congenital anomaly of jaw,racial,White,14,34,48
141663,Osteomyelitis,racial,White,16,33,49
199744,Carcinoma liver and/or biliary system,ethnic,Hispanic or Latino,33,16,49
75863,Chronic interstitial cystitis,racial,White,49,0,49
140648,Onychomycosis due to dermatophyte,racial,Black or African American ,14,35,49
314379,First degree atrioventricular block,ethnic,Hispanic or Latino,25,24,49
135333,Pressure sore,ethnic,Hispanic or Latino,31,17,48
257905,Mucopurulent chronic bronchitis,ethnic,Hispanic or Latino,43,5,48
137829,Erythroid aplasia,ethnic,Hispanic or Latino,41,8,49
441092,Advanced maternal age gravida,racial,Unknown,48,0,48
436944,Chronic paranoid schizophrenia,racial,Unknown,29,19,48
376400,Combined form of senile cataract,ethnic,Not Hispanic or Latino,23,25,48
444202,Abscess,racial,Other Race,25,23,48
440374,Obsessive compulsive disorder,racial,White,13,35,48
198846,Enthesopathy of hip region,ethnic,Hispanic or Latino,35,13,48
73564,Complete rupture of rotator cuff,racial,White,39,9,48
316999,Cardiac arrhythmia,racial,Black or African American ,44,4,48
195596,Chronic pancreatitis,ethnic,Not Hispanic or Latino,16,32,48
377575,Tinnitus,ethnic,Not Hispanic or Latino,19,29,48
442597,Meteorism,ethnic,Hispanic or Latino,45,3,48
437175,"Fall on same level from slipping, tripping or stumbling",racial,White,38,10,48
201894,Acute intestinal vascular insufficiency,racial,Unknown,1,47,48
73571,Pathological fracture,ethnic,Hispanic or Latino,26,22,48
259865,Cyst of Bartholin's gland duct,ethnic,Hispanic or Latino,48,0,48
196163,Cervicitis and endocervicitis,ethnic,Hispanic or Latino,48,0,48
4028716,Idiopathic thrombocythemia,racial,White,35,13,48
78831,Disease of ankle,ethnic,Hispanic or Latino,34,14,48
442623,Abrasion AND/OR friction burn of scalp without infection,ethnic,Hispanic or Latino,20,28,48
439147,Amnesia,racial,Black or African American ,47,1,48
374034,Visual disturbance,racial,Other Race,26,22,48
380038,Viral conjunctivitis,racial,White,32,16,48
197484,Diarrhea of presumed infectious origin,ethnic,Hispanic or Latino,29,19,48
314971,Chronic respiratory failure,racial,White,21,27,48
4109880,Varicose veins of the leg with ulcer,racial,Unknown,22,26,48
443878,Injury of superior mesenteric artery,ethnic,Hispanic or Latino,0,47,47
434016,"Nondependent opioid abuse, continuous",racial,White,19,28,47
200845,Urinary precipitancy,racial,Unknown,32,15,47
438134,Excessive sleep,ethnic,Hispanic or Latino,29,19,48
443344,Barrett esophagus,racial,Unknown,13,34,47
321587,Bilateral bundle branch block,ethnic,Hispanic or Latino,46,1,47
137967,"Muscle, ligament and fascia disorders",ethnic,Hispanic or Latino,29,18,47
30978,Hereditary leptocytosis,racial,White,31,17,48
4150307,Dental restoration observation,racial,White,35,13,48
435933,Closed fracture of lumbar vertebra without spinal cord injury,ethnic,Not Hispanic or Latino,17,31,48
317002,Hypopiesis,ethnic,Not Hispanic or Latino,16,31,47
4048191,Enlargement of tonsil or adenoid,racial,White,17,30,47
434462,VSD - Ventricular septal defect,racial,White,16,31,47
4050572,Implantation of automatic cardiac defibrillator,ethnic,Not Hispanic or Latino,16,31,47
196858,Late effect of fracture of neck of femur,ethnic,Hispanic or Latino,47,0,47
315831,Chronic pulmonary heart disease,racial,White,37,11,48
139902,Allergic urticaria,racial,Unknown,29,18,47
379010,Macular retinal puckering,ethnic,Hispanic or Latino,39,8,47
200483,Disease of pelvis,ethnic,Hispanic or Latino,35,12,47
443878,Injury of superior mesenteric artery,racial,Unknown,0,47,47
255891,Lupus erythematosus,ethnic,Hispanic or Latino,45,2,47
381270,Parkinson's disease,racial,Other Race,6,41,47
201826,Type 2 diabetes mellitus,racial,American Indian,29,18,47
376979,Diabetic cataract,racial,Other Race,43,4,47
436677,"Brief situational non-psychotic disorder, NOS",racial,White,27,20,47
444239,Postprocedural state finding,racial,Asian,32,15,47
433942,Accident whilst engaged in household activity,racial,Unknown,36,11,47
80767,Breast irregular nodularity,racial,Asian,47,0,47
433033,Abnormal cervical Papanicolaou smear,ethnic,Hispanic or Latino,47,0,47
78473,Solitary cyst of breast,racial,Unknown,47,0,47
4064377,Depression screening,racial,Native Hawaiian or Other Pacific Islander ,29,19,48
193326,Urge incontinence of urine,ethnic,Not Hispanic or Latino,35,12,47
381444,Black eye,ethnic,Hispanic or Latino,23,23,46
315296,Preinfarction syndrome,ethnic,Hispanic or Latino,20,26,46
135772,Goiter,racial,Unknown,40,7,47
4307254,Closed fracture,racial,White,28,19,47
133228,Dental caries,racial,Other Race,25,22,47
258453,Acute upper respiratory infection of multiple sites,ethnic,Hispanic or Latino,30,17,47
76786,Derangement of knee,racial,Black or African American ,25,22,47
441918,"Emotional AND/OR mental disease in mother complicating pregnancy, childbirth AND/OR puerperium",racial,White,46,1,47
4064377,Depression screening,racial,Filipino,29,18,47
81144,Sprain of medial collateral ligament of knee,racial,White,26,21,47
195977,Contusion of trunk,ethnic,Hispanic or Latino,31,16,47
435224,Leukopenia,racial,Unknown,41,6,47
434272,Varicella infection,ethnic,Hispanic or Latino,24,23,47
40480431,Speech and language developmental delay due to hearing loss,racial,White,8,39,47
376422,Mucopurulent conjunctivitis,racial,White,27,20,47
434016,"Nondependent opioid abuse, continuous",ethnic,Not Hispanic or Latino,32,15,47
199062,"Acute gastric ulcer without hemorrhage, without perforation AND without obstruction",ethnic,Hispanic or Latino,35,12,47
4185471,Disorder of pigmentation,racial,White,32,15,47
196858,Late effect of fracture of neck of femur,racial,Unknown,47,0,47
376686,Polyneuropathy associated with another disorder,racial,Unknown,23,23,46
198124,Disorder of kidney,racial,Other Race,35,11,46
198075,Venereal wart,ethnic,Not Hispanic or Latino,17,30,47
254443,Sicca syndrome,racial,Unknown,32,14,46
373852,Neuralgia,ethnic,Not Hispanic or Latino,31,16,47
439120,Aseptic necrosis of head AND/OR neck of femur,racial,White,15,32,47
4064925,Hypertension screening,ethnic,Hispanic or Latino,34,13,47
436336,Herpes zoster with nervous system complication,racial,White,20,26,46
432881,Pancytopenia,racial,Unknown,32,15,47
137820,Postoperative hypothyroidism,racial,White,36,11,47
133729,Hyperparathyroidism,ethnic,Not Hispanic or Latino,29,18,47
375281,Acute suppurative otitis media - tympanic membrane intact,racial,Other Race,29,17,46
377821,Neurological disorder associated with type I diabetes mellitus,ethnic,Not Hispanic or Latino,29,17,46
436839,Closed fracture of metacarpal bone,racial,White,14,32,46
81984,Sprain of shoulder and upper arm,ethnic,Not Hispanic or Latino,32,14,46
314665,Atrial flutter,ethnic,Not Hispanic or Latino,16,31,47
136496,Cellulitis and abscess of face,racial,Unknown,20,26,46
440029,Viral disease,racial,Other Race,23,23,46
377888,CHL - Conductive hearing loss,ethnic,Not Hispanic or Latino,26,20,46
376680,Generalized nonconvulsive epilepsy,racial,Unknown,46,0,46
439251,"Bipolar affective disorder, currently depressed, in full remission",racial,Unknown,46,0,46
22340,Esophageal varices without bleeding,racial,White,28,19,47
438688,Sarcoidosis,racial,Unknown,46,0,46
377861,Disorder of refraction AND/OR accommodation,racial,Black or African American ,23,23,46
73341,Closed fracture of head of radius,ethnic,Hispanic or Latino,31,16,47
437038,Blood in urine,racial,Asian,20,26,46
201131,Pelvic mass,ethnic,Not Hispanic or Latino,36,10,46
80573,Contusion of ankle,racial,White,25,22,47
199878,Light and infrequent menstruation,racial,White,44,2,46
439937,C-reactive protein abnormal,racial,White,33,13,46
132740,Positive skin test reaction,racial,Other Race,33,13,46
318174,Phlebitis,ethnic,Hispanic or Latino,1,45,46
136760,Transient hypertension of pregnancy - not delivered,racial,White,46,1,47
374923,Bell palsy,ethnic,Not Hispanic or Latino,28,18,46
4060985,BMI 30+ - obesity,racial,Native Hawaiian or Other Pacific Islander ,25,21,46
75095,Closed fracture of ankle,ethnic,Not Hispanic or Latino,36,10,46
135287,Non-neoplastic naevus,racial,Unknown,32,14,46
372309,Mononeuritis,racial,Black or African American ,4,43,47
380415,Acute swimmer's ear,racial,Unknown,29,17,46
198062,"Infectious colitis, enteritis and gastroenteritis",racial,White,21,25,46
193256,Alcoholic fatty liver,ethnic,Hispanic or Latino,6,40,46
315833,Secondary cardiomyopathy,racial,White,18,28,46
256716,Asthma with status asthmaticus,racial,White,23,23,46
381592,Chronic mucoid otitis media,racial,White,24,22,46
432517,Posttraumatic wound infection,racial,Unknown,20,26,46
435928,Abnormal decrease in weight,racial,Asian,25,22,47
376063,Benign neoplasm of cerebral meninges,ethnic,Hispanic or Latino,37,9,46
26935,Disorder of endocrine testis,racial,White,0,46,46
433750,"Single major depressive episode, in full remission",racial,Unknown,29,17,46
75650,Proteinuria,racial,Other Race,19,27,46
133853,Osteomyelitis of ankle AND/OR foot,ethnic,Hispanic or Latino,35,11,46
134441,Chronic ulcer of skin,racial,Other Race,4,43,47
75337,Cellulitis and abscess of buttock,ethnic,Not Hispanic or Latino,28,18,46
254387,Upper respiratory tract hypersensitivity reaction,ethnic,Not Hispanic or Latino,20,26,46
137951,Acquired keratoderma,ethnic,Hispanic or Latino,39,7,46
81379,Lateral epicondylitis,racial,Unknown,28,18,46
195501,Polycystic ovaries,ethnic,Not Hispanic or Latino,46,1,47
40482247,Organic sleep apnea,racial,Unknown,46,0,46
4084229,Primary gout,ethnic,Not Hispanic or Latino,8,37,45
437891,PPHT - Primary pulmonary hypertension,ethnic,Hispanic or Latino,45,1,46
133424,Primary malignant neoplasm of thyroid gland,racial,White,37,8,45
199074,Acute pancreatitis,racial,Unknown,25,20,45
81426,Closed fracture of clavicle,racial,White,19,26,45
440377,Paralysis,racial,Unknown,45,1,46
79833,Meniere's disease,racial,White,42,4,46
318736,Migraine,racial,Asian,43,3,46
194018,"Functional enuresis, NOS",racial,White,10,36,46
441284,Open-angle glaucoma,racial,White,30,16,46
374317,Alcohol-induced psychosis,racial,Unknown,26,20,46
138519,Spondylosis without myelopathy,racial,White,42,4,46
321314,Abdominal aortic aneurysm without rupture,racial,White,11,35,46
439224,Drug allergy,racial,White,19,27,46
312723,Congenital heart disease,ethnic,Not Hispanic or Latino,21,25,46
4012570,High risk sexual behavior,racial,White,28,18,46
79127,Congenital spondylolisthesis,ethnic,Hispanic or Latino,36,10,46
257007,Allergic rhinitis,racial,Filipino,24,22,46
40491340,Closed fracture of tibia,ethnic,Hispanic or Latino,34,11,45
200445,Chronic prostatitis,racial,Unknown,0,46,46
376686,Polyneuropathy associated with another disorder,racial,White,28,17,45
78832,Intervertebral disc disorder with myelopathy,ethnic,Not Hispanic or Latino,10,36,46
434500,Closed fracture of neck of femur,racial,Unknown,23,23,46
73090,Superficial bruising of foot,racial,White,25,20,45
432741,Abnormal immunology finding,ethnic,Not Hispanic or Latino,34,12,46
80951,Candidiasis of urogenital site,ethnic,Not Hispanic or Latino,21,25,46
4179214,Family history of malignant neoplasm of gastrointestinal tract,ethnic,Hispanic or Latino,31,15,46
196061,Benign tumour of stomach,ethnic,Not Hispanic or Latino,45,0,45
196165,Cervical intraepithelial neoplasia grade 2,racial,White,45,0,45
40480435,Spastic hemiplegia of nondominant side,ethnic,Hispanic or Latino,41,4,45
256716,Asthma with status asthmaticus,ethnic,Hispanic or Latino,22,23,45
434172,Insomnia with sleep apnoea,racial,Asian,23,22,45
80187,Medial epicondylitis,racial,White,26,19,45
381295,Age-related cataract,ethnic,Not Hispanic or Latino,36,9,45
375806,Idiopathic peripheral neuropathy,racial,Asian,37,8,45
437992,Abnormal results of kidney function studies,racial,White,19,26,45
4147961,Screening for malignant neoplasm of breast,racial,American Indian or Alaska Native ,45,0,45
441264,Primary thrombocytopenia,racial,Unknown,20,25,45
442615,Carotid artery stenosis,ethnic,Not Hispanic or Latino,29,16,45
197494,Viral hepatitis C,racial,Unknown,27,18,45
320746,Cardiomyopathy associated with another disorder,racial,White,17,28,45
4263748,Recurrent major depression in complete remission,racial,Unknown,10,35,45
4261613,Educational problem,ethnic,Hispanic or Latino,16,29,45
376124,Pinguecula,ethnic,Hispanic or Latino,26,19,45
376961,Disturbance of consciousness,racial,Unknown,27,18,45
4108533,Unspecified otalgia,racial,White,30,15,45
260131,Bronchial disorder,ethnic,Hispanic or Latino,29,16,45
194083,Vaginitis and vulvovaginitis,racial,Asian,45,0,45
196061,Benign tumour of stomach,racial,Asian,44,1,45
77421,Open wound of hand except fingers without complication,racial,White,19,26,45
376208,Soft tissue disorder,ethnic,Hispanic or Latino,21,24,45
197036,Vesicoureteral reflux,ethnic,Hispanic or Latino,26,19,45
440424,Aphasia,racial,White,30,15,45
194175,Left upper quadrant pain,ethnic,Not Hispanic or Latino,28,17,45
72737,Microcalcifications of the breast,racial,White,44,1,45
434164,Glycosuria,racial,White,30,15,45
77030,Disease of breast,ethnic,Not Hispanic or Latino,45,0,45
437541,Glaucoma,racial,Black or African American ,37,8,45
80004,Hand injury,ethnic,Hispanic or Latino,22,23,45
434752,Positive serological AND/OR viral culture findings for human immunodeficiency virus,ethnic,Not Hispanic or Latino,7,38,45
201688,Urinary hesitancy,ethnic,Hispanic or Latino,16,29,45
440358,Lipoma,racial,Unknown,26,19,45
4273095,Acute tracheitis without obstruction,racial,White,6,38,44
381581,Chalazion,racial,Unknown,22,22,44
132393,Pressure ulcer stage 1,ethnic,Hispanic or Latino,23,21,44
4201387,Tracheostomy in situ,ethnic,Not Hispanic or Latino,31,13,44
443790,Multi-infarct dementia with delusions,racial,Unknown,35,9,44
78272,Sprain of wrist,ethnic,Not Hispanic or Latino,26,18,44
4059157,Family circumstance NOS,ethnic,Hispanic or Latino,31,13,44
440279,Accident,ethnic,Hispanic or Latino,23,21,44
433811,Hydronephrosis,racial,Unknown,26,18,44
373786,Abnormal vision,ethnic,Hispanic or Latino,15,29,44
443677,Open wound of knee and/or leg and/or ankle,racial,White,19,26,45
135923,CP - Cleft palate,ethnic,Hispanic or Latino,18,26,44
4210149,Substance abuse counseling,ethnic,Not Hispanic or Latino,20,24,44
133551,Vesicular eczema of hands and/or feet,ethnic,Hispanic or Latino,29,16,45
140259,Open wound of face without complication,ethnic,Hispanic or Latino,13,31,44
194152,Renal agenesis and dysgenesis,ethnic,Hispanic or Latino,31,13,44
318174,Phlebitis,racial,White,0,44,44
4103723,Other refraction and accommodation disorders,racial,White,35,9,44
434153,Chromosomopathy,racial,White,17,27,44
4252735,Mourning,ethnic,Not Hispanic or Latino,40,5,45
254591,Secondary malignant tumour of lung,ethnic,Hispanic or Latino,16,28,44
40485064,Latent syphilis,racial,Unknown,23,21,44
194411,Unilateral simple inguinal hernia,racial,Other Race,0,44,44
201621,Chronic cystitis,racial,White,40,5,45
29056,Sialoadenitis,ethnic,Hispanic or Latino,23,22,45
443409,On examination - left lower abdominal mass,ethnic,Hispanic or Latino,40,4,44
78529,Kyphoscoliosis and scoliosis,ethnic,Hispanic or Latino,20,23,43
201606,Crohn's disease,racial,White,28,16,44
26727,Vomiting blood,ethnic,Hispanic or Latino,22,22,44
4245252,Raised prostate specific antigen,racial,Other Race,0,44,44
439706,Psychosis with origin in childhood,racial,White,2,42,44
197318,Cholesterolosis of gallbladder,ethnic,Hispanic or Latino,26,17,43
4110815,"Sensorineural hearing loss, bilateral",racial,White,26,17,43
436238,Elevated levels of transaminase and lactic acid dehydrogenase,racial,Black or African American ,10,34,44
375415,Injury of head region,racial,Unknown,26,18,44
198678,Intestinal infectious disease,ethnic,Not Hispanic or Latino,20,23,43
440695,Encopresis,ethnic,Hispanic or Latino,12,32,44
441840,Clinical finding,racial,Unknown,31,13,44
373478,Presbyopia,racial,Asian,19,25,44
374028,AAMD - Age related macular degeneration,ethnic,Not Hispanic or Latino,17,26,43
4273095,Acute tracheitis without obstruction,ethnic,Hispanic or Latino,5,38,43
376966,Exudative age-related macular degeneration,ethnic,Hispanic or Latino,35,9,44
313459,Sleep apnea,racial,Black or African American ,23,21,44
4195572,"Mild major depression, single episode",racial,Asian,14,30,44
435651,Atypical squamous cells on cervical Papanicolaou smear cannot exclude high grade squamous intraepithelial lesion,racial,White,42,2,44
255573,Chronic obstructive lung disease,racial,American Indian or Alaska Native ,26,18,44
201909,Female infertility,racial,White,44,0,44
77987,Respiratory observations of chest,ethnic,Hispanic or Latino,26,18,44
374375,Impacted cerumen,racial,Black or African American ,25,19,44
201826,Type 2 diabetes mellitus,racial,Asian Indian,19,25,44
444132,Knee injury,ethnic,Not Hispanic or Latino,25,19,44
81931,Psoriasis with arthropathy,racial,White,28,16,44
201418,"Flatulence, eructation and gas pain",ethnic,Not Hispanic or Latino,31,13,44
444247,Venous thrombosis,racial,White,27,17,44
252365,MGN - Membranous glomerulonephritis,ethnic,Hispanic or Latino,34,10,44
441969,Radiology result abnormal,ethnic,Hispanic or Latino,26,17,43
433163,Deficiency of macronutrients,racial,Unknown,34,9,43
138113,Cyst of thyroid,racial,White,40,3,43
141305,Unilateral sensorineural hearing loss with unrestricted hearing on the contralateral side,ethnic,Hispanic or Latino,26,17,43
441258,Anemia in neoplastic disease,ethnic,Hispanic or Latino,42,1,43
23325,Heartburn,ethnic,Not Hispanic or Latino,20,23,43
441507,"Early latent syphilis, positive serology, negative cerebrospinal fluid, less than 2 years after infection",racial,White,1,43,44
432285,Recurrent major depressive episodes,racial,American Indian or Alaska Native ,40,3,43
26711,Chronic pharyngitis,racial,White,22,21,43
381001,Subjective visual disturbance,ethnic,Hispanic or Latino,39,4,43
443563,Arteriosclerosis in coronary artery bypass graft,ethnic,Not Hispanic or Latino,12,31,43
376965,Hypertensive retinopathy,ethnic,Hispanic or Latino,32,11,43
78228,Joint derangement,ethnic,Hispanic or Latino,18,25,43
435508,Adrenal cortical hypofunction,racial,Unknown,41,2,43
4147497,Nervous system and sense organ diseases,racial,White,28,15,43
437165,Motor vehicle traffic accident,racial,White,26,17,43
4016352,Tuberculosis contact,ethnic,Hispanic or Latino,28,16,44
435788,Disorder of phosphorus metabolism,ethnic,Hispanic or Latino,31,12,43
443865,Non-infective colitis,racial,Other Race,28,16,44
313219,Phlebitis and thrombophlebitis,ethnic,Hispanic or Latino,34,10,44
4084229,Primary gout,racial,Unknown,14,29,43
137945,Pressure ulcer stage 2,racial,Unknown,41,2,43
376224,Spina bifida without hydrocephalus,ethnic,Hispanic or Latino,19,24,43
4168213,Chest pain on breathing,ethnic,Not Hispanic or Latino,16,28,44
141095,Acne,racial,Black or African American ,21,22,43
438727,Atypical depressive disorder,racial,Unknown,34,9,43
435810,After-cataract,ethnic,Hispanic or Latino,29,14,43
40480435,Spastic hemiplegia of nondominant side,racial,Unknown,41,2,43
433031,Hallucinations,racial,Unknown,36,7,43
40481345,Monoplegia of upper limb of dominant side,racial,White,0,43,43
40481345,Monoplegia of upper limb of dominant side,ethnic,Hispanic or Latino,0,43,43
4179963,Family history of malignant neoplasm of breast,racial,White,42,1,43
256451,Bronchitis,racial,Black or African American ,29,13,42
432585,Blood coagulation disorder,racial,White,29,13,42
4046893,Lifestyle,racial,Unknown,25,18,43
4240902,Allergy to peanuts,ethnic,Hispanic or Latino,13,29,42
4216894,Precipitous drop in hematocrit,racial,Unknown,43,0,43
374357,Acquired stenosis of nasolacrimal duct,racial,White,26,16,42
438480,"Abnormal glucose tolerance in mother complicating pregnancy, childbirth AND/OR puerperium",racial,Unknown,43,0,43
258482,Abscess of Bartholin's gland,ethnic,Hispanic or Latino,43,0,43
28779,Oesophageal varices with bleeding,ethnic,Hispanic or Latino,18,25,43
26378,Hyperpituitarism,ethnic,Hispanic or Latino,40,3,43
140641,Verruca vulgaris,racial,Asian,20,22,42
140966,Benign neoplasm of skin of face,racial,White,22,21,43
378161,Disorder of ear,ethnic,Hispanic or Latino,29,13,42
78517,Arthralgia of multiple joints,racial,Other Race,32,10,42
4340379,Hepatitis B carrier,ethnic,Not Hispanic or Latino,16,27,43
380986,Senile dementia with delusion,racial,Asian,43,0,43
374924,Generalized convulsive epilepsy,racial,Black or African American ,6,37,43
434165,Abnormal cervical smear,ethnic,Not Hispanic or Latino,43,0,43
437753,Seen by surgical fitting - service,ethnic,Hispanic or Latino,43,0,43
4216894,Precipitous drop in hematocrit,ethnic,Hispanic or Latino,43,0,43
255919,Finding of head and neck region,racial,White,19,24,43
372608,Amnestic disorder,ethnic,Hispanic or Latino,43,0,43
441691,Atypical squamous cells of undetermined significance on vaginal Papanicolaou smear,ethnic,Hispanic or Latino,43,0,43
440233,Strain of supraspinatus muscle AND/OR tendon,ethnic,Hispanic or Latino,29,13,42
433069,Open wound of external genital organs with complication,ethnic,Not Hispanic or Latino,19,24,43
134324,Lipodystrophy,racial,White,4,38,42
376680,Generalized nonconvulsive epilepsy,ethnic,Hispanic or Latino,32,10,42
440905,Toxic effect of venom,racial,White,29,13,42
441258,Anemia in neoplastic disease,racial,Unknown,42,0,42
377910,Deviated nasal septum,racial,White,22,20,42
378425,Eyelid inflammation,ethnic,Not Hispanic or Latino,17,25,42
138604,"Contusion of face, scalp and neck, excluding eye(s)",racial,Unknown,19,23,42
377886,Chronic purulent otitis media,racial,White,16,26,42
4116452,Generalized osteoarthritis NOS,ethnic,Not Hispanic or Latino,33,9,42
194286,"Malignant neoplasm of corpus uteri, excluding isthmus",ethnic,Hispanic or Latino,42,0,42
316822,Finding of heart murmur,racial,Other Race,22,20,42
200845,Urinary precipitancy,ethnic,Not Hispanic or Latino,28,14,42
441542,Anxiety,racial,American Indian or Alaska Native ,14,28,42
314666,Healed coronary,racial,Other Race,27,15,42
440529,Abnormal findings on diagnostic imaging of urinary organs,racial,White,30,12,42
77310,Deep vein phlebitis and thrombophlebitis of the leg,racial,Unknown,20,22,42
192606,Paraplegia,ethnic,Not Hispanic or Latino,2,40,42
438406,"Major depressive disorder, single episode, severe with psychotic features",racial,Other Race,42,0,42
24609,Hypoglycaemia,ethnic,Not Hispanic or Latino,25,17,42
77066,Derangement of medial meniscus,racial,White,25,17,42
376120,"Keratoconjunctivitis sicca, not specified as Sjogren's",ethnic,Hispanic or Latino,39,3,42
76611,Injury of shoulder region,racial,Unknown,27,15,42
434005,Morbid obesity,racial,Native Hawaiian or Other Pacific Islander ,14,28,42
197381,Epigastric pain,racial,Other Race,25,17,42
443414,Chronic post-traumatic stress disorder,racial,Unknown,32,10,42
77354,Primary localised osteoarthrosis of lower leg,racial,Asian,22,20,42
256451,Bronchitis,racial,Asian,25,17,42
4147961,Screening for malignant neoplasm of breast,racial,Black or African American ,42,0,42
254061,Pleural effusion,racial,White,20,22,42
4296205,Second degree burn,ethnic,Hispanic or Latino,20,22,42
441840,Clinical finding,ethnic,Not Hispanic or Latino,32,10,42
376112,Diabetic polyneuropathy,racial,Native Hawaiian or Other Pacific Islander ,0,41,41
4179925,Basic learning problem,ethnic,Hispanic or Latino,15,26,41
80045,Primary malignant neoplasm of anus,racial,White,40,2,42
199913,Acquired deformity of ankle AND/OR foot,racial,White,22,19,41
201449,Unilateral traumatic amputation of leg below knee without complication,ethnic,Hispanic or Latino,38,3,41
442256,Disorder of bursae of shoulder region,ethnic,Not Hispanic or Latino,20,22,42
373852,Neuralgia,racial,Unknown,31,10,41
78162,Peripheral vertigo,ethnic,Hispanic or Latino,30,11,41
77403,Closed fracture of vertebral column without spinal cord injury,racial,White,22,19,41
435262,Primary open angle glaucoma,racial,White,27,14,41
199860,Hernia of abdominal cavity,racial,Unknown,22,19,41
134324,Lipodystrophy,ethnic,Hispanic or Latino,4,38,42
437251,Benign neoplasm of pituitary gland and craniopharyngeal duct,ethnic,Not Hispanic or Latino,11,30,41
133280,Alopecia,ethnic,Not Hispanic or Latino,22,19,41
434972,Developmental abnormality of tooth size and form,ethnic,Hispanic or Latino,28,14,42
197676,Hepatomegaly,racial,Unknown,35,7,42
440647,Sexually transmitted infectious disease,ethnic,Hispanic or Latino,19,23,42
73300,Radial styloid tenosynovitis,ethnic,Hispanic or Latino,34,7,41
443563,Arteriosclerosis in coronary artery bypass graft,racial,White,11,30,41
198846,Enthesopathy of hip region,racial,White,35,6,41
255348,Polymyalgia rheumatica,ethnic,Hispanic or Latino,32,9,41
198995,Type 1 diabetes mellitus - poor control,racial,Filipino,21,20,41
433315,Feeding difficulties in newborn,racial,White,12,29,41
138821,Seborrhea,racial,White,14,27,41
437541,Glaucoma,racial,Other Race,35,7,42
433507,Loss of teeth due to local periodontal disease,ethnic,Hispanic or Latino,0,41,41
77340,Genitourinary tract infection in pregnancy,racial,White,41,1,42
4154309,Severe recurrent major depression with psychotic features,racial,Unknown,38,3,41
136496,Cellulitis and abscess of face,ethnic,Not Hispanic or Latino,22,19,41
80816,Intervertebral disc degeneration,racial,Unknown,22,20,42
440374,Obsessive compulsive disorder,ethnic,Not Hispanic or Latino,22,19,41
437382,Urine observation,racial,Asian,34,7,41
4062636,Bacterial disease screening,ethnic,Not Hispanic or Latino,38,2,40
76506,Effusion of joint of lower leg,racial,White,27,14,41
261687,Hemoptysis,racial,White,23,17,40
443524,Mixed incontinence,racial,Black or African American ,41,0,41
136198,Cervical spondylosis with myelopathy,ethnic,Hispanic or Latino,24,17,41
321314,Abdominal aortic aneurysm without rupture,ethnic,Not Hispanic or Latino,8,32,40
4066376,Pilonidal sinus with abscess,racial,White,21,20,41
443728,Mass of chest wall,ethnic,Not Hispanic or Latino,23,17,40
4171556,Ankle ulcer,racial,Unknown,32,8,40
4094448,Pregnancy test negative,ethnic,Not Hispanic or Latino,40,1,41
444413,Pyrexial convulsion,racial,White,21,20,41
376103,Retinopathy,racial,Unknown,26,14,40
4239301,Unwanted pregnancy,racial,White,41,0,41
201606,Crohn's disease,ethnic,Hispanic or Latino,26,15,41
4142479,Hyperthyroidism,ethnic,Hispanic or Latino,23,17,40
380096,Proliferative diabetic retinopathy,ethnic,Not Hispanic or Latino,20,21,41
436677,"Brief situational non-psychotic disorder, NOS",racial,Black or African American ,1,40,41
72469,Closed dislocation of shoulder region,ethnic,Hispanic or Latino,17,23,40
439166,Closed fracture of radius,ethnic,Hispanic or Latino,22,19,41
440083,Acute stress disorder,racial,Unknown,32,8,40
81186,Contusion of wrist,racial,White,35,5,40
4060985,BMI 30+ - obesity,racial,American Indian,24,17,41
72778,Open wound of toe(s) without mention of complication,racial,White,26,14,40
255848,Pneumonia,racial,Other Race,21,20,41
316211,Acquired spondylolisthesis,racial,White,26,14,40
197795,Acute hepatitis B,ethnic,Hispanic or Latino,26,14,40
200450,Disease of urethra,ethnic,Hispanic or Latino,25,16,41
4152813,Family disruption,ethnic,Hispanic or Latino,20,20,40
193666,Hip injury,ethnic,Hispanic or Latino,29,12,41
4261613,Educational problem,racial,White,17,23,40
192242,Acute hepatitis C,racial,Unknown,8,32,40
193807,Anorectal fistula,ethnic,Hispanic or Latino,8,32,40
4292726,Contact - infectious disease,ethnic,Not Hispanic or Latino,19,21,40
137829,Erythroid aplasia,racial,Unknown,38,2,40
432295,Pernicious anemia,racial,White,13,27,40
198995,Type 1 diabetes mellitus - poor control,racial,American Indian or Alaska Native ,29,11,40
4196960,Varicocele,ethnic,Hispanic or Latino,1,39,40
376103,Retinopathy,racial,White,22,18,40
436962,Sleeplessness,racial,Asian Indian,39,1,40
435082,Closed fracture nasal bone,racial,White,23,17,40
440519,Premature - weight 1000g-2499g or gestation of 28-37weeks,ethnic,Hispanic or Latino,21,19,40
440921,Traumatic injury,ethnic,Hispanic or Latino,23,17,40
196436,Internal haemorrhoid,ethnic,Hispanic or Latino,17,23,40
78236,Muscle wasting disorder,racial,White,10,30,40
4103638,Amputated - transfemoral,ethnic,Hispanic or Latino,18,22,40
376663,Vitamin A deficiency with conjunctival xerosis,ethnic,Hispanic or Latino,40,0,40
198101,Lipoma of skin and subcutaneous tissue (excluding face),racial,Unknown,23,17,40
379019,Inflammation of conjunctiva,racial,Asian,25,16,41
4104853,Epileptic seizures - clonic,ethnic,Hispanic or Latino,26,14,40
252658,Intrinsic asthma without status asthmaticus,racial,White,24,16,40
435171,Allergic state,racial,Black or African American ,32,8,40
30978,Hereditary leptocytosis,ethnic,Not Hispanic or Latino,34,7,41
75650,Proteinuria,racial,Asian,20,20,40
433507,Loss of teeth due to local periodontal disease,racial,White,0,40,40
4112816,Other respiratory system diseases,ethnic,Hispanic or Latino,17,23,40
442588,OSA - Obstructive sleep apnoea,racial,Other Race,5,35,40
316998,Left bundle branch block,racial,Unknown,26,14,40
438460,Edentulous alveolar ridge atrophy,racial,Unknown,29,11,40
316127,Vitreous opacities,ethnic,Hispanic or Latino,28,12,40
437986,FTT - Failure to thrive,racial,Unknown,20,20,40
135027,"Carbuncle of leg, except foot",ethnic,Hispanic or Latino,20,20,40
376663,Vitamin A deficiency with conjunctival xerosis,racial,Unknown,40,0,40
432585,Blood coagulation disorder,racial,Other Race,0,40,40
4114314,Screening for osteoporosis,racial,Other Race,39,1,40
433822,Complication related to pregnancy,ethnic,Hispanic or Latino,40,0,40
141932,Senile hyperkeratosis,ethnic,Not Hispanic or Latino,25,15,40
134159,Precordial pain,racial,Unknown,24,16,40
4030270,Proliferative polycythemia,racial,White,31,8,39
4014230,Ankle sprain NOS,ethnic,Hispanic or Latino,16,24,40
201072,Benign prostatic hypertrophy without outflow obstruction,ethnic,Hispanic or Latino,0,40,40
135893,Decubitus ulcer of heel,racial,White,38,1,39
4088920,Womb absent,ethnic,Not Hispanic or Latino,40,0,40
440029,Viral disease,racial,Black or African American ,19,21,40
137967,"Muscle, ligament and fascia disorders",racial,White,26,14,40
141213,Scarlet fever,racial,White,21,19,40
74396,TMJ - Temporomandibular joint disorder,racial,Unknown,32,7,39
81112,Arthralgia of the lower leg,racial,American Indian or Alaska Native ,37,3,40
318397,Chronic idiopathic thrombocytopenic purpura,ethnic,Hispanic or Latino,20,19,39
436209,Fracture of fibula,ethnic,Hispanic or Latino,29,10,39
432791,Urticaria-angio-oedema,racial,White,22,17,39
4066820,Ingestion dermatitis due to food,ethnic,Hispanic or Latino,26,13,39
259043,Emphysematous bleb of lung,ethnic,Hispanic or Latino,39,1,40
134144,Cleft palate with cleft lip,ethnic,Hispanic or Latino,14,26,40
75637,Acquired postural kyphosis,racial,White,38,2,40
432453,General clinical state finding,racial,White,25,14,39
78605,Superficial bruising of elbow,ethnic,Hispanic or Latino,22,17,39
78832,Intervertebral disc disorder with myelopathy,racial,Black or African American ,6,34,40
440985,Phobia,ethnic,Hispanic or Latino,37,2,39
444132,Knee injury,racial,Unknown,25,14,39
442306,Adjustment disorder with depressed mood,racial,Other Race,32,8,40
201070,Cholelithiasis AND cholecystitis without obstruction,ethnic,Not Hispanic or Latino,39,1,40
443876,Obsessive compulsive personality disorder,racial,Unknown,40,0,40
438398,Leukocytosis,ethnic,Not Hispanic or Latino,19,21,40
75911,Acquired hallux valgus,racial,Unknown,31,9,40
433701,Mycosis,ethnic,Hispanic or Latino,24,16,40
140821,Spasm,racial,Asian,20,19,39
193807,Anorectal fistula,racial,White,5,35,40
434821,SIRS - System inflammatory response syndrome,racial,White,22,17,39
440953,Cysticercosis,ethnic,Hispanic or Latino,34,5,39
438567,Adult failure to thrive syndrome,racial,Other Race,39,0,39
197724,Unilateral traumatic amputation of foot without complication,ethnic,Hispanic or Latino,35,4,39
435950,Closed Colles' fracture,ethnic,Hispanic or Latino,34,5,39
141371,PR - Pityriasis rosea,ethnic,Hispanic or Latino,23,16,39
432801,"Injury undetermined whether accidentally or purposely inflicted, fall from natural site",ethnic,Hispanic or Latino,32,7,39
197950,Cellulitis and abscess of trunk,ethnic,Not Hispanic or Latino,24,15,39
134671,Dental abscess without a sinus,racial,White,25,14,39
4179214,Family history of malignant neoplasm of gastrointestinal tract,racial,White,31,8,39
437663,Fever,racial,Black or African American ,16,23,39
138225,Disease of sebaceous glands,ethnic,Hispanic or Latino,20,19,39
374919,Disseminated sclerosis,racial,Unknown,39,0,39
193787,Varicose veins of lower extremity with ulcer AND inflammation,ethnic,Hispanic or Latino,17,22,39
432585,Blood coagulation disorder,racial,Black or African American ,2,37,39
72993,Primary localised osteoarthrosis,ethnic,Not Hispanic or Latino,11,28,39
444246,Cirrhosis of liver not due to alcohol,racial,Other Race,39,0,39
201530,"Diabetes mellitus, adult onset, with hyperosmolar coma",ethnic,Hispanic or Latino,30,9,39
381017,Ametropic amblyopia,racial,Unknown,23,16,39
432941,Disease of tongue,ethnic,Hispanic or Latino,26,13,39
4168217,Generalized hyperhidrosis,racial,Unknown,31,8,39
195312,Functional voiding disorder,racial,Unknown,34,5,39
432541,Primary tuberculosis,racial,Asian Indian,39,0,39
441408,Vomiting,racial,Other Race,20,19,39
373766,Retinopathy of prematurity,racial,White,22,17,39
432541,Primary tuberculosis,ethnic,Not Hispanic or Latino,39,0,39
138519,Spondylosis without myelopathy,racial,Unknown,37,2,39
440977,Megaloblastic anemia due to folate deficiency,ethnic,Hispanic or Latino,23,16,39
80156,Asymptomatic bacteriuria in pregnancy,ethnic,Hispanic or Latino,39,0,39
259043,Emphysematous bleb of lung,racial,Other Race,39,0,39
201070,Cholelithiasis AND cholecystitis without obstruction,racial,Asian,39,0,39
254662,Pulmonary infarction,racial,Unknown,32,7,39
374036,Chronic conjunctivitis,ethnic,Hispanic or Latino,21,18,39
139188,Open wound of scalp without complication,racial,White,13,26,39
195590,Urethral stricture,ethnic,Hispanic or Latino,2,37,39
253797,Post-inflammatory pulmonary fibrosis,racial,Unknown,28,11,39
441701,Sprain of hip joint,racial,White,24,14,38
432967,Anemia during pregnancy - baby not yet delivered,ethnic,Not Hispanic or Latino,38,0,38
312950,IgE-mediated allergic asthma,racial,Asian Indian,38,0,38
432308,Mononeuritis of lower limb,racial,White,21,17,38
436445,Abrasion of teeth,racial,White,20,19,39
77638,Displacement of intervertebral disc without myelopathy,racial,White,29,9,38
201613,Chronic nonalcoholic liver disease,racial,Asian,28,11,39
437995,Closed ill-defined fractures of upper limb,ethnic,Hispanic or Latino,33,5,38
138389,Benign neoplasm of scalp and skin of neck,racial,White,23,15,38
74188,Closed fracture of rib,racial,Unknown,26,12,38
74114,Cellulitis and abscess of foot excluding toe,racial,Unknown,22,17,39
4196362,Genetic counselling,ethnic,Hispanic or Latino,36,2,38
435534,"Nondependent alcohol abuse, continuous",racial,Unknown,8,31,39
253815,Ulceration of vulva,ethnic,Hispanic or Latino,38,0,38
440922,Diabetic on insulin,racial,White,22,16,38
442623,Abrasion AND/OR friction burn of scalp without infection,racial,White,16,23,39
74729,Ganglion and synovial cyst,racial,Unknown,28,10,38
136934,Primary hyperparathyroidism,ethnic,Hispanic or Latino,27,11,38
377554,Hereditary peripheral neuropathy,racial,White,35,3,38
134452,Miners' elbow,ethnic,Hispanic or Latino,10,28,38
4103471,Observation of body mass index,racial,Asian Indian,25,14,39
439708,Disorders of initiating and maintaining sleep,racial,Other Race,25,13,38
443422,Scleroderma,racial,White,38,1,39
257004,Acute exacerbation of chronic obstructive airways disease,racial,Asian Indian,38,0,38
4029488,Hepatic encephalopathy,racial,Unknown,1,38,39
436246,Low libido,racial,White,8,31,39
433000,Patellar tendonitis,ethnic,Hispanic or Latino,17,22,39
4188027,Food allergy,racial,White,18,20,38
443115,Closed fracture finger proximal phalanx,ethnic,Hispanic or Latino,13,25,38
4062650,Malnutrition screening,racial,White,4,35,39
4062488,Thyroid disorder screening,ethnic,Hispanic or Latino,28,10,38
436812,Tongue tie,ethnic,Hispanic or Latino,4,34,38
433599,Abnormal biochemistry finding,racial,Unknown,26,12,38
80809,Rheumatoid arthritis,racial,Black or African American ,25,14,39
379801,Trigeminal neuralgia,racial,Unknown,35,4,39
433968,Candidiasis,ethnic,Not Hispanic or Latino,25,14,39
435227,Nutritional deficiency,racial,White,23,16,39
317309,Peripheral arterial occlusive disease,ethnic,Not Hispanic or Latino,19,20,39
201998,Unilateral traumatic amputation of leg at OR above knee without complication,ethnic,Hispanic or Latino,32,6,38
443577,Asymmetric sensorineural hearing loss,ethnic,Hispanic or Latino,25,13,38
444297,Vertiginous syndrome,racial,Unknown,37,2,39
443430,HPV - Human papillomavirus test positive,racial,Unknown,37,1,38
4145627,Biliary calculus,ethnic,Hispanic or Latino,35,4,39
432454,Excessive thirst,ethnic,Hispanic or Latino,17,22,39
439002,Eating disorder,ethnic,Hispanic or Latino,25,13,38
432595,Amyloidosis,ethnic,Hispanic or Latino,38,0,38
437891,PPHT - Primary pulmonary hypertension,racial,Unknown,38,1,39
141216,MC - Molluscum contagiosum,racial,Unknown,25,13,38
373724,Neoplasm of brain,racial,White,23,16,39
195588,Cystitis,racial,Unknown,37,1,38
138994,MDS - Myelodysplastic syndrome,ethnic,Hispanic or Latino,31,8,39
140259,Open wound of face without complication,racial,White,12,26,38
4062495,Glaucoma screening,racial,Unknown,32,5,37
30968,Diabetes insipidus,ethnic,Hispanic or Latino,25,13,38
4064377,Depression screening,racial,American Indian,23,14,37
438480,"Abnormal glucose tolerance in mother complicating pregnancy, childbirth AND/OR puerperium",ethnic,Not Hispanic or Latino,38,0,38
440358,Lipoma,ethnic,Not Hispanic or Latino,24,14,38
437390,Hypoxaemia,racial,Unknown,21,17,38
372886,Refractory migraine with aura,ethnic,Hispanic or Latino,35,2,37
75389,Current tear of lateral cartilage AND/OR meniscus of knee,racial,White,24,14,38
80568,Traumatic amputation of finger without mention of complication,ethnic,Hispanic or Latino,4,34,38
192676,Cervical intraepithelial neoplasia grade 1,racial,Unknown,38,0,38
81250,Carcinoma in situ of breast,ethnic,Hispanic or Latino,38,0,38
4062650,Malnutrition screening,ethnic,Hispanic or Latino,3,35,38
437251,Benign neoplasm of pituitary gland and craniopharyngeal duct,racial,Unknown,16,22,38
432739,Red blood cell disorder,ethnic,Hispanic or Latino,23,15,38
436446,Cracked tooth syndrome,ethnic,Hispanic or Latino,17,20,37
201519,Ca liver - primary,racial,White,1,37,38
376979,Diabetic cataract,racial,Asian,22,16,38
436882,[X]Fall involving bed,racial,Unknown,26,11,37
443587,Diastolic heart failure,ethnic,Not Hispanic or Latino,17,20,37
72748,Strain of rotator cuff of shoulder,racial,Unknown,28,10,38
79072,Inflammatory disorder of breast,racial,Unknown,34,4,38
321588,Heart disease,ethnic,Not Hispanic or Latino,5,32,37
80225,Sprain of ligament of lumbosacral joint,ethnic,Hispanic or Latino,19,19,38
4206460,Problem,ethnic,Not Hispanic or Latino,14,23,37
4280828,"Carrier, infectious agent",racial,White,26,12,38
198194,Female genital organ symptoms,racial,Other Race,38,0,38
378416,Retinal disorder,ethnic,Hispanic or Latino,29,8,37
4310768,Fall on steps,ethnic,Hispanic or Latino,29,8,37
440385,Obstructive hydrocephalus,ethnic,Hispanic or Latino,12,25,37
441264,Primary thrombocytopenia,ethnic,Not Hispanic or Latino,5,32,37
376525,Audiogram abnormal,ethnic,Hispanic or Latino,15,22,37
441628,Menopausal and postmenopausal disorders,ethnic,Not Hispanic or Latino,37,0,37
441830,Disorder of fluid AND/OR electrolyte,ethnic,Hispanic or Latino,21,16,37
436078,Malnutrition of moderate degree (Gomez: 60% to less than 75% of standard weight),ethnic,Hispanic or Latino,29,8,37
442793,Diabetic complication,racial,Asian,20,17,37
132397,Pilonidal cyst with no abscess,ethnic,Hispanic or Latino,7,30,37
141917,Balanitis xerotica obliterans,racial,Unknown,0,37,37
77025,Diverticulitis of colon,ethnic,Not Hispanic or Latino,18,19,37
444202,Abscess,racial,Asian,23,14,37
4104864,Migraine NOS,racial,White,31,7,38
80004,Hand injury,racial,White,18,19,37
194984,Hepatopathy,ethnic,Not Hispanic or Latino,23,14,37
312922,Coronary bypass graft observation,racial,Asian,15,22,37
440012,Fall from chair or bed,ethnic,Hispanic or Latino,27,10,37
443943,Herpes zoster,ethnic,Hispanic or Latino,16,21,37
138384,Acquired hypothyroidism,ethnic,Not Hispanic or Latino,21,16,37
377853,Chronic tension-type headache,ethnic,Hispanic or Latino,29,8,37
378424,Astigmatism,ethnic,Hispanic or Latino,23,14,37
444211,Disease of thigh,racial,Unknown,19,19,38
381591,Cerebrovascular disease,racial,Filipino,36,1,37
434339,Adolescent - emotional problem,ethnic,Hispanic or Latino,13,24,37
198683,Viral hepatitis B without hepatic coma,ethnic,Not Hispanic or Latino,19,19,38
138525,Pain in limb,racial,American Indian or Alaska Native ,34,4,38
314665,Atrial flutter,racial,Unknown,11,26,37
4158567,Post percutaneous transluminal coronary angioplasty,racial,Asian,8,29,37
30365,Panhypopituitarism,ethnic,Hispanic or Latino,28,9,37
195240,Monoplegia of lower limb,ethnic,Hispanic or Latino,32,5,37
4062484,Cervical neoplasia screening,racial,American Indian or Alaska Native ,37,0,37
433163,Deficiency of macronutrients,racial,White,28,8,36
141933,Alopecia areata,racial,White,22,15,37
192279,Diabetic nephropathy,racial,American Indian or Alaska Native ,37,0,37
433595,Interstitial edema,racial,American Indian or Alaska Native ,22,14,36
201899,Unilateral recurrent inguinal hernia,racial,Unknown,1,36,37
439081,Premenstrual tension syndrome,ethnic,Hispanic or Latino,37,0,37
74723,Arthropathy associated with a neurological disorder,ethnic,Hispanic or Latino,17,20,37
4152047,Lipid screening,racial,Unknown,28,8,36
443585,Abrasion AND/OR friction burn of multiple sites,racial,Unknown,16,20,36
441969,Radiology result abnormal,racial,White,24,13,37
137785,Verruca plantaris,ethnic,Not Hispanic or Latino,14,22,36
198715,Premature menopause,ethnic,Hispanic or Latino,37,0,37
76685,MG - Myasthenia gravis,ethnic,Not Hispanic or Latino,8,29,37
436155,Redundant prepuce and phimosis,ethnic,Not Hispanic or Latino,0,37,37
4152047,Lipid screening,ethnic,Not Hispanic or Latino,28,9,37
443774,"Disease condition determination, uncontrolled",ethnic,Hispanic or Latino,16,21,37
81611,Diverticular disease of colon,racial,Other Race,13,24,37
313217,Atrial fibrillation,racial,Native Hawaiian or Other Pacific Islander ,1,36,37
437233,Plasmacytic myeloma,racial,White,32,4,36
442077,Anxiety disorder,ethnic,Not Hispanic or Latino,21,16,37
137627,Prickly heat,racial,White,16,20,36
441428,Closed fracture of lateral malleolus,racial,White,26,10,36
433400,Emergency contraception,racial,Unknown,37,0,37
133857,Acquired deformity of limb,racial,White,16,20,36
73560,Calcaneal spur,ethnic,Not Hispanic or Latino,23,14,37
81378,Chondromalacia of patella,ethnic,Hispanic or Latino,22,15,37
4168213,Chest pain on breathing,racial,Unknown,25,11,36
4340379,Hepatitis B carrier,ethnic,Hispanic or Latino,20,17,37
4171434,Immunization refused,ethnic,Not Hispanic or Latino,26,11,37
316995,Coronary occlusion,ethnic,Hispanic or Latino,32,4,36
376680,Generalized nonconvulsive epilepsy,racial,White,28,8,36
138463,Oral aphthae,racial,Unknown,26,10,36
81893,Chronic ulcerative colitis,racial,Unknown,8,29,37
4245252,Raised prostate specific antigen,racial,Asian,0,36,36
4107655,Observations relating to psychosocial functioning,racial,Unknown,21,15,36
257907,Disorder of lung,racial,Asian,13,23,36
439697,Hypertensive renal disease with renal failure,racial,White,31,5,36
433596,Abnormal sputum,ethnic,Hispanic or Latino,23,13,36
73241,Anal and rectal polyp,racial,White,10,26,36
4103725,Refraction or accommodation disorder NOS,ethnic,Hispanic or Latino,21,15,36
436651,Hodgkin's disease of extranodal AND/OR solid organ site,ethnic,Hispanic or Latino,28,8,36
4146248,Rheumatoid arthritis and other inflammatory polyarthropathies,ethnic,Hispanic or Latino,32,4,36
79936,Polyuria,racial,Unknown,18,18,36
319826,Secondary hypertension,ethnic,Hispanic or Latino,36,0,36
198464,Incisional hernia,racial,White,28,8,36
444112,Integumentary system finding,racial,Unknown,18,18,36
443454,Cerebral infarction,racial,Black or African American ,32,4,36
75091,Closed fracture of carpal bone,racial,Unknown,26,10,36
379019,Inflammation of conjunctiva,racial,Other Race,20,16,36
314131,Degeneration of cervical intervertebral disc,racial,Unknown,23,13,36
4048727,Neoplasm screening,ethnic,Hispanic or Latino,17,19,36
435788,Disorder of phosphorus metabolism,racial,Unknown,25,11,36
195259,Entrapment of lateral cutaneous nerve of thigh,ethnic,Hispanic or Latino,27,9,36
381308,Abscess of eyelid,racial,White,22,14,36
136237,Cardiovascular system problem,racial,White,23,13,36
4012491,Difficulty chewing,racial,Unknown,25,11,36
197684,Dysuria,racial,American Indian or Alaska Native ,28,8,36
443580,Systolic heart failure,racial,White,16,20,36
441417,Lack of coordination,ethnic,Hispanic or Latino,22,14,36
435933,Closed fracture of lumbar vertebra without spinal cord injury,racial,Unknown,26,10,36
436944,Chronic paranoid schizophrenia,racial,White,7,29,36
377552,Moderate nonproliferative diabetic retinopathy,racial,White,8,28,36
78200,Benign mammary dysplasia,ethnic,Hispanic or Latino,35,1,36
440388,[X]Developmental co - ordination disorder,ethnic,Hispanic or Latino,7,29,36
441407,Appetite loss - anorexia,racial,Asian,19,17,36
133298,Musculoskeletal disorder of the neck,racial,Unknown,27,9,36
135923,CP - Cleft palate,racial,White,10,26,36
436230,Blood chemistry abnormal,racial,Other Race,26,10,36
4103725,Refraction or accommodation disorder NOS,racial,White,21,15,36
73840,Primary localised osteoarthrosis of shoulder region,racial,White,26,10,36
134870,Pityriasis versicolor,racial,Unknown,23,13,36
372914,Optic atrophy,racial,Unknown,24,12,36
316429,Ectopics,racial,White,19,17,36
192687,Vulvovaginitis associated with another disease,racial,White,35,0,35
4305589,"Neoplasm, benign",racial,White,27,8,35
139099,Ingrowing nail,racial,Other Race,14,22,36
444391,Pain around eye,racial,Unknown,25,11,36
436658,Vitamin deficiency,racial,Unknown,28,8,36
4175226,Screening for malignant neoplasm of colon,racial,Filipino,25,11,36
381859,Infective OE,racial,Other Race,17,18,35
443753,Abrasion AND/OR friction burn of wrist without infection,ethnic,Hispanic or Latino,13,22,35
313221,Rheumatic aortic stenosis,ethnic,Hispanic or Latino,30,5,35
437478,Bite of nonvenomous arthropod,ethnic,Not Hispanic or Latino,21,14,35
315078,Palpitations,racial,Other Race,28,7,35
141216,MC - Molluscum contagiosum,ethnic,Not Hispanic or Latino,11,24,35
40480002,Aphasia as late effect of cerebrovascular disease,racial,White,15,20,35
440695,Encopresis,racial,White,8,28,36
317893,Paroxysmal supraventricular tachycardia,ethnic,Not Hispanic or Latino,26,9,35
73008,Enthesopathy,ethnic,Not Hispanic or Latino,21,14,35
437478,Bite of nonvenomous arthropod,racial,Unknown,19,17,36
197304,Ulcer of lower limb,racial,Other Race,3,32,35
4142479,Hyperthyroidism,racial,White,19,16,35
433033,Abnormal cervical Papanicolaou smear,racial,White,35,0,35
80504,Acquired genu valgum,ethnic,Hispanic or Latino,23,13,36
380097,Diabetic macular edema,racial,White,19,16,35
140821,Spasm,racial,Black or African American ,21,14,35
434084,Abscess of vulva,ethnic,Hispanic or Latino,35,0,35
436670,MD - Metabolic disorders,racial,White,14,21,35
439221,"Adverse effect, due to correct medicinal substance properly administered",racial,Unknown,20,16,36
321689,Apneic,racial,White,11,25,36
437992,Abnormal results of kidney function studies,ethnic,Not Hispanic or Latino,11,25,36
137057,Paronychia,ethnic,Not Hispanic or Latino,23,12,35
194997,Prostatitis,racial,Unknown,0,35,35
133794,Chronic gingivitis,racial,Unknown,16,19,35
438527,"Juvenile osteochondrosis of lower extremity, excluding foot",racial,White,8,28,36
198075,Venereal wart,racial,Unknown,25,10,35
440374,Obsessive compulsive disorder,ethnic,Hispanic or Latino,12,23,35
198985,Primary malignant neoplasm of kidney,racial,Unknown,1,34,35
439406,Allergy to animal,racial,White,20,16,36
440814,Torticollis,racial,White,14,22,36
137682,Skin sensation disturbance,racial,Other Race,22,13,35
81378,Chondromalacia of patella,racial,White,25,10,35
437525,Overweight,racial,American Indian,22,13,35
4247802,Muscular dystrophy,racial,White,10,25,35
433000,Patellar tendonitis,racial,White,19,16,35
201449,Unilateral traumatic amputation of leg below knee without complication,ethnic,Not Hispanic or Latino,0,35,35
374027,Lesion of ulnar nerve,ethnic,Hispanic or Latino,9,26,35
433877,Finding of cerebrospinal fluid: chemical content - general,ethnic,Hispanic or Latino,35,0,35
4105330,Chronic undifferentiated schizophrenia,racial,Unknown,34,1,35
194574,Chronic type B viral hepatitis,racial,Asian,10,25,35
198978,Acute gonorrhea of lower genitourinary tract,ethnic,Hispanic or Latino,16,19,35
28457,Hypertrophy of tonsils,ethnic,Not Hispanic or Latino,14,21,35
73231,Arthralgia of temporomandibular joint,racial,White,26,9,35
440385,Obstructive hydrocephalus,racial,White,8,27,35
80951,Candidiasis of urogenital site,racial,Unknown,11,24,35
378135,Facial nerve disorder,racial,Unknown,35,0,35
257011,Acute upper respiratory infection,racial,Native Hawaiian or Other Pacific Islander ,10,25,35
437832,Malnutrition of mild degree (Gomez: 75% to less than 90% of standard weight),ethnic,Hispanic or Latino,31,4,35
79106,Arthralgia of the pelvic region and thigh,racial,Other Race,26,9,35
199067,Inflammatory disease of female pelvic organs AND/OR tissues,ethnic,Hispanic or Latino,35,0,35
4147466,Panic disorder with agoraphobia,ethnic,Hispanic or Latino,32,3,35
433877,Finding of cerebrospinal fluid: chemical content - general,racial,Other Race,35,0,35
440202,Multiple congenital malformations,ethnic,Hispanic or Latino,20,15,35
193512,Embolism and thrombosis of the renal vein,ethnic,Hispanic or Latino,29,6,35
80180,Osteoarthritis,racial,American Indian or Alaska Native ,28,7,35
73575,Deformity of toe,ethnic,Hispanic or Latino,18,17,35
440457,Threatened abortion,ethnic,Hispanic or Latino,35,0,35
373638,Superficial injury of cornea,racial,White,13,22,35
195862,Urethritis,ethnic,Hispanic or Latino,5,30,35
193512,Embolism and thrombosis of the renal vein,racial,White,29,6,35
432588,Megaloblastic anemia due to vitamin B>12< deficiency,racial,White,21,14,35
4252594,Subconjunctival injection,ethnic,Hispanic or Latino,20,15,35
377554,Hereditary peripheral neuropathy,ethnic,Not Hispanic or Latino,35,0,35
75637,Acquired postural kyphosis,racial,Unknown,32,3,35
441532,Monoclonal paraproteinaemia,ethnic,Hispanic or Latino,10,25,35
442116,Allergy to eggs,ethnic,Hispanic or Latino,11,23,34
432869,Hemorrhagic disorder due to circulating anticoagulants,ethnic,Not Hispanic or Latino,0,35,35
192956,Cholecystitis,racial,White,31,4,35
381295,Age-related cataract,racial,Asian,29,5,34
80225,Sprain of ligament of lumbosacral joint,racial,White,20,15,35
75863,Chronic interstitial cystitis,racial,Unknown,34,1,35
78235,Disorder of coccyx,racial,White,29,6,35
4112816,Other respiratory system diseases,racial,White,18,17,35
200783,Previous cesarean section,ethnic,Hispanic or Latino,35,0,35
434003,GSD - Glycogen storage disease,ethnic,Hispanic or Latino,34,1,35
440069,Drug dependence,ethnic,Not Hispanic or Latino,12,23,35
375549,Double pterygium,ethnic,Hispanic or Latino,16,19,35
74194,Back sprain,racial,White,19,16,35
432923,SAH - Subarachnoid haemorrhage,racial,Unknown,30,4,34
441788,Human papilloma virus infection,ethnic,Hispanic or Latino,31,4,35
435372,Underweight,ethnic,Not Hispanic or Latino,21,13,34
435783,Schizophrenia,racial,Other Race,6,28,34
378427,Tear film insufficiency,racial,Asian,25,10,35
4176874,Infantile melanodontia,ethnic,Hispanic or Latino,12,22,34
376966,Exudative age-related macular degeneration,racial,Unknown,29,5,34
77635,Disease of hand,ethnic,Not Hispanic or Latino,34,1,35
79884,Galactorrhea not associated with childbirth,racial,Unknown,34,0,34
442077,Anxiety disorder,racial,Unknown,32,2,34
381306,Deaf mutism,ethnic,Hispanic or Latino,28,7,35
4057825,Constipation NOS,racial,Unknown,22,12,34
437038,Blood in urine,racial,Other Race,29,5,34
4100857,Pickwickian syndrome,racial,Black or African American ,20,14,34
201605,Unilateral inguinal hernia with gangrene,racial,Other Race,0,34,34
432729,Crying infant,ethnic,Hispanic or Latino,11,23,34
372423,Reduction deformities of brain,racial,Unknown,31,3,34
372887,Disease of brain,ethnic,Hispanic or Latino,4,30,34
200970,CIS - Carcinoma in situ of prostate,ethnic,Hispanic or Latino,0,34,34
443350,Lower urinary tract symptoms,racial,Black or African American ,0,34,34
192438,Abdominal mass,racial,White,32,2,34
133569,Fasciitis,ethnic,Hispanic or Latino,22,12,34
259865,Cyst of Bartholin's gland duct,racial,White,33,1,34
433946,Fall on same level due to impact against another person,ethnic,Hispanic or Latino,21,13,34
197044,Female infertility associated with anovulation,ethnic,Hispanic or Latino,34,0,34
439081,Premenstrual tension syndrome,racial,White,33,1,34
437671,Abnormal feces,racial,Unknown,33,1,34
193688,Clostridium difficile infection,ethnic,Hispanic or Latino,13,21,34
442013,Burn,racial,Unknown,23,11,34
201605,Unilateral inguinal hernia with gangrene,ethnic,Hispanic or Latino,0,34,34
4059157,Family circumstance NOS,racial,White,24,10,34
201449,Unilateral traumatic amputation of leg below knee without complication,racial,Black or African American ,0,34,34
81539,Mitochondrial disease,racial,White,20,14,34
435933,Closed fracture of lumbar vertebra without spinal cord injury,racial,White,11,23,34
377254,"Multi-infarct dementia, uncomplicated",racial,Asian,20,14,34
195453,"Colitis, enteritis and gastroenteritis presumed infectious",ethnic,Not Hispanic or Latino,20,14,34
4062488,Thyroid disorder screening,racial,White,28,6,34
192239,Post-herpetic polyneuropathy,racial,White,23,11,34
4101602,Henoch-Schonlein purpura,ethnic,Hispanic or Latino,19,15,34
4144103,Influenza NOS,ethnic,Hispanic or Latino,21,13,34
313459,Sleep apnea,racial,Other Race,4,30,34
434003,GSD - Glycogen storage disease,racial,Unknown,34,0,34
376065,Neurologic disorder associated with type II diabetes mellitus,racial,Filipino,19,14,33
81902,Urinary tract infectious disease,racial,American Indian or Alaska Native ,31,2,33
194152,Renal agenesis and dysgenesis,racial,White,22,12,34
321588,Heart disease,racial,White,20,13,33
4086928,IUCD status,racial,White,34,0,34
434327,Cannabis abuse,ethnic,Hispanic or Latino,7,26,33
439314,Thrombophlebitis of the femoral vein,ethnic,Hispanic or Latino,4,29,33
440940,Methicillin resistant Staphylococcus aureus infection,ethnic,Hispanic or Latino,19,14,33
193518,Intestinal obstruction,ethnic,Hispanic or Latino,19,14,33
316139,HF - Heart failure,ethnic,Not Hispanic or Latino,15,19,34
433125,Infection due to Staphylocccus aureus,ethnic,Hispanic or Latino,23,11,34
260131,Bronchial disorder,racial,White,25,8,33
201070,Cholelithiasis AND cholecystitis without obstruction,ethnic,Hispanic or Latino,33,1,34
198124,Disorder of kidney,racial,Black or African American ,25,9,34
132706,Nail disease,ethnic,Not Hispanic or Latino,22,12,34
435782,Chronic schizophrenic,racial,Unknown,29,5,34
374358,Dermatochalasis,ethnic,Hispanic or Latino,28,5,33
4175807,Rheumatic disease of tricuspid valve,ethnic,Hispanic or Latino,21,13,34
372903,Retinal edema,racial,White,22,11,33
376961,Disturbance of consciousness,racial,White,19,15,34
432730,Dysphonia,ethnic,Hispanic or Latino,22,11,33
440321,Helicobacter-associated disease,racial,Other Race,22,11,33
253788,Nasal polyp,ethnic,Not Hispanic or Latino,20,13,33
4110046,Obstructive chronic bronchitis NOS,ethnic,Hispanic or Latino,21,13,34
201093,Infection of skin AND/OR subcutaneous tissue,ethnic,Not Hispanic or Latino,23,11,34
138463,Oral aphthae,ethnic,Not Hispanic or Latino,23,11,34
442588,OSA - Obstructive sleep apnoea,racial,Black or African American ,13,21,34
4066163,Ureteric colic,racial,Unknown,2,32,34
139841,Chronic frontal sinusitis,ethnic,Hispanic or Latino,28,5,33
432869,Hemorrhagic disorder due to circulating anticoagulants,racial,Black or African American ,0,34,34
440238,Closed fracture of metatarsal bone,ethnic,Not Hispanic or Latino,24,10,34
140266,Superficial bruising of back,ethnic,Hispanic or Latino,18,16,34
444297,Vertiginous syndrome,ethnic,Not Hispanic or Latino,32,1,33
438120,Opioid dependence,racial,Black or African American ,10,23,33
439696,Hypertensive heart and renal disease with (congestive) heart failure,racial,White,7,26,33
438557,Abnormal glucose level,racial,American Indian or Alaska Native ,16,18,34
79116,Disorder of tendon of shoulder region,ethnic,Hispanic or Latino,20,13,33
74188,Closed fracture of rib,racial,White,14,19,33
197914,Chronic gastric ulcer with perforation but without obstruction,racial,Asian,30,4,34
436263,Broken tooth without complication,ethnic,Hispanic or Latino,21,13,34
40484513,Hemiplegia of nondominant side as late effect of cerebrovascular disease,racial,Other Race,34,0,34
376713,Cerebral hemorrhage,ethnic,Hispanic or Latino,16,17,33
195603,Vulval and/or perineal noninflammatory disorders,racial,White,32,1,33
435524,Sleep disorder,racial,Unknown,20,13,33
443228,"Abrasion or friction burn of foot and toe, without mention of infection",ethnic,Hispanic or Latino,20,13,33
375281,Acute suppurative otitis media - tympanic membrane intact,racial,Black or African American ,17,16,33
196044,Primary malignant neoplasm of stomach,racial,White,9,24,33
320835,TOF - Tetralogy of Fallot,racial,White,11,22,33
443913,Congenital anomaly of trachea,racial,White,7,26,33
75346,Disorder of meniscus of knee,ethnic,Hispanic or Latino,13,20,33
439005,Chronic alcoholism in remission,racial,White,10,23,33
79106,Arthralgia of the pelvic region and thigh,racial,Asian,23,10,33
4185302,Chronic myocardial ischemia,racial,White,11,22,33
4016352,Tuberculosis contact,racial,White,23,10,33
4166776,Dupuytren contracture,ethnic,Hispanic or Latino,10,23,33
134765,General body deterioration,ethnic,Hispanic or Latino,14,19,33
440202,Multiple congenital malformations,racial,White,15,18,33
432869,Hemorrhagic disorder due to circulating anticoagulants,racial,Other Race,0,33,33
432594,Osteomalacia,ethnic,Hispanic or Latino,33,0,33
78149,Congenital hereditary muscular dystrophy,ethnic,Hispanic or Latino,5,28,33
377085,Congenital anomaly of brain,ethnic,Hispanic or Latino,15,18,33
75623,Old disruption of anterior cruciate ligament,racial,White,17,16,33
195012,Metrorrhagia,ethnic,Not Hispanic or Latino,33,0,33
436730,"Appendicitis, unqualified",racial,White,13,20,33
437382,Urine observation,racial,Other Race,25,8,33
193874,Bed wetting,ethnic,Not Hispanic or Latino,10,23,33
77644,Adhesive capsulitis of shoulder,ethnic,Not Hispanic or Latino,24,9,33
443115,Closed fracture finger proximal phalanx,racial,White,9,24,33
4240902,Allergy to peanuts,racial,White,9,24,33
434272,Varicella infection,racial,White,16,17,33
197206,Balantidiasis,ethnic,Hispanic or Latino,0,33,33
201045,Thrombosed external haemorrhoids,ethnic,Hispanic or Latino,20,13,33
320835,TOF - Tetralogy of Fallot,ethnic,Hispanic or Latino,11,22,33
74728,Synovitis and tenosynovitis,racial,White,18,15,33
440078,"Bipolar affective disorder, current episode manic",racial,Black or African American ,4,29,33
376114,Severe nonproliferative diabetic retinopathy,racial,Unknown,13,20,33
380097,Diabetic macular edema,racial,Unknown,17,16,33
436919,Primary malignant neoplasm of unspecified site,ethnic,Not Hispanic or Latino,29,4,33
4168217,Generalized hyperhidrosis,racial,White,16,17,33
442270,Disease of duodenum,ethnic,Hispanic or Latino,17,16,33
437828,Disorder of calcium metabolism,ethnic,Hispanic or Latino,22,11,33
198978,Acute gonorrhea of lower genitourinary tract,racial,White,14,19,33
79833,Meniere's disease,ethnic,Hispanic or Latino,30,3,33
4144103,Influenza NOS,racial,White,21,12,33
377279,"Profound impairment, one eye",racial,Black or African American ,5,28,33
314666,Healed coronary,racial,Black or African American ,20,12,32
138896,Open wound of forehead without complication,ethnic,Hispanic or Latino,16,17,33
432739,Red blood cell disorder,racial,White,18,14,32
135618,Prurigo,ethnic,Hispanic or Latino,20,12,32
260123,Acute inflammation of sinus,racial,American Indian or Alaska Native ,20,12,32
199860,Hernia of abdominal cavity,ethnic,Not Hispanic or Latino,3,29,32
258780,Chronic obstructive bronchitis,racial,Other Race,27,5,32
443622,Aneurysm of thoracic aorta,racial,White,23,10,33
195590,Urethral stricture,racial,White,7,26,33
442794,Poisoning by wasp sting,ethnic,Hispanic or Latino,16,17,33
4147164,Hematologic malignancy,ethnic,Hispanic or Latino,25,8,33
4308509,Impaired fasting glycaemia,racial,Black or African American ,13,20,33
4149382,Endocrine/metabolic screening,ethnic,Hispanic or Latino,23,9,32
133228,Dental caries,racial,Black or African American ,15,17,32
78497,Cellulitis and abscess of toe,ethnic,Not Hispanic or Latino,18,14,32
314968,Varices,ethnic,Hispanic or Latino,28,4,32
437097,Congenital anomaly of cartilage,ethnic,Hispanic or Latino,2,30,32
72576,Benign tumour of breast,ethnic,Hispanic or Latino,32,0,32
377287,Phlyctenular keratoconjunctivitis,ethnic,Hispanic or Latino,31,1,32
320536,Abnormal EKG finding,racial,Asian,13,20,33
433095,Fall on or from steps,racial,Unknown,22,11,33
444090,Disease of foot,ethnic,Hispanic or Latino,21,11,32
439697,Hypertensive renal disease with renal failure,ethnic,Not Hispanic or Latino,26,7,33
197607,Polymenorrhagia,racial,Other Race,32,0,32
23220,Chronic tonsillitis,ethnic,Hispanic or Latino,22,11,33
78831,Disease of ankle,racial,White,19,14,33
444202,Abscess,racial,Black or African American ,14,18,32
437579,Paroxysmal ventricular tachycardia,racial,Unknown,32,1,33
253954,PTB - Pulmonary tuberculosis,ethnic,Hispanic or Latino,23,10,33
4139420,Foreign body in auditory canal,racial,Unknown,15,17,32
4080568,Problem behaviour,racial,Unknown,11,22,33
73843,Synovial cyst of popliteal space,racial,Unknown,29,3,32
199067,Inflammatory disease of female pelvic organs AND/OR tissues,racial,White,32,0,32
193530,Follicular cyst of ovary,racial,White,32,0,32
317576,Coronary arteriosclerosis,racial,American Indian or Alaska Native ,7,26,33
134870,Pityriasis versicolor,ethnic,Not Hispanic or Latino,15,17,32
77139,Open wound of finger without complication,racial,Unknown,21,11,32
4287544,Manic bipolar I disorder,racial,Unknown,27,5,32
4295261,Postmenopausal state,ethnic,Not Hispanic or Latino,32,0,32
4170576,Pressure ulcer,racial,Unknown,24,8,32
132397,Pilonidal cyst with no abscess,racial,White,5,26,31
196163,Cervicitis and endocervicitis,racial,White,31,1,32
4103722,Cataract NOS,racial,Unknown,17,14,31
134460,Plantar fascial fibromatosis,racial,Other Race,28,4,32
437663,Fever,racial,Asian,15,17,32
4149353,"Attention deficit hyperactivity disorder, predominantly inattentive type",racial,Unknown,17,15,32
132572,Chronic myeloid leukaemia in remission,racial,Unknown,32,0,32
436096,Chronic pain,racial,Asian,24,8,32
439928,Gangrenous disorder,ethnic,Hispanic or Latino,6,26,32
4247802,Muscular dystrophy,ethnic,Hispanic or Latino,10,22,32
379769,Benign brain tumour,ethnic,Hispanic or Latino,25,7,32
314379,First degree atrioventricular block,racial,White,20,11,31
137951,Acquired keratoderma,racial,White,26,6,32
134736,Backache,racial,American Indian or Alaska Native ,22,10,32
140273,"Contusion, forearm area",ethnic,Hispanic or Latino,20,11,31
4005823,Tobacco user,racial,Other Race,9,23,32
437113,Asthenia,racial,White,17,14,31
434309,Sexual precocity,ethnic,Hispanic or Latino,25,7,32
138519,Spondylosis without myelopathy,ethnic,Not Hispanic or Latino,22,10,32
136368,Non-toxic multinodular goiter,racial,White,25,7,32
257315,Bacterial pneumonia,ethnic,Not Hispanic or Latino,20,12,32
193809,Melena due to gastrointestinal hemorrhage,racial,Asian,6,26,32
135615,Pityriasis,racial,Unknown,11,21,32
4144876,Contact dermatitis and other eczemas,ethnic,Hispanic or Latino,16,16,32
138148,Plantar nerve lesion,ethnic,Hispanic or Latino,25,7,32
140266,Superficial bruising of back,racial,White,17,14,31
317893,Paroxysmal supraventricular tachycardia,racial,White,20,12,32
134441,Chronic ulcer of skin,ethnic,Not Hispanic or Latino,6,26,32
437247,Anaemia of chronic disease,racial,Other Race,16,16,32
432863,Acquired coagulation factor deficiency,ethnic,Hispanic or Latino,17,14,31
76161,Impotence of organic origin,racial,Other Race,0,32,32
81893,Chronic ulcerative colitis,ethnic,Not Hispanic or Latino,20,11,31
374950,Oedema of eyelid,ethnic,Hispanic or Latino,16,16,32
132572,Chronic myeloid leukaemia in remission,ethnic,Hispanic or Latino,32,0,32
433942,Accident whilst engaged in household activity,racial,White,20,12,32
4107655,Observations relating to psychosocial functioning,ethnic,Not Hispanic or Latino,16,16,32
198199,Pyelonephritis,ethnic,Not Hispanic or Latino,25,7,32
441818,Haemangioma,racial,White,19,13,32
433599,Abnormal biochemistry finding,ethnic,Not Hispanic or Latino,13,19,32
434750,Feeding difficulties and mismanagement,racial,Unknown,14,18,32
373474,Seeing double,ethnic,Hispanic or Latino,8,23,31
376208,Soft tissue disorder,racial,Unknown,14,17,31
434675,Complication of gastrostomy,ethnic,Hispanic or Latino,14,17,31
139057,Disease of oral soft tissues,ethnic,Not Hispanic or Latino,23,9,32
380094,Carpal tunnel syndrome,racial,Other Race,31,1,32
444090,Disease of foot,racial,White,21,11,32
436882,[X]Fall involving bed,racial,White,25,7,32
193253,Nephritis,racial,Other Race,21,11,32
4144997,Osteoarthritis NOS,racial,Unknown,28,4,32
4164707,Canceled operative procedure,ethnic,Not Hispanic or Latino,19,13,32
201061,Diaphragmatic hernia,ethnic,Not Hispanic or Latino,17,15,32
441534,"Severe major depression, single episode, without psychotic features",racial,White,25,6,31
133853,Osteomyelitis of ankle AND/OR foot,racial,Unknown,30,1,31
4170137,Non-suppurative otitis media,ethnic,Not Hispanic or Latino,16,16,32
437584,Ataxia,racial,Unknown,6,25,31
78228,Joint derangement,racial,White,7,24,31
441691,Atypical squamous cells of undetermined significance on vaginal Papanicolaou smear,racial,White,31,0,31
138176,Acute gingivitis,racial,Unknown,13,18,31
22340,Esophageal varices without bleeding,racial,Unknown,28,4,32
77074,Joint pain,racial,Asian,16,15,31
442753,Furuncle of trunk,ethnic,Hispanic or Latino,15,16,31
4111392,Angina pectoris NOS,ethnic,Hispanic or Latino,19,13,32
141371,PR - Pityriasis rosea,racial,White,16,15,31
442752,Myalgia,racial,Black or African American ,26,5,31
4053045,Dog bite,racial,Unknown,22,10,32
440846,"Blood coagulation disorder, categorized by value of screening test",ethnic,Hispanic or Latino,22,10,32
432545,Bacterial disease,racial,Unknown,26,5,31
261326,Viral pneumonia,ethnic,Hispanic or Latino,13,18,31
200452,Disease of female genital organ,ethnic,Hispanic or Latino,31,1,32
194475,Singultus,racial,White,1,31,32
73923,"Contusion, upper arm",ethnic,Hispanic or Latino,23,8,31
75344,Intervertebral disc disorder,ethnic,Not Hispanic or Latino,7,24,31
4092879,Absent kidney,racial,White,17,14,31
432876,Bipolar I disorder,racial,Unknown,8,23,31
135777,Neoplasm of uncertain behaviour of skin,racial,Unknown,26,5,31
377287,Phlyctenular keratoconjunctivitis,racial,Unknown,31,1,32
4024013,Sensory nervous system finding,ethnic,Hispanic or Latino,20,11,31
435783,Schizophrenia,racial,Asian,5,26,31
442286,Abscess of digit,racial,Unknown,23,8,31
260139,Acute bronchitis,racial,American Indian or Alaska Native ,26,5,31
438879,Closed bimalleolar fracture,ethnic,Hispanic or Latino,24,7,31
4202322,Amputated big toe,ethnic,Hispanic or Latino,5,26,31
72986,Disease of lower leg,ethnic,Hispanic or Latino,14,17,31
4150307,Dental restoration observation,ethnic,Not Hispanic or Latino,22,10,32
73300,Radial styloid tenosynovitis,racial,White,26,5,31
376415,Hypermetropia,ethnic,Hispanic or Latino,12,19,31
75623,Old disruption of anterior cruciate ligament,ethnic,Hispanic or Latino,14,17,31
195562,Hemorrhoids,racial,Other Race,19,13,32
4014230,Ankle sprain NOS,racial,White,15,16,31
443585,Abrasion AND/OR friction burn of multiple sites,ethnic,Not Hispanic or Latino,15,16,31
74472,Congenital deformity of foot,ethnic,Hispanic or Latino,7,25,32
81942,Enthesopathy of ankle AND/OR tarsus,ethnic,Hispanic or Latino,17,14,31
438418,Meningitis with clear cerebrospinal fluid,ethnic,Hispanic or Latino,0,31,31
432586,Mental disorder,ethnic,Hispanic or Latino,19,13,32
438418,Meningitis with clear cerebrospinal fluid,racial,Unknown,0,31,31
197610,Ovarian cyst,racial,Other Race,31,0,31
432441,Finding of length of gestation,ethnic,Hispanic or Latino,20,11,31
4103640,Amputated foot,ethnic,Hispanic or Latino,0,31,31
375822,Neonatal obstruction of nasolacrimal duct,ethnic,Hispanic or Latino,14,17,31
432447,Atypical glandular cells on cervical Papanicolaou smear,racial,White,31,0,31
435224,Leukopenia,ethnic,Not Hispanic or Latino,15,16,31
441085,Elderly primip,ethnic,Hispanic or Latino,31,0,31
436176,Spontaneous abortion without complication,ethnic,Hispanic or Latino,31,0,31
77373,Congenital deformity of hip joint,ethnic,Hispanic or Latino,20,11,31
441836,Depressed bipolar I disorder,ethnic,Not Hispanic or Latino,21,10,31
4028716,Idiopathic thrombocythemia,racial,Unknown,24,7,31
192372,Placenta praevia without haemorrhage - not delivered,ethnic,Hispanic or Latino,31,0,31
198363,Candidiasis of vagina,racial,Other Race,31,0,31
316376,Eosinophilia,ethnic,Hispanic or Latino,10,20,30
200528,Ascites,racial,Unknown,20,10,30
194686,Acquired renal cyst,ethnic,Not Hispanic or Latino,19,12,31
135027,"Carbuncle of leg, except foot",racial,White,15,16,31
316376,Eosinophilia,racial,White,10,21,31
372629,Nonexudative age-related macular degeneration,racial,Unknown,25,5,30
381290,Ocular hypertension,ethnic,Hispanic or Latino,25,5,30
434902,Autistic disorder of childhood onset,racial,Asian,1,29,30
313023,Neonatal chronic respiratory disease,racial,White,11,20,31
440431,Pneumonia due to Mycoplasma pneumoniae,ethnic,Hispanic or Latino,14,17,31
375292,Perforation of tympanic membrane,ethnic,Not Hispanic or Latino,20,11,31
4201387,Tracheostomy in situ,racial,Unknown,19,12,31
4028716,Idiopathic thrombocythemia,ethnic,Not Hispanic or Latino,16,14,30
72990,Localised osteoarthrosis uncertain if primary OR secondary,ethnic,Hispanic or Latino,26,4,30
4028641,Pregnancy and drug dependence,ethnic,Hispanic or Latino,31,0,31
253815,Ulceration of vulva,racial,White,31,0,31
440927,High risk drug monitoring status,ethnic,Hispanic or Latino,23,7,30
376224,Spina bifida without hydrocephalus,racial,White,6,25,31
4062637,TB - Tuberculosis screening,racial,American Indian or Alaska Native ,20,11,31
433125,Infection due to Staphylocccus aureus,racial,White,19,12,31
318775,Venous embolism,ethnic,Not Hispanic or Latino,25,5,30
432295,Pernicious anemia,racial,Unknown,22,8,30
373475,Impairment level: one eye: moderate impairment: other eye: not specified,racial,Other Race,0,31,31
437528,"Bipolar affective disorder, currently depressed, moderate",racial,Unknown,19,11,30
440424,Aphasia,racial,Black or African American ,30,1,31
201093,Infection of skin AND/OR subcutaneous tissue,racial,Unknown,13,18,31
436096,Chronic pain,racial,Other Race,13,18,31
377091,Fits - convulsions,racial,Black or African American ,13,18,31
436072,Bipolar disorder in partial remission,racial,Unknown,29,1,30
200051,Primary malignant neoplasm of ovary,ethnic,Hispanic or Latino,31,0,31
313209,Left bundle branch hemiblock,ethnic,Hispanic or Latino,17,13,30
374905,Non-organic sleep disorder,racial,Unknown,8,23,31
442565,Gestational edema without hypertension,racial,Unknown,31,0,31
442286,Abscess of digit,ethnic,Not Hispanic or Latino,20,11,31
4173498,FH: Heart disorder,ethnic,Hispanic or Latino,13,18,31
193016,Cystic disease of kidney,ethnic,Not Hispanic or Latino,20,11,31
199876,Prolapse of female genital organs,ethnic,Hispanic or Latino,31,0,31
440647,Sexually transmitted infectious disease,racial,White,10,20,30
136497,Scar conditions and fibrosis of skin,ethnic,Hispanic or Latino,22,9,31
442584,Carbuncle of buttock,racial,White,20,11,31
375504,Psychoactive substance-induced organic mental disorder,ethnic,Hispanic or Latino,20,11,31
75051,Derangement of posterior horn of medial meniscus,ethnic,Hispanic or Latino,19,12,31
4179925,Basic learning problem,racial,White,10,21,31
133294,Prepatellar bursitis,ethnic,Hispanic or Latino,13,18,31
432863,Acquired coagulation factor deficiency,racial,Unknown,16,14,30
436222,Altered mental status,racial,Asian,31,0,31
4145627,Biliary calculus,racial,White,29,1,30
259848,Chronic rhinitis,racial,Asian,10,20,30
436222,Altered mental status,racial,Unknown,20,10,30
318772,Disease of pericardium,ethnic,Hispanic or Latino,22,8,30
434467,Ostium secundum type atrial septal defect,ethnic,Not Hispanic or Latino,21,9,30
76786,Derangement of knee,racial,Asian,6,24,30
133424,Primary malignant neoplasm of thyroid gland,racial,Unknown,10,20,30
433750,"Single major depressive episode, in full remission",racial,White,22,8,30
433533,Incomplete spontaneous abortion with no mention of complication,ethnic,Hispanic or Latino,30,0,30
78508,Arthralgia of the ankle and/or foot,racial,Asian,25,5,30
433596,Abnormal sputum,racial,White,14,16,30
433316,Giddiness,racial,Black or African American ,16,14,30
4173498,FH: Heart disorder,racial,White,11,19,30
192606,Paraplegia,racial,Unknown,19,11,30
439141,Abnormal increase in weight,racial,Filipino,26,4,30
380731,OE - Otitis externa,ethnic,Hispanic or Latino,11,19,30
376114,Severe nonproliferative diabetic retinopathy,racial,White,7,23,30
380839,TS - Tuberous sclerosis,ethnic,Hispanic or Latino,26,4,30
374025,Retinal haemorrhages,ethnic,Hispanic or Latino,20,10,30
133810,Secondary hyperparathyroidism of renal origin,ethnic,Not Hispanic or Latino,11,19,30
377286,VFD - Visual field defect,racial,Unknown,3,27,30
198683,Viral hepatitis B without hepatic coma,racial,Asian,14,16,30
140027,Herpetic gingivostomatitis,ethnic,Not Hispanic or Latino,21,9,30
193688,Clostridium difficile infection,racial,White,15,15,30
255891,Lupus erythematosus,ethnic,Not Hispanic or Latino,23,7,30
435227,Nutritional deficiency,racial,Unknown,19,11,30
376208,Soft tissue disorder,ethnic,Not Hispanic or Latino,7,23,30
376422,Mucopurulent conjunctivitis,racial,Unknown,23,7,30
137945,Pressure ulcer stage 2,racial,White,28,2,30
432454,Excessive thirst,racial,White,14,16,30
197914,Chronic gastric ulcer with perforation but without obstruction,ethnic,Not Hispanic or Latino,30,0,30
434169,Abnormal findings on diagnostic imaging of breast,racial,Asian,30,0,30
432554,Human immunodeficiency virus II infection,racial,White,12,18,30
201909,Female infertility,racial,Unknown,30,0,30
23798,Acute laryngopharyngitis,ethnic,Hispanic or Latino,19,11,30
437655,Cryptorchism,ethnic,Not Hispanic or Latino,0,30,30
74729,Ganglion and synovial cyst,ethnic,Not Hispanic or Latino,22,8,30
197500,Primary malignant neoplasm of colon,racial,Black or African American ,25,5,30
134144,Cleft palate with cleft lip,racial,White,16,14,30
81251,Neoplasm of breast,racial,Unknown,30,0,30
197917,Disorder of biliary tract,ethnic,Hispanic or Latino,18,12,30
72418,Scoliosis deformity of spine,racial,White,16,14,30
377085,Congenital anomaly of brain,racial,White,14,16,30
316084,Lymphadenitis,ethnic,Not Hispanic or Latino,14,16,30
439795,Minimal cognitive impairment,racial,Asian,30,0,30
72715,Exostosis,ethnic,Hispanic or Latino,23,7,30
4185471,Disorder of pigmentation,racial,Unknown,14,16,30
193165,Adrenal disease,ethnic,Hispanic or Latino,23,7,30
376105,Krampfe salaam attacks,ethnic,Hispanic or Latino,22,8,30
437097,Congenital anomaly of cartilage,racial,White,0,30,30
195596,Chronic pancreatitis,racial,Unknown,21,9,30
439791,Emotional upset,ethnic,Hispanic or Latino,22,8,30
439314,Thrombophlebitis of the femoral vein,racial,White,0,30,30
440228,Closed fracture of lower end of humerus,ethnic,Hispanic or Latino,21,9,30
436076,Adjustment disorder with mixed disturbance of emotions AND conduct,ethnic,Hispanic or Latino,28,2,30
4147466,Panic disorder with agoraphobia,ethnic,Not Hispanic or Latino,20,10,30
320420,Vitreous degeneration,racial,Unknown,27,3,30
200970,CIS - Carcinoma in situ of prostate,racial,White,0,30,30
441946,Calcific tendinitis of shoulder,racial,White,26,4,30
440238,Closed fracture of metatarsal bone,racial,Unknown,26,4,30
442584,Carbuncle of buttock,ethnic,Hispanic or Latino,18,12,30
374028,AAMD - Age related macular degeneration,racial,Other Race,7,23,30
75052,Enthesopathy of wrist AND/OR carpus,ethnic,Hispanic or Latino,24,5,29
75354,Osteochondropathy,racial,Asian,21,8,29
442604,Hypertensive heart disease,racial,Native Hawaiian or Other Pacific Islander ,29,1,30
40481920,Periumbilical pain,racial,Unknown,20,9,29
436235,Taste sense altered,ethnic,Hispanic or Latino,26,4,30
134116,Dermatitis due to drug AND/OR medicine taken internally,ethnic,Hispanic or Latino,17,12,29
440686,Residual schizophrenia in remission,ethnic,Hispanic or Latino,4,25,29
73649,Contusion of finger,racial,Unknown,18,11,29
74189,Sprain of cruciate ligament of knee,ethnic,Hispanic or Latino,18,11,29
434500,Closed fracture of neck of femur,racial,White,17,12,29
4299574,Factitious skin disease,ethnic,Hispanic or Latino,24,5,29
434502,Closed fracture of phalanx of toe,racial,Unknown,24,5,29
196456,Cholecystolithiasis,racial,Other Race,20,9,29
435553,Watery eye,ethnic,Hispanic or Latino,22,7,29
138225,Disease of sebaceous glands,racial,White,17,12,29
192963,Disease of pancreas,ethnic,Hispanic or Latino,21,8,29
442764,Anal pain,racial,Unknown,21,8,29
372409,Sciatica neuralgia,racial,Asian,23,6,29
200483,Disease of pelvis,racial,White,23,7,30
4161978,Patient on oxygen,racial,White,21,8,29
81106,Acquired genu varum,ethnic,Hispanic or Latino,11,19,30
136368,Non-toxic multinodular goiter,racial,Unknown,29,0,29
440508,Congenital disease,ethnic,Not Hispanic or Latino,12,17,29
443865,Non-infective colitis,racial,Black or African American ,9,20,29
380415,Acute swimmer's ear,ethnic,Not Hispanic or Latino,15,14,29
75004,Frank hematuria,racial,Unknown,8,21,29
134159,Precordial pain,racial,Black or African American ,1,28,29
4091532,Bowel observation,ethnic,Not Hispanic or Latino,20,9,29
4028641,Pregnancy and drug dependence,racial,White,29,0,29
4066820,Ingestion dermatitis due to food,racial,White,19,10,29
197332,Incomplete uterovaginal prolapse,ethnic,Hispanic or Latino,29,0,29
138239,Observation of limb structure,racial,Unknown,19,11,30
78236,Muscle wasting disorder,ethnic,Not Hispanic or Latino,4,25,29
443677,Open wound of knee and/or leg and/or ankle,racial,Unknown,25,5,30
4104853,Epileptic seizures - clonic,racial,White,17,13,30
439154,Abnormal findings on diagnostic imaging of skull and head,ethnic,Hispanic or Latino,13,17,30
141941,Cervical spondylosis without myelopathy,racial,Unknown,22,8,30
194092,Uterine prolapse without vaginal wall prolapse,racial,Unknown,29,0,29
198964,Chronic type C viral hepatitis,racial,American Indian or Alaska Native ,16,13,29
374028,AAMD - Age related macular degeneration,racial,Asian,4,26,30
78273,Closed fracture multiple ribs,ethnic,Hispanic or Latino,19,11,30
437584,Ataxia,racial,White,15,14,29
4147164,Hematologic malignancy,racial,White,25,5,30
376065,Neurologic disorder associated with type II diabetes mellitus,racial,American Indian or Alaska Native ,16,14,30
260134,Croup,ethnic,Not Hispanic or Latino,12,17,29
312648,Benign essential hypertension,racial,Asian Indian,16,13,29
442262,Blister of toe without infection,racial,White,15,14,29
432895,Cortical senile cataract,racial,Unknown,16,13,29
434084,Abscess of vulva,racial,White,29,0,29
192854,Interstitial uterine fibroid,racial,Unknown,29,0,29
440088,Academic underachievement disorder,racial,Unknown,11,18,29
439791,Emotional upset,racial,White,20,8,28
433822,Complication related to pregnancy,racial,White,28,1,29
443728,Mass of chest wall,racial,Unknown,22,7,29
380103,Retinal detachment with retinal defect,ethnic,Hispanic or Latino,21,8,29
442792,Pes anserinus bursitis,ethnic,Hispanic or Latino,17,11,28
440029,Viral disease,racial,Asian,11,17,28
374358,Dermatochalasis,racial,Unknown,23,5,28
195862,Urethritis,racial,White,4,25,29
4296205,Second degree burn,racial,White,13,16,29
77734,Contusion of lower leg,racial,White,21,8,29
434309,Sexual precocity,racial,White,20,9,29
432730,Dysphonia,racial,White,20,8,28
380702,Cerebral cysts,ethnic,Hispanic or Latino,17,12,29
434657,Weakness of face muscles,ethnic,Hispanic or Latino,17,12,29
321588,Heart disease,racial,Other Race,29,0,29
77072,Joint effusion of ankle AND/OR foot,ethnic,Hispanic or Latino,16,13,29
439727,HIV - Human immunodeficiency virus infection,racial,American Indian or Alaska Native ,22,7,29
435516,Lipoprotein deficiency disorder,racial,Unknown,17,12,29
74451,Palindromic rheumatism of the forearm,racial,Unknown,19,10,29
440977,Megaloblastic anemia due to folate deficiency,racial,Unknown,15,14,29
440751,Peritonsillar abscess,ethnic,Hispanic or Latino,17,12,29
4340380,Hepatitis C carrier,ethnic,Not Hispanic or Latino,11,18,29
380111,Acute atopic conjunctivitis,racial,Unknown,23,6,29
315922,Patent ductus arteriosus,ethnic,Hispanic or Latino,9,20,29
442753,Furuncle of trunk,racial,White,13,16,29
77395,Current tear of semilunar cartilage,racial,White,19,10,29
443865,Non-infective colitis,racial,Asian,10,19,29
76482,MA - Missed abortion,racial,Unknown,29,0,29
433992,"Bipolar affective disorder, currently manic, moderate",ethnic,Not Hispanic or Latino,2,27,29
434490,Shivering,ethnic,Hispanic or Latino,22,7,29
434610,Hyperkalemia,racial,Asian,17,12,29
72465,Closed fracture of one or more phalanges of hand,racial,Unknown,15,14,29
141758,Spinal cord injury without spinal bone injury,ethnic,Hispanic or Latino,0,29,29
437986,FTT - Failure to thrive,racial,Other Race,16,13,29
4077577,Moderate recurrent major depression,racial,Other Race,26,3,29
4113027,Dietary intake observations,ethnic,Not Hispanic or Latino,13,16,29
376709,Discharge of eye,racial,Unknown,22,7,29
193253,Nephritis,racial,Asian,16,13,29
80497,Disorder of cervical spine,ethnic,Hispanic or Latino,15,14,29
314962,Raynaud disease,ethnic,Hispanic or Latino,25,4,29
377888,CHL - Conductive hearing loss,racial,Asian,25,4,29
315831,Chronic pulmonary heart disease,ethnic,Not Hispanic or Latino,14,15,29
376680,Generalized nonconvulsive epilepsy,ethnic,Not Hispanic or Latino,26,2,28
138841,Disorder of sacrum,ethnic,Hispanic or Latino,18,11,29
437969,Acquired pes planus,ethnic,Not Hispanic or Latino,10,19,29
261325,Pulmonary emphysema,racial,Black or African American ,8,20,28
197672,Urinary incontinence,racial,Black or African American ,22,7,29
436812,Tongue tie,racial,White,4,25,29
316995,Coronary occlusion,racial,Unknown,28,1,29
433450,Paranoid schizophrenia,ethnic,Hispanic or Latino,11,17,28
26378,Hyperpituitarism,racial,White,23,5,28
434008,White blood cell disorder,racial,White,22,7,29
134668,Chronic maxillary sinusitis,ethnic,Hispanic or Latino,19,10,29
376104,Posttraumatic headache,ethnic,Hispanic or Latino,17,11,28
256722,Bronchopneumonia,ethnic,Hispanic or Latino,16,13,29
321596,Peripheral venous insufficiency,racial,Black or African American ,28,1,29
27587,Disturbance of salivary secretion,racial,White,21,7,28
256440,Disorder of paranasal sinuses,racial,Other Race,22,6,28
133835,Dermatitis,racial,Asian,10,18,28
4002644,Rotator cuff shoulder syndrome and allied disorders,ethnic,Hispanic or Latino,13,15,28
376125,Disorder of eyelid,ethnic,Hispanic or Latino,15,13,28
380094,Carpal tunnel syndrome,racial,Asian,19,10,29
136775,Contact dermatitis due to solar radiation,ethnic,Hispanic or Latino,16,12,28
196735,Acute pyelonephritis without medullary necrosis,racial,White,23,5,28
434339,Adolescent - emotional problem,racial,White,11,17,28
440694,"Nondependent mixed drug abuse, episodic",racial,White,13,15,28
77234,Benign tumour of colon,racial,Asian,17,11,28
316999,Cardiac arrhythmia,racial,Other Race,11,17,28
4103574,Chronic depression,ethnic,Not Hispanic or Latino,14,14,28
72726,Light-for-dates with signs of fetal malnutrition,ethnic,Not Hispanic or Latino,0,28,28
40479192,Chronic systolic heart failure,racial,White,14,14,28
373472,Pigmentary retinal dystrophy,ethnic,Hispanic or Latino,28,0,28
256449,Bronchiectasis,ethnic,Hispanic or Latino,27,1,28
378165,Nystagmus,ethnic,Hispanic or Latino,17,11,28
4155526,Acute otitis media with effusion,ethnic,Hispanic or Latino,10,19,29
312437,Dyspnea,racial,Other Race,12,16,28
29056,Sialoadenitis,racial,White,16,13,29
313023,Neonatal chronic respiratory disease,ethnic,Not Hispanic or Latino,4,24,28
373747,Extrapyramidal disease,racial,White,17,11,28
4144876,Contact dermatitis and other eczemas,racial,White,15,13,28
198194,Female genital organ symptoms,racial,Asian,28,0,28
443442,Finding of vaginal vault smear result,racial,White,28,0,28
24966,OV - Oesophageal varices,racial,White,19,9,28
436785,Spinal stenosis in cervical region,racial,Unknown,20,8,28
134671,Dental abscess without a sinus,ethnic,Not Hispanic or Latino,23,5,28
435093,Closed fracture of femur,racial,White,6,22,28
134074,Oral soft tissue cellulitis,ethnic,Hispanic or Latino,19,9,28
4340379,Hepatitis B carrier,racial,White,17,11,28
197223,Enterobiasis,ethnic,Hispanic or Latino,15,13,28
4201388,Gastrostomy present,racial,Asian,13,15,28
4340379,Hepatitis B carrier,racial,Asian,6,22,28
199877,Mucous polyp of cervix,ethnic,Not Hispanic or Latino,28,1,29
72726,Light-for-dates with signs of fetal malnutrition,racial,White,0,28,28
30163,Cellulitis and abscess of neck,ethnic,Hispanic or Latino,10,18,28
141758,Spinal cord injury without spinal bone injury,racial,Unknown,0,28,28
255841,Chronic bronchitis,racial,Asian,17,11,28
321596,Peripheral venous insufficiency,racial,Other Race,25,3,28
76161,Impotence of organic origin,racial,Black or African American ,0,28,28
433400,Emergency contraception,ethnic,Not Hispanic or Latino,28,1,29
4252594,Subconjunctival injection,racial,White,16,12,28
321588,Heart disease,racial,Black or African American ,1,27,28
440276,"Infection AND/OR inflammatory reaction due to internal prosthetic device, implant AND/OR graft",ethnic,Hispanic or Latino,22,6,28
438836,Poliomyelitis osteopathy of the lower leg,ethnic,Hispanic or Latino,6,22,28
197981,Abdominal tenderness,ethnic,Hispanic or Latino,20,8,28
435243,Alcohol dependence,racial,Unknown,1,27,28
314369,Malignant hypertensive heart disease without congestive heart failure,racial,Unknown,18,10,28
4048727,Neoplasm screening,racial,White,11,17,28
195012,Metrorrhagia,racial,Unknown,28,0,28
433752,Impulse control disorder,ethnic,Not Hispanic or Latino,0,28,28
257778,Pertussis,ethnic,Hispanic or Latino,19,10,29
77635,Disease of hand,racial,Other Race,15,13,28
4295261,Postmenopausal state,racial,Unknown,28,0,28
438727,Atypical depressive disorder,ethnic,Not Hispanic or Latino,16,12,28
4141492,Other ill-defined heart disease,ethnic,Hispanic or Latino,26,2,28
435524,Sleep disorder,ethnic,Not Hispanic or Latino,14,14,28
434327,Cannabis abuse,racial,White,7,20,27
440233,Strain of supraspinatus muscle AND/OR tendon,racial,White,23,5,28
438155,Optic disc glaucomatous atrophy,ethnic,Hispanic or Latino,11,17,28
378735,Migraine without aura,racial,White,20,7,27
72993,Primary localised osteoarthrosis,racial,Black or African American ,1,27,28
193666,Hip injury,racial,White,15,13,28
316437,Cerebral atherosclerosis,racial,Black or African American ,28,0,28
76194,Osteoarthrosis involving multiple sites but not designated as generalized,ethnic,Not Hispanic or Latino,26,1,27
436077,Developmental delay,racial,Black or African American ,8,19,27
75650,Proteinuria,racial,Black or African American ,12,16,28
437986,FTT - Failure to thrive,racial,Asian,7,21,28
377001,Unruptured cerebral aneurysm,racial,White,3,25,28
135340,Pressure ulcer stage 3,ethnic,Hispanic or Latino,12,16,28
137785,Verruca plantaris,racial,Unknown,22,6,28
201916,Ureteric stone,ethnic,Hispanic or Latino,13,15,28
74469,Light-for-dates without mention of fetal malnutrition,racial,White,3,25,28
439871,Haemospermia,ethnic,Hispanic or Latino,0,28,28
439799,Leg cramps,ethnic,Not Hispanic or Latino,21,7,28
375252,Disorder of eye,ethnic,Not Hispanic or Latino,16,11,27
81723,Contusion of hand,racial,Unknown,16,11,27
4110047,Chronic bronchitis NOS,ethnic,Hispanic or Latino,12,16,28
434972,Developmental abnormality of tooth size and form,racial,Unknown,19,9,28
375246,Mononeuritis of upper limb,racial,Unknown,28,0,28
192683,Uterovaginal prolapse,ethnic,Hispanic or Latino,28,0,28
316437,Cerebral atherosclerosis,ethnic,Not Hispanic or Latino,28,0,28
196734,Disease of prostate,racial,White,0,28,28
80497,Disorder of cervical spine,racial,White,15,13,28
374317,Alcohol-induced psychosis,ethnic,Hispanic or Latino,1,27,28
314754,Wheezing,racial,Asian,14,14,28
256717,Bronchospasm,ethnic,Not Hispanic or Latino,14,13,27
443617,Conduct disorder,racial,Unknown,8,19,27
78193,Epididymo-orchitis,racial,Unknown,0,28,28
434752,Positive serological AND/OR viral culture findings for human immunodeficiency virus,racial,Black or African American ,5,22,27
442609,Friction blister without infection,ethnic,Hispanic or Latino,16,12,28
440985,Phobia,racial,Unknown,28,0,28
437969,Acquired pes planus,racial,Unknown,12,16,28
372634,Nonphysiologic vision loss,racial,Other Race,22,6,28
433985,Hypercarotinemia,racial,Unknown,7,21,28
199877,Mucous polyp of cervix,racial,Unknown,28,0,28
437474,Postoperative infection,ethnic,Hispanic or Latino,23,4,27
433742,Latent schizophrenia,racial,Unknown,26,2,28
437992,Abnormal results of kidney function studies,ethnic,Hispanic or Latino,14,14,28
193165,Adrenal disease,racial,White,23,4,27
30978,Hereditary leptocytosis,racial,Asian,25,2,27
434376,Acute myocardial infarction of anterior wall,racial,Black or African American ,28,0,28
77987,Respiratory observations of chest,racial,White,18,10,28
436466,Balanoposthitis,ethnic,Not Hispanic or Latino,0,28,28
192360,Cyst and pseudocyst of pancreas,racial,Unknown,22,6,28
75863,Chronic interstitial cystitis,ethnic,Not Hispanic or Latino,28,0,28
439166,Closed fracture of radius,racial,White,11,16,27
4100857,Pickwickian syndrome,racial,Other Race,16,11,27
201313,Hypertensive renal disease,ethnic,Hispanic or Latino,20,7,27
78235,Disorder of coccyx,racial,Unknown,23,5,28
4204904,Education about sexually transmitted disease prevention,ethnic,Not Hispanic or Latino,18,9,27
4044391,Diabetic neuropathy,ethnic,Hispanic or Latino,20,7,27
136198,Cervical spondylosis with myelopathy,racial,White,13,14,27
436067,Schizophrenia simplex,racial,Other Race,24,3,27
436375,Sodium and water depletion,ethnic,Hispanic or Latino,26,1,27
26727,Vomiting blood,racial,White,12,15,27
192667,Atrophic gastritis,racial,Other Race,24,3,27
79833,Meniere's disease,ethnic,Not Hispanic or Latino,26,1,27
437116,Closed fracture of distal end of radius,ethnic,Hispanic or Latino,17,10,27
435023,Mild hyperemesis-not delivered,racial,Unknown,27,0,27
437092,Physiological development failure,racial,Black or African American ,4,23,27
81390,Idiopathic osteoporosis,racial,White,26,1,27
4094448,Pregnancy test negative,racial,Unknown,27,0,27
312327,Acute myocardial infarction,racial,Other Race,11,16,27
133810,Secondary hyperparathyroidism of renal origin,racial,Asian,8,19,27
4139420,Foreign body in auditory canal,ethnic,Not Hispanic or Latino,10,17,27
443943,Herpes zoster,racial,White,9,18,27
195867,Noninflammatory vaginal disorders,ethnic,Not Hispanic or Latino,26,1,27
134453,Inflammation of bursa,racial,Unknown,18,9,27
260125,Acute bronchiolitis,racial,Asian,8,19,27
375557,Cerebral embolism,ethnic,Hispanic or Latino,23,4,27
436166,Mild hyperemesis gravidarum,ethnic,Hispanic or Latino,27,0,27
440216,Abnormal glucose tolerance test,racial,Asian,12,15,27
4055758,Temporomandibular joint disorder NOS,ethnic,Hispanic or Latino,21,6,27
40485064,Latent syphilis,ethnic,Not Hispanic or Latino,8,19,27
30753,Esophagitis,racial,Unknown,20,7,27
199744,Carcinoma liver and/or biliary system,racial,Unknown,26,1,27
198528,Acquired unequal leg length,racial,Unknown,5,22,27
4108982,Cataract associated with other syndromes,ethnic,Hispanic or Latino,20,7,27
312950,IgE-mediated allergic asthma,racial,Other Race,8,19,27
436118,After-cataract with vision obscured,racial,Unknown,17,10,27
4196362,Genetic counselling,racial,White,27,0,27
201621,Chronic cystitis,racial,Unknown,16,11,27
139841,Chronic frontal sinusitis,racial,White,20,7,27
4152813,Family disruption,racial,White,15,12,27
196168,Irregular menstrual bleeding,racial,Other Race,27,0,27
378735,Migraine without aura,racial,Unknown,22,5,27
436278,Superficial bruising of thigh,ethnic,Hispanic or Latino,18,9,27
4139681,Allergy to dairy product,ethnic,Hispanic or Latino,7,20,27
195977,Contusion of trunk,racial,White,16,11,27
259055,Extrinsic asthma with asthma attack,racial,Black or African American ,23,4,27
72618,Disorder of muscle,ethnic,Hispanic or Latino,19,8,27
432898,Severe mental handicap,racial,White,1,26,27
78508,Arthralgia of the ankle and/or foot,racial,Other Race,19,8,27
436209,Fracture of fibula,racial,White,17,10,27
4201388,Gastrostomy present,racial,Black or African American ,7,20,27
135030,Discoloration of skin,racial,Unknown,23,4,27
381292,Chronic allergic conjunctivitis,racial,Other Race,15,12,27
4110046,Obstructive chronic bronchitis NOS,racial,White,20,7,27
377294,Exotropia,racial,White,14,13,27
318556,Nosebleed,racial,Other Race,17,10,27
133551,Vesicular eczema of hands and/or feet,racial,White,11,16,27
259849,Pneumonia with infectious diseases EC,ethnic,Hispanic or Latino,20,7,27
201998,Unilateral traumatic amputation of leg at OR above knee without complication,racial,Other Race,26,0,26
73575,Deformity of toe,racial,White,16,11,27
440704,Chronic pain syndrome,racial,Asian,0,26,26
76887,Disorders of urogenital prostheses or implants,ethnic,Hispanic or Latino,23,3,26
439002,Eating disorder,racial,White,18,8,26
439700,Inhibited sexual desire,racial,Other Race,0,26,26
374034,Visual disturbance,racial,Asian,12,14,26
40490888,Herniation of rectum into vagina,ethnic,Hispanic or Latino,26,0,26
432585,Blood coagulation disorder,racial,Unknown,23,3,26
4056329,Vaginitis and vulvovaginitis NOS,racial,Unknown,26,0,26
437046,Complete abortion,racial,Unknown,26,0,26
199978,Contusion of lower limb,ethnic,Hispanic or Latino,13,14,27
133569,Fasciitis,racial,White,17,9,26
138994,MDS - Myelodysplastic syndrome,racial,White,20,6,26
434750,Feeding difficulties and mismanagement,racial,Asian,16,10,26
374040,Ill-defined disorder of eye,racial,White,13,13,26
435511,Hypercalcemia,racial,Asian,14,12,26
198528,Acquired unequal leg length,racial,White,11,16,27
78890,Sprain of elbow and forearm,ethnic,Hispanic or Latino,17,9,26
195312,Functional voiding disorder,ethnic,Not Hispanic or Latino,18,8,26
134735,Chronic osteomyelitis,ethnic,Hispanic or Latino,14,13,27
74189,Sprain of cruciate ligament of knee,racial,White,17,10,27
441532,Monoclonal paraproteinaemia,racial,Unknown,8,19,27
381591,Cerebrovascular disease,racial,Native Hawaiian or Other Pacific Islander ,0,26,26
136185,Abnormal granulation tissue,ethnic,Hispanic or Latino,17,10,27
444211,Disease of thigh,ethnic,Not Hispanic or Latino,20,6,26
4101199,Hearing problem,ethnic,Not Hispanic or Latino,13,14,27
78505,"Localised, primary osteoarthritis of the ankle and/or foot",ethnic,Hispanic or Latino,25,1,26
437942,Caesarean delivery - delivered,ethnic,Hispanic or Latino,26,0,26
201613,Chronic nonalcoholic liver disease,racial,Other Race,19,8,27
434854,FP - Food poisoning,ethnic,Hispanic or Latino,16,11,27
137682,Skin sensation disturbance,racial,Asian,15,11,26
435785,Meningitis,ethnic,Hispanic or Latino,11,16,27
194382,External haemorrhoid,racial,White,18,8,26
197023,Bilateral inguinal hernia,racial,Unknown,0,26,26
80156,Asymptomatic bacteriuria in pregnancy,racial,White,26,1,27
4028253,Neoplasm of digestive system,ethnic,Hispanic or Latino,20,6,26
377889,Hearing loss,racial,Black or African American ,19,8,27
439777,Anemia,racial,Native Hawaiian or Other Pacific Islander ,6,20,26
380731,OE - Otitis externa,racial,White,9,17,26
200783,Previous cesarean section,racial,White,26,0,26
201072,Benign prostatic hypertrophy without outflow obstruction,racial,White,0,26,26
76791,Acquired deformity of hip,racial,White,13,13,26
73301,Synovitis/tenosynovitis - wrist,ethnic,Not Hispanic or Latino,24,2,26
4139681,Allergy to dairy product,racial,White,10,16,26
441561,Low tension glaucoma,ethnic,Not Hispanic or Latino,26,1,27
381306,Deaf mutism,ethnic,Not Hispanic or Latino,17,10,27
200174,Disease of skin AND/OR subcutaneous tissue,racial,Other Race,22,4,26
434750,Feeding difficulties and mismanagement,racial,Black or African American ,15,11,26
441561,Low tension glaucoma,racial,Black or African American ,26,1,27
77234,Benign tumour of colon,racial,Other Race,23,4,27
140648,Onychomycosis due to dermatophyte,racial,Asian,17,9,26
78786,Pleurisy,ethnic,Hispanic or Latino,20,7,27
134057,Disease of cardiovascular system,ethnic,Not Hispanic or Latino,15,11,26
374937,Impairment level: better eye: near-total impairment: lesser-eye: not further specified,ethnic,Hispanic or Latino,26,1,27
437176,Late effect of accidental fall,ethnic,Hispanic or Latino,14,12,26
435933,Closed fracture of lumbar vertebra without spinal cord injury,racial,Asian,9,17,26
201612,ALD - Alcoholic liver disease,ethnic,Hispanic or Latino,8,18,26
201254,Insulin dependent diabetes mellitus,racial,Black or African American ,20,6,26
4115379,"Localised, primary osteoarthritis of the pelvic region and thigh",ethnic,Not Hispanic or Latino,25,1,26
196625,Viral hepatitis A without hepatic coma,ethnic,Hispanic or Latino,16,11,27
4016359,Streptococcus carrier,ethnic,Hispanic or Latino,26,1,27
433881,Additional general conditions of patient,ethnic,Hispanic or Latino,20,6,26
200174,Disease of skin AND/OR subcutaneous tissue,racial,Asian,14,13,27
4173498,FH: Heart disorder,ethnic,Not Hispanic or Latino,10,16,26
138896,Open wound of forehead without complication,racial,White,13,13,26
441085,Elderly primip,racial,White,26,0,26
315276,Vitreous hemorrhage,racial,White,14,11,25
80504,Acquired genu valgum,racial,White,14,11,25
192680,Portal hypertension,racial,White,15,11,26
81175,Contusion of chest,ethnic,Not Hispanic or Latino,16,10,26
201688,Urinary hesitancy,racial,White,7,19,26
433742,Latent schizophrenia,ethnic,Not Hispanic or Latino,26,0,26
134442,Thibierge-Weissenbach syndrome,ethnic,Hispanic or Latino,17,9,26
444391,Pain around eye,ethnic,Not Hispanic or Latino,15,11,26
4276723,Finding of child weight centiles,racial,Asian,17,8,25
434770,Closed fracture of bones of trunk,racial,Unknown,26,0,26
30365,Panhypopituitarism,racial,White,20,5,25
375529,Infantile cerebral palsy,racial,Black or African American ,8,18,26
441126,Monosomy and deletion from autosome,ethnic,Hispanic or Latino,14,11,25
199074,Acute pancreatitis,ethnic,Not Hispanic or Latino,13,13,26
81250,Carcinoma in situ of breast,racial,White,26,0,26
444382,Thoracic radiculitis,racial,Asian,23,3,26
321462,Cardiac complications of care,ethnic,Hispanic or Latino,5,21,26
75051,Derangement of posterior horn of medial meniscus,racial,White,17,9,26
4012570,High risk sexual behavior,racial,Unknown,10,16,26
78149,Congenital hereditary muscular dystrophy,racial,Unknown,2,23,25
434770,Closed fracture of bones of trunk,ethnic,Hispanic or Latino,26,0,26
443933,Nicotiana tabacum poisoning,racial,White,16,10,26
439125,T21 - Trisomy 21,racial,Other Race,18,8,26
434008,White blood cell disorder,ethnic,Hispanic or Latino,15,11,26
435739,Late syphilis,ethnic,Hispanic or Latino,8,17,25
4090550,Evening colic,ethnic,Hispanic or Latino,16,10,26
4016359,Streptococcus carrier,racial,White,25,1,26
444291,Cochlear hearing loss,racial,White,8,18,26
193528,Third degree uterine prolapse,ethnic,Hispanic or Latino,26,0,26
76791,Acquired deformity of hip,ethnic,Hispanic or Latino,16,10,26
4171430,Screening for malignant neoplasm of rectum,racial,Asian,16,10,26
133853,Osteomyelitis of ankle AND/OR foot,racial,White,2,23,25
75617,Polyarticular osteoarthritis,racial,Filipino,4,22,26
440431,Pneumonia due to Mycoplasma pneumoniae,racial,White,9,17,26
136198,Cervical spondylosis with myelopathy,ethnic,Not Hispanic or Latino,8,17,25
436222,Altered mental status,ethnic,Not Hispanic or Latino,19,7,26
4154309,Severe recurrent major depression with psychotic features,racial,Black or African American ,11,14,25
435510,Hypocalcemia,racial,Unknown,19,7,26
379832,Mixed conductive and sensorineural deafness,racial,White,20,6,26
434502,Closed fracture of phalanx of toe,ethnic,Not Hispanic or Latino,20,5,25
259848,Chronic rhinitis,racial,Black or African American ,16,10,26
192450,Not passing urine,ethnic,Not Hispanic or Latino,6,20,26
78097,Metastatic tumour of bone,ethnic,Hispanic or Latino,22,4,26
434902,Autistic disorder of childhood onset,racial,Black or African American ,5,21,26
436067,Schizophrenia simplex,racial,Asian,4,22,26
200391,Peripheral autonomic neuropathy disease EC,ethnic,Not Hispanic or Latino,1,25,26
200763,Chronic hepatitis,racial,Asian,7,19,26
375552,Pterygium,ethnic,Not Hispanic or Latino,13,13,26
197484,Diarrhea of presumed infectious origin,racial,White,13,13,26
438698,"Malignant lymphoma of lymph nodes of head, face AND/OR neck",ethnic,Hispanic or Latino,26,0,26
135618,Prurigo,racial,White,14,12,26
435839,Lymphatic oedema,racial,Unknown,25,1,26
133794,Chronic gingivitis,ethnic,Not Hispanic or Latino,16,10,26
137053,Seborrheic dermatitis,racial,Asian,11,14,25
433657,Fall from furniture,ethnic,Hispanic or Latino,16,10,26
4013526,ESR raised,ethnic,Hispanic or Latino,22,4,26
252365,MGN - Membranous glomerulonephritis,racial,White,20,5,25
433992,"Bipolar affective disorder, currently manic, moderate",racial,White,3,23,26
381444,Black eye,racial,White,12,14,26
4005933,Urethral meatus underneath penis,racial,White,0,26,26
4062491,Anemia screening,ethnic,Hispanic or Latino,16,10,26
373472,Pigmentary retinal dystrophy,racial,Unknown,25,0,25
192676,Cervical intraepithelial neoplasia grade 1,ethnic,Not Hispanic or Latino,25,1,26
377001,Unruptured cerebral aneurysm,racial,Unknown,25,0,25
257628,Systemic lupus erythematosus,racial,Asian,20,5,25
434657,Weakness of face muscles,racial,White,14,11,25
134452,Miners' elbow,racial,White,10,16,26
140673,Hypothyroid,racial,American Indian,25,0,25
192279,Diabetic nephropathy,racial,Native Hawaiian or Other Pacific Islander ,14,11,25
316822,Finding of heart murmur,racial,Black or African American ,14,11,25
4084229,Primary gout,racial,Other Race,4,22,26
79116,Disorder of tendon of shoulder region,racial,White,11,14,25
255919,Finding of head and neck region,racial,Unknown,10,15,25
74114,Cellulitis and abscess of foot excluding toe,ethnic,Not Hispanic or Latino,8,17,25
436078,Malnutrition of moderate degree (Gomez: 60% to less than 75% of standard weight),racial,Unknown,20,5,25
140362,Hypoparathyroidism,racial,Unknown,20,5,25
438698,"Malignant lymphoma of lymph nodes of head, face AND/OR neck",racial,White,25,0,25
193522,Acute prostatitis,racial,Unknown,0,25,25
443409,On examination - left lower abdominal mass,racial,White,22,3,25
137944,Bullous dermatosis,racial,White,5,20,25
440519,Premature - weight 1000g-2499g or gestation of 28-37weeks,racial,White,16,10,26
141941,Cervical spondylosis without myelopathy,ethnic,Not Hispanic or Latino,22,3,25
437677,Abnormal findings on diagnostic imaging of lung,ethnic,Not Hispanic or Latino,11,14,25
193552,Furuncle of skin AND/OR subcutaneous tissue,ethnic,Not Hispanic or Latino,13,13,26
30437,Gastroesophageal reflux disease with esophagitis,racial,Other Race,13,12,25
434169,Abnormal findings on diagnostic imaging of breast,racial,Other Race,25,0,25
31317,Can't get food down,racial,Black or African American ,4,22,26
440081,Barbiturate dependence,ethnic,Hispanic or Latino,7,18,25
135526,Myelopathy,ethnic,Hispanic or Latino,10,16,26
443933,Nicotiana tabacum poisoning,ethnic,Hispanic or Latino,17,8,25
436391,Primary cerebellar degeneration,ethnic,Hispanic or Latino,15,10,25
78605,Superficial bruising of elbow,racial,White,14,11,25
319049,Acute respiratory failure,ethnic,Hispanic or Latino,10,16,26
377886,Chronic purulent otitis media,racial,Unknown,2,23,25
440083,Acute stress disorder,ethnic,Not Hispanic or Latino,22,4,26
439120,Aseptic necrosis of head AND/OR neck of femur,ethnic,Not Hispanic or Latino,10,16,26
433752,Impulse control disorder,racial,Asian,0,25,25
444129,Wrist injury,ethnic,Not Hispanic or Latino,14,11,25
440279,Accident,racial,White,13,12,25
75860,Costiveness,racial,American Indian or Alaska Native ,16,9,25
133141,Tinea pedis,racial,Black or African American ,8,17,25
198363,Candidiasis of vagina,racial,Black or African American ,25,0,25
4100365,Schizophrenic disorders,ethnic,Hispanic or Latino,23,2,25
317248,Disorder of hematopoietic structure,ethnic,Not Hispanic or Latino,11,14,25
74892,Articular gout,ethnic,Hispanic or Latino,5,20,25
432590,Delusional disorder,racial,White,13,12,25
380378,Epilepsy,racial,Other Race,25,0,25
378161,Disorder of ear,racial,White,16,10,26
443415,Gestation greater than 24 weeks,ethnic,Hispanic or Latino,15,10,25
436298,Adverse reaction to food,racial,Black or African American ,10,16,26
4230642,Acquired deformity of chest,racial,White,25,1,26
438005,Closed fracture shaft of fibula,ethnic,Hispanic or Latino,21,4,25
141038,Diastolic dysfunction,racial,White,17,8,25
77635,Disease of hand,racial,Asian,20,5,25
141831,Branchial arch syndrome,ethnic,Hispanic or Latino,8,17,25
77074,Joint pain,racial,Black or African American ,14,11,25
137944,Bullous dermatosis,ethnic,Hispanic or Latino,5,20,25
197684,Dysuria,racial,Filipino,19,7,26
259153,Throat soreness,racial,Asian,17,8,25
433751,Prolonged depressive adjustment reaction,ethnic,Not Hispanic or Latino,24,1,25
4005933,Urethral meatus underneath penis,ethnic,Hispanic or Latino,0,25,25
4008089,Dysentery,ethnic,Hispanic or Latino,14,11,25
260427,Common cold,racial,Asian,13,12,25
440921,Traumatic injury,racial,White,12,13,25
444243,Neurotic disorder,ethnic,Hispanic or Latino,14,11,25
377885,Disorder of eye movements,ethnic,Not Hispanic or Latino,13,13,26
437165,Motor vehicle traffic accident,racial,Unknown,14,11,25
4179963,Family history of malignant neoplasm of breast,ethnic,Not Hispanic or Latino,25,1,26
77029,Epididymo-orchitis without abscess,ethnic,Hispanic or Latino,0,25,25
379019,Inflammation of conjunctiva,racial,Black or African American ,13,12,25
4179963,Family history of malignant neoplasm of breast,racial,Unknown,25,0,25
437688,Abnormal findings on antenatal screening of mother,racial,White,25,0,25
313236,Cough variant asthma,racial,Asian,12,13,25
133294,Prepatellar bursitis,racial,White,6,19,25
4167406,Eye disorder screening,racial,Unknown,11,14,25
4150307,Dental restoration observation,racial,Asian,16,9,25
77421,Open wound of hand except fingers without complication,ethnic,Not Hispanic or Latino,7,19,26
79072,Inflammatory disorder of breast,ethnic,Not Hispanic or Latino,21,4,25
432517,Posttraumatic wound infection,racial,White,9,16,25
432597,Schizoaffective schizophrenia,racial,Black or African American ,22,2,24
374948,Acute nonsuppurative otitis media,racial,Unknown,12,13,25
73341,Closed fracture of head of radius,racial,White,10,14,24
435950,Closed Colles' fracture,racial,White,21,4,25
76565,Shoulder bruise,ethnic,Hispanic or Latino,13,11,24
440385,Obstructive hydrocephalus,ethnic,Not Hispanic or Latino,10,15,25
74135,Disorder of synovium,ethnic,Hispanic or Latino,12,13,25
441126,Monosomy and deletion from autosome,racial,White,11,13,24
73089,Contusion of buttock,ethnic,Hispanic or Latino,19,6,25
139179,Open wound of lip without complication,ethnic,Hispanic or Latino,6,19,25
194491,Tenderness of epigastrium,ethnic,Hispanic or Latino,20,4,24
440438,Anodontia,racial,Unknown,19,6,25
440329,Herpes zoster without complication,racial,Other Race,8,17,25
436176,Spontaneous abortion without complication,racial,White,25,0,25
432554,Human immunodeficiency virus II infection,ethnic,Hispanic or Latino,9,16,25
442794,Poisoning by wasp sting,racial,White,14,11,25
435219,Schizophrenia in remission,racial,White,16,9,25
437655,Cryptorchism,racial,Unknown,0,25,25
136368,Non-toxic multinodular goiter,ethnic,Not Hispanic or Latino,23,2,25
4196960,Varicocele,racial,White,1,24,25
372409,Sciatica neuralgia,racial,Black or African American ,16,9,25
254761,Cough,racial,American Indian or Alaska Native ,22,3,25
198263,Right upper quadrant pain,racial,Other Race,10,15,25
4090651,Dialysis observation,racial,Asian,23,1,24
441202,Generalized anaphylaxis,racial,White,16,8,24
320744,Complete atrioventricular block,ethnic,Hispanic or Latino,14,11,25
4046500,Acute peptic ulcer with hemorrhage,ethnic,Hispanic or Latino,25,0,25
199754,Primary malignant neoplasm of pancreas,ethnic,Hispanic or Latino,13,11,24
438134,Excessive sleep,racial,White,17,7,24
79873,Urolith,racial,White,17,8,25
436972,Glaucoma associated with systemic syndromes,racial,Other Race,11,14,25
81151,Sprain of ankle joint,racial,Other Race,14,10,24
197236,Uterine fibroid,racial,Asian,25,0,25
318459,Respiratory insufficiency,ethnic,Hispanic or Latino,8,16,24
25297,Acute pharyngitis,racial,American Indian or Alaska Native ,18,7,25
4105187,Speech or language developmental disorder NOS,ethnic,Hispanic or Latino,10,15,25
197036,Vesicoureteral reflux,racial,White,9,16,25
320136,Disease of respiratory system,racial,White,13,11,24
200527,Splenomegaly,racial,White,14,10,24
40483107,Inflamed seborrheic keratosis,ethnic,Hispanic or Latino,20,5,25
436375,Sodium and water depletion,racial,Unknown,25,0,25
256448,Chronic asthmatic bronchitis,racial,Native Hawaiian or Other Pacific Islander ,17,7,24
258453,Acute upper respiratory infection of multiple sites,racial,White,14,10,24
4141481,"Hand, foot and mouth disease",racial,Unknown,8,16,24
253788,Nasal polyp,racial,Unknown,13,11,24
81454,Injury of finger,ethnic,Not Hispanic or Latino,9,16,25
372423,Reduction deformities of brain,racial,White,20,4,24
441276,Nondependent alcohol abuse in remission,racial,Unknown,2,22,24
30163,Cellulitis and abscess of neck,racial,White,9,16,25
380055,Primary malignant neoplasm of brain,ethnic,Hispanic or Latino,17,7,24
197304,Ulcer of lower limb,ethnic,Not Hispanic or Latino,19,6,25
198809,Acute cholecystitis,ethnic,Hispanic or Latino,14,10,24
253954,PTB - Pulmonary tuberculosis,racial,White,16,9,25
312358,CGN - Chronic glomerulonephritis,racial,White,9,16,25
24970,Chronic laryngitis,ethnic,Hispanic or Latino,11,13,24
443111,Tenosynovitis of foot,ethnic,Hispanic or Latino,19,5,24
135338,Pemphigus,ethnic,Hispanic or Latino,21,4,25
260125,Acute bronchiolitis,racial,Black or African American ,7,18,25
195856,Cholangitis,racial,White,24,1,25
199078,Vaginal wall prolapse,racial,Unknown,25,0,25
81175,Contusion of chest,racial,Unknown,11,13,24
376382,Tension-type headache,racial,Asian,23,1,24
138604,"Contusion of face, scalp and neck, excluding eye(s)",ethnic,Not Hispanic or Latino,15,10,25
437394,Closed fracture of lower end of forearm,ethnic,Not Hispanic or Latino,16,9,25
30679,Benign tumour major salivary gland,ethnic,Hispanic or Latino,22,2,24
436253,Sprain of foot,racial,Unknown,14,10,24
438170,Acute myocardial infarction of inferior wall,ethnic,Hispanic or Latino,3,21,24
436583,[X]Falls,racial,Other Race,13,11,24
4170137,Non-suppurative otitis media,racial,Unknown,16,8,24
4062637,TB - Tuberculosis screening,racial,Native Hawaiian or Other Pacific Islander ,14,10,24
313459,Sleep apnea,racial,American Indian or Alaska Native ,20,4,24
74464,Idiopathic scoliosis AND/OR kyphoscoliosis,racial,Other Race,13,11,24
201907,Oedema of male genital organs,ethnic,Hispanic or Latino,0,24,24
79804,Myotonic dystrophy,racial,White,17,7,24
74396,TMJ - Temporomandibular joint disorder,ethnic,Not Hispanic or Latino,20,4,24
256622,Pulmonary disease due to Mycobacteria,ethnic,Hispanic or Latino,11,13,24
439082,Menopausal syndrome,racial,Other Race,24,0,24
133436,Thyrotoxic crisis,racial,Asian,24,0,24
257007,Allergic rhinitis,racial,Native Hawaiian or Other Pacific Islander ,5,19,24
4261613,Educational problem,ethnic,Not Hispanic or Latino,9,15,24
432447,Atypical glandular cells on cervical Papanicolaou smear,racial,Unknown,24,0,24
378414,Separation of retinal layers,racial,White,8,16,24
378752,Corneal opacity,ethnic,Hispanic or Latino,14,10,24
4305080,Abnormal breathing,ethnic,Hispanic or Latino,13,11,24
27321,Persistent vomiting,ethnic,Hispanic or Latino,19,5,24
79069,Disease of rectum,racial,White,9,15,24
192353,Disorder of gallbladder,ethnic,Hispanic or Latino,21,3,24
439154,Abnormal findings on diagnostic imaging of skull and head,racial,White,10,14,24
435928,Abnormal decrease in weight,racial,Other Race,7,17,24
443675,Traumatic amputation of toe(s) without mention of complication,ethnic,Hispanic or Latino,10,14,24
381036,Multiple AND bilateral precerebral artery stenosis,ethnic,Hispanic or Latino,18,6,24
438244,Congenital hydrocephalus,racial,White,13,11,24
317585,Aortic aneurysm,racial,Unknown,2,22,24
255348,Polymyalgia rheumatica,racial,White,16,8,24
258482,Abscess of Bartholin's gland,racial,White,24,0,24
440373,Subchronic schizophrenia,ethnic,Hispanic or Latino,4,20,24
4008683,Anxiety neurosis,racial,Unknown,20,4,24
136495,Lichenification and lichen simplex chronicus,ethnic,Hispanic or Latino,16,8,24
4012491,Difficulty chewing,racial,White,20,4,24
79069,Disease of rectum,ethnic,Hispanic or Latino,9,15,24
261326,Viral pneumonia,racial,White,9,15,24
377252,Neurofibromatosis type 1,racial,White,10,14,24
76725,Fissure in ano,ethnic,Not Hispanic or Latino,12,12,24
196360,Primary malignant neoplasm of bladder,racial,White,4,20,24
74469,Light-for-dates without mention of fetal malnutrition,ethnic,Not Hispanic or Latino,1,23,24
72469,Closed dislocation of shoulder region,racial,White,10,14,24
434896,Benign neoplasm of skin of upper limb and shoulder,ethnic,Hispanic or Latino,17,7,24
72715,Exostosis,racial,White,16,8,24
197381,Epigastric pain,racial,Asian,17,7,24
442597,Meteorism,racial,White,22,2,24
375822,Neonatal obstruction of nasolacrimal duct,racial,White,13,11,24
313236,Cough variant asthma,racial,Black or African American ,9,15,24
372888,Sciatic nerve lesion,ethnic,Hispanic or Latino,22,2,24
72618,Disorder of muscle,racial,White,17,7,24
259153,Throat soreness,racial,Black or African American ,12,12,24
438409,Attention deficit hyperactivity disorder,racial,Other Race,3,21,24
376111,Unqualified visual loss of one eye,ethnic,Hispanic or Latino,15,9,24
30133,Acute laryngitis,ethnic,Not Hispanic or Latino,19,5,24
374914,Quadriplegia,racial,White,1,23,24
440689,Agranulocytosis,ethnic,Hispanic or Latino,17,7,24
135888,Decubitus ulcer,ethnic,Hispanic or Latino,11,13,24
4179332,Parent-child problem,ethnic,Hispanic or Latino,12,12,24
440321,Helicobacter-associated disease,racial,Asian,16,8,24
198700,Liver secondary cancer,ethnic,Hispanic or Latino,7,17,24
435802,Blepharospasm,ethnic,Hispanic or Latino,14,10,24
4161978,Patient on oxygen,ethnic,Not Hispanic or Latino,14,10,24
80816,Intervertebral disc degeneration,racial,Other Race,11,13,24
433450,Paranoid schizophrenia,ethnic,Not Hispanic or Latino,23,1,24
256622,Pulmonary disease due to Mycobacteria,racial,White,11,13,24
377802,Late effects of poliomyelitis,racial,White,16,8,24
4340380,Hepatitis C carrier,racial,Unknown,7,17,24
4060985,BMI 30+ - obesity,racial,Filipino,21,3,24
80495,Palindromic rheumatism of the pelvic region and thigh,racial,Unknown,20,3,23
193528,Third degree uterine prolapse,racial,White,23,0,23
201820,Diabetes mellitus,ethnic,Not Hispanic or Latino,7,16,23
443587,Diastolic heart failure,racial,Asian,11,13,24
4256640,Body mass index 40+ - severely obese,ethnic,Not Hispanic or Latino,17,6,23
140027,Herpetic gingivostomatitis,racial,Unknown,18,5,23
442270,Disease of duodenum,racial,Unknown,12,11,23
4055758,Temporomandibular joint disorder NOS,racial,White,17,6,23
318736,Migraine,racial,Black or African American ,18,5,23
4175226,Screening for malignant neoplasm of colon,racial,Native Hawaiian or Other Pacific Islander ,11,12,23
442067,Atopic dermatitis and related conditions,racial,Filipino,7,16,23
378419,AD - Alzheimer's disease,racial,Native Hawaiian or Other Pacific Islander ,21,2,23
438409,Attention deficit hyperactivity disorder,racial,Asian,8,16,24
432311,Angle-closure glaucoma - borderline,ethnic,Hispanic or Latino,18,5,23
4101660,Amputated below knee,racial,Unknown,13,11,24
437246,Vitamin B deficiency,racial,Unknown,8,15,23
381316,CVA - Cerebrovascular accident,ethnic,Not Hispanic or Latino,15,8,23
440382,LD - Learning difficulties,racial,Unknown,5,18,23
443617,Conduct disorder,ethnic,Not Hispanic or Latino,6,17,23
373786,Abnormal vision,racial,White,8,16,24
76161,Impotence of organic origin,racial,Asian,0,23,23
313217,Atrial fibrillation,racial,American Indian or Alaska Native ,17,6,23
4102739,Screening for cardiovascular system disease,ethnic,Hispanic or Latino,4,19,23
4319325,Acquired deformity of trunk,racial,Unknown,20,3,23
4103894,Hordeolum and other deep inflammation of eyelid NOS,ethnic,Hispanic or Latino,19,5,24
198715,Premature menopause,racial,Unknown,23,0,23
4193570,Abnormal results of hearing screening test,ethnic,Hispanic or Latino,8,15,23
200219,Abdominal pain,racial,American Indian or Alaska Native ,17,7,24
316127,Vitreous opacities,racial,White,13,10,23
259848,Chronic rhinitis,racial,Other Race,12,11,23
432588,Megaloblastic anemia due to vitamin B>12< deficiency,racial,Unknown,19,5,24
133414,Candidiasis of skin and nails,racial,Unknown,21,2,23
4168213,Chest pain on breathing,racial,Asian,5,19,24
439254,"Bipolar affective disorder, current episode depression",racial,White,23,0,23
443430,HPV - Human papillomavirus test positive,ethnic,Not Hispanic or Latino,20,3,23
4167075,Fusion of knee,ethnic,Hispanic or Latino,11,12,23
443622,Aneurysm of thoracic aorta,ethnic,Hispanic or Latino,13,11,24
4062495,Glaucoma screening,racial,Asian,15,8,23
436077,Developmental delay,racial,Unknown,9,14,23
435802,Blepharospasm,racial,White,15,8,23
4110815,"Sensorineural hearing loss, bilateral",ethnic,Not Hispanic or Latino,17,7,24
440465,Postpartum state,racial,Unknown,23,0,23
443876,Obsessive compulsive personality disorder,ethnic,Hispanic or Latino,22,1,23
201620,Calculus of kidney,racial,Asian,10,13,23
434742,Congenital abnormality of skull and face bones,ethnic,Not Hispanic or Latino,10,14,24
312723,Congenital heart disease,racial,Unknown,12,11,23
4230642,Acquired deformity of chest,racial,Unknown,23,1,24
81106,Acquired genu varum,racial,White,8,16,24
432867,Hyperlipidemia,racial,American Indian,10,13,23
440694,"Nondependent mixed drug abuse, episodic",ethnic,Hispanic or Latino,12,11,23
198194,Female genital organ symptoms,racial,Black or African American ,23,0,23
74130,Thoracic spondylosis without myelopathy,ethnic,Hispanic or Latino,14,9,23
73843,Synovial cyst of popliteal space,racial,White,11,12,23
77373,Congenital deformity of hip joint,racial,White,16,7,23
4138253,Malabsorption syndrome,ethnic,Hispanic or Latino,21,2,23
201620,Calculus of kidney,racial,Other Race,14,9,23
197318,Cholesterolosis of gallbladder,racial,White,14,9,23
4090550,Evening colic,racial,White,14,9,23
198101,Lipoma of skin and subcutaneous tissue (excluding face),ethnic,Not Hispanic or Latino,13,11,24
4167075,Fusion of knee,racial,White,13,10,23
132344,Gingival and periodontal disease,racial,Unknown,8,16,24
30133,Acute laryngitis,racial,Unknown,20,4,24
135333,Pressure sore,racial,Unknown,14,10,24
440069,Drug dependence,racial,Unknown,6,17,23
435875,"Complications of pregnancy, childbirth and the puerperium",ethnic,Hispanic or Latino,23,1,24
138148,Plantar nerve lesion,racial,White,19,5,24
317585,Aortic aneurysm,racial,White,6,17,23
193525,Abdominal pregnancy,ethnic,Hispanic or Latino,23,0,23
441829,Hyperosmolality and or hypernatremia,ethnic,Hispanic or Latino,17,6,23
4055208,Chronic hepatitis unspecified,ethnic,Hispanic or Latino,14,8,22
437489,Herpes zoster with complication,ethnic,Hispanic or Latino,19,4,23
439141,Abnormal increase in weight,racial,Asian,2,20,22
80189,Displacement of lumbar intervertebral disc without myelopathy,racial,Black or African American ,16,7,23
200450,Disease of urethra,racial,White,14,8,22
193787,Varicose veins of lower extremity with ulcer AND inflammation,racial,White,11,12,23
194158,Perinatal gastrointestinal hemorrhage,ethnic,Hispanic or Latino,8,15,23
440535,Abnormal radiographic examination,ethnic,Hispanic or Latino,13,10,23
435219,Schizophrenia in remission,ethnic,Hispanic or Latino,19,4,23
434610,Hyperkalemia,racial,Other Race,17,6,23
4005823,Tobacco user,racial,Asian,0,23,23
137063,Corns and callus,racial,Other Race,17,6,23
199075,Neurogenic bladder,ethnic,Not Hispanic or Latino,4,19,23
4062637,TB - Tuberculosis screening,racial,Filipino,12,11,23
200687,Renal disorder associated with type I diabetes mellitus,racial,Other Race,16,7,23
192273,Benign tumour of adrenal gland,ethnic,Hispanic or Latino,13,10,23
437525,Overweight,racial,Asian Indian,17,5,22
194611,CIN 3 - Cervical intraepithelial neoplasia grade 3,racial,Unknown,23,0,23
195867,Noninflammatory vaginal disorders,racial,Unknown,23,0,23
432453,General clinical state finding,racial,Unknown,19,4,23
78529,Kyphoscoliosis and scoliosis,racial,White,17,5,22
442116,Allergy to eggs,racial,White,5,17,22
376124,Pinguecula,racial,White,12,11,23
80767,Breast irregular nodularity,racial,Other Race,22,1,23
139750,Primary malignant neoplasm of skin,ethnic,Hispanic or Latino,15,8,23
441417,Lack of coordination,racial,White,10,13,23
440388,[X]Developmental co - ordination disorder,racial,White,4,19,23
193874,Bed wetting,racial,Unknown,10,13,23
316998,Left bundle branch block,racial,White,20,2,22
377560,Internal hordeolum,racial,Unknown,16,7,23
72990,Localised osteoarthrosis uncertain if primary OR secondary,racial,White,19,4,23
201337,Disorder of bladder and bladder neck,ethnic,Hispanic or Latino,14,8,22
314369,Malignant hypertensive heart disease without congestive heart failure,racial,White,11,11,22
317248,Disorder of hematopoietic structure,racial,Unknown,13,10,23
197610,Ovarian cyst,racial,Black or African American ,23,0,23
4318408,Subdural haematoma,ethnic,Hispanic or Latino,4,19,23
442425,Lumbar post-laminectomy syndrome,racial,Unknown,1,22,23
197378,Overflow incontinence of urine,racial,White,15,8,23
74132,Degeneration of lumbosacral intervertebral disc,racial,Other Race,12,11,23
439253,"Bipolar affective disorder, currently depressed, mild",ethnic,Not Hispanic or Latino,16,7,23
432941,Disease of tongue,racial,White,15,8,23
137213,Fungal dermatosis,racial,Unknown,14,9,23
194913,Idiopathic peripheral autonomic neuropathy,racial,Other Race,0,23,23
40491340,Closed fracture of tibia,racial,White,13,10,23
441259,Non-thrombocytopenic purpura,ethnic,Hispanic or Latino,12,11,23
372613,Flaccid hemiplegia,racial,White,4,19,23
439695,Hypertensive heart and renal disease with renal failure,racial,White,17,6,23
4101602,Henoch-Schonlein purpura,racial,White,7,16,23
440686,Residual schizophrenia in remission,racial,Unknown,0,23,23
139902,Allergic urticaria,ethnic,Not Hispanic or Latino,10,13,23
261880,Atelectasis,ethnic,Hispanic or Latino,16,7,23
140486,Ulcer of calf,ethnic,Hispanic or Latino,11,11,22
4103638,Amputated - transfemoral,racial,White,16,7,23
313878,Respiratory symptoms,racial,American Indian or Alaska Native ,18,5,23
437233,Plasmacytic myeloma,ethnic,Not Hispanic or Latino,23,0,23
437677,Abnormal findings on diagnostic imaging of lung,racial,Unknown,1,22,23
436681,Insomnia disorder related to known organic factor,ethnic,Hispanic or Latino,10,13,23
4086918,Viral screening,racial,American Indian or Alaska Native ,18,5,23
443415,Gestation greater than 24 weeks,racial,White,19,4,23
79127,Congenital spondylolisthesis,racial,White,14,8,22
437251,Benign neoplasm of pituitary gland and craniopharyngeal duct,racial,Black or African American ,0,23,23
255334,Collagen disease,ethnic,Hispanic or Latino,17,5,22
435889,Decubitus ulcer of ankle,ethnic,Hispanic or Latino,10,13,23
320746,Cardiomyopathy associated with another disorder,ethnic,Not Hispanic or Latino,0,23,23
201078,Senile atrophic vaginitis,ethnic,Not Hispanic or Latino,20,2,22
23220,Chronic tonsillitis,racial,White,13,10,23
4148407,Family history: Cardiovascular disease,ethnic,Hispanic or Latino,10,13,23
379010,Macular retinal puckering,racial,Unknown,20,2,22
195906,Disorder of lumbar spine,ethnic,Not Hispanic or Latino,4,19,23
4250023,Severe major depression with psychotic features,racial,Black or African American ,10,13,23
435810,After-cataract,racial,White,13,10,23
4263370,R.I.N.D. syndrome,racial,Asian,5,17,22
437986,FTT - Failure to thrive,racial,Black or African American ,5,17,22
136934,Primary hyperparathyroidism,racial,White,12,10,22
378849,Microtia,ethnic,Hispanic or Latino,10,13,23
433885,Closed supracondylar fracture of humerus,ethnic,Hispanic or Latino,11,11,22
78474,Hypertrophy of breast,racial,Unknown,5,17,22
440751,Peritonsillar abscess,racial,White,10,12,22
192359,RF - Renal failure,ethnic,Not Hispanic or Latino,10,13,23
201606,Crohn's disease,ethnic,Not Hispanic or Latino,9,13,22
138996,Carcinoma in situ of skin,ethnic,Hispanic or Latino,15,7,22
432867,Hyperlipidemia,racial,Asian Indian,8,14,22
4064905,Venereal disease screening,racial,Asian,12,10,22
80946,Tinea manus,ethnic,Hispanic or Latino,10,13,23
137626,Seborrhoeic eczema of scalp,ethnic,Not Hispanic or Latino,5,17,22
75052,Enthesopathy of wrist AND/OR carpus,racial,White,17,5,22
443237,"Manic disorder, single episode",ethnic,Not Hispanic or Latino,18,4,22
201927,Cellulitis and abscess of leg,racial,Other Race,13,10,23
376208,Soft tissue disorder,racial,White,8,14,22
80141,Functional diarrhea,ethnic,Hispanic or Latino,14,8,22
435508,Adrenal cortical hypofunction,ethnic,Not Hispanic or Latino,7,16,23
381842,Petit mal status,ethnic,Not Hispanic or Latino,14,8,22
380839,TS - Tuberous sclerosis,racial,Unknown,20,2,22
436839,Closed fracture of metacarpal bone,racial,Unknown,5,17,22
377885,Disorder of eye movements,racial,Unknown,14,8,22
381306,Deaf mutism,racial,White,14,8,22
434376,Acute myocardial infarction of anterior wall,racial,Asian,17,5,22
374882,Benign connective tissue neoplasm,ethnic,Hispanic or Latino,15,7,22
437828,Disorder of calcium metabolism,racial,Unknown,16,7,23
315947,Thoracic back sprain,ethnic,Not Hispanic or Latino,13,10,23
194286,"Malignant neoplasm of corpus uteri, excluding isthmus",racial,White,22,0,22
440788,Hyperemesis gravidarum with metabolic disturbance - not delivered,ethnic,Hispanic or Latino,22,0,22
134765,General body deterioration,racial,White,10,12,22
4093344,Prostate observation,racial,Black or African American ,0,22,22
197925,Haemorrhage of rectum and anus,racial,Other Race,8,14,22
436147,Glossitis,ethnic,Hispanic or Latino,15,7,22
4064381,Nephropathy screening,racial,Unknown,16,7,23
201343,Acute alcoholic liver disease,ethnic,Hispanic or Latino,4,18,22
132553,Herpangina,racial,Unknown,10,13,23
440424,Aphasia,racial,Other Race,1,22,23
437995,Closed ill-defined fractures of upper limb,racial,Unknown,22,1,23
376382,Tension-type headache,racial,Other Race,16,6,22
79873,Urolith,racial,Unknown,10,13,23
377001,Unruptured cerebral aneurysm,ethnic,Not Hispanic or Latino,17,5,22
440700,Communicating hydrocephalus,ethnic,Hispanic or Latino,2,20,22
376707,Acute conjunctivitis,racial,Asian,11,11,22
75354,Osteochondropathy,racial,Other Race,20,2,22
378424,Astigmatism,racial,White,14,8,22
256449,Bronchiectasis,racial,White,22,1,23
443344,Barrett esophagus,ethnic,Not Hispanic or Latino,13,9,22
435216,Disorder associated with type I diabetes mellitus,ethnic,Not Hispanic or Latino,7,15,22
40491340,Closed fracture of tibia,racial,Unknown,19,4,23
443228,"Abrasion or friction burn of foot and toe, without mention of infection",racial,White,10,12,22
75036,Primary localized osteoarthrosis of hand,racial,White,18,4,22
199754,Primary malignant neoplasm of pancreas,racial,Unknown,12,10,22
4028253,Neoplasm of digestive system,racial,White,16,6,22
4201387,Tracheostomy in situ,racial,Black or African American ,20,2,22
434119,Hidradenitis,ethnic,Not Hispanic or Latino,17,5,22
77395,Current tear of semilunar cartilage,racial,Unknown,12,10,22
4166776,Dupuytren contracture,racial,White,6,16,22
141104,Intervertebral disc disorder of lumbar region with myelopathy,racial,Other Race,7,15,22
4326601,Anorectal abscess,ethnic,Not Hispanic or Latino,11,11,22
375823,Optic nerve hypoplasia,ethnic,Hispanic or Latino,8,14,22
441547,Oppositional defiant disorder,ethnic,Hispanic or Latino,2,20,22
4155526,Acute otitis media with effusion,racial,White,6,16,22
374950,Oedema of eyelid,racial,White,14,8,22
437474,Postoperative infection,racial,White,20,2,22
141090,PG - Pyogenic granuloma,racial,White,10,13,23
74125,Inflammatory polyarthropathy,ethnic,Hispanic or Latino,17,5,22
437966,Calcium deposits in tendon,ethnic,Hispanic or Latino,14,8,22
436265,Open wound of multiple sites of one lower limb AND thigh without complication,ethnic,Hispanic or Latino,16,6,22
77029,Epididymo-orchitis without abscess,racial,White,0,22,22
438962,Herpes simplex with complication,racial,White,7,15,22
444115,Disorder of bursa,ethnic,Hispanic or Latino,12,10,22
440216,Abnormal glucose tolerance test,racial,Other Race,15,7,22
31967,Nausea,racial,Other Race,16,5,21
194611,CIN 3 - Cervical intraepithelial neoplasia grade 3,ethnic,Not Hispanic or Latino,22,0,22
78474,Hypertrophy of breast,ethnic,Not Hispanic or Latino,7,14,21
133141,Tinea pedis,racial,Asian,9,13,22
134074,Oral soft tissue cellulitis,racial,White,14,8,22
376647,Primary malignant neoplasm of soft tissues,ethnic,Hispanic or Latino,4,18,22
436118,After-cataract with vision obscured,racial,White,13,8,21
4263325,Actinic cheilitis,ethnic,Hispanic or Latino,12,10,22
141508,Dermatophytosis of scalp or beard,racial,Unknown,6,16,22
436245,Atypical glandular cells on vaginal Papanicolaou smear,racial,Unknown,22,0,22
198289,Nonvenomous insect bite of hip without infection,ethnic,Hispanic or Latino,16,6,22
198263,Right upper quadrant pain,racial,Asian,14,7,21
381859,Infective OE,racial,Asian,11,10,21
4307254,Closed fracture,racial,Unknown,13,9,22
440530,Oropharyngeal dysphagia,racial,White,14,8,22
75010,Fibroadenosis of breast,ethnic,Hispanic or Latino,22,0,22
198550,"Atresia and stenosis of large intestine, rectum and anal canal",racial,White,5,16,21
252658,Intrinsic asthma without status asthmaticus,ethnic,Not Hispanic or Latino,14,8,22
138176,Acute gingivitis,ethnic,Not Hispanic or Latino,15,7,22
437536,Somatoform autonomic dysfunction - gastrointestinal tract,ethnic,Hispanic or Latino,8,14,22
440685,"Nondependent alcohol abuse, episodic",ethnic,Not Hispanic or Latino,5,16,21
433885,Closed supracondylar fracture of humerus,racial,White,8,13,21
78529,Kyphoscoliosis and scoliosis,racial,Unknown,3,19,22
140020,Viral exanthem,racial,Unknown,8,13,21
379832,Mixed conductive and sensorineural deafness,racial,Unknown,17,5,22
433527,Endometriosis,racial,White,22,0,22
79884,Galactorrhea not associated with childbirth,ethnic,Not Hispanic or Latino,22,0,22
319034,Hypertensive heart disease without congestive heart failure,ethnic,Not Hispanic or Latino,19,2,21
72457,Closed fracture of sacrum AND/OR coccyx without spinal cord injury,ethnic,Hispanic or Latino,17,4,21
193249,Acute erosive gastritis,ethnic,Hispanic or Latino,13,8,21
195562,Hemorrhoids,racial,Black or African American ,11,10,21
4030270,Proliferative polycythemia,racial,Unknown,0,22,22
192731,Digestive symptom,ethnic,Not Hispanic or Latino,16,5,21
254591,Secondary malignant tumour of lung,racial,White,22,0,22
196436,Internal haemorrhoid,racial,White,7,14,21
73075,Contusion of upper limb,ethnic,Hispanic or Latino,16,5,21
372247,Candidal otomycosis,ethnic,Hispanic or Latino,19,2,21
135745,Exanthema subitum,ethnic,Hispanic or Latino,11,11,22
141831,Branchial arch syndrome,racial,White,7,15,22
196359,Primary malignant neoplasm of uterine cervix,racial,Other Race,22,0,22
439155,Carcinoembryonic antigen present,racial,Unknown,12,10,22
440465,Postpartum state,ethnic,Not Hispanic or Latino,20,2,22
439406,Allergy to animal,racial,Unknown,11,10,21
442139,Primary bronchial cancer,ethnic,Not Hispanic or Latino,2,19,21
444375,"Contact dermatitis due to plants, except food",ethnic,Hispanic or Latino,13,9,22
134569,Erythema infectiosum,ethnic,Hispanic or Latino,7,14,21
28060,Strept throat,racial,Black or African American ,8,13,21
375824,Abnormal auditory perception,ethnic,Hispanic or Latino,11,10,21
443577,Asymmetric sensorineural hearing loss,racial,Unknown,12,10,22
197607,Polymenorrhagia,racial,Black or African American ,22,0,22
439080,Dyspareunia,racial,Unknown,22,0,22
75897,Polyarthropathy,ethnic,Hispanic or Latino,17,4,21
257628,Systemic lupus erythematosus,racial,Other Race,8,14,22
4228802,Mild recurrent major depression,racial,Asian,15,7,22
321462,Cardiac complications of care,racial,White,7,15,22
438836,Poliomyelitis osteopathy of the lower leg,racial,Unknown,2,20,22
4171430,Screening for malignant neoplasm of rectum,racial,Other Race,5,16,21
141104,Intervertebral disc disorder of lumbar region with myelopathy,racial,Black or African American ,5,16,21
436940,Insulin resistance syndrome,ethnic,Not Hispanic or Latino,17,5,22
4290927,Impairment level: low vision of both eyes,racial,Unknown,13,9,22
73553,Arthropathy,racial,Filipino,22,0,22
78832,Intervertebral disc disorder with myelopathy,racial,White,14,7,21
438722,Non megaloblastic anemia associated with nutritional deficiency,ethnic,Hispanic or Latino,19,3,22
312934,Atherosclerosis of aorta,racial,Asian,12,10,22
444112,Integumentary system finding,ethnic,Not Hispanic or Latino,13,8,21
73571,Pathological fracture,racial,Unknown,17,5,22
201069,"Peptic ulcer without hemorrhage, without perforation AND without obstruction",racial,Filipino,21,0,21
373474,Seeing double,racial,White,6,15,21
374025,Retinal haemorrhages,racial,White,14,7,21
197044,Female infertility associated with anovulation,racial,White,21,0,21
81377,Climacteric arthritis of the lower leg,ethnic,Hispanic or Latino,16,5,21
80512,Acquired kyphosis,ethnic,Hispanic or Latino,19,2,21
378735,Migraine without aura,ethnic,Not Hispanic or Latino,20,1,21
257628,Systemic lupus erythematosus,racial,Black or African American ,21,0,21
194871,Trichomonal vulvovaginitis,ethnic,Hispanic or Latino,21,0,21
380055,Primary malignant neoplasm of brain,racial,White,16,5,21
201603,Disease of teeth AND/OR supporting structures,racial,Other Race,5,16,21
315078,Palpitations,racial,Black or African American ,13,8,21
201530,"Diabetes mellitus, adult onset, with hyperosmolar coma",racial,White,15,6,21
381581,Chalazion,ethnic,Not Hispanic or Latino,11,10,21
378756,Conjunctival hemorrhage,ethnic,Not Hispanic or Latino,11,10,21
193782,End stage renal disease,racial,Black or African American ,5,16,21
439004,Restzustand,racial,White,0,21,21
4181604,Subcutaneous contraceptive implant,ethnic,Hispanic or Latino,21,0,21
195259,Entrapment of lateral cutaneous nerve of thigh,racial,White,13,8,21
197988,General abdominal pain-symptom,racial,Other Race,18,3,21
377291,"Peripheral pterygium, progressive",ethnic,Hispanic or Latino,11,10,21
434896,Benign neoplasm of skin of upper limb and shoulder,racial,White,13,8,21
40481820,Flaccid hemiplegia of nondominant side,ethnic,Hispanic or Latino,13,8,21
4239721,Seafood allergy,ethnic,Hispanic or Latino,14,7,21
4112525,Acute bronchiolitis NOS,racial,Unknown,8,13,21
77403,Closed fracture of vertebral column without spinal cord injury,ethnic,Not Hispanic or Latino,14,7,21
376707,Acute conjunctivitis,racial,Other Race,16,5,21
24970,Chronic laryngitis,racial,White,11,10,21
437394,Closed fracture of lower end of forearm,racial,Unknown,13,8,21
193519,Impaired renal function disorder,racial,White,12,9,21
439155,Carcinoembryonic antigen present,ethnic,Hispanic or Latino,16,5,21
135852,Teething syndrome,ethnic,Not Hispanic or Latino,5,16,21
439846,LVF - Left ventricular failure,ethnic,Not Hispanic or Latino,2,19,21
198550,"Atresia and stenosis of large intestine, rectum and anal canal",ethnic,Hispanic or Latino,5,16,21
80242,Current tear of medial cartilage AND/OR meniscus of knee,ethnic,Not Hispanic or Latino,14,7,21
194382,External haemorrhoid,racial,Unknown,19,2,21
375281,Acute suppurative otitis media - tympanic membrane intact,racial,Asian,9,12,21
74080,Orthostatic proteinuria,ethnic,Hispanic or Latino,7,14,21
253321,Stridor,ethnic,Hispanic or Latino,7,14,21
24966,OV - Oesophageal varices,racial,Unknown,14,7,21
4109253,Pterygium NOS,ethnic,Hispanic or Latino,8,13,21
378165,Nystagmus,racial,White,13,8,21
318186,Achalasia of esophagus,ethnic,Hispanic or Latino,20,1,21
4110047,Chronic bronchitis NOS,racial,Unknown,8,13,21
254061,Pleural effusion,racial,Unknown,8,13,21
134144,Cleft palate with cleft lip,ethnic,Not Hispanic or Latino,10,11,21
436666,Psychosexual disorder,ethnic,Hispanic or Latino,4,17,21
78473,Solitary cyst of breast,ethnic,Not Hispanic or Latino,20,1,21
442793,Diabetic complication,racial,Black or African American ,15,6,21
316432,Right bundle branch block AND left anterior fascicular block,ethnic,Hispanic or Latino,7,14,21
138717,Thyrotoxicosis with diffuse goitre,ethnic,Hispanic or Latino,19,2,21
199754,Primary malignant neoplasm of pancreas,ethnic,Not Hispanic or Latino,17,4,21
321042,Cardiac arrest,ethnic,Hispanic or Latino,8,13,21
437241,Qualitative platelet defect,racial,White,7,14,21
201603,Disease of teeth AND/OR supporting structures,racial,Asian,13,8,21
381292,Chronic allergic conjunctivitis,racial,Black or African American ,7,14,21
4115173,Atrial premature complex,ethnic,Hispanic or Latino,11,10,21
433599,Abnormal biochemistry finding,racial,Other Race,2,19,21
433227,Abnormal sensation,ethnic,Hispanic or Latino,14,7,21
320073,Neutrophil count below reference range,ethnic,Not Hispanic or Latino,14,7,21
315273,MS - Mitral stenosis,ethnic,Hispanic or Latino,20,1,21
438407,BN - Bulimia nervosa,ethnic,Hispanic or Latino,18,3,21
435656,Neonatal jaundice,ethnic,Not Hispanic or Latino,7,14,21
81390,Idiopathic osteoporosis,ethnic,Not Hispanic or Latino,21,0,21
252365,MGN - Membranous glomerulonephritis,ethnic,Not Hispanic or Latino,4,17,21
321314,Abdominal aortic aneurysm without rupture,racial,Asian,7,14,21
381549,Migraine with aura,racial,Unknown,19,2,21
4018734,Sprain of costal cartilage,ethnic,Not Hispanic or Latino,12,9,21
432612,Mild mental handicap,racial,Unknown,9,12,21
4086928,IUCD status,racial,Unknown,21,0,21
436070,Vitamin D deficiency,racial,Other Race,16,5,21
31821,Endocrinopathy,ethnic,Hispanic or Latino,13,8,21
76611,Injury of shoulder region,ethnic,Not Hispanic or Latino,10,11,21
444093,Patient status finding,racial,Unknown,17,4,21
317009,Hyperreactive airway disease,racial,American Indian,17,4,21
433440,Dysthymia,racial,Black or African American ,21,0,21
320073,Neutrophil count below reference range,racial,Unknown,15,6,21
195856,Cholangitis,ethnic,Not Hispanic or Latino,21,0,21
197378,Overflow incontinence of urine,racial,Unknown,19,2,21
4196960,Varicocele,racial,Unknown,1,20,21
440748,Interstitial emphysema of lung,racial,Black or African American ,2,19,21
374914,Quadriplegia,ethnic,Hispanic or Latino,1,20,21
436033,Syphilis,racial,Unknown,10,11,21
78232,Shoulder joint pain,racial,American Indian or Alaska Native ,13,8,21
321107,AR - Congenital aortic regurgitation,ethnic,Hispanic or Latino,7,14,21
4064925,Hypertension screening,racial,Unknown,16,5,21
4018734,Sprain of costal cartilage,racial,Unknown,14,6,20
313761,Central retinal vein occlusion,ethnic,Hispanic or Latino,11,9,20
432661,Stomatitis,ethnic,Not Hispanic or Latino,12,8,20
312358,CGN - Chronic glomerulonephritis,racial,Unknown,14,6,20
380096,Proliferative diabetic retinopathy,racial,Other Race,10,11,21
196158,Disease of penis,racial,Unknown,0,20,20
4204904,Education about sexually transmitted disease prevention,racial,Unknown,19,2,21
200051,Primary malignant neoplasm of ovary,racial,White,20,0,20
77965,Nodular tendinous disease of finger,racial,Other Race,11,9,20
196168,Irregular menstrual bleeding,racial,Black or African American ,20,0,20
436391,Primary cerebellar degeneration,racial,White,13,7,20
72465,Closed fracture of one or more phalanges of hand,ethnic,Not Hispanic or Latino,11,9,20
442790,Growth and development,ethnic,Hispanic or Latino,13,8,21
4133029,Primigravida,racial,Black or African American ,20,0,20
4028716,Idiopathic thrombocythemia,racial,Asian,7,13,20
444297,Vertiginous syndrome,ethnic,Hispanic or Latino,16,5,21
137977,Icteric,racial,Unknown,2,18,20
197206,Balantidiasis,racial,White,0,20,20
441974,Closed fracture of forearm,racial,Unknown,10,11,21
134898,Non-toxic single thyroid nodule,racial,Asian,18,2,20
194993,Intestinal malabsorption,ethnic,Hispanic or Latino,12,8,20
40480668,Chronic inflammatory demyelinating polyneuritis,racial,Unknown,20,0,20
318397,Chronic idiopathic thrombocytopenic purpura,racial,White,4,16,20
4146248,Rheumatoid arthritis and other inflammatory polyarthropathies,racial,Unknown,20,1,21
432582,Neoplastic disease of uncertain behavior,racial,White,10,10,20
379801,Trigeminal neuralgia,ethnic,Not Hispanic or Latino,17,4,21
192680,Portal hypertension,racial,Unknown,16,4,20
140489,Acquired acanthosis nigricans,ethnic,Not Hispanic or Latino,11,9,20
444239,Postprocedural state finding,racial,Black or African American ,11,9,20
4104710,Parkinson's disease NOS,ethnic,Hispanic or Latino,18,2,20
4133029,Primigravida,racial,Other Race,20,0,20
135852,Teething syndrome,racial,Unknown,5,16,21
381839,Habit disorder,ethnic,Hispanic or Latino,7,14,21
438244,Congenital hydrocephalus,racial,Other Race,16,4,20
434374,Anisocoria,ethnic,Hispanic or Latino,12,8,20
4108975,Borderline glaucoma NOS,ethnic,Hispanic or Latino,20,1,21
4005823,Tobacco user,racial,Black or African American ,7,13,20
198683,Viral hepatitis B without hepatic coma,ethnic,Hispanic or Latino,19,2,21
433527,Endometriosis,ethnic,Hispanic or Latino,20,0,20
437058,Sunburn,ethnic,Hispanic or Latino,8,13,21
440382,LD - Learning difficulties,ethnic,Not Hispanic or Latino,8,13,21
438879,Closed bimalleolar fracture,racial,Unknown,19,2,21
377527,Presenile dementia with depression,racial,Black or African American ,20,0,20
40481820,Flaccid hemiplegia of nondominant side,racial,Unknown,4,17,21
40480668,Chronic inflammatory demyelinating polyneuritis,ethnic,Not Hispanic or Latino,20,0,20
441276,Nondependent alcohol abuse in remission,ethnic,Not Hispanic or Latino,7,13,20
4201390,Colostomy present,ethnic,Not Hispanic or Latino,20,1,21
30361,Hypoglycemic disorder,ethnic,Hispanic or Latino,17,3,20
80509,Bone cyst,ethnic,Hispanic or Latino,10,11,21
134461,Tietze disease,racial,Other Race,16,4,20
435648,Testicular retraction,ethnic,Hispanic or Latino,0,20,20
81942,Enthesopathy of ankle AND/OR tarsus,racial,White,10,10,20
193255,"Noninflammatory disorders of the ovary, fallopian tube and broad ligament",ethnic,Hispanic or Latino,20,0,20
200762,Autoimmune hepatitis,ethnic,Hispanic or Latino,10,11,21
437671,Abnormal feces,racial,White,15,5,20
135287,Non-neoplastic naevus,ethnic,Not Hispanic or Latino,11,10,21
24660,Acute tonsillitis,racial,Black or African American ,9,11,20
432729,Crying infant,racial,White,8,13,21
134116,Dermatitis due to drug AND/OR medicine taken internally,racial,White,8,12,20
260427,Common cold,racial,Black or African American ,10,11,21
437954,Lateral meniscus derangement,ethnic,Hispanic or Latino,9,11,20
137497,Dermatophytosis of the body,racial,Black or African American ,11,9,20
4090651,Dialysis observation,racial,Other Race,3,17,20
252663,Pneumonitis due to inhalation of food or vomitus,ethnic,Hispanic or Latino,13,7,20
199866,Acute gastritis,racial,Asian,8,13,21
137379,Musculoskeletal symptom,racial,Asian,12,8,20
319041,Orthostatic hypotension,ethnic,Not Hispanic or Latino,4,17,21
433701,Mycosis,racial,White,15,5,20
27674,N&V - Nausea and vomiting,racial,Black or African American ,5,15,20
4110787,Other otitis externa,ethnic,Hispanic or Latino,15,5,20
437092,Physiological development failure,racial,Other Race,17,3,20
75623,Old disruption of anterior cruciate ligament,ethnic,Not Hispanic or Latino,11,10,21
193251,Umbilical hernia without obstruction AND without gangrene,racial,Other Race,17,4,21
4252735,Mourning,racial,Black or African American ,19,2,21
194491,Tenderness of epigastrium,racial,White,16,5,21
434854,FP - Food poisoning,racial,White,11,10,21
253797,Post-inflammatory pulmonary fibrosis,ethnic,Not Hispanic or Latino,19,1,20
192353,Disorder of gallbladder,racial,White,18,2,20
78234,Arthralgia of the hand,racial,Other Race,17,4,21
4210151,HIV counseling,racial,White,16,5,21
438407,BN - Bulimia nervosa,racial,White,15,5,20
442615,Carotid artery stenosis,racial,Asian,14,6,20
197675,Bowel incontinence,racial,White,16,5,21
4024567,Respiratory observation,ethnic,Hispanic or Latino,8,13,21
432878,Drug abuse using speed,racial,White,10,10,20
373999,Diabetic oculopathy associated with type I diabetes mellitus,ethnic,Not Hispanic or Latino,7,13,20
440927,High risk drug monitoring status,racial,White,14,7,21
4150307,Dental restoration observation,racial,Unknown,17,4,21
73045,Hand sprain,ethnic,Not Hispanic or Latino,10,11,21
201927,Cellulitis and abscess of leg,racial,Asian,13,7,20
192376,Rhesus isoimmunization with antenatal problem,ethnic,Hispanic or Latino,20,0,20
198928,Mechanical complication due to intrauterine contraceptive device,ethnic,Hispanic or Latino,20,0,20
4029488,Hepatic encephalopathy,racial,White,5,15,20
4092896,Stool contents abnormal,racial,Asian,13,7,20
440457,Threatened abortion,racial,White,20,0,20
443753,Abrasion AND/OR friction burn of wrist without infection,racial,White,7,13,20
194077,Chronic ulcerative enterocolitis,racial,White,2,17,19
77673,Sign or symptom of the urinary system,racial,White,9,11,20
258540,Marfan syndrome,ethnic,Hispanic or Latino,9,11,20
374027,Lesion of ulnar nerve,racial,White,10,10,20
4012570,High risk sexual behavior,ethnic,Not Hispanic or Latino,13,7,20
373766,Retinopathy of prematurity,ethnic,Not Hispanic or Latino,9,11,20
254980,Intrinsic asthma with asthma attack,ethnic,Hispanic or Latino,8,12,20
432347,Chronic disease of tonsils AND/OR adenoids,ethnic,Hispanic or Latino,14,6,20
193552,Furuncle of skin AND/OR subcutaneous tissue,racial,Unknown,7,13,20
318800,GERD - Gastro-esophageal reflux disease,racial,Filipino,10,10,20
440373,Subchronic schizophrenia,racial,Unknown,0,20,20
441553,Myoclonus,ethnic,Hispanic or Latino,16,4,20
442425,Lumbar post-laminectomy syndrome,racial,White,8,11,19
4053599,Open wound of forearm,ethnic,Hispanic or Latino,10,10,20
436235,Taste sense altered,racial,White,16,4,20
199754,Primary malignant neoplasm of pancreas,racial,White,17,3,20
439695,Hypertensive heart and renal disease with renal failure,racial,Unknown,2,18,20
256722,Bronchopneumonia,racial,White,10,10,20
4302252,High risk pregnancy care,racial,Black or African American ,20,0,20
432586,Mental disorder,racial,White,11,9,20
78230,Rheumatoid arthritis with organ / system involvement,ethnic,Hispanic or Latino,14,6,20
4148407,Family history: Cardiovascular disease,racial,White,8,11,19
437530,Disorders of lipoid metabolism,ethnic,Hispanic or Latino,17,2,19
140362,Hypoparathyroidism,racial,White,7,13,20
443597,Chronic kidney disease stage 3,racial,American Indian or Alaska Native ,20,0,20
439770,Ketoacidosis in type I diabetes mellitus,ethnic,Hispanic or Latino,13,7,20
380513,Congenital cataract,racial,White,14,5,19
193809,Melena due to gastrointestinal hemorrhage,racial,Other Race,9,11,20
320752,Influenza with non-respiratory manifestation,racial,Unknown,15,5,20
192854,Interstitial uterine fibroid,ethnic,Not Hispanic or Latino,20,0,20
435875,"Complications of pregnancy, childbirth and the puerperium",racial,White,20,0,20
439697,Hypertensive renal disease with renal failure,racial,Asian,20,0,20
193984,Adrenal hypofunction,ethnic,Hispanic or Latino,17,2,19
137809,Primary malignant neoplasm of female breast,racial,Filipino,20,0,20
437839,Pica,ethnic,Hispanic or Latino,11,8,19
136495,Lichenification and lichen simplex chronicus,racial,White,14,6,20
78236,Muscle wasting disorder,racial,Black or African American ,1,19,20
377877,Convergent squint,racial,Unknown,11,9,20
320074,Lymphocytosis,racial,White,18,2,20
437041,Mother not delivered,racial,Other Race,20,0,20
441835,Chronic schizoaffective schizophrenia,ethnic,Not Hispanic or Latino,9,11,20
314754,Wheezing,racial,Black or African American ,8,12,20
4144274,Housing lack,racial,White,4,16,20
4160859,Methicillin resistant staphylococcus aureus carrier,ethnic,Hispanic or Latino,14,6,20
78505,"Localised, primary osteoarthritis of the ankle and/or foot",racial,Unknown,19,1,20
378839,Spina bifida with hydrocephalus,ethnic,Hispanic or Latino,16,4,20
140020,Viral exanthem,ethnic,Not Hispanic or Latino,11,9,20
372765,Open wound of head without complication,ethnic,Hispanic or Latino,7,13,20
72576,Benign tumour of breast,racial,White,20,0,20
378849,Microtia,racial,White,10,10,20
436252,Closed fracture of shaft of tibia,ethnic,Hispanic or Latino,16,4,20
257004,Acute exacerbation of chronic obstructive airways disease,racial,Asian,5,15,20
192278,Type II diabetes mellitus - poor control,racial,Asian Indian,11,9,20
375239,Cerebral degeneration,racial,White,11,9,20
432545,Bacterial disease,ethnic,Not Hispanic or Latino,17,2,19
136185,Abnormal granulation tissue,racial,White,11,8,19
4103642,Amputated toe,ethnic,Not Hispanic or Latino,5,15,20
75406,Crush injury of finger,ethnic,Hispanic or Latino,10,10,20
4064918,Diabetes mellitus screening,racial,Native Hawaiian or Other Pacific Islander ,11,9,20
439254,"Bipolar affective disorder, current episode depression",ethnic,Not Hispanic or Latino,17,3,20
134765,General body deterioration,ethnic,Not Hispanic or Latino,3,17,20
315296,Preinfarction syndrome,racial,White,10,10,20
197023,Bilateral inguinal hernia,racial,White,1,19,20
432441,Finding of length of gestation,racial,White,13,7,20
4311159,Midline cystocele,ethnic,Not Hispanic or Latino,20,0,20
4022073,Dependance on wheel chair,racial,Unknown,12,8,20
200485,Decubitus ulcer of buttock,ethnic,Not Hispanic or Latino,13,7,20
134668,Chronic maxillary sinusitis,racial,White,11,9,20
4154623,Fit denture,ethnic,Hispanic or Latino,16,4,20
432441,Finding of length of gestation,ethnic,Not Hispanic or Latino,6,14,20
140641,Verruca vulgaris,racial,Other Race,10,10,20
73562,Solitary sacroiliitis,racial,White,19,1,20
442985,Male,ethnic,Not Hispanic or Latino,7,13,20
26378,Hyperpituitarism,racial,Unknown,19,1,20
132835,Pediculosis capitis,ethnic,Not Hispanic or Latino,19,1,20
432795,Traumatic AND/OR non-traumatic injury,ethnic,Not Hispanic or Latino,9,11,20
201337,Disorder of bladder and bladder neck,racial,White,13,7,20
433946,Fall on same level due to impact against another person,racial,Unknown,10,10,20
132446,Congenital anomaly of skin,ethnic,Not Hispanic or Latino,5,15,20
4047937,Neonatal urinary tract infection,ethnic,Hispanic or Latino,13,7,20
194077,Chronic ulcerative enterocolitis,ethnic,Hispanic or Latino,2,17,19
256531,Head and neck swelling,racial,Other Race,15,5,20
199744,Carcinoma liver and/or biliary system,racial,White,7,13,20
75346,Disorder of meniscus of knee,racial,White,10,10,20
200171,Carbuncle of skin AND/OR subcutaneous tissue,ethnic,Hispanic or Latino,13,7,20
437449,Victim of child abuse,ethnic,Hispanic or Latino,12,8,20
437489,Herpes zoster with complication,racial,Unknown,19,1,20
135777,Neoplasm of uncertain behaviour of skin,ethnic,Not Hispanic or Latino,10,10,20
138102,Benign tumour of skin,racial,Other Race,16,4,20
434701,"Anemia in mother complicating pregnancy, childbirth AND/OR puerperium",ethnic,Hispanic or Latino,20,0,20
4252735,Mourning,racial,Asian,18,2,20
4240902,Allergy to peanuts,ethnic,Not Hispanic or Latino,5,15,20
376120,"Keratoconjunctivitis sicca, not specified as Sjogren's",racial,White,17,2,19
444093,Patient status finding,ethnic,Not Hispanic or Latino,8,11,19
75004,Frank hematuria,ethnic,Not Hispanic or Latino,7,13,20
438028,Poisoning by drug AND/OR medicinal substance,ethnic,Hispanic or Latino,6,13,19
74194,Back sprain,racial,Unknown,16,3,19
312934,Atherosclerosis of aorta,racial,Other Race,8,11,19
435790,Spurious polycythaemia,ethnic,Not Hispanic or Latino,4,15,19
320536,Abnormal EKG finding,racial,Other Race,8,11,19
435515,Hypo-osmolality and or hyponatremia,racial,Native Hawaiian or Other Pacific Islander ,18,1,19
78162,Peripheral vertigo,racial,Unknown,16,4,20
443537,Deep venous thrombosis of lower extremity,racial,Filipino,0,19,19
4092879,Absent kidney,racial,Unknown,19,0,19
313792,PT - Paroxysmal tachycardia,ethnic,Hispanic or Latino,15,4,19
438170,Acute myocardial infarction of inferior wall,racial,White,1,18,19
436706,Acute myocardial infarction of lateral wall,racial,White,19,0,19
4174977,Diabetic retinopathy,ethnic,Not Hispanic or Latino,11,8,19
443431,Disorder of menstruation,racial,Other Race,19,0,19
372897,Homonymous bilateral visual field defects,ethnic,Hispanic or Latino,8,11,19
444437,Congenital abnormality of cervix,ethnic,Hispanic or Latino,19,0,19
437038,Blood in urine,racial,Black or African American ,10,10,20
432795,Traumatic AND/OR non-traumatic injury,racial,Unknown,12,7,19
444098,"Gestation period, 40 weeks",ethnic,Hispanic or Latino,8,11,19
4147497,Nervous system and sense organ diseases,ethnic,Not Hispanic or Latino,8,11,19
433071,Contusion of multiple sites,ethnic,Hispanic or Latino,10,9,19
381290,Ocular hypertension,racial,Unknown,16,3,19
4235140,Operation for bone injury of phalanges of hand,ethnic,Hispanic or Latino,10,9,19
437688,Abnormal findings on antenatal screening of mother,racial,Unknown,19,0,19
435244,Developmental disorder,ethnic,Hispanic or Latino,8,11,19
4005743,Female sterility,ethnic,Hispanic or Latino,19,0,19
78230,Rheumatoid arthritis with organ / system involvement,racial,Unknown,13,6,19
199866,Acute gastritis,racial,Other Race,11,8,19
79917,Acquired deformity of toe,ethnic,Hispanic or Latino,13,7,20
197913,Disorder of function of stomach,racial,Black or African American ,10,9,19
437390,Hypoxaemia,ethnic,Not Hispanic or Latino,10,10,20
196821,Observation of urethral discharge,ethnic,Hispanic or Latino,0,19,19
200527,Splenomegaly,racial,Unknown,8,11,19
373724,Neoplasm of brain,racial,Unknown,10,10,20
140486,Ulcer of calf,racial,White,9,10,19
133414,Candidiasis of skin and nails,ethnic,Not Hispanic or Latino,16,4,20
77963,Achilles tendinitis,racial,Unknown,16,3,19
80874,Open wound of multiple sites of one upper limb without complication,ethnic,Hispanic or Latino,10,10,20
4102739,Screening for cardiovascular system disease,racial,White,3,16,19
437464,"Injury undetermined whether accidentally or purposely inflicted, fall from residential premises",ethnic,Hispanic or Latino,14,5,19
4111875,Varicose veins of the leg NOS,ethnic,Hispanic or Latino,14,5,19
132344,Gingival and periodontal disease,racial,White,10,9,19
379801,Trigeminal neuralgia,racial,Other Race,13,6,19
81403,Osteopetrosis,ethnic,Hispanic or Latino,16,3,19
196165,Cervical intraepithelial neoplasia grade 2,ethnic,Not Hispanic or Latino,19,0,19
433168,Iron deficiency anaemia secondary to inadequate dietary iron intake,ethnic,Hispanic or Latino,17,2,19
438699,Primary malignant neoplasm of rectosigmoid junction,ethnic,Hispanic or Latino,1,19,20
440329,Herpes zoster without complication,racial,Asian,10,10,20
435023,Mild hyperemesis-not delivered,ethnic,Not Hispanic or Latino,19,0,19
433533,Incomplete spontaneous abortion with no mention of complication,racial,White,19,0,19
80495,Palindromic rheumatism of the pelvic region and thigh,ethnic,Not Hispanic or Latino,19,0,19
4208970,History of physical abuse,ethnic,Hispanic or Latino,17,2,19
433990,Subchronic catatonic schizophrenia,racial,White,0,19,19
376961,Disturbance of consciousness,ethnic,Not Hispanic or Latino,13,6,19
255841,Chronic bronchitis,racial,Black or African American ,17,2,19
435207,"Nodular lymphoma of lymph nodes of head, face and neck",ethnic,Hispanic or Latino,19,1,20
441974,Closed fracture of forearm,ethnic,Not Hispanic or Latino,14,5,19
132740,Positive skin test reaction,racial,Black or African American ,7,12,19
78516,Arthralgia of the upper arm,racial,Black or African American ,14,5,19
443876,Obsessive compulsive personality disorder,ethnic,Not Hispanic or Latino,19,0,19
435666,Closed fracture of upper end of tibia,ethnic,Hispanic or Latino,7,12,19
319835,Congestive cardiac failure,racial,Filipino,0,19,19
197223,Enterobiasis,racial,White,12,7,19
4055337,Gallbladder calculus without mention of cholecystitis,ethnic,Hispanic or Latino,9,10,19
137379,Musculoskeletal symptom,racial,Black or African American ,11,8,19
439700,Inhibited sexual desire,racial,Black or African American ,0,19,19
257012,Chronic rhinosinusitis,racial,Native Hawaiian or Other Pacific Islander ,19,0,19
438066,Chlamydial infection,racial,Black or African American ,10,9,19
320136,Disease of respiratory system,racial,Unknown,8,11,19
198995,Type 1 diabetes mellitus - poor control,racial,Native Hawaiian or Other Pacific Islander ,10,9,19
133444,Thyroiditis,racial,White,18,1,19
321596,Peripheral venous insufficiency,racial,Asian,3,16,19
436658,Vitamin deficiency,ethnic,Not Hispanic or Latino,16,3,19
200169,Pruritus ani,racial,Unknown,12,7,19
4288676,Acute and chronic cholecystitis,ethnic,Hispanic or Latino,18,1,19
201627,Abnormal vaginal bleeding,ethnic,Not Hispanic or Latino,19,0,19
4086928,IUCD status,ethnic,Not Hispanic or Latino,19,0,19
79768,Neoplasm of urinary system,ethnic,Not Hispanic or Latino,2,17,19
197230,Malignant neoplasm of uterus,racial,Unknown,19,0,19
436706,Acute myocardial infarction of lateral wall,ethnic,Hispanic or Latino,19,0,19
73866,Congenital anomaly of breast,ethnic,Hispanic or Latino,17,2,19
194995,Disorder of ureter,racial,White,17,2,19
4171434,Immunization refused,racial,Unknown,12,7,19
76548,Closed dislocation of hip,ethnic,Hispanic or Latino,13,7,20
441874,Cerebral thrombosis,racial,White,13,7,20
435093,Closed fracture of femur,racial,Unknown,10,9,19
377252,Neurofibromatosis type 1,ethnic,Hispanic or Latino,10,10,20
4091532,Bowel observation,racial,Unknown,13,7,20
195363,Congenital anomaly of kidney,ethnic,Hispanic or Latino,9,10,19
438536,Congenital anomaly of jaw,ethnic,Not Hispanic or Latino,8,11,19
201916,Ureteric stone,racial,White,12,7,19
138841,Disorder of sacrum,racial,White,11,8,19
381842,Petit mal status,racial,White,17,2,19
255573,Chronic obstructive lung disease,racial,Native Hawaiian or Other Pacific Islander ,4,15,19
319835,Congestive cardiac failure,racial,Native Hawaiian or Other Pacific Islander ,2,17,19
432582,Neoplastic disease of uncertain behavior,ethnic,Hispanic or Latino,12,7,19
378427,Tear film insufficiency,racial,Other Race,17,2,19
78149,Congenital hereditary muscular dystrophy,racial,White,8,11,19
315947,Thoracic back sprain,racial,Unknown,14,5,19
318712,Peripheral circulatory disorder associated with type I diabetes mellitus,racial,Asian,0,19,19
441039,Phlebitis of lower limb vein,ethnic,Hispanic or Latino,17,1,18
436070,Vitamin D deficiency,racial,Asian,11,8,19
442985,Male,racial,Asian,5,13,18
79864,Hematuria syndrome,racial,Unknown,7,12,19
312349,Venous varices,racial,Asian,6,13,19
378421,Alcoholic peripheral neuropathy,ethnic,Hispanic or Latino,0,19,19
379805,Myopia,racial,Black or African American ,8,10,18
31610,Disorder of oesophagus,ethnic,Hispanic or Latino,10,9,19
4293175,"Mental state, behaviour and/or psychosocial function finding",racial,Black or African American ,4,15,19
378144,Disease of basal ganglia,ethnic,Hispanic or Latino,4,14,18
436839,Closed fracture of metacarpal bone,ethnic,Not Hispanic or Latino,6,13,19
141933,Alopecia areata,racial,Unknown,11,8,19
77129,Closed fracture of pelvis,ethnic,Hispanic or Latino,17,1,18
193688,Clostridium difficile infection,ethnic,Not Hispanic or Latino,18,1,19
4234604,Disruption of cesarean wound in the puerperium,ethnic,Hispanic or Latino,19,0,19
198846,Enthesopathy of hip region,ethnic,Not Hispanic or Latino,17,1,18
436265,Open wound of multiple sites of one lower limb AND thigh without complication,racial,White,13,5,18
197230,Malignant neoplasm of uterus,ethnic,Hispanic or Latino,19,0,19
261889,Simple chronic bronchitis,ethnic,Not Hispanic or Latino,6,13,19
316437,Cerebral atherosclerosis,racial,White,14,5,19
440228,Closed fracture of lower end of humerus,racial,White,13,6,19
436246,Low libido,racial,Unknown,5,13,18
4298697,Multiple open wounds without complication,racial,Other Race,9,10,19
381312,Neural hearing loss,racial,Unknown,16,3,19
378742,Blind hypotensive eye,ethnic,Hispanic or Latino,5,14,19
376115,Cystoid macular retinal degeneration,ethnic,Hispanic or Latino,16,3,19
201907,Oedema of male genital organs,racial,White,0,19,19
444445,Benign neoplasm of skin of leg,ethnic,Hispanic or Latino,13,5,18
441788,Human papilloma virus infection,racial,White,15,4,19
4179214,Family history of malignant neoplasm of gastrointestinal tract,ethnic,Not Hispanic or Latino,13,5,18
441202,Generalized anaphylaxis,ethnic,Hispanic or Latino,9,10,19
24660,Acute tonsillitis,racial,Other Race,11,8,19
315831,Chronic pulmonary heart disease,racial,Other Race,11,7,18
433735,Alcohol dependence with acute alcoholic intoxication,ethnic,Hispanic or Latino,1,18,19
30968,Diabetes insipidus,racial,White,13,5,18
198197,Male infertility,ethnic,Hispanic or Latino,0,19,19
312950,IgE-mediated allergic asthma,racial,Asian,12,7,19
198062,"Infectious colitis, enteritis and gastroenteritis",racial,Unknown,14,4,18
437041,Mother not delivered,racial,Asian,19,0,19
438731,Fat pad,ethnic,Hispanic or Latino,15,4,19
4147497,Nervous system and sense organ diseases,racial,Unknown,10,9,19
318800,GERD - Gastro-esophageal reflux disease,racial,Native Hawaiian or Other Pacific Islander ,16,3,19
436940,Insulin resistance syndrome,racial,Unknown,14,4,18
436445,Abrasion of teeth,racial,Unknown,10,9,19
74080,Orthostatic proteinuria,racial,White,4,14,18
438567,Adult failure to thrive syndrome,racial,Unknown,14,4,18
444129,Wrist injury,racial,Unknown,14,4,18
257581,Exacerbation of asthma,racial,Filipino,5,13,18
441207,Drug reaction,ethnic,Not Hispanic or Latino,12,7,19
443869,Nonvenomous insect bite of wrist without infection,ethnic,Hispanic or Latino,10,9,19
314666,Healed coronary,racial,Asian,1,17,18
440525,Prematurity of fetus,racial,Black or African American ,8,11,19
136368,Non-toxic multinodular goiter,racial,Asian,19,0,19
437902,Teeth development and eruption disorders,ethnic,Not Hispanic or Latino,7,12,19
434056,Late effects of cerebrovascular disease,racial,Filipino,7,11,18
442775,Degeneration of thoracic intervertebral disc,ethnic,Hispanic or Latino,9,10,19
376337,Disease of nervous system,ethnic,Hispanic or Latino,10,9,19
139179,Open wound of lip without complication,racial,White,5,14,19
313209,Left bundle branch hemiblock,racial,White,10,8,18
73045,Hand sprain,racial,Unknown,14,4,18
320074,Lymphocytosis,ethnic,Hispanic or Latino,18,1,19
373487,AION - Acute ischaemic optic neuropathy,ethnic,Hispanic or Latino,5,14,19
380094,Carpal tunnel syndrome,racial,Black or African American ,18,1,19
80568,Traumatic amputation of finger without mention of complication,racial,White,4,15,19
440329,Herpes zoster without complication,racial,Black or African American ,1,17,18
4263370,R.I.N.D. syndrome,racial,Other Race,5,13,18
439251,"Bipolar affective disorder, currently depressed, in full remission",racial,White,16,3,19
380702,Cerebral cysts,racial,White,8,11,19
192667,Atrophic gastritis,racial,Asian,5,14,19
40484513,Hemiplegia of nondominant side as late effect of cerebrovascular disease,racial,Filipino,1,18,19
197917,Disorder of biliary tract,racial,White,12,7,19
254761,Cough,racial,Native Hawaiian or Other Pacific Islander ,11,8,19
439847,Intracranial hemorrhage,ethnic,Hispanic or Latino,12,7,19
372914,Optic atrophy,racial,White,6,13,19
318443,Arteriosclerotic vascular disease,ethnic,Hispanic or Latino,13,5,18
4202322,Amputated big toe,racial,White,4,14,18
434675,Complication of gastrostomy,racial,White,5,13,18
381114,Microcephalus,ethnic,Hispanic or Latino,14,4,18
435516,Lipoprotein deficiency disorder,ethnic,Not Hispanic or Latino,9,10,19
380733,Otalgia,racial,Other Race,13,6,19
437264,Tobacco dependence syndrome,racial,Native Hawaiian or Other Pacific Islander ,7,11,18
4210151,HIV counseling,ethnic,Hispanic or Latino,14,4,18
134569,Erythema infectiosum,racial,White,5,13,18
79106,Arthralgia of the pelvic region and thigh,racial,Native Hawaiian or Other Pacific Islander ,1,18,19
444243,Neurotic disorder,racial,White,8,10,18
320536,Abnormal EKG finding,racial,Black or African American ,8,11,19
200831,Congenital anomaly of penis,ethnic,Hispanic or Latino,0,19,19
194684,Crohn's disease of large bowel,racial,White,17,2,19
194696,Menorrhalgia,racial,Other Race,19,0,19
4165091,Lack of exercise,ethnic,Not Hispanic or Latino,7,12,19
194081,Acute cystitis,racial,Other Race,17,1,18
377560,Internal hordeolum,ethnic,Not Hispanic or Latino,12,6,18
4160859,Methicillin resistant staphylococcus aureus carrier,racial,White,12,6,18
196168,Irregular menstrual bleeding,racial,Asian,18,0,18
435368,Congenital pigeon chest,ethnic,Hispanic or Latino,0,18,18
81378,Chondromalacia of patella,ethnic,Not Hispanic or Latino,13,5,18
440525,Prematurity of fetus,racial,Other Race,10,8,18
137548,Cervical root lesion,racial,Asian,2,16,18
376065,Neurologic disorder associated with type II diabetes mellitus,racial,Native Hawaiian or Other Pacific Islander ,3,15,18
4273391,Suicidal thoughts,ethnic,Hispanic or Latino,14,4,18
374375,Impacted cerumen,racial,Filipino,5,13,18
437058,Sunburn,racial,White,6,12,18
317309,Peripheral arterial occlusive disease,racial,Other Race,13,5,18
443571,Cervicovaginal cytology: High grade squamous intraepithelial lesion or carcinoma,ethnic,Not Hispanic or Latino,14,4,18
436253,Sprain of foot,ethnic,Not Hispanic or Latino,9,9,18
73090,Superficial bruising of foot,racial,Unknown,17,1,18
201322,Internal hemorrhoids without complication,ethnic,Not Hispanic or Latino,13,5,18
192376,Rhesus isoimmunization with antenatal problem,racial,White,18,0,18
435569,Disorder of jaw,ethnic,Hispanic or Latino,7,11,18
440377,Paralysis,racial,White,5,13,18
319034,Hypertensive heart disease without congestive heart failure,racial,White,11,7,18
72737,Microcalcifications of the breast,ethnic,Not Hispanic or Latino,17,1,18
432904,Blood in anterior chamber,ethnic,Hispanic or Latino,16,2,18
78200,Benign mammary dysplasia,racial,White,18,0,18
443563,Arteriosclerosis in coronary artery bypass graft,racial,Unknown,14,4,18
140641,Verruca vulgaris,racial,Black or African American ,3,15,18
198185,Chronic renal failure syndrome,racial,Unknown,5,13,18
135526,Myelopathy,racial,White,8,10,18
77963,Achilles tendinitis,ethnic,Not Hispanic or Latino,16,2,18
434622,Deficiency anemias,racial,Unknown,5,13,18
441085,Elderly primip,ethnic,Not Hispanic or Latino,18,0,18
74464,Idiopathic scoliosis AND/OR kyphoscoliosis,racial,Black or African American ,7,11,18
73301,Synovitis/tenosynovitis - wrist,racial,Unknown,17,1,18
200662,Lymphosarcoma,ethnic,Hispanic or Latino,10,8,18
439926,Malaise and fatigue,racial,American Indian or Alaska Native ,14,4,18
373185,Drug-induced dyskinesia,ethnic,Not Hispanic or Latino,4,14,18
442067,Atopic dermatitis and related conditions,racial,Native Hawaiian or Other Pacific Islander ,1,17,18
433315,Feeding difficulties in newborn,ethnic,Not Hispanic or Latino,8,10,18
316429,Ectopics,racial,Unknown,13,5,18
315361,Orthopnea,ethnic,Hispanic or Latino,11,7,18
321080,"Hypertension complicating pregnancy, childbirth and the puerperium",ethnic,Hispanic or Latino,18,0,18
199913,Acquired deformity of ankle AND/OR foot,ethnic,Not Hispanic or Latino,11,7,18
193688,Clostridium difficile infection,racial,Unknown,12,6,18
4062488,Thyroid disorder screening,ethnic,Not Hispanic or Latino,16,2,18
133853,Osteomyelitis of ankle AND/OR foot,ethnic,Not Hispanic or Latino,0,18,18
80813,Lumbosacral spondylosis without myelopathy,racial,Other Race,4,14,18
80813,Lumbosacral spondylosis without myelopathy,racial,American Indian or Alaska Native ,0,18,18
257778,Pertussis,racial,White,11,7,18
138239,Observation of limb structure,ethnic,Not Hispanic or Latino,8,10,18
312622,BVO - Branch retinal occlusion,ethnic,Hispanic or Latino,14,4,18
372247,Candidal otomycosis,racial,White,16,2,18
441334,Glossodynia,ethnic,Hispanic or Latino,14,4,18
4051564,FH: Metabolic disorder,ethnic,Hispanic or Latino,13,5,18
437127,Closed dislocation of acromioclavicular joint,ethnic,Hispanic or Latino,7,11,18
312935,Venous hypertension,ethnic,Hispanic or Latino,4,14,18
433753,Alcohol abuse,racial,Other Race,1,17,18
81902,Urinary tract infectious disease,racial,Filipino,18,0,18
4077577,Moderate recurrent major depression,racial,Asian,18,0,18
137548,Cervical root lesion,racial,Other Race,14,4,18
77421,Open wound of hand except fingers without complication,racial,Unknown,10,8,18
435798,"Nondependent opioid abuse, episodic",ethnic,Hispanic or Latino,3,15,18
133468,Disease of extremity,ethnic,Hispanic or Latino,4,14,18
4111392,Angina pectoris NOS,racial,Unknown,8,10,18
192731,Digestive symptom,racial,Unknown,7,11,18
434164,Glycosuria,racial,Unknown,14,4,18
197684,Dysuria,racial,Native Hawaiian or Other Pacific Islander ,14,4,18
201070,Cholelithiasis AND cholecystitis without obstruction,racial,White,17,1,18
79768,Neoplasm of urinary system,ethnic,Hispanic or Latino,9,9,18
439004,Restzustand,ethnic,Hispanic or Latino,0,18,18
432898,Severe mental handicap,ethnic,Not Hispanic or Latino,0,18,18
260139,Acute bronchitis,racial,Filipino,9,9,18
440535,Abnormal radiographic examination,racial,White,8,10,18
4276723,Finding of child weight centiles,racial,Black or African American ,9,9,18
381504,Post-herpetic trigeminal neuralgia,ethnic,Hispanic or Latino,16,2,18
434097,Twin pregnancy with antenatal problem,ethnic,Not Hispanic or Latino,17,1,18
435940,"Closed fracture of humerus, shaft",ethnic,Hispanic or Latino,17,1,18
436658,Vitamin deficiency,racial,White,16,2,18
31821,Endocrinopathy,racial,White,10,8,18
27321,Persistent vomiting,racial,White,13,5,18
441968,Acetonuria,ethnic,Hispanic or Latino,8,10,18
198978,Acute gonorrhea of lower genitourinary tract,ethnic,Not Hispanic or Latino,14,4,18
197230,Malignant neoplasm of uterus,racial,White,18,0,18
440693,Continuous opioid dependence,racial,Other Race,1,17,18
254761,Cough,racial,Filipino,12,6,18
439871,Haemospermia,racial,White,0,18,18
197925,Haemorrhage of rectum and anus,racial,Asian,10,8,18
77647,Mallet finger,ethnic,Hispanic or Latino,7,11,18
4194160,Thyroid function tests abnormal,racial,Asian,13,5,18
316084,Lymphadenitis,racial,Unknown,8,10,18
443452,Bleeding of unknown origin,ethnic,Hispanic or Latino,11,7,18
23798,Acute laryngopharyngitis,racial,White,13,5,18
436583,[X]Falls,racial,Black or African American ,10,8,18
373999,Diabetic oculopathy associated with type I diabetes mellitus,racial,Other Race,15,3,18
442790,Growth and development,racial,White,12,6,18
196821,Observation of urethral discharge,racial,White,0,17,17
441547,Oppositional defiant disorder,racial,White,2,16,18
312437,Dyspnea,racial,Black or African American ,16,2,18
201914,Premenopausal menorrhagia,racial,Other Race,17,0,17
374027,Lesion of ulnar nerve,racial,Unknown,0,17,17
200843,Observation of frequency of urination,racial,Other Race,8,10,18
432250,Infective disorder,ethnic,Hispanic or Latino,11,6,17
436787,Panniculitis affecting neck,racial,White,17,0,17
4310682,Multiple open wounds with complication,ethnic,Hispanic or Latino,10,8,18
75756,Malignant neoplasm of posterior wall of urinary bladder,racial,Unknown,0,17,17
442262,Blister of toe without infection,racial,Unknown,8,10,18
374040,Ill-defined disorder of eye,ethnic,Not Hispanic or Latino,7,10,17
432597,Schizoaffective schizophrenia,racial,American Indian or Alaska Native ,17,0,17
258785,Pneumococcal pneumonia,ethnic,Hispanic or Latino,8,9,17
443537,Deep venous thrombosis of lower extremity,racial,Black or African American ,7,10,17
4103894,Hordeolum and other deep inflammation of eyelid NOS,racial,White,12,5,17
194699,Liver disorder in pregnancy,ethnic,Hispanic or Latino,17,0,17
193809,Melena due to gastrointestinal hemorrhage,racial,Black or African American ,11,7,18
4147837,Generalized metabolic disorder,ethnic,Hispanic or Latino,7,10,17
195851,"Gastric ulcer without hemorrhage, without perforation AND without obstruction",ethnic,Not Hispanic or Latino,12,5,17
139188,Open wound of scalp without complication,racial,Unknown,6,11,17
74635,Lumbosacral root lesion,ethnic,Not Hispanic or Latino,11,7,18
201265,Splenic disorder,ethnic,Hispanic or Latino,7,10,17
79898,Cellulitis and abscess of finger,ethnic,Not Hispanic or Latino,9,8,17
314659,Arteritis,ethnic,Hispanic or Latino,14,4,18
4111875,Varicose veins of the leg NOS,racial,White,12,5,17
137497,Dermatophytosis of the body,racial,Other Race,11,7,18
434170,Atypical squamous cells of undetermined significance on cervical Papanicolaou smear,racial,Asian,17,0,17
432301,Opioid dependence in remission,racial,Unknown,8,9,17
376647,Primary malignant neoplasm of soft tissues,racial,Unknown,0,17,17
378253,HA - Headache,racial,American Indian or Alaska Native ,15,2,17
4298854,HIV seropositivity,racial,Asian,0,17,17
4116452,Generalized osteoarthritis NOS,racial,Asian,13,4,17
4112816,Other respiratory system diseases,ethnic,Not Hispanic or Latino,13,5,18
321107,AR - Congenital aortic regurgitation,racial,White,3,14,17
381308,Abscess of eyelid,racial,Unknown,10,7,17
436787,Panniculitis affecting neck,ethnic,Hispanic or Latino,17,0,17
24818,Neck injury,racial,Unknown,10,8,18
26711,Chronic pharyngitis,ethnic,Not Hispanic or Latino,13,5,18
194871,Trichomonal vulvovaginitis,racial,White,17,0,17
193525,Abdominal pregnancy,racial,White,17,0,17
261324,Pneumonia due to Streptococcus,ethnic,Hispanic or Latino,13,5,18
441190,Injury of unknown intent due to fall from height,ethnic,Hispanic or Latino,14,3,17
135745,Exanthema subitum,racial,White,7,10,17
200775,Endometrial hyperplasia,ethnic,Hispanic or Latino,17,0,17
444115,Disorder of bursa,racial,White,8,9,17
199856,Varicose veins of lower extremity with inflammation,ethnic,Not Hispanic or Latino,11,7,18
441391,"Acquired forearm deformity, excluding fingers",ethnic,Hispanic or Latino,5,12,17
195401,Superficial bruising of hip,ethnic,Hispanic or Latino,10,7,17
4331899,Child in family care,racial,White,5,13,18
4110046,Obstructive chronic bronchitis NOS,racial,Unknown,1,17,18
443675,Traumatic amputation of toe(s) without mention of complication,racial,White,7,10,17
439037,Aneurysm of artery of neck,ethnic,Hispanic or Latino,17,1,18
317009,Hyperreactive airway disease,racial,Asian Indian,7,10,17
436373,DSD - Developmental speech disorder,racial,Black or African American ,7,10,17
78832,Intervertebral disc disorder with myelopathy,ethnic,Hispanic or Latino,11,6,17
75128,Injury of chest wall,ethnic,Hispanic or Latino,10,8,18
317895,Hypertension due to renovascular disease,ethnic,Hispanic or Latino,16,2,18
443556,Primary focal hyperhidrosis,ethnic,Hispanic or Latino,14,4,18
4105330,Chronic undifferentiated schizophrenia,ethnic,Not Hispanic or Latino,9,8,17
432461,"Closed fracture clavicle, shaft",ethnic,Hispanic or Latino,8,9,17
199978,Contusion of lower limb,racial,White,10,7,17
137792,Kaposi's varicelliform eruption,ethnic,Hispanic or Latino,10,8,18
438867,Generalized body aches,racial,Other Race,11,6,17
321319,Cardiomyopathy,racial,Black or African American ,6,11,17
381859,Infective OE,racial,Black or African American ,13,5,18
80805,Primary localized osteoarthrosis of forearm,ethnic,Hispanic or Latino,10,7,17
378523,Residual foreign body in soft tissue,ethnic,Hispanic or Latino,7,10,17
437540,CRAO - Central retinal artery occlusion,ethnic,Hispanic or Latino,3,14,17
4066260,Galactorrhea in pregnancy and the puerperium,ethnic,Hispanic or Latino,17,0,17
28779,Oesophageal varices with bleeding,ethnic,Not Hispanic or Latino,17,0,17
136057,Benign neoplasm of skin of trunk,ethnic,Not Hispanic or Latino,11,6,17
434005,Morbid obesity,racial,American Indian,16,2,18
376981,Amblyopia,ethnic,Hispanic or Latino,7,11,18
317309,Peripheral arterial occlusive disease,racial,Asian,4,13,17
433751,Prolonged depressive adjustment reaction,racial,Asian,17,0,17
192239,Post-herpetic polyneuropathy,ethnic,Not Hispanic or Latino,17,0,17
260134,Croup,racial,Unknown,6,11,17
75756,Malignant neoplasm of posterior wall of urinary bladder,ethnic,Hispanic or Latino,0,17,17
4024361,Paralysis of glottis,ethnic,Hispanic or Latino,8,9,17
374366,Sensorineural hearing loss,racial,Other Race,4,13,17
200845,Urinary precipitancy,racial,Asian,11,7,18
380513,Congenital cataract,ethnic,Hispanic or Latino,14,3,17
4104864,Migraine NOS,ethnic,Not Hispanic or Latino,16,1,17
140273,"Contusion, forearm area",racial,White,11,6,17
80189,Displacement of lumbar intervertebral disc without myelopathy,racial,Other Race,16,1,17
374036,Chronic conjunctivitis,racial,Unknown,14,4,18
196347,Intestinal parasitism,ethnic,Hispanic or Latino,10,8,18
4139915,Acute pyelitis,ethnic,Hispanic or Latino,16,1,17
73673,Disorder of prosthetic joint,ethnic,Hispanic or Latino,14,3,17
78149,Congenital hereditary muscular dystrophy,ethnic,Not Hispanic or Latino,8,10,18
440508,Congenital disease,racial,Asian,1,16,17
140168,Psoriasis,ethnic,Hispanic or Latino,4,13,17
4164707,Canceled operative procedure,racial,Unknown,10,8,18
375538,"Degeneration of macula due to cyst, hole or pseudohole",ethnic,Hispanic or Latino,12,5,17
80946,Tinea manus,racial,White,12,5,17
200452,Disease of female genital organ,racial,White,17,0,17
197684,Dysuria,racial,American Indian,14,4,18
132736,Bacteremia,ethnic,Hispanic or Latino,4,13,17
316994,Malignant hypertensive heart disease with congestive cardiac failure,racial,Unknown,7,10,17
4096198,Vitamin B-complex deficiency,ethnic,Hispanic or Latino,10,8,18
434462,VSD - Ventricular septal defect,ethnic,Not Hispanic or Latino,6,11,17
4100365,Schizophrenic disorders,racial,Unknown,17,0,17
434494,Closed fracture of the proximal humerus,racial,Unknown,8,9,17
314059,Right bundle branch block,ethnic,Not Hispanic or Latino,9,8,17
192963,Disease of pancreas,racial,White,10,7,17
441963,Prader-Willi syndrome,ethnic,Hispanic or Latino,0,17,17
441422,Closed fracture of humerus,racial,Unknown,16,1,17
376707,Acute conjunctivitis,racial,Black or African American ,6,11,17
77139,Open wound of finger without complication,ethnic,Not Hispanic or Latino,7,10,17
141056,Acute ethmoidal sinusitis,ethnic,Hispanic or Latino,8,9,17
321042,Cardiac arrest,racial,White,4,13,17
4179332,Parent-child problem,racial,White,7,10,17
79061,Colonic constipation,ethnic,Hispanic or Latino,12,5,17
436073,Psychotic disorder,racial,Asian,1,16,17
433227,Abnormal sensation,racial,White,11,5,16
136198,Cervical spondylosis with myelopathy,racial,Asian,4,13,17
4334644,Decubitus ulcer of lower back,ethnic,Hispanic or Latino,16,1,17
195245,Reflex sympathetic dystrophy,ethnic,Not Hispanic or Latino,7,10,17
440276,"Infection AND/OR inflammatory reaction due to internal prosthetic device, implant AND/OR graft",racial,White,13,4,17
437241,Qualitative platelet defect,ethnic,Hispanic or Latino,8,8,16
374905,Non-organic sleep disorder,racial,White,10,7,17
28403,Acromegaly and gigantism,ethnic,Hispanic or Latino,1,16,17
196738,Male genital organ disease,racial,Asian,0,17,17
79898,Cellulitis and abscess of finger,racial,Unknown,8,8,16
374923,Bell palsy,racial,Black or African American ,13,4,17
443422,Scleroderma,ethnic,Not Hispanic or Latino,14,2,16
197717,Open wound of anterior abdominal wall without complication,ethnic,Hispanic or Latino,7,10,17
441408,Vomiting,racial,Asian,8,8,16
4133029,Primigravida,racial,Asian,17,0,17
75053,Fracture of bone,ethnic,Hispanic or Latino,11,5,16
80809,Rheumatoid arthritis,racial,Filipino,17,0,17
196061,Benign tumour of stomach,ethnic,Hispanic or Latino,14,2,16
80502,Osteoporosis,racial,American Indian or Alaska Native ,17,0,17
77670,Chest pain,racial,American Indian or Alaska Native ,15,2,17
321462,Cardiac complications of care,ethnic,Not Hispanic or Latino,5,11,16
315922,Patent ductus arteriosus,racial,White,6,11,17
375824,Abnormal auditory perception,racial,White,10,7,17
136575,Nonvenomous insect bite with infection,racial,Unknown,8,8,16
377001,Unruptured cerebral aneurysm,racial,Asian,17,0,17
376709,Discharge of eye,racial,White,7,10,17
81377,Climacteric arthritis of the lower leg,racial,Unknown,12,5,17
134460,Plantar fascial fibromatosis,racial,Asian,6,11,17
76565,Shoulder bruise,racial,White,8,9,17
198928,Mechanical complication due to intrauterine contraceptive device,racial,White,16,1,17
28060,Strept throat,racial,Other Race,8,8,16
4059637,Work environment deleterious,ethnic,Hispanic or Latino,9,8,17
435782,Chronic schizophrenic,racial,Black or African American ,11,6,17
4103416,Drug dependence NOS,ethnic,Hispanic or Latino,4,13,17
134735,Chronic osteomyelitis,racial,White,7,10,17
437851,Open angle with borderline intraocular pressure,ethnic,Hispanic or Latino,14,3,17
317002,Hypopiesis,racial,Asian,1,16,17
440927,High risk drug monitoring status,ethnic,Not Hispanic or Latino,16,1,17
133436,Thyrotoxic crisis,racial,Other Race,17,0,17
436972,Glaucoma associated with systemic syndromes,racial,Black or African American ,6,11,17
192278,Type II diabetes mellitus - poor control,racial,American Indian,9,8,17
201612,ALD - Alcoholic liver disease,racial,White,9,8,17
4201388,Gastrostomy present,racial,Other Race,14,3,17
192671,GI - Gastrointestinal haemorrhage,racial,Asian,11,6,17
375823,Optic nerve hypoplasia,racial,White,8,8,16
200843,Observation of frequency of urination,racial,Asian,10,7,17
40490888,Herniation of rectum into vagina,racial,White,17,0,17
77647,Mallet finger,racial,White,7,10,17
4144274,Housing lack,ethnic,Hispanic or Latino,4,13,17
74052,Labyrinthitis,ethnic,Hispanic or Latino,11,6,17
75860,Costiveness,racial,Native Hawaiian or Other Pacific Islander ,7,10,17
26935,Disorder of endocrine testis,racial,Unknown,0,17,17
194133,Low back pain,racial,Native Hawaiian or Other Pacific Islander ,2,14,16
444202,Abscess,racial,American Indian or Alaska Native ,14,3,17
4292726,Contact - infectious disease,racial,Unknown,10,7,17
441284,Open-angle glaucoma,racial,Other Race,14,3,17
432695,Post-term pregnancy,ethnic,Hispanic or Latino,17,0,17
196341,Dermatophytosis of the perianal area,racial,Other Race,2,14,16
201313,Hypertensive renal disease,racial,White,11,6,17
440377,Paralysis,ethnic,Hispanic or Latino,6,11,17
78517,Arthralgia of multiple joints,racial,Black or African American ,11,5,16
376125,Disorder of eyelid,racial,White,7,10,17
141305,Unilateral sensorineural hearing loss with unrestricted hearing on the contralateral side,racial,White,7,10,17
4100912,Screening for rheumatoid conditions,ethnic,Hispanic or Latino,17,0,17
434894,Acute post-hemorrhagic anemia,ethnic,Hispanic or Latino,8,9,17
4084229,Primary gout,racial,Asian,2,15,17
316139,HF - Heart failure,racial,Other Race,15,2,17
442306,Adjustment disorder with depressed mood,ethnic,Not Hispanic or Latino,7,10,17
373488,Pupil-sparing third nerve palsy,ethnic,Hispanic or Latino,10,7,17
201079,Acute parametritis and pelvic cellulitis,ethnic,Hispanic or Latino,17,0,17
433881,Additional general conditions of patient,racial,White,12,5,17
437082,Marie-Strumpell spondylitis,ethnic,Hispanic or Latino,1,16,17
443237,"Manic disorder, single episode",racial,White,13,4,17
439150,Hypersomnia with sleep apnea,ethnic,Hispanic or Latino,7,10,17
4064918,Diabetes mellitus screening,racial,American Indian or Alaska Native ,11,5,16
312338,Benign hypertensive heart disease with congestive heart failure,racial,Asian,0,17,17
432899,Normal pressure hydrocephalus,racial,White,1,16,17
256440,Disorder of paranasal sinuses,racial,Asian,12,5,17
321389,Thoracic disc disorder,racial,White,2,14,16
255573,Chronic obstructive lung disease,racial,Filipino,4,13,17
321389,Thoracic disc disorder,ethnic,Hispanic or Latino,2,14,16
80552,Closed fracture of the scaphoid,racial,White,5,11,16
435798,"Nondependent opioid abuse, episodic",ethnic,Not Hispanic or Latino,7,10,17
134671,Dental abscess without a sinus,racial,Unknown,5,11,16
198683,Viral hepatitis B without hepatic coma,racial,White,13,4,17
432876,Bipolar I disorder,racial,Black or African American ,10,7,17
133848,Non-traumatic slipped upper femoral epiphysis,ethnic,Hispanic or Latino,1,16,17
132553,Herpangina,ethnic,Not Hispanic or Latino,6,11,17
201045,Thrombosed external haemorrhoids,racial,White,8,8,16
437247,Anaemia of chronic disease,racial,Black or African American ,3,14,17
438962,Herpes simplex with complication,ethnic,Hispanic or Latino,10,7,17
435956,Closed fracture of base of neck of femur,ethnic,Hispanic or Latino,7,10,17
136516,Congenital pes planus,racial,Unknown,7,10,17
4092896,Stool contents abnormal,racial,Other Race,9,8,17
200779,Intrauterine polyp,ethnic,Hispanic or Latino,17,0,17
135338,Pemphigus,racial,White,17,0,17
256716,Asthma with status asthmaticus,ethnic,Not Hispanic or Latino,7,10,17
75354,Osteochondropathy,racial,Native Hawaiian or Other Pacific Islander ,13,4,17
30234,Cervical sprain,racial,Other Race,11,5,16
136580,Dehiscence of surgical wound,ethnic,Hispanic or Latino,4,13,17
439221,"Adverse effect, due to correct medicinal substance properly administered",ethnic,Not Hispanic or Latino,12,5,17
441422,Closed fracture of humerus,ethnic,Not Hispanic or Latino,13,4,17
138502,Vitiligo,ethnic,Not Hispanic or Latino,13,4,17
4103638,Amputated - transfemoral,racial,Unknown,1,16,17
372897,Homonymous bilateral visual field defects,racial,Unknown,5,11,16
440088,Academic underachievement disorder,racial,White,7,10,17
133848,Non-traumatic slipped upper femoral epiphysis,racial,White,1,16,17
4299574,Factitious skin disease,racial,Unknown,11,5,16
195259,Entrapment of lateral cutaneous nerve of thigh,racial,Unknown,13,3,16
4062495,Glaucoma screening,racial,Other Race,15,1,16
381860,Vascular abnormality of conjunctiva,ethnic,Hispanic or Latino,16,0,16
376657,Lipoma of face,ethnic,Hispanic or Latino,10,7,17
140168,Psoriasis,racial,White,2,14,16
436278,Superficial bruising of thigh,racial,White,8,8,16
80004,Hand injury,ethnic,Not Hispanic or Latino,7,9,16
313023,Neonatal chronic respiratory disease,racial,Black or African American ,3,13,16
432611,Explosive personality disorder,ethnic,Hispanic or Latino,1,15,16
441192,Accidentally struck by or against objects or persons,ethnic,Hispanic or Latino,5,11,16
139841,Chronic frontal sinusitis,ethnic,Not Hispanic or Latino,12,4,16
436539,Closed fracture of patella,racial,White,11,5,16
132583,Postablative hypothyroidism,ethnic,Hispanic or Latino,16,1,17
315296,Preinfarction syndrome,racial,Unknown,11,5,16
378735,Migraine without aura,racial,Asian,16,0,16
4286333,Carcinoma in situ,ethnic,Hispanic or Latino,11,5,16
77066,Derangement of medial meniscus,ethnic,Not Hispanic or Latino,6,10,16
4146239,Pruritus of genital organs,racial,Unknown,16,1,17
256909,Primary pulmonary coccidioidomycosis,ethnic,Not Hispanic or Latino,7,10,17
438722,Non megaloblastic anemia associated with nutritional deficiency,racial,White,13,4,17
379010,Macular retinal puckering,racial,White,10,6,16
436147,Glossitis,racial,White,10,6,16
73021,Bilateral congenital dislocation of hip,ethnic,Hispanic or Latino,16,0,16
4051564,FH: Metabolic disorder,racial,White,11,5,16
444200,Neoplasm of nervous system,ethnic,Hispanic or Latino,14,2,16
441818,Haemangioma,ethnic,Not Hispanic or Latino,7,9,16
376063,Benign neoplasm of cerebral meninges,racial,Unknown,10,7,17
140803,Idiopathic angio-oedema-urticaria,ethnic,Hispanic or Latino,8,8,16
4086918,Viral screening,racial,Native Hawaiian or Other Pacific Islander ,9,7,16
81671,Unilateral congenital dislocation of hip,ethnic,Hispanic or Latino,11,5,16
140821,Spasm,racial,American Indian or Alaska Native ,10,6,16
374924,Generalized convulsive epilepsy,racial,Asian,5,11,16
141249,Benign tumour of thyroid gland,ethnic,Hispanic or Latino,13,3,16
134398,Periodontal disease,ethnic,Hispanic or Latino,8,8,16
193251,Umbilical hernia without obstruction AND without gangrene,racial,Black or African American ,8,8,16
201254,Insulin dependent diabetes mellitus,racial,Asian,4,13,17
197795,Acute hepatitis B,racial,White,10,6,16
377910,Deviated nasal septum,ethnic,Not Hispanic or Latino,7,10,17
439937,C-reactive protein abnormal,racial,Unknown,9,7,16
200174,Disease of skin AND/OR subcutaneous tissue,racial,Black or African American ,11,5,16
196157,Induratio penis plastica,ethnic,Hispanic or Latino,0,16,16
24075,Esophageal stricture and stenosis,ethnic,Hispanic or Latino,11,5,16
432899,Normal pressure hydrocephalus,ethnic,Hispanic or Latino,0,16,16
437954,Lateral meniscus derangement,racial,White,8,8,16
4141622,Asthma NOS,racial,Unknown,11,5,16
134765,General body deterioration,racial,Black or African American ,3,13,16
379822,Cyst of eyelid,ethnic,Hispanic or Latino,14,2,16
78831,Disease of ankle,racial,Unknown,13,4,17
443869,Nonvenomous insect bite of wrist without infection,racial,White,7,9,16
372328,Otitis media,racial,American Indian or Alaska Native ,8,8,16
135333,Pressure sore,racial,White,8,8,16
78097,Metastatic tumour of bone,racial,Unknown,12,4,16
132703,Lichen planus,ethnic,Hispanic or Latino,13,3,16
4193570,Abnormal results of hearing screening test,racial,White,6,10,16
314968,Varices,racial,White,13,4,17
319835,Congestive cardiac failure,racial,American Indian or Alaska Native ,5,11,16
201340,Gastritis,ethnic,Not Hispanic or Latino,9,7,16
440985,Phobia,racial,White,13,4,17
4161977,Patient with cardiac pacemaker,racial,Other Race,3,13,16
4149382,Endocrine/metabolic screening,racial,Unknown,13,3,16
4296204,First degree burn,ethnic,Hispanic or Latino,14,2,16
314379,First degree atrioventricular block,ethnic,Not Hispanic or Latino,8,8,16
78162,Peripheral vertigo,racial,White,8,8,16
372610,Post-concussion syndrome,ethnic,Hispanic or Latino,7,10,17
4310768,Fall on steps,racial,White,14,2,16
4176874,Infantile melanodontia,racial,White,4,13,17
29735,Candidiasis of mouth,racial,Asian,10,6,16
444375,"Contact dermatitis due to plants, except food",racial,White,10,7,17
136497,Scar conditions and fibrosis of skin,racial,White,11,5,16
432312,Anatomical narrow angle glaucoma,ethnic,Hispanic or Latino,5,11,16
443564,Malignant neoplasm of bone,racial,White,8,8,16
434097,Twin pregnancy with antenatal problem,racial,Unknown,16,0,16
312664,Influenza with respiratory manifestation other than pneumonia,racial,Other Race,7,9,16
194700,"Diabetes mellitus in mother complicating pregnancy, childbirth AND/OR puerperium",racial,Unknown,16,0,16
30753,Esophagitis,ethnic,Not Hispanic or Latino,13,4,17
439014,Panuveitis,ethnic,Hispanic or Latino,15,1,16
197610,Ovarian cyst,racial,Asian,16,0,16
192364,Nephrotic syndrome associated with another disorder,ethnic,Hispanic or Latino,8,8,16
375549,Double pterygium,racial,Unknown,10,7,17
4144274,Housing lack,ethnic,Not Hispanic or Latino,4,12,16
375249,Traction detachment of retina,ethnic,Hispanic or Latino,8,8,16
438332,Disease of possible viral origin,racial,Filipino,8,8,16
4110815,"Sensorineural hearing loss, bilateral",racial,Asian,11,5,16
193807,Anorectal fistula,ethnic,Not Hispanic or Latino,5,11,16
316211,Acquired spondylolisthesis,racial,Unknown,11,5,16
77960,Joint observation,ethnic,Hispanic or Latino,11,5,16
376525,Audiogram abnormal,racial,White,8,8,16
381864,Subjective tinnitus,ethnic,Hispanic or Latino,11,5,16
441830,Disorder of fluid AND/OR electrolyte,racial,Unknown,10,6,16
317576,Coronary arteriosclerosis,racial,Filipino,0,16,16
436373,DSD - Developmental speech disorder,racial,Asian,2,14,16
141056,Acute ethmoidal sinusitis,racial,White,10,7,17
81151,Sprain of ankle joint,racial,Black or African American ,11,5,16
443933,Nicotiana tabacum poisoning,ethnic,Not Hispanic or Latino,12,4,16
197237,Benign tumour of prostate,ethnic,Hispanic or Latino,0,16,16
4048727,Neoplasm screening,ethnic,Not Hispanic or Latino,6,10,16
314665,Atrial flutter,racial,Asian,7,10,17
443111,Tenosynovitis of foot,racial,White,13,4,17
78097,Metastatic tumour of bone,ethnic,Not Hispanic or Latino,16,0,16
436962,Sleeplessness,racial,Filipino,10,7,17
4008566,Atypical schizophrenia,racial,White,7,9,16
440155,Postartificial menopausal syndrome,ethnic,Hispanic or Latino,16,0,16
434073,Loss of teeth - acquired,ethnic,Not Hispanic or Latino,15,1,16
435798,"Nondependent opioid abuse, episodic",racial,White,1,15,16
440424,Aphasia,racial,Asian,0,16,16
437041,Mother not delivered,racial,Black or African American ,16,0,16
80815,Mucous cyst of skin,racial,Unknown,10,6,16
4024567,Respiratory observation,racial,White,8,8,16
437165,Motor vehicle traffic accident,ethnic,Not Hispanic or Latino,7,10,17
193255,"Noninflammatory disorders of the ovary, fallopian tube and broad ligament",racial,White,16,0,16
4101068,Observation of ear discharge,ethnic,Hispanic or Latino,7,9,16
436088,Nondependent opioid abuse in remission,ethnic,Hispanic or Latino,5,11,16
315085,Enlargement of lymph nodes,racial,Asian,12,4,16
141758,Spinal cord injury without spinal bone injury,racial,White,0,16,16
78804,Schimmelbusch's disease,racial,Unknown,16,0,16
192683,Uterovaginal prolapse,racial,White,16,0,16
28060,Strept throat,racial,Asian,10,6,16
74892,Articular gout,ethnic,Not Hispanic or Latino,13,3,16
260427,Common cold,racial,Other Race,7,8,15
198520,Lumbar spondylosis with myelopathy,racial,Unknown,0,16,16
200171,Carbuncle of skin AND/OR subcutaneous tissue,racial,White,10,6,16
4263370,R.I.N.D. syndrome,racial,Black or African American ,14,2,16
73089,Contusion of buttock,racial,White,12,4,16
139900,Urticaria,racial,Other Race,8,8,16
378839,Spina bifida with hydrocephalus,racial,White,4,11,15
439391,Physical abuse of adult,ethnic,Hispanic or Latino,15,1,16
73866,Congenital anomaly of breast,racial,White,14,2,16
316535,Closed fracture of dorsal vertebra without spinal cord injury,racial,White,11,5,16
378160,Otorrhea,ethnic,Hispanic or Latino,5,11,16
4176874,Infantile melanodontia,racial,Unknown,8,8,16
199839,External haemorrhoids without complication,racial,Asian,8,8,16
196813,Simple renal cyst,racial,White,11,4,15
77630,Disease of shoulder,racial,Other Race,11,5,16
442792,Pes anserinus bursitis,racial,White,14,2,16
132835,Pediculosis capitis,racial,Unknown,14,1,15
319049,Acute respiratory failure,racial,White,5,10,15
79936,Polyuria,ethnic,Not Hispanic or Latino,3,13,16
4093311,Latent early syphilis NOS,racial,White,0,16,16
434467,Ostium secundum type atrial septal defect,racial,Black or African American ,16,0,16
78472,Microscopic haematuria,racial,Asian,9,7,16
436140,Vulval varices,ethnic,Hispanic or Latino,16,0,16
256439,Allergic rhinitis due to pollen,racial,Black or African American ,4,11,15
378416,Retinal disorder,racial,Unknown,13,2,15
194684,Crohn's disease of large bowel,ethnic,Not Hispanic or Latino,14,1,15
78257,Osteogenesis imperfecta,racial,White,4,11,15
4093311,Latent early syphilis NOS,ethnic,Hispanic or Latino,0,16,16
376973,Cataract secondary to ocular disease,ethnic,Hispanic or Latino,11,4,15
196347,Intestinal parasitism,racial,White,9,7,16
26378,Hyperpituitarism,ethnic,Not Hispanic or Latino,11,5,16
134718,Hirsutism,ethnic,Not Hispanic or Latino,16,0,16
4168226,Micturition frequency and polyuria,ethnic,Hispanic or Latino,13,3,16
316432,Right bundle branch block AND left anterior fascicular block,racial,Unknown,5,11,16
134438,CD - Contact dermatitis,racial,Filipino,10,6,16
194997,Prostatitis,ethnic,Not Hispanic or Latino,0,16,16
197911,Hernia of anterior abdominal wall without obstruction AND without gangrene,racial,Black or African American ,0,16,16
437382,Urine observation,racial,Black or African American ,11,5,16
193518,Intestinal obstruction,racial,White,9,7,16
81390,Idiopathic osteoporosis,racial,Native Hawaiian or Other Pacific Islander ,16,0,16
4310682,Multiple open wounds with complication,racial,White,7,9,16
76482,MA - Missed abortion,ethnic,Not Hispanic or Latino,14,1,15
440508,Congenital disease,racial,Unknown,1,14,15
74458,Enthesopathy of knee region,ethnic,Not Hispanic or Latino,13,3,16
78835,Palindromic rheumatism of the lower leg,racial,Other Race,13,2,15
80497,Disorder of cervical spine,ethnic,Not Hispanic or Latino,10,6,16
80767,Breast irregular nodularity,racial,Black or African American ,14,1,15
4016675,"Sprain, ankle joint, medial",ethnic,Hispanic or Latino,8,7,15
134304,Benign tumour of parathyroid gland,ethnic,Hispanic or Latino,14,2,16
432881,Pancytopenia,ethnic,Not Hispanic or Latino,2,14,16
200164,Urine-induced contact dermatitis,racial,Other Race,7,9,16
437104,"Abnormal smear, noted, recall delete",racial,White,16,0,16
437891,PPHT - Primary pulmonary hypertension,racial,White,16,0,16
261325,Pulmonary emphysema,racial,Asian,1,14,15
253482,Cortical blindness,ethnic,Hispanic or Latino,4,11,15
318775,Venous embolism,racial,Other Race,13,3,16
75010,Fibroadenosis of breast,racial,White,16,0,16
441201,"[X]Fall from, out of or through building or structure",ethnic,Hispanic or Latino,8,7,15
442425,Lumbar post-laminectomy syndrome,ethnic,Not Hispanic or Latino,8,7,15
4060318,Chest pain NOS,ethnic,Hispanic or Latino,8,8,16
75091,Closed fracture of carpal bone,ethnic,Not Hispanic or Latino,7,8,15
25572,Disease of salivary gland,ethnic,Hispanic or Latino,4,11,15
73291,Palindromic rheumatism of the ankle and/or foot,racial,Other Race,5,11,16
198964,Chronic type C viral hepatitis,racial,American Indian,16,0,16
433032,Pyrexia postprocedure,ethnic,Hispanic or Latino,14,1,15
437942,Caesarean delivery - delivered,racial,White,16,0,16
4173811,Congenital quadriplegia,ethnic,Not Hispanic or Latino,5,10,15
436067,Schizophrenia simplex,racial,Black or African American ,5,11,16
441836,Depressed bipolar I disorder,racial,Unknown,14,1,15
78237,Bicipital tenosynovitis,ethnic,Not Hispanic or Latino,12,4,16
137548,Cervical root lesion,racial,Unknown,10,6,16
4058247,Anaemia during pregnancy/childbirth/puerperium NOS,ethnic,Hispanic or Latino,16,0,16
444243,Neurotic disorder,ethnic,Not Hispanic or Latino,6,10,16
441333,Geographic tongue,ethnic,Hispanic or Latino,6,10,16
136775,Contact dermatitis due to solar radiation,racial,White,11,5,16
196813,Simple renal cyst,ethnic,Hispanic or Latino,11,4,15
312437,Dyspnea,racial,Asian,13,2,15
138479,Thyroid dysfunction during pregnancy - baby not yet delivered,ethnic,Not Hispanic or Latino,15,1,16
4161977,Patient with cardiac pacemaker,racial,Native Hawaiian or Other Pacific Islander ,12,4,16
201618,Disease of intestine,ethnic,Hispanic or Latino,10,5,15
4108079,Perceptive hearing loss NOS,ethnic,Hispanic or Latino,9,7,16
4044391,Diabetic neuropathy,racial,White,16,0,16
432933,Aneurysm of artery of lower extremity,racial,White,1,15,16
377853,Chronic tension-type headache,racial,White,13,3,16
433736,Obesity,racial,Asian Indian,10,5,15
435914,Metatarsus varus,ethnic,Hispanic or Latino,6,10,16
72245,Chlamydial infection of lower genitourinary tract,ethnic,Hispanic or Latino,14,1,15
257583,Allergic bronchopulmonary aspergillosis,ethnic,Hispanic or Latino,16,0,16
376105,Krampfe salaam attacks,racial,White,10,5,15
197981,Abdominal tenderness,racial,White,11,4,15
4188027,Food allergy,racial,Unknown,10,5,15
4158567,Post percutaneous transluminal coronary angioplasty,racial,Black or African American ,10,5,15
72418,Scoliosis deformity of spine,racial,Unknown,4,11,15
436176,Spontaneous abortion without complication,ethnic,Not Hispanic or Latino,16,0,16
4053599,Open wound of forearm,racial,White,8,7,15
194018,"Functional enuresis, NOS",racial,Unknown,11,4,15
78786,Pleurisy,racial,White,10,5,15
439770,Ketoacidosis in type I diabetes mellitus,racial,White,8,8,16
372887,Disease of brain,racial,White,4,12,16
200768,Inflammatory disease of vagina and/or vulva,ethnic,Hispanic or Latino,16,0,16
434750,Feeding difficulties and mismanagement,racial,Other Race,7,8,15
376120,"Keratoconjunctivitis sicca, not specified as Sjogren's",racial,Unknown,15,1,16
442067,Atopic dermatitis and related conditions,racial,American Indian or Alaska Native ,12,4,16
255919,Finding of head and neck region,ethnic,Not Hispanic or Latino,8,7,15
200528,Ascites,ethnic,Not Hispanic or Latino,9,7,16
4053045,Dog bite,ethnic,Not Hispanic or Latino,10,6,16
443909,"Decreased level, laboratory test",racial,White,7,8,15
440129,Hypertrophy of nasal turbinates,ethnic,Not Hispanic or Latino,8,7,15
81723,Contusion of hand,ethnic,Not Hispanic or Latino,8,7,15
437843,Childhood conduct disorder,ethnic,Hispanic or Latino,4,11,15
434219,Anaphylactic shock due to adverse food reaction,racial,White,2,13,15
255348,Polymyalgia rheumatica,racial,Unknown,16,0,16
194093,Postcoital bleeding,racial,Unknown,16,0,16
435656,Neonatal jaundice,racial,Unknown,4,12,16
376111,Unqualified visual loss of one eye,racial,White,11,4,15
201603,Disease of teeth AND/OR supporting structures,racial,Black or African American ,8,7,15
193519,Impaired renal function disorder,ethnic,Hispanic or Latino,9,6,15
81984,Sprain of shoulder and upper arm,racial,Other Race,13,2,15
374347,Blepharoconjunctivitis,ethnic,Hispanic or Latino,8,7,15
377286,VFD - Visual field defect,racial,White,6,9,15
440392,Retinal vascular occlusion,ethnic,Hispanic or Latino,11,4,15
139899,Pemphigoid,ethnic,Hispanic or Latino,7,8,15
440689,Agranulocytosis,racial,White,13,2,15
438329,Late effect of motor vehicle accident,ethnic,Hispanic or Latino,14,1,15
201111,Congenital renal dysplasia,ethnic,Hispanic or Latino,13,2,15
73026,Abnormal respiratory sounds,ethnic,Hispanic or Latino,10,5,15
376063,Benign neoplasm of cerebral meninges,racial,White,10,5,15
198100,Carcinoid tumor of small intestine,ethnic,Hispanic or Latino,14,1,15
141216,MC - Molluscum contagiosum,racial,Black or African American ,3,12,15
439700,Inhibited sexual desire,racial,Asian,0,15,15
132703,Lichen planus,racial,White,13,2,15
135033,Hair and hair follicle diseases,racial,Black or African American ,6,9,15
141758,Spinal cord injury without spinal bone injury,ethnic,Not Hispanic or Latino,0,15,15
4108533,Unspecified otalgia,racial,Unknown,12,3,15
312648,Benign essential hypertension,racial,Alaska Native,0,15,15
4310768,Fall on steps,racial,Unknown,10,5,15
312349,Venous varices,racial,Other Race,13,2,15
132412,Failed back syndrome,ethnic,Hispanic or Latino,2,13,15
381028,Acute suppurative otitis media - tympanic membrane ruptured,racial,Unknown,7,8,15
192592,Pseudoprimary aldosteronism,racial,White,0,15,15
440694,"Nondependent mixed drug abuse, episodic",ethnic,Not Hispanic or Latino,5,10,15
441190,Injury of unknown intent due to fall from height,racial,Unknown,12,3,15
318459,Respiratory insufficiency,racial,White,1,14,15
438005,Closed fracture shaft of fibula,racial,White,9,6,15
138379,"Chronic lymphoid leukemia, disease",racial,White,8,7,15
439155,Carcinoembryonic antigen present,ethnic,Not Hispanic or Latino,6,9,15
78518,Observation of shoulder joint,ethnic,Hispanic or Latino,13,2,15
442308,Abrasion AND/OR friction burn of thigh without infection,racial,Unknown,7,8,15
255891,Lupus erythematosus,racial,Black or African American ,15,0,15
318556,Nosebleed,racial,Asian,5,10,15
4064377,Depression screening,racial,Asian Indian,7,8,15
132489,Partial thickness burn of finger,ethnic,Hispanic or Latino,10,5,15
321318,Angina,racial,Filipino,0,15,15
436446,Cracked tooth syndrome,racial,White,7,8,15
253321,Stridor,racial,White,7,8,15
436816,Vaginal vault smear abnormal,ethnic,Hispanic or Latino,15,0,15
432571,Malignant lymphoma,ethnic,Not Hispanic or Latino,1,14,15
77068,Secondary localised osteoarthrosis of lower leg,ethnic,Hispanic or Latino,10,5,15
441968,Acetonuria,racial,White,7,8,15
316535,Closed fracture of dorsal vertebra without spinal cord injury,racial,Unknown,14,1,15
433990,Subchronic catatonic schizophrenia,ethnic,Hispanic or Latino,0,15,15
313219,Phlebitis and thrombophlebitis,racial,White,10,5,15
199192,Abrasion AND/OR friction burn of trunk without infection,ethnic,Hispanic or Latino,7,8,15
440012,Fall from chair or bed,racial,White,10,5,15
312336,Arterial aneurysm,ethnic,Hispanic or Latino,11,4,15
442588,OSA - Obstructive sleep apnoea,racial,Asian,10,5,15
4002644,Rotator cuff shoulder syndrome and allied disorders,racial,Unknown,8,7,15
141693,Elevated blood-pressure reading without diagnosis of hypertension,racial,American Indian or Alaska Native ,12,3,15
79897,Obstetric non-purulent mastitis - delivered with postnatal complication,racial,White,15,0,15
4104853,Epileptic seizures - clonic,racial,Unknown,13,2,15
440386,Transsexualism,ethnic,Hispanic or Latino,0,15,15
192592,Pseudoprimary aldosteronism,ethnic,Hispanic or Latino,0,15,15
4112525,Acute bronchiolitis NOS,ethnic,Not Hispanic or Latino,5,10,15
439183,Concussion,racial,Unknown,5,10,15
372912,Visual discomfort,ethnic,Hispanic or Latino,10,5,15
135858,Disorder of lip,ethnic,Not Hispanic or Latino,9,6,15
438557,Abnormal glucose level,racial,Filipino,8,7,15
200768,Inflammatory disease of vagina and/or vulva,racial,White,15,0,15
377575,Tinnitus,racial,Other Race,10,5,15
381575,Disorder of external ear,ethnic,Hispanic or Latino,11,4,15
433811,Hydronephrosis,racial,Asian,6,9,15
320835,TOF - Tetralogy of Fallot,ethnic,Not Hispanic or Latino,3,12,15
315276,Vitreous hemorrhage,racial,Unknown,13,2,15
436096,Chronic pain,racial,American Indian or Alaska Native ,1,14,15
81931,Psoriasis with arthropathy,ethnic,Not Hispanic or Latino,5,10,15
4066260,Galactorrhea in pregnancy and the puerperium,racial,White,15,0,15
135699,Burn any degree involving 10-19 percent of body surface,racial,White,7,8,15
137658,Congenital pigmentary anomaly of skin,ethnic,Hispanic or Latino,5,10,15
437246,Vitamin B deficiency,ethnic,Not Hispanic or Latino,10,5,15
4150157,Other anemias,ethnic,Hispanic or Latino,10,5,15
436077,Developmental delay,racial,Other Race,12,3,15
435236,Acute exacerbation of chronic schizoaffective schizophrenia,ethnic,Not Hispanic or Latino,14,1,15
441207,Drug reaction,racial,Unknown,14,1,15
75103,Sprain of jaw,ethnic,Hispanic or Latino,8,7,15
434165,Abnormal cervical smear,racial,Asian,15,0,15
4028641,Pregnancy and drug dependence,ethnic,Not Hispanic or Latino,15,0,15
77638,Displacement of intervertebral disc without myelopathy,ethnic,Not Hispanic or Latino,14,1,15
377910,Deviated nasal septum,racial,Unknown,1,14,15
74135,Disorder of synovium,racial,White,5,10,15
432933,Aneurysm of artery of lower extremity,ethnic,Not Hispanic or Latino,0,15,15
441678,"Gestation period, 33 weeks",racial,White,6,9,15
23325,Heartburn,racial,Other Race,10,5,15
432725,Congenital anomaly of integument,ethnic,Hispanic or Latino,6,9,15
254058,Acute bronchiolitis due to respiratory syncytial virus,ethnic,Not Hispanic or Latino,2,13,15
443723,Finding of cellular component of blood,racial,White,9,6,15
434821,SIRS - System inflammatory response syndrome,racial,Unknown,10,5,15
315558,Atherosclerosis of arteries of the extremities,ethnic,Not Hispanic or Latino,8,7,15
443360,Eye mass,ethnic,Hispanic or Latino,8,7,15
200764,Bile duct calculus without mention of cholecystitis and no obstruction,ethnic,Hispanic or Latino,5,10,15
442139,Primary bronchial cancer,racial,Unknown,2,13,15
432898,Severe mental handicap,ethnic,Hispanic or Latino,1,14,15
321887,Disorder of artery,racial,Other Race,15,0,15
376686,Polyneuropathy associated with another disorder,ethnic,Not Hispanic or Latino,7,8,15
436075,Adjustment disorder with anxious mood,ethnic,Not Hispanic or Latino,6,9,15
4100529,Misuse of drugs NOS,ethnic,Hispanic or Latino,11,4,15
313792,PT - Paroxysmal tachycardia,racial,Unknown,10,5,15
443570,Cervicovaginal cytology: Low grade squamous intraepithelial lesion,racial,Asian,15,0,15
192675,Biliary cirrhosis,racial,Unknown,11,4,15
374013,Secondary Parkinson's disease,ethnic,Not Hispanic or Latino,0,15,15
440990,Chorea,ethnic,Hispanic or Latino,3,12,15
444371,Abrasion AND/OR friction burn of finger without infection,ethnic,Hispanic or Latino,7,8,15
437579,Paroxysmal ventricular tachycardia,racial,Other Race,15,0,15
378741,Brachial plexus lesion,ethnic,Hispanic or Latino,10,5,15
135930,Musculoskeletal system observation,ethnic,Hispanic or Latino,11,4,15
4299574,Factitious skin disease,racial,White,14,1,15
76506,Effusion of joint of lower leg,racial,Unknown,8,7,15
135030,Discoloration of skin,ethnic,Not Hispanic or Latino,11,4,15
435372,Underweight,racial,Black or African American ,1,14,15
440940,Methicillin resistant Staphylococcus aureus infection,racial,White,10,5,15
436972,Glaucoma associated with systemic syndromes,racial,Asian,4,11,15
432526,Needs influenza immunisation,racial,American Indian,8,7,15
139036,Systolic dysfunction,ethnic,Hispanic or Latino,4,11,15
4024000,Urinary system finding,ethnic,Hispanic or Latino,6,9,15
252365,MGN - Membranous glomerulonephritis,racial,Black or African American ,1,14,15
439654,Partial epilepsy with impairment of consciousness,ethnic,Not Hispanic or Latino,13,2,15
434752,Positive serological AND/OR viral culture findings for human immunodeficiency virus,racial,Unknown,0,15,15
433911,Contusion of eye AND ocular adnexa,ethnic,Hispanic or Latino,4,11,15
193256,Alcoholic fatty liver,racial,Unknown,1,14,15
437530,Disorders of lipoid metabolism,racial,White,11,4,15
198100,Carcinoid tumor of small intestine,racial,White,14,1,15
4025009,Inguinal hernia NOS,racial,White,1,14,15
435515,Hypo-osmolality and or hyponatremia,racial,Asian,5,10,15
25297,Acute pharyngitis,racial,Filipino,8,7,15
28714,Syndrome of diencephalo-hypophyseal origin,ethnic,Hispanic or Latino,14,1,15
28385,Disorder of posterior pituitary,ethnic,Not Hispanic or Latino,15,0,15
380096,Proliferative diabetic retinopathy,racial,Asian,2,13,15
321689,Apneic,ethnic,Not Hispanic or Latino,5,10,15
444429,Herpes simplex infection,ethnic,Hispanic or Latino,10,5,15
376946,Senile delirium,ethnic,Hispanic or Latino,12,3,15
374375,Impacted cerumen,racial,Native Hawaiian or Other Pacific Islander ,11,4,15
80186,Recurrent dislocation of shoulder region,ethnic,Hispanic or Latino,4,11,15
439224,Drug allergy,ethnic,Not Hispanic or Latino,7,8,15
74892,Articular gout,racial,White,0,15,15
441980,Closed fracture of foot,ethnic,Not Hispanic or Latino,11,4,15
4025009,Inguinal hernia NOS,ethnic,Hispanic or Latino,1,14,15
433030,False-positive serological test for syphilis,ethnic,Hispanic or Latino,12,3,15
4263325,Actinic cheilitis,racial,Unknown,10,5,15
4130036,Brain damage due to hypoxia,racial,White,4,11,15
441604,Acute appendicitis without peritonitis,ethnic,Hispanic or Latino,8,7,15
444098,"Gestation period, 40 weeks",racial,White,5,9,14
443570,Cervicovaginal cytology: Low grade squamous intraepithelial lesion,racial,Black or African American ,14,0,14
138113,Cyst of thyroid,ethnic,Not Hispanic or Latino,14,0,14
80187,Medial epicondylitis,racial,Unknown,11,3,14
435796,Dehydration,racial,Asian,2,12,14
436263,Broken tooth without complication,racial,White,10,5,15
195083,Left lower quadrant pain,racial,Asian,13,2,15
378161,Disorder of ear,racial,Unknown,13,2,15
4001998,Pulmonary apoplexy,racial,White,2,13,15
4288676,Acute and chronic cholecystitis,racial,White,11,4,15
436673,Chronic residual schizophrenia,ethnic,Hispanic or Latino,10,4,14
376422,Mucopurulent conjunctivitis,ethnic,Not Hispanic or Latino,7,7,14
253954,PTB - Pulmonary tuberculosis,racial,Unknown,13,2,15
197484,Diarrhea of presumed infectious origin,racial,Unknown,13,2,15
140273,"Contusion, forearm area",racial,Unknown,8,7,15
200174,Disease of skin AND/OR subcutaneous tissue,racial,American Indian or Alaska Native ,14,0,14
77352,Pyogenic arthritis of the lower leg,ethnic,Hispanic or Latino,10,5,15
379782,Gilles de la Tourette's syndrome,ethnic,Hispanic or Latino,8,6,14
439795,Minimal cognitive impairment,racial,Other Race,5,9,14
197911,Hernia of anterior abdominal wall without obstruction AND without gangrene,racial,Other Race,7,7,14
440921,Traumatic injury,racial,Unknown,10,4,14
132932,Chronic ethmoidal sinusitis,ethnic,Hispanic or Latino,13,2,15
80509,Bone cyst,racial,White,6,8,14
381857,Impairment level: one eye: total impairment: other eye: not specified,ethnic,Not Hispanic or Latino,10,4,14
196443,Gastric ulcer without hemorrhage AND without perforation but with obstruction,ethnic,Hispanic or Latino,13,2,15
377298,Chronic otitis externa,ethnic,Hispanic or Latino,11,4,15
141411,Scalp injury,ethnic,Hispanic or Latino,6,8,14
29056,Sialoadenitis,racial,Unknown,8,7,15
138113,Cyst of thyroid,racial,Unknown,14,1,15
196359,Primary malignant neoplasm of uterine cervix,ethnic,Not Hispanic or Latino,14,0,14
433316,Giddiness,racial,American Indian or Alaska Native ,13,1,14
435236,Acute exacerbation of chronic schizoaffective schizophrenia,racial,Black or African American ,13,1,14
432612,Mild mental handicap,ethnic,Not Hispanic or Latino,3,11,14
77072,Joint effusion of ankle AND/OR foot,racial,White,9,5,14
4273391,Suicidal thoughts,ethnic,Not Hispanic or Latino,8,7,15
432453,General clinical state finding,ethnic,Not Hispanic or Latino,10,5,15
81251,Neoplasm of breast,racial,Asian,14,0,14
374036,Chronic conjunctivitis,racial,White,4,10,14
436954,Drug abuse,racial,Unknown,9,5,14
437104,"Abnormal smear, noted, recall delete",ethnic,Hispanic or Latino,14,0,14
441481,Adult victim of abuse,ethnic,Hispanic or Latino,10,4,14
75512,Carcinoma in situ of colon,ethnic,Hispanic or Latino,10,4,14
439080,Dyspareunia,ethnic,Not Hispanic or Latino,14,0,14
435220,Severe recurrent major depression without psychotic features,racial,Black or African American ,14,0,14
26662,Testicular hypofunction,racial,Other Race,0,14,14
375246,Mononeuritis of upper limb,racial,White,3,11,14
434094,Spontaneous abortion with complication,ethnic,Hispanic or Latino,14,0,14
4194160,Thyroid function tests abnormal,racial,Other Race,0,14,14
197921,Renal osteodystrophy,ethnic,Hispanic or Latino,13,1,14
374044,Droopy eyelid,ethnic,Not Hispanic or Latino,4,10,14
261687,Hemoptysis,racial,Unknown,12,2,14
73090,Superficial bruising of foot,ethnic,Not Hispanic or Latino,13,1,14
441655,Disorder of sweat gland,ethnic,Hispanic or Latino,11,4,15
74472,Congenital deformity of foot,racial,White,4,11,15
200831,Congenital anomaly of penis,racial,White,0,14,14
374954,Optic neuritis,ethnic,Hispanic or Latino,7,8,15
435666,Closed fracture of upper end of tibia,racial,White,6,8,14
442558,"Gestation period, 32 weeks",racial,White,11,4,15
4059157,Family circumstance NOS,ethnic,Not Hispanic or Latino,10,5,15
439304,Retinal round hole without detachment,ethnic,Hispanic or Latino,11,4,15
4293175,"Mental state, behaviour and/or psychosocial function finding",racial,Other Race,2,12,14
4109880,Varicose veins of the leg with ulcer,ethnic,Not Hispanic or Latino,10,5,15
260123,Acute inflammation of sinus,racial,Filipino,7,8,15
73338,Sprain of lateral collateral ligament of knee,ethnic,Hispanic or Latino,7,7,14
442558,"Gestation period, 32 weeks",ethnic,Hispanic or Latino,11,4,15
81251,Neoplasm of breast,ethnic,Not Hispanic or Latino,14,0,14
198715,Premature menopause,racial,White,14,0,14
195007,Female stress incontinence,racial,Other Race,14,0,14
76685,MG - Myasthenia gravis,ethnic,Hispanic or Latino,10,4,14
4060318,Chest pain NOS,racial,White,8,7,15
80141,Functional diarrhea,racial,White,7,7,14
374882,Benign connective tissue neoplasm,racial,White,11,4,15
433909,Foreign body on external eye,ethnic,Hispanic or Latino,1,13,14
4115370,Arthralgia NOS,ethnic,Hispanic or Latino,13,1,14
432878,Drug abuse using speed,ethnic,Not Hispanic or Latino,9,5,14
4110787,Other otitis externa,racial,White,10,5,15
373499,Disorder of eye region,ethnic,Not Hispanic or Latino,11,4,15
198197,Male infertility,racial,White,0,14,14
4245252,Raised prostate specific antigen,racial,Black or African American ,0,14,14
435088,Senility,ethnic,Hispanic or Latino,8,6,14
40484028,Dental caries extending into dentine,racial,White,9,5,14
261687,Hemoptysis,ethnic,Not Hispanic or Latino,8,7,15
439120,Aseptic necrosis of head AND/OR neck of femur,racial,Black or African American ,3,11,14
139750,Primary malignant neoplasm of skin,racial,Unknown,11,4,15
435394,Intracranial hemorrhage following injury,racial,Unknown,0,14,14
141499,Septicemia,ethnic,Hispanic or Latino,8,6,14
440012,Fall from chair or bed,racial,Unknown,10,4,14
443211,Benign prostatic hypertrophy with outflow obstruction,ethnic,Hispanic or Latino,0,14,14
137351,Epidermoid cyst of skin,racial,Asian,8,6,14
4141481,"Hand, foot and mouth disease",ethnic,Not Hispanic or Latino,4,10,14
435244,Developmental disorder,racial,White,5,9,14
138825,Actinic keratosis,racial,Asian,4,11,15
440389,MR - Mental retardation,racial,Black or African American ,4,10,14
197795,Acute hepatitis B,racial,Unknown,4,10,14
4024013,Sensory nervous system finding,racial,White,10,5,15
439706,Psychosis with origin in childhood,ethnic,Not Hispanic or Latino,1,13,14
40481920,Periumbilical pain,ethnic,Not Hispanic or Latino,7,8,15
381839,Habit disorder,racial,White,8,7,15
199876,Prolapse of female genital organs,racial,Unknown,14,0,14
435394,Intracranial hemorrhage following injury,ethnic,Hispanic or Latino,0,14,14
31317,Can't get food down,racial,Other Race,6,8,14
379805,Myopia,racial,Other Race,11,4,15
432695,Post-term pregnancy,racial,White,14,1,15
4345578,Rhabdomyolysis,ethnic,Hispanic or Latino,7,7,14
443431,Disorder of menstruation,racial,Black or African American ,14,0,14
193787,Varicose veins of lower extremity with ulcer AND inflammation,racial,Unknown,2,12,14
135858,Disorder of lip,racial,Unknown,7,7,14
4008566,Atypical schizophrenia,ethnic,Hispanic or Latino,7,7,14
77354,Primary localised osteoarthrosis of lower leg,racial,Black or African American ,10,4,14
261782,Herpetic ulceration of vulva,racial,White,14,0,14
201914,Premenopausal menorrhagia,racial,Black or African American ,14,0,14
79106,Arthralgia of the pelvic region and thigh,racial,American Indian or Alaska Native ,13,1,14
135215,Hashimoto thyroiditis,racial,White,14,0,14
30515,Oesophagostenosis,ethnic,Hispanic or Latino,6,8,14
432310,Meningitis due to cryptococcus,ethnic,Hispanic or Latino,0,14,14
372888,Sciatic nerve lesion,racial,White,13,2,15
4100529,Misuse of drugs NOS,racial,Unknown,6,8,14
4110046,Obstructive chronic bronchitis NOS,ethnic,Not Hispanic or Latino,0,14,14
78831,Disease of ankle,ethnic,Not Hispanic or Latino,10,5,15
373185,Drug-induced dyskinesia,racial,Asian,0,14,14
376415,Hypermetropia,racial,White,6,8,14
4025514,Unspecified peptic ulcer,racial,White,4,11,15
27674,N&V - Nausea and vomiting,racial,Other Race,10,5,15
197318,Cholesterolosis of gallbladder,racial,Unknown,8,6,14
193874,Bed wetting,racial,Black or African American ,5,10,15
441918,"Emotional AND/OR mental disease in mother complicating pregnancy, childbirth AND/OR puerperium",ethnic,Not Hispanic or Latino,14,0,14
198809,Acute cholecystitis,racial,White,9,5,14
437092,Physiological development failure,racial,Asian,3,11,14
77642,Arthralgia of the forearm,racial,Black or African American ,11,4,15
380038,Viral conjunctivitis,racial,Unknown,8,7,15
4171556,Ankle ulcer,ethnic,Not Hispanic or Latino,1,14,15
438699,Primary malignant neoplasm of rectosigmoid junction,racial,Asian,0,14,14
436298,Adverse reaction to food,racial,Unknown,2,12,14
316994,Malignant hypertensive heart disease with congestive cardiac failure,racial,White,9,5,14
440081,Barbiturate dependence,racial,White,3,11,14
4008089,Dysentery,racial,White,7,8,15
74582,Primary malignant neoplasm of rectum,racial,Asian,1,14,15
435836,Disorder of nasopharynx,ethnic,Hispanic or Latino,5,9,14
74468,Congenital anomaly of rib,ethnic,Hispanic or Latino,7,7,14
197236,Uterine fibroid,racial,American Indian or Alaska Native ,14,0,14
4147639,Cellulitis and abscess of toe NOS,racial,White,5,8,13
194574,Chronic type B viral hepatitis,racial,Black or African American ,0,14,14
374655,Mastoiditis,ethnic,Hispanic or Latino,10,4,14
381036,Multiple AND bilateral precerebral artery stenosis,racial,White,13,1,14
439246,"Mixed bipolar affective disorder, severe, with psychosis",ethnic,Hispanic or Latino,14,0,14
381278,Cluster headache,racial,White,9,5,14
432301,Opioid dependence in remission,ethnic,Hispanic or Latino,2,11,13
436730,"Appendicitis, unqualified",racial,Unknown,4,10,14
435534,"Nondependent alcohol abuse, continuous",racial,Black or African American ,0,14,14
193666,Hip injury,ethnic,Not Hispanic or Latino,8,6,14
376713,Cerebral hemorrhage,racial,Unknown,8,6,14
4152813,Family disruption,ethnic,Not Hispanic or Latino,5,9,14
373185,Drug-induced dyskinesia,ethnic,Hispanic or Latino,10,4,14
320420,Vitreous degeneration,racial,White,12,2,14
437832,Malnutrition of mild degree (Gomez: 75% to less than 90% of standard weight),racial,White,12,2,14
375525,Athetoid cerebral palsy,ethnic,Hispanic or Latino,11,2,13
376229,Abnormal involuntary movement,racial,Asian,5,9,14
193256,Alcoholic fatty liver,racial,White,1,13,14
432311,Angle-closure glaucoma - borderline,racial,Unknown,11,3,14
373769,Nuclear cataract,ethnic,Hispanic or Latino,5,9,14
444445,Benign neoplasm of skin of leg,racial,White,11,3,14
376208,Soft tissue disorder,racial,Black or African American ,0,14,14
379769,Benign brain tumour,racial,Unknown,13,1,14
435912,Endocardial cushion defect,ethnic,Hispanic or Latino,10,4,14
193666,Hip injury,racial,Unknown,12,2,14
40483107,Inflamed seborrheic keratosis,racial,Unknown,11,3,14
373487,AION - Acute ischaemic optic neuropathy,racial,Unknown,0,14,14
4331899,Child in family care,ethnic,Hispanic or Latino,4,10,14
141232,MM - Malignant melanoma of skin,ethnic,Not Hispanic or Latino,10,4,14
434613,Generalized anxiety disorder,racial,Black or African American ,3,11,14
74451,Palindromic rheumatism of the forearm,ethnic,Not Hispanic or Latino,5,8,13
433071,Contusion of multiple sites,racial,White,10,4,14
378414,Separation of retinal layers,ethnic,Not Hispanic or Latino,10,4,14
4154623,Fit denture,racial,Unknown,11,2,13
433985,Hypercarotinemia,ethnic,Not Hispanic or Latino,2,12,14
138996,Carcinoma in situ of skin,racial,White,4,10,14
314658,Cardiomegaly,racial,Native Hawaiian or Other Pacific Islander ,13,1,14
4299535,Pregnancy confirmed,racial,Black or African American ,14,0,14
140648,Onychomycosis due to dermatophyte,racial,American Indian or Alaska Native ,8,5,13
200779,Intrauterine polyp,racial,White,14,0,14
379769,Benign brain tumour,racial,White,11,3,14
443570,Cervicovaginal cytology: Low grade squamous intraepithelial lesion,racial,Other Race,14,0,14
78517,Arthralgia of multiple joints,racial,American Indian or Alaska Native ,12,2,14
201627,Abnormal vaginal bleeding,racial,Other Race,14,0,14
381308,Abscess of eyelid,ethnic,Not Hispanic or Latino,6,8,14
4222138,Allergic contact dermatitis of eyelid,ethnic,Hispanic or Latino,12,2,14
133278,Disorder of hair,ethnic,Hispanic or Latino,14,0,14
73923,"Contusion, upper arm",racial,White,8,5,13
376713,Cerebral hemorrhage,racial,White,5,8,13
77646,Disorder of bone and articular cartilage,ethnic,Hispanic or Latino,6,8,14
192357,Paralytic ileus,ethnic,Hispanic or Latino,7,7,14
196463,Alcoholic cirrhosis,racial,Other Race,2,11,13
434782,Closed fracture of tibia AND fibula,ethnic,Hispanic or Latino,11,3,14
313236,Cough variant asthma,racial,Other Race,8,5,13
4086918,Viral screening,racial,Filipino,10,4,14
381677,SBO - Spina bifida occulta,racial,White,2,12,14
434459,Ganglion of tendon sheath,ethnic,Hispanic or Latino,11,2,13
75406,Crush injury of finger,racial,White,7,7,14
4249474,Generalized seborrheic dermatitis of infants,ethnic,Hispanic or Latino,7,7,14
195363,Congenital anomaly of kidney,racial,White,4,10,14
31317,Can't get food down,racial,Asian,4,10,14
197032,Hyperplasia of prostate,racial,Native Hawaiian or Other Pacific Islander ,0,14,14
138996,Carcinoma in situ of skin,racial,Unknown,13,1,14
74723,Arthropathy associated with a neurological disorder,racial,White,6,8,14
78890,Sprain of elbow and forearm,racial,White,10,4,14
197332,Incomplete uterovaginal prolapse,racial,Unknown,14,0,14
436033,Syphilis,ethnic,Not Hispanic or Latino,1,13,14
440846,"Blood coagulation disorder, categorized by value of screening test",racial,White,7,7,14
376124,Pinguecula,racial,Unknown,8,6,14
437409,Intracranial injury,racial,White,1,13,14
80806,Climacteric arthritis of multiple sites,ethnic,Hispanic or Latino,10,4,14
433455,Teeth grinding whilst asleep,ethnic,Hispanic or Latino,11,3,14
444455,Benign tumour of soft tissue of head,ethnic,Hispanic or Latino,12,2,14
141090,PG - Pyogenic granuloma,racial,Unknown,2,11,13
4080568,Problem behaviour,ethnic,Not Hispanic or Latino,4,10,14
432306,Gender identity disorder of adolescence,ethnic,Hispanic or Latino,5,8,13
79897,Obstetric non-purulent mastitis - delivered with postnatal complication,ethnic,Hispanic or Latino,14,0,14
197018,Chronic gastric ulcer with hemorrhage but without obstruction,ethnic,Hispanic or Latino,10,4,14
434490,Shivering,racial,White,10,4,14
132393,Pressure ulcer stage 1,racial,Other Race,0,14,14
381562,"Impairment level: better eye: moderate impairment: lesser eye: blind, not further specified",ethnic,Hispanic or Latino,11,2,13
314962,Raynaud disease,racial,White,13,1,14
201343,Acute alcoholic liver disease,racial,Unknown,1,13,14
138479,Thyroid dysfunction during pregnancy - baby not yet delivered,racial,Unknown,14,0,14
133002,Acute osteomyelitis,ethnic,Hispanic or Latino,1,13,14
435950,Closed Colles' fracture,racial,Unknown,13,1,14
372328,Otitis media,racial,Native Hawaiian or Other Pacific Islander ,5,8,13
439081,Premenstrual tension syndrome,ethnic,Not Hispanic or Latino,13,1,14
4171115,Low birth weight infant,ethnic,Hispanic or Latino,7,7,14
4218764,Gastroschisis,ethnic,Hispanic or Latino,5,8,13
134743,Congenital ichthyosis of skin,ethnic,Hispanic or Latino,5,8,13
132393,Pressure ulcer stage 1,racial,Unknown,13,1,14
4047937,Neonatal urinary tract infection,racial,White,7,7,14
444437,Congenital abnormality of cervix,racial,White,14,0,14
195498,Benign tumour of kidney,racial,Unknown,1,13,14
139888,Threatened premature labor - not delivered,racial,Unknown,14,0,14
259849,Pneumonia with infectious diseases EC,racial,White,8,6,14
435796,Dehydration,racial,Other Race,8,6,14
434219,Anaphylactic shock due to adverse food reaction,ethnic,Hispanic or Latino,1,13,14
376104,Posttraumatic headache,racial,White,7,7,14
196734,Disease of prostate,racial,Unknown,0,14,14
4103471,Observation of body mass index,racial,Alaska Native,4,10,14
443257,Swellings and lumps,racial,Other Race,3,11,14
4086918,Viral screening,racial,American Indian,7,7,14
4194232,Absence seizure,racial,White,10,4,14
4181604,Subcutaneous contraceptive implant,racial,White,14,0,14
317893,Paroxysmal supraventricular tachycardia,racial,Unknown,11,2,13
435220,Severe recurrent major depression without psychotic features,racial,Other Race,11,2,13
437993,Closed fracture of cervical spine,ethnic,Hispanic or Latino,0,13,13
372328,Otitis media,racial,Filipino,4,9,13
442013,Burn,ethnic,Not Hispanic or Latino,4,9,13
4305589,"Neoplasm, benign",racial,Unknown,7,6,13
435242,Cerebellar ataxia,ethnic,Hispanic or Latino,11,2,13
198678,Intestinal infectious disease,racial,Other Race,7,7,14
317309,Peripheral arterial occlusive disease,racial,Black or African American ,13,1,14
197924,Bile duct calculus with acute cholecystitis and obstruction,ethnic,Hispanic or Latino,8,5,13
4147837,Generalized metabolic disorder,racial,White,7,6,13
4048191,Enlargement of tonsil or adenoid,racial,Unknown,7,6,13
80205,Perinatal condition,ethnic,Hispanic or Latino,11,2,13
381549,Migraine with aura,ethnic,Not Hispanic or Latino,11,2,13
4114314,Screening for osteoporosis,racial,American Indian or Alaska Native ,13,1,14
4280828,"Carrier, infectious agent",racial,Unknown,10,3,13
432878,Drug abuse using speed,ethnic,Hispanic or Latino,4,10,14
436446,Cracked tooth syndrome,racial,Unknown,7,6,13
435368,Congenital pigeon chest,racial,White,0,13,13
381278,Cluster headache,ethnic,Hispanic or Latino,7,7,14
132412,Failed back syndrome,racial,Unknown,0,13,13
74892,Articular gout,racial,Unknown,5,8,13
254061,Pleural effusion,ethnic,Not Hispanic or Latino,3,10,13
441868,Optic disc oedema,ethnic,Hispanic or Latino,13,1,14
437784,Pfeiffer's disease,racial,White,8,5,13
75617,Polyarticular osteoarthritis,racial,American Indian or Alaska Native ,11,2,13
442139,Primary bronchial cancer,racial,Black or African American ,0,13,13
432725,Congenital anomaly of integument,racial,White,7,7,14
141305,Unilateral sensorineural hearing loss with unrestricted hearing on the contralateral side,racial,Unknown,13,0,13
4273391,Suicidal thoughts,racial,White,8,5,13
436070,Vitamin D deficiency,racial,Black or African American ,13,0,13
316135,AVB - Atrioventricular block,ethnic,Hispanic or Latino,0,13,13
198803,Nodular hyperplasia of prostate gland,racial,American Indian or Alaska Native ,0,13,13
375826,Central hearing loss,racial,Unknown,10,4,14
136934,Primary hyperparathyroidism,ethnic,Not Hispanic or Latino,8,5,13
74130,Thoracic spondylosis without myelopathy,racial,White,9,4,13
192691,Diabetes mellitus during pregnancy - baby not yet delivered,ethnic,Hispanic or Latino,13,0,13
4186238,Louse infestation,ethnic,Not Hispanic or Latino,11,2,13
201075,Noninflammatory disorder of cervix,ethnic,Hispanic or Latino,13,0,13
375545,Lens opacity,racial,Native Hawaiian or Other Pacific Islander ,2,11,13
138239,Observation of limb structure,racial,Asian,7,6,13
441701,Sprain of hip joint,ethnic,Not Hispanic or Latino,8,5,13
312664,Influenza with respiratory manifestation other than pneumonia,racial,Asian,4,9,13
196625,Viral hepatitis A without hepatic coma,racial,White,9,4,13
381017,Ametropic amblyopia,ethnic,Not Hispanic or Latino,10,4,14
135122,Multiple spinal cord injuries without spinal bone injury,ethnic,Hispanic or Latino,0,13,13
440785,Vomiting of pregnancy,ethnic,Hispanic or Latino,13,0,13
81186,Contusion of wrist,ethnic,Not Hispanic or Latino,11,2,13
76887,Disorders of urogenital prostheses or implants,racial,White,13,1,14
439237,Assault,ethnic,Hispanic or Latino,10,3,13
4147961,Screening for malignant neoplasm of breast,racial,Filipino,13,0,13
434281,Aspergillosis,ethnic,Hispanic or Latino,10,3,13
374919,Disseminated sclerosis,racial,Black or African American ,13,0,13
372886,Refractory migraine with aura,racial,Unknown,13,0,13
372435,Periventricular leukomalacia,ethnic,Hispanic or Latino,11,2,13
373769,Nuclear cataract,racial,Unknown,5,8,13
315286,Chronic ischemic heart disease,racial,White,4,10,14
437264,Tobacco dependence syndrome,racial,American Indian,7,6,13
381035,Vertigo of central origin,ethnic,Hispanic or Latino,8,5,13
26638,Primary malignant neoplasm of oesophagus,ethnic,Hispanic or Latino,2,11,13
4108975,Borderline glaucoma NOS,racial,Unknown,13,0,13
4109253,Pterygium NOS,racial,Unknown,5,8,13
437176,Late effect of accidental fall,racial,Unknown,10,3,13
256531,Head and neck swelling,racial,Asian,8,5,13
192273,Benign tumour of adrenal gland,racial,White,10,3,13
435782,Chronic schizophrenic,racial,Asian,10,3,13
438350,Pneumocystosis,ethnic,Hispanic or Latino,0,13,13
77734,Contusion of lower leg,racial,Unknown,12,1,13
4024013,Sensory nervous system finding,racial,Unknown,8,5,13
441077,Stenosis of cervix,ethnic,Hispanic or Latino,13,0,13
439183,Concussion,ethnic,Not Hispanic or Latino,4,10,14
4104157,Genital observation,ethnic,Hispanic or Latino,6,7,13
198464,Incisional hernia,racial,Unknown,7,7,14
442764,Anal pain,ethnic,Not Hispanic or Latino,5,8,13
78219,Cellulitis and abscess of hand excluding digits,ethnic,Not Hispanic or Latino,4,9,13
194158,Perinatal gastrointestinal hemorrhage,racial,Unknown,5,8,13
439082,Menopausal syndrome,racial,Asian,13,0,13
198850,Congenital hypoplasia of penis,ethnic,Hispanic or Latino,0,13,13
442584,Carbuncle of buttock,ethnic,Not Hispanic or Latino,10,3,13
136184,Pruritic disorder,racial,Other Race,11,2,13
134668,Chronic maxillary sinusitis,racial,Unknown,9,4,13
440689,Agranulocytosis,racial,Unknown,8,5,13
4139915,Acute pyelitis,racial,White,12,1,13
78524,Acquired deformity of finger,ethnic,Hispanic or Latino,9,4,13
434942,Postseptal orbital cellulitis,ethnic,Hispanic or Latino,10,4,14
136788,Spinal stenosis of lumbar region,racial,Black or African American ,6,7,13
4064925,Hypertension screening,racial,White,8,5,13
78193,Epididymo-orchitis,ethnic,Not Hispanic or Latino,0,13,13
439037,Aneurysm of artery of neck,racial,White,13,0,13
4235140,Operation for bone injury of phalanges of hand,racial,White,5,8,13
443571,Cervicovaginal cytology: High grade squamous intraepithelial lesion or carcinoma,racial,Unknown,13,0,13
80552,Closed fracture of the scaphoid,ethnic,Hispanic or Latino,4,9,13
372765,Open wound of head without complication,racial,White,4,10,14
441482,Administrative reason for encounter,racial,Black or African American ,6,7,13
4103416,Drug dependence NOS,racial,White,5,8,13
441829,Hyperosmolality and or hypernatremia,racial,White,11,2,13
376712,Purulent otitis media,ethnic,Hispanic or Latino,6,7,13
441261,Episodic acute alcoholic intoxication in alcoholism,ethnic,Hispanic or Latino,2,11,13
135350,Acute osteomyelitis of the ankle and/or foot,ethnic,Hispanic or Latino,2,11,13
4185471,Disorder of pigmentation,ethnic,Not Hispanic or Latino,8,5,13
75044,"Stiff joint NEC, of the hand",ethnic,Hispanic or Latino,10,3,13
137792,Kaposi's varicelliform eruption,racial,White,4,9,13
319825,Rheumatic heart disease,ethnic,Hispanic or Latino,7,7,14
443431,Disorder of menstruation,racial,American Indian or Alaska Native ,13,0,13
138117,Benign tumour of spinal cord,ethnic,Hispanic or Latino,11,2,13
440374,Obsessive compulsive disorder,racial,Unknown,13,0,13
40480431,Speech and language developmental delay due to hearing loss,ethnic,Not Hispanic or Latino,0,13,13
433095,Fall on or from steps,racial,White,10,4,14
4101199,Hearing problem,racial,Other Race,11,2,13
437082,Marie-Strumpell spondylitis,ethnic,Not Hispanic or Latino,3,10,13
75897,Polyarthropathy,ethnic,Not Hispanic or Latino,2,11,13
192239,Post-herpetic polyneuropathy,racial,Unknown,11,2,13
440990,Chorea,racial,White,3,10,13
192606,Paraplegia,racial,Asian,0,13,13
442282,Urinary casts,ethnic,Not Hispanic or Latino,11,2,13
434459,Ganglion of tendon sheath,racial,White,11,2,13
260139,Acute bronchitis,racial,Native Hawaiian or Other Pacific Islander ,7,7,14
4103723,Other refraction and accommodation disorders,racial,Unknown,8,5,13
261325,Pulmonary emphysema,racial,Native Hawaiian or Other Pacific Islander ,13,1,14
435171,Allergic state,racial,Other Race,9,4,13
28779,Oesophageal varices with bleeding,racial,White,7,7,14
74513,Open wound of foot without mention of complication,racial,Unknown,8,5,13
438477,Atrophy of testis,ethnic,Hispanic or Latino,0,13,13
434889,"Hysterical neurosis, conversion type",ethnic,Hispanic or Latino,13,1,14
4302252,High risk pregnancy care,racial,Asian,13,0,13
193249,Acute erosive gastritis,racial,White,9,4,13
137658,Congenital pigmentary anomaly of skin,racial,White,5,8,13
373638,Superficial injury of cornea,racial,Unknown,9,4,13
133228,Dental caries,racial,Native Hawaiian or Other Pacific Islander ,10,3,13
140214,Eruption of skin,racial,American Indian or Alaska Native ,12,1,13
195294,Thrombosed hemorrhoids,ethnic,Hispanic or Latino,9,4,13
196217,Congenital malformation of diaphragm,ethnic,Hispanic or Latino,9,4,13
438788,Hypertrophy of adenoids,ethnic,Hispanic or Latino,1,12,13
135122,Multiple spinal cord injuries without spinal bone injury,racial,White,0,13,13
4085922,Infection screening,racial,White,8,5,13
198289,Nonvenomous insect bite of hip without infection,racial,White,10,3,13
436386,Severe depressed bipolar I disorder with psychotic features,ethnic,Not Hispanic or Latino,5,8,13
438447,Acute myocardial infarction of inferolateral wall,ethnic,Hispanic or Latino,4,10,14
192372,Placenta praevia without haemorrhage - not delivered,racial,White,13,0,13
376117,Cataract in degenerative disorder,ethnic,Not Hispanic or Latino,12,1,13
4108982,Cataract associated with other syndromes,racial,White,13,0,13
437536,Somatoform autonomic dysfunction - gastrointestinal tract,racial,White,0,13,13
314665,Atrial flutter,racial,Other Race,2,11,13
4051114,FH: Diabetes mellitus,racial,Other Race,5,8,13
137213,Fungal dermatosis,ethnic,Not Hispanic or Latino,6,7,13
4105187,Speech or language developmental disorder NOS,racial,White,7,6,13
440940,Methicillin resistant Staphylococcus aureus infection,racial,Unknown,8,5,13
381292,Chronic allergic conjunctivitis,racial,Native Hawaiian or Other Pacific Islander ,8,5,13
198558,Nycturia,racial,Other Race,1,13,14
437221,Chlamydia trachomatis infection,ethnic,Hispanic or Latino,13,1,14
436373,DSD - Developmental speech disorder,racial,Other Race,4,10,14
381301,Chronic serous otitis media,ethnic,Not Hispanic or Latino,4,9,13
441202,Generalized anaphylaxis,ethnic,Not Hispanic or Latino,10,3,13
377274,Nonsenile cataract,ethnic,Hispanic or Latino,11,2,13
4213085,Family history of prostate cancer,ethnic,Hispanic or Latino,0,13,13
75512,Carcinoma in situ of colon,ethnic,Not Hispanic or Latino,13,0,13
439125,T21 - Trisomy 21,racial,Asian,10,4,14
439125,T21 - Trisomy 21,racial,Black or African American ,13,0,13
380038,Viral conjunctivitis,ethnic,Not Hispanic or Latino,8,5,13
439002,Eating disorder,racial,Unknown,9,4,13
78273,Closed fracture multiple ribs,racial,Unknown,11,2,13
81426,Closed fracture of clavicle,racial,Unknown,8,5,13
433168,Iron deficiency anaemia secondary to inadequate dietary iron intake,racial,White,10,3,13
4305303,Sleep deprivation,ethnic,Hispanic or Latino,10,4,14
135892,Erythematous condition,racial,Unknown,13,1,14
135699,Burn any degree involving 10-19 percent of body surface,ethnic,Hispanic or Latino,7,7,14
4105880,Contact of sexually transmissible disorder,racial,Black or African American ,7,5,12
4093146,Herpes simplex with other specified complication,racial,White,2,11,13
381252,Benign neoplasm of eye,ethnic,Hispanic or Latino,10,3,13
201136,Infection of navel cord,ethnic,Hispanic or Latino,6,7,13
372887,Disease of brain,racial,Unknown,1,11,12
4287237,Vascular hamartoma of skin,ethnic,Hispanic or Latino,5,8,13
195083,Left lower quadrant pain,racial,Other Race,13,0,13
377274,Nonsenile cataract,racial,White,11,2,13
137977,Icteric,ethnic,Not Hispanic or Latino,5,7,12
74855,Genital herpes simplex,racial,Black or African American ,8,4,12
434926,Iridocyclitis,racial,White,10,2,12
198846,Enthesopathy of hip region,racial,Unknown,6,7,13
79127,Congenital spondylolisthesis,racial,Unknown,13,0,13
444413,Pyrexial convulsion,ethnic,Not Hispanic or Latino,8,5,13
4249474,Generalized seborrheic dermatitis of infants,racial,White,4,8,12
437891,PPHT - Primary pulmonary hypertension,ethnic,Not Hispanic or Latino,13,0,13
4150157,Other anemias,racial,White,10,3,13
133299,Swelling of limb,racial,Other Race,7,6,13
74606,Benign bone tumor,ethnic,Hispanic or Latino,12,1,13
378421,Alcoholic peripheral neuropathy,racial,Unknown,0,13,13
195314,Nephrotic syndrome,racial,Other Race,5,7,12
377575,Tinnitus,racial,Asian,7,5,12
436230,Blood chemistry abnormal,racial,Black or African American ,8,5,13
442005,Full thickness burn of back of hand,racial,Unknown,13,0,13
437833,Hypokalaemia,racial,Black or African American ,8,4,12
443585,Abrasion AND/OR friction burn of multiple sites,racial,Black or African American ,10,3,13
74468,Congenital anomaly of rib,racial,White,6,7,13
437222,Respiratory syncytial virus infection,ethnic,Hispanic or Latino,3,10,13
197304,Ulcer of lower limb,racial,Filipino,13,0,13
4093146,Herpes simplex with other specified complication,ethnic,Hispanic or Latino,2,11,13
196991,Chronic renal disease,racial,Filipino,0,13,13
73562,Solitary sacroiliitis,ethnic,Not Hispanic or Latino,13,0,13
434319,Premature orgasm - male,ethnic,Hispanic or Latino,0,13,13
4025514,Unspecified peptic ulcer,ethnic,Not Hispanic or Latino,1,12,13
81395,Metatarsus primus varus,ethnic,Hispanic or Latino,0,13,13
201045,Thrombosed external haemorrhoids,racial,Unknown,9,4,13
435216,Disorder associated with type I diabetes mellitus,racial,Other Race,9,4,13
374357,Acquired stenosis of nasolacrimal duct,racial,Unknown,4,8,12
192286,Intestinal disaccharidase deficiency,ethnic,Not Hispanic or Latino,4,8,12
4055337,Gallbladder calculus without mention of cholecystitis,racial,White,6,7,13
444101,Hypertensive heart failure,racial,Other Race,11,2,13
379806,Migraine variants,ethnic,Hispanic or Latino,8,5,13
135340,Pressure ulcer stage 3,racial,White,2,11,13
441482,Administrative reason for encounter,racial,Asian,7,6,13
437093,Congenital ptosis of upper eyelid,ethnic,Hispanic or Latino,10,3,13
4206460,Problem,racial,Black or African American ,5,7,12
26935,Disorder of endocrine testis,ethnic,Not Hispanic or Latino,0,13,13
443260,Umbilical lump,ethnic,Hispanic or Latino,10,3,13
439706,Psychosis with origin in childhood,racial,Unknown,1,12,13
4055208,Chronic hepatitis unspecified,racial,White,3,10,13
4281232,Type B viral hepatitis,ethnic,Hispanic or Latino,6,7,13
4111392,Angina pectoris NOS,racial,White,10,3,13
133424,Primary malignant neoplasm of thyroid gland,ethnic,Not Hispanic or Latino,11,2,13
434309,Sexual precocity,ethnic,Not Hispanic or Latino,7,6,13
432284,Single major depressive episode,racial,Native Hawaiian or Other Pacific Islander ,1,12,13
375415,Injury of head region,racial,Other Race,7,6,13
196735,Acute pyelonephritis without medullary necrosis,racial,Unknown,11,2,13
433760,Dysreflexia,racial,White,8,4,12
74816,Contusion of toe,racial,Unknown,8,5,13
200836,Congenital anomaly of gastrointestinal tract,ethnic,Hispanic or Latino,9,4,13
435956,Closed fracture of base of neck of femur,racial,White,3,10,13
139099,Ingrowing nail,racial,Asian,11,1,12
373786,Abnormal vision,racial,Unknown,4,9,13
436140,Vulval varices,racial,White,12,1,13
4149382,Endocrine/metabolic screening,racial,White,10,2,12
435648,Testicular retraction,racial,White,0,13,13
318556,Nosebleed,racial,Black or African American ,2,10,12
77968,Hallux valgus AND bunion,racial,Black or African American ,6,7,13
438332,Disease of possible viral origin,racial,Native Hawaiian or Other Pacific Islander ,4,9,13
201530,"Diabetes mellitus, adult onset, with hyperosmolar coma",racial,Unknown,11,1,12
440690,Social phobia,racial,White,7,5,12
78200,Benign mammary dysplasia,racial,Unknown,13,0,13
373489,Congenital nystagmus,ethnic,Hispanic or Latino,9,4,13
138821,Seborrhea,ethnic,Not Hispanic or Latino,7,5,12
4176890,Male sterility,ethnic,Hispanic or Latino,0,13,13
134976,Complex dental caries,ethnic,Hispanic or Latino,8,4,12
434972,Developmental abnormality of tooth size and form,racial,White,8,4,12
40481819,Early satiety,ethnic,Hispanic or Latino,9,4,13
313219,Phlebitis and thrombophlebitis,racial,Unknown,9,4,13
437498,Primary malignant neoplasm of tongue,ethnic,Hispanic or Latino,0,13,13
80156,Asymptomatic bacteriuria in pregnancy,racial,Unknown,13,0,13
434467,Ostium secundum type atrial septal defect,racial,Unknown,10,2,12
318186,Achalasia of esophagus,racial,Unknown,13,0,13
437896,Disorder of language,ethnic,Hispanic or Latino,4,8,12
314754,Wheezing,racial,American Indian or Alaska Native ,9,4,13
4108905,Congenital malformation of the urinary system,racial,White,5,8,13
73571,Pathological fracture,racial,Other Race,0,13,13
4031190,Swallowed foreign body,ethnic,Hispanic or Latino,8,5,13
73026,Abnormal respiratory sounds,racial,White,8,4,12
194990,Inflammatory disorder of liver,racial,Other Race,10,2,12
4147639,Cellulitis and abscess of toe NOS,ethnic,Hispanic or Latino,7,6,13
200765,Chronic cholecystitis,ethnic,Hispanic or Latino,10,2,12
321319,Cardiomyopathy,racial,Other Race,13,0,13
437784,Pfeiffer's disease,ethnic,Hispanic or Latino,9,4,13
137820,Postoperative hypothyroidism,racial,Unknown,8,4,12
195603,Vulval and/or perineal noninflammatory disorders,racial,Unknown,13,0,13
193308,Congenital anomaly of spleen,ethnic,Hispanic or Latino,6,7,13
436962,Sleeplessness,racial,American Indian or Alaska Native ,10,2,12
30163,Cellulitis and abscess of neck,ethnic,Not Hispanic or Latino,7,5,12
4002644,Rotator cuff shoulder syndrome and allied disorders,racial,White,5,8,13
80189,Displacement of lumbar intervertebral disc without myelopathy,racial,Asian,5,7,12
74719,Foot ulcer,racial,Asian,11,2,13
259865,Cyst of Bartholin's gland duct,ethnic,Not Hispanic or Latino,11,1,12
438531,Chondromalacia,ethnic,Hispanic or Latino,10,2,12
314971,Chronic respiratory failure,racial,Other Race,11,1,12
77673,Sign or symptom of the urinary system,racial,Unknown,8,5,13
433315,Feeding difficulties in newborn,racial,Black or African American ,6,7,13
196152,Peritonitis,ethnic,Hispanic or Latino,4,8,12
4194895,Screening for disorder,racial,Black or African American ,5,8,13
436027,Coxsackie virus disease,ethnic,Hispanic or Latino,7,6,13
437498,Primary malignant neoplasm of tongue,racial,Unknown,0,13,13
4055208,Chronic hepatitis unspecified,racial,Unknown,11,1,12
195007,Female stress incontinence,racial,Asian,13,0,13
432590,Delusional disorder,racial,Unknown,8,5,13
4062491,Anemia screening,racial,White,8,5,13
133278,Disorder of hair,racial,White,12,1,13
141508,Dermatophytosis of scalp or beard,ethnic,Not Hispanic or Latino,4,8,12
134743,Congenital ichthyosis of skin,racial,White,2,11,13
441408,Vomiting,racial,Black or African American ,4,8,12
377535,Sleep walking disorder,ethnic,Hispanic or Latino,6,7,13
257004,Acute exacerbation of chronic obstructive airways disease,racial,Native Hawaiian or Other Pacific Islander ,9,4,13
134331,Cauda equina syndrome without neurogenic bladder,racial,White,12,1,13
442005,Full thickness burn of back of hand,ethnic,Hispanic or Latino,13,0,13
443597,Chronic kidney disease stage 3,racial,Filipino,4,8,12
435521,Psychophysiologic disorder,ethnic,Hispanic or Latino,6,7,13
76545,Closed traumatic dislocation of patella,ethnic,Hispanic or Latino,8,4,12
441553,Myoclonus,racial,White,13,0,13
259123,Congenital subaortic stenosis,ethnic,Hispanic or Latino,11,1,12
439696,Hypertensive heart and renal disease with (congestive) heart failure,racial,Unknown,1,11,12
73560,Calcaneal spur,racial,Other Race,10,3,13
443790,Multi-infarct dementia with delusions,racial,White,12,1,13
441542,Anxiety,racial,American Indian,12,1,13
40481820,Flaccid hemiplegia of nondominant side,ethnic,Not Hispanic or Latino,0,13,13
4319325,Acquired deformity of trunk,ethnic,Not Hispanic or Latino,8,4,12
79091,Unstable lie,ethnic,Hispanic or Latino,13,0,13
134671,Dental abscess without a sinus,racial,Other Race,5,8,13
261880,Atelectasis,racial,White,7,6,13
194133,Low back pain,racial,Filipino,7,6,13
439706,Psychosis with origin in childhood,racial,Other Race,9,4,13
28779,Oesophageal varices with bleeding,racial,Unknown,5,8,13
27587,Disturbance of salivary secretion,racial,Unknown,8,5,13
440674,Gout,racial,Native Hawaiian or Other Pacific Islander ,2,10,12
132702,Erythema multiforme,ethnic,Hispanic or Latino,5,8,13
377254,"Multi-infarct dementia, uncomplicated",racial,Other Race,2,10,12
437943,Pulp abscess of finger,ethnic,Hispanic or Latino,5,7,12
200169,Pruritus ani,ethnic,Not Hispanic or Latino,3,10,13
4001998,Pulmonary apoplexy,ethnic,Not Hispanic or Latino,0,13,13
320136,Disease of respiratory system,ethnic,Not Hispanic or Latino,7,6,13
442753,Furuncle of trunk,ethnic,Not Hispanic or Latino,4,9,13
200970,CIS - Carcinoma in situ of prostate,ethnic,Not Hispanic or Latino,0,13,13
73576,Acquired chest and rib deformity,ethnic,Hispanic or Latino,4,9,13
437966,Calcium deposits in tendon,racial,White,9,4,13
440922,Diabetic on insulin,racial,Unknown,11,2,13
443801,Exercise-induced asthma,racial,Other Race,6,7,13
436336,Herpes zoster with nervous system complication,racial,Unknown,5,7,12
440922,Diabetic on insulin,ethnic,Not Hispanic or Latino,6,7,13
374375,Impacted cerumen,racial,American Indian or Alaska Native ,11,2,13
4088777,Vagina observation,ethnic,Not Hispanic or Latino,13,0,13
4186238,Louse infestation,racial,Unknown,10,3,13
192691,Diabetes mellitus during pregnancy - baby not yet delivered,racial,White,12,0,12
4175028,Irritant gastritis,racial,Unknown,10,2,12
199878,Light and infrequent menstruation,racial,Unknown,12,0,12
135762,Acute myeloid leukaemia in remission,ethnic,Hispanic or Latino,8,4,12
378135,Facial nerve disorder,racial,White,7,5,12
4109698,Acute conjunctivitis NOS,ethnic,Hispanic or Latino,6,6,12
437082,Marie-Strumpell spondylitis,racial,White,1,11,12
134057,Disease of cardiovascular system,racial,Black or African American ,10,2,12
441264,Primary thrombocytopenia,racial,Asian,0,12,12
4052931,Abandoned child,ethnic,Hispanic or Latino,8,4,12
29735,Candidiasis of mouth,racial,Black or African American ,6,6,12
375552,Pterygium,racial,Other Race,7,5,12
197033,Endometriosis of pelvic peritoneum,ethnic,Hispanic or Latino,12,0,12
140960,Secondary malignant neoplasm of breast,ethnic,Not Hispanic or Latino,12,0,12
441701,Sprain of hip joint,racial,Unknown,7,5,12
4085922,Infection screening,ethnic,Hispanic or Latino,7,5,12
432741,Abnormal immunology finding,racial,Other Race,6,6,12
40481820,Flaccid hemiplegia of nondominant side,racial,White,8,4,12
437243,Chronic paranoid schizophrenia with acute exacerbation,racial,White,0,12,12
436245,Atypical glandular cells on vaginal Papanicolaou smear,ethnic,Not Hispanic or Latino,12,0,12
138858,Pale complexion,ethnic,Hispanic or Latino,7,5,12
439928,Gangrenous disorder,racial,White,2,10,12
436231,Abnormal findings diagnostic imaging of liver and biliary tract,ethnic,Hispanic or Latino,8,4,12
195300,Alcoholic gastritis,ethnic,Hispanic or Latino,5,7,12
435723,Wound seroma,ethnic,Hispanic or Latino,11,1,12
373489,Congenital nystagmus,racial,White,8,4,12
78835,Palindromic rheumatism of the lower leg,racial,American Indian or Alaska Native ,5,7,12
75911,Acquired hallux valgus,ethnic,Not Hispanic or Latino,9,3,12
436336,Herpes zoster with nervous system complication,ethnic,Not Hispanic or Latino,8,4,12
194411,Unilateral simple inguinal hernia,racial,Black or African American ,0,12,12
28974,Candidiasis of oesophagus,ethnic,Hispanic or Latino,7,5,12
435553,Watery eye,racial,Unknown,10,2,12
443883,Acute disease,ethnic,Hispanic or Latino,2,10,12
79804,Myotonic dystrophy,ethnic,Not Hispanic or Latino,8,4,12
436673,Chronic residual schizophrenia,racial,White,10,2,12
378741,Brachial plexus lesion,racial,White,10,2,12
436059,Multiple myeloma in remission,racial,White,12,0,12
432910,Disorder of lacrimal system,ethnic,Hispanic or Latino,10,2,12
4108817,"Tricuspid valve disorders, non-rheumatic",racial,Unknown,12,0,12
28083,Primary malignant neoplasm of pharynx,ethnic,Hispanic or Latino,1,11,12
443545,Nonvenomous insect bite,racial,Black or African American ,6,6,12
4013526,ESR raised,racial,White,9,3,12
443616,Refractory migraine without aura,ethnic,Hispanic or Latino,4,8,12
4087756,Late latent syphilis,racial,Unknown,1,11,12
377298,Chronic otitis externa,racial,White,7,5,12
74458,Enthesopathy of knee region,racial,Black or African American ,12,0,12
321315,Trifascicular block,ethnic,Hispanic or Latino,12,0,12
255848,Pneumonia,racial,American Indian or Alaska Native ,12,0,12
4016675,"Sprain, ankle joint, medial",racial,White,7,5,12
4092879,Absent kidney,ethnic,Not Hispanic or Latino,1,11,12
24977,Mucocele of salivary gland,ethnic,Hispanic or Latino,8,4,12
436671,Carcinoma in situ of anal canal,ethnic,Hispanic or Latino,6,6,12
440788,Hyperemesis gravidarum with metabolic disturbance - not delivered,racial,White,12,0,12
140949,Scabies,racial,Other Race,5,7,12
433752,Impulse control disorder,ethnic,Hispanic or Latino,11,1,12
4064383,Rheumatoid arthritis screening,ethnic,Hispanic or Latino,8,4,12
375256,Anterior subcapsular polar senile cataract,ethnic,Hispanic or Latino,9,3,12
433450,Paranoid schizophrenia,racial,Unknown,12,0,12
138117,Benign tumour of spinal cord,racial,White,10,2,12
4170576,Pressure ulcer,ethnic,Not Hispanic or Latino,8,4,12
4109544,"Total, mature senile cataract",ethnic,Hispanic or Latino,12,0,12
194286,"Malignant neoplasm of corpus uteri, excluding isthmus",ethnic,Not Hispanic or Latino,12,0,12
81671,Unilateral congenital dislocation of hip,racial,White,7,5,12
195079,Functional urinary incontinence,racial,White,11,1,12
79768,Neoplasm of urinary system,racial,Asian,2,10,12
436386,Severe depressed bipolar I disorder with psychotic features,racial,White,5,7,12
4103580,Unspecified senile cataract,ethnic,Hispanic or Latino,7,5,12
440525,Prematurity of fetus,racial,Asian,4,8,12
133436,Thyrotoxic crisis,racial,Black or African American ,8,4,12
444071,Furuncle of forearm,ethnic,Hispanic or Latino,5,7,12
321315,Trifascicular block,racial,Unknown,12,0,12
140960,Secondary malignant neoplasm of breast,racial,White,12,0,12
192239,Post-herpetic polyneuropathy,racial,Black or African American ,1,11,12
314971,Chronic respiratory failure,ethnic,Not Hispanic or Latino,10,2,12
435224,Leukopenia,racial,Black or African American ,2,10,12
4101660,Amputated below knee,racial,Other Race,0,12,12
375527,Headache disorder,ethnic,Hispanic or Latino,7,5,12
433015,Congenital anomaly of aortic arch,racial,White,7,5,12
255348,Polymyalgia rheumatica,ethnic,Not Hispanic or Latino,12,0,12
374954,Optic neuritis,racial,White,8,4,12
74189,Sprain of cruciate ligament of knee,ethnic,Not Hispanic or Latino,8,4,12
193322,Right lower quadrant pain,racial,Asian,7,5,12
25572,Disease of salivary gland,racial,White,4,8,12
40485064,Latent syphilis,racial,Black or African American ,1,11,12
196733,Urethral syndrome,ethnic,Hispanic or Latino,8,4,12
438005,Closed fracture shaft of fibula,racial,Unknown,12,0,12
4152167,Acute stress reaction NOS,racial,White,11,1,12
193262,Inflammatory disorder of penis,ethnic,Hispanic or Latino,0,12,12
374025,Retinal haemorrhages,ethnic,Not Hispanic or Latino,5,7,12
132685,Severe pre-eclampsia - not delivered,ethnic,Hispanic or Latino,12,0,12
377282,Conjunctivitis with mucocutaneous disorder,ethnic,Hispanic or Latino,10,2,12
252365,MGN - Membranous glomerulonephritis,racial,Other Race,12,0,12
441269,Autoimmune hemolytic anemia,ethnic,Hispanic or Latino,12,0,12
193984,Adrenal hypofunction,racial,Unknown,12,0,12
439155,Carcinoembryonic antigen present,racial,White,10,2,12
441547,Oppositional defiant disorder,ethnic,Not Hispanic or Latino,2,10,12
197925,Haemorrhage of rectum and anus,racial,American Indian or Alaska Native ,11,1,12
135033,Hair and hair follicle diseases,racial,Other Race,6,6,12
440386,Transsexualism,ethnic,Not Hispanic or Latino,4,8,12
26052,Primary malignant neoplasm of larynx,ethnic,Hispanic or Latino,1,11,12
138455,Stomatitis,ethnic,Hispanic or Latino,7,5,12
4064381,Nephropathy screening,ethnic,Not Hispanic or Latino,7,5,12
201347,Pelvic pain syndrome,ethnic,Hispanic or Latino,12,0,12
435535,Aggressive type unsocialized behavior disorder,ethnic,Hispanic or Latino,2,10,12
137951,Acquired keratoderma,ethnic,Not Hispanic or Latino,8,4,12
28714,Syndrome of diencephalo-hypophyseal origin,racial,White,11,1,12
444055,Thrombophlebitis of superficial veins of lower extremity,ethnic,Hispanic or Latino,10,2,12
197239,Haemangioma of intra-abdominal structure,ethnic,Hispanic or Latino,7,5,12
261782,Herpetic ulceration of vulva,ethnic,Hispanic or Latino,12,0,12
439082,Menopausal syndrome,racial,Black or African American ,12,0,12
434675,Complication of gastrostomy,racial,Unknown,8,4,12
22281,Sickle cell disease,ethnic,Not Hispanic or Latino,3,9,12
379782,Gilles de la Tourette's syndrome,racial,White,8,4,12
78835,Palindromic rheumatism of the lower leg,racial,Black or African American ,10,2,12
136834,Closed intertrochanteric fracture,ethnic,Hispanic or Latino,10,2,12
30284,Motion sickness,ethnic,Hispanic or Latino,8,4,12
443729,Peripheral circulatory disorder associated with type II diabetes mellitus,racial,American Indian or Alaska Native ,11,1,12
132446,Congenital anomaly of skin,racial,Unknown,6,6,12
379006,Cerebral degeneration in childhood,racial,White,12,0,12
197320,ARF - Acute renal failure,racial,Black or African American ,5,7,12
28083,Primary malignant neoplasm of pharynx,racial,White,0,12,12
377550,Compression of brain,ethnic,Hispanic or Latino,10,2,12
436386,Severe depressed bipolar I disorder with psychotic features,ethnic,Hispanic or Latino,5,7,12
199192,Abrasion AND/OR friction burn of trunk without infection,racial,White,6,6,12
80800,Polymyositis,racial,White,11,1,12
4103640,Amputated foot,racial,White,0,12,12
442774,Intermittent claudication,racial,Black or African American ,1,11,12
135618,Prurigo,ethnic,Not Hispanic or Latino,4,8,12
72469,Closed dislocation of shoulder region,racial,Unknown,6,6,12
440697,Nonaggressive unsocial conduct disorder,ethnic,Hispanic or Latino,5,7,12
443414,Chronic post-traumatic stress disorder,racial,Black or African American ,2,10,12
440379,Episodic opioid dependence,ethnic,Hispanic or Latino,5,7,12
441969,Radiology result abnormal,ethnic,Not Hispanic or Latino,10,2,12
381677,SBO - Spina bifida occulta,ethnic,Hispanic or Latino,2,10,12
372610,Post-concussion syndrome,racial,White,6,6,12
4152167,Acute stress reaction NOS,ethnic,Hispanic or Latino,11,1,12
313223,Wegener granulomatosis,racial,White,1,11,12
81395,Metatarsus primus varus,racial,Unknown,0,12,12
442597,Meteorism,racial,Unknown,11,1,12
372721,Congenital anomaly of cerebrovascular system,ethnic,Hispanic or Latino,5,7,12
72501,Superficial foreign body of foot without major open wound AND without infection,ethnic,Hispanic or Latino,7,5,12
4305080,Abnormal breathing,racial,White,7,5,12
436059,Multiple myeloma in remission,ethnic,Hispanic or Latino,12,0,12
4164792,Hemophilus influenzae laryngitis,ethnic,Hispanic or Latino,10,2,12
444100,Mood disorder,racial,Black or African American ,3,9,12
442775,Degeneration of thoracic intervertebral disc,racial,White,7,5,12
134603,CML - Chronic myeloid leukaemia,racial,White,11,1,12
4340380,Hepatitis C carrier,racial,Asian,1,11,12
75382,Closed fractures of tarsal AND metatarsal bones,ethnic,Hispanic or Latino,9,3,12
378416,Retinal disorder,racial,White,9,3,12
134118,Atrophic condition of skin,racial,Other Race,5,7,12
137063,Corns and callus,racial,Asian,3,9,12
194526,Injury of trunk,ethnic,Hispanic or Latino,7,5,12
195562,Hemorrhoids,racial,American Indian or Alaska Native ,12,0,12
444429,Herpes simplex infection,racial,White,10,2,12
4129342,Nephrectomy of remaining or solitary kidney,ethnic,Hispanic or Latino,10,2,12
440979,Acquired hemolytic anemia,ethnic,Hispanic or Latino,4,8,12
379805,Myopia,racial,Asian,7,5,12
439937,C-reactive protein abnormal,ethnic,Not Hispanic or Latino,10,2,12
22281,Sickle cell disease,racial,Black or African American ,2,10,12
4164222,Tendon contracture,ethnic,Hispanic or Latino,8,4,12
377861,Disorder of refraction AND/OR accommodation,racial,Native Hawaiian or Other Pacific Islander ,7,5,12
78219,Cellulitis and abscess of hand excluding digits,racial,Unknown,8,4,12
437116,Closed fracture of distal end of radius,racial,White,10,2,12
374034,Visual disturbance,racial,Black or African American ,8,4,12
28127,"Multiple endocrine neoplasia, type 1",ethnic,Hispanic or Latino,8,4,12
317893,Paroxysmal supraventricular tachycardia,racial,Black or African American ,12,0,12
440704,Chronic pain syndrome,racial,Other Race,8,4,12
72374,Unstable lie with antenatal problem,ethnic,Hispanic or Latino,12,0,12
441678,"Gestation period, 33 weeks",ethnic,Hispanic or Latino,4,8,12
198363,Candidiasis of vagina,racial,Asian,12,0,12
138102,Benign tumour of skin,racial,Asian,8,4,12
314131,Degeneration of cervical intervertebral disc,racial,American Indian or Alaska Native ,8,4,12
444455,Benign tumour of soft tissue of head,racial,Unknown,12,0,12
195498,Benign tumour of kidney,ethnic,Not Hispanic or Latino,2,10,12
376229,Abnormal involuntary movement,racial,Other Race,9,3,12
438750,Old total retinal detachment,ethnic,Hispanic or Latino,6,6,12
4110499,Allergic rhinitis NOS,ethnic,Not Hispanic or Latino,7,5,12
441039,Phlebitis of lower limb vein,racial,Unknown,12,0,12
72986,Disease of lower leg,ethnic,Not Hispanic or Latino,0,12,12
197033,Endometriosis of pelvic peritoneum,racial,White,12,0,12
137497,Dermatophytosis of the body,racial,Asian,5,7,12
4239721,Seafood allergy,racial,White,7,5,12
4012491,Difficulty chewing,ethnic,Not Hispanic or Latino,5,7,12
378742,Blind hypotensive eye,racial,Other Race,0,11,11
439128,Extreme immaturity,ethnic,Hispanic or Latino,5,7,12
81237,Primary malignant neoplasm of upper limb bones and scapula,racial,Unknown,11,0,11
377853,Chronic tension-type headache,racial,Unknown,11,0,11
4044391,Diabetic neuropathy,racial,Unknown,5,7,12
433457,Agoraphobia without mention of panic attacks,ethnic,Hispanic or Latino,5,7,12
74728,Synovitis and tenosynovitis,ethnic,Not Hispanic or Latino,5,6,11
313791,Bundle branch block,ethnic,Hispanic or Latino,9,2,11
24818,Neck injury,ethnic,Not Hispanic or Latino,5,7,12
435798,"Nondependent opioid abuse, episodic",racial,Unknown,2,10,12
74138,Pathological fracture of vertebra,racial,White,8,4,12
81237,Primary malignant neoplasm of upper limb bones and scapula,ethnic,Hispanic or Latino,11,0,11
201998,Unilateral traumatic amputation of leg at OR above knee without complication,racial,Unknown,5,6,11
72404,Joint stiffness,ethnic,Hispanic or Latino,6,5,11
78508,Arthralgia of the ankle and/or foot,racial,Black or African American ,10,2,12
433450,Paranoid schizophrenia,racial,White,5,6,11
196473,Hypertrophy of uterus,ethnic,Not Hispanic or Latino,11,0,11
379806,Migraine variants,racial,White,7,5,12
81336,Rectal prolapse,ethnic,Hispanic or Latino,11,0,11
74188,Closed fracture of rib,ethnic,Not Hispanic or Latino,2,9,11
197676,Hepatomegaly,ethnic,Not Hispanic or Latino,5,7,12
434926,Iridocyclitis,ethnic,Not Hispanic or Latino,10,1,11
444202,Abscess,racial,Filipino,8,4,12
439694,Hypertensive heart and renal disease with both (congestive) heart failure and renal failure,ethnic,Not Hispanic or Latino,0,11,11
444071,Furuncle of forearm,racial,White,3,8,11
195321,Postmenopausal bleeding,racial,Asian,11,0,11
139900,Urticaria,racial,Asian,5,6,11
378544,Subdural and cerebral hemorrhage due to birth trauma,ethnic,Hispanic or Latino,9,2,11
72986,Disease of lower leg,racial,Unknown,3,8,11
30234,Cervical sprain,racial,Asian,7,4,11
141371,PR - Pityriasis rosea,ethnic,Not Hispanic or Latino,7,5,12
80815,Mucous cyst of skin,ethnic,Not Hispanic or Latino,9,2,11
443728,Mass of chest wall,racial,Other Race,10,2,12
254068,Upper respiratory disease,ethnic,Not Hispanic or Latino,6,5,11
436670,MD - Metabolic disorders,ethnic,Not Hispanic or Latino,10,1,11
435925,Very premature - less than 1000g or less than 28 weeks,ethnic,Hispanic or Latino,11,1,12
195339,Decubitus ulcer of hip,ethnic,Hispanic or Latino,5,6,11
4346969,Joint mice in knee,ethnic,Hispanic or Latino,5,7,12
441805,Primary malignant neoplasm of endocervix,ethnic,Hispanic or Latino,11,0,11
444247,Venous thrombosis,racial,Unknown,1,11,12
201626,Mid-cycle pain,ethnic,Hispanic or Latino,11,0,11
440529,Abnormal findings on diagnostic imaging of urinary organs,ethnic,Not Hispanic or Latino,11,1,12
141095,Acne,racial,Native Hawaiian or Other Pacific Islander ,6,5,11
197981,Abdominal tenderness,racial,Unknown,8,4,12
441589,Endocarditis,ethnic,Hispanic or Latino,11,0,11
442609,Friction blister without infection,racial,White,6,5,11
439224,Drug allergy,racial,Unknown,7,4,11
312728,Congenital tricuspid atresia and stenosis,ethnic,Hispanic or Latino,11,0,11
378523,Residual foreign body in soft tissue,racial,White,4,7,11
444433,Open wound of toe with complication,ethnic,Hispanic or Latino,10,1,11
4204966,Regurgitant esophagitis,ethnic,Hispanic or Latino,5,7,12
78529,Kyphoscoliosis and scoliosis,ethnic,Not Hispanic or Latino,10,2,12
318222,Acute adenitis,ethnic,Not Hispanic or Latino,10,2,12
440653,Infection by toxoplasma gondii,ethnic,Hispanic or Latino,0,11,11
77129,Closed fracture of pelvis,racial,Unknown,11,1,12
317893,Paroxysmal supraventricular tachycardia,racial,Asian,11,0,11
312935,Venous hypertension,racial,Unknown,2,9,11
374940,Blepharophimosis syndrome,ethnic,Hispanic or Latino,1,11,12
312934,Atherosclerosis of aorta,racial,Native Hawaiian or Other Pacific Islander ,11,0,11
134976,Complex dental caries,racial,White,5,6,11
197320,ARF - Acute renal failure,racial,Asian,4,8,12
201079,Acute parametritis and pelvic cellulitis,racial,White,11,1,12
134442,Thibierge-Weissenbach syndrome,racial,White,8,4,12
194382,External haemorrhoid,ethnic,Not Hispanic or Latino,8,3,11
81454,Injury of finger,racial,Unknown,8,4,12
435797,Selective immunoglobulin dysfunction,racial,White,11,0,11
440386,Transsexualism,racial,White,4,8,12
259123,Congenital subaortic stenosis,racial,Unknown,11,0,11
317585,Aortic aneurysm,ethnic,Not Hispanic or Latino,0,11,11
443723,Finding of cellular component of blood,ethnic,Not Hispanic or Latino,6,5,11
443728,Mass of chest wall,racial,Asian,0,11,11
312337,Arterial embolic and thrombotic occlusion,racial,White,9,2,11
135360,Fainting,racial,Other Race,9,2,11
136934,Primary hyperparathyroidism,racial,Unknown,11,0,11
137682,Skin sensation disturbance,racial,Black or African American ,6,5,11
134438,CD - Contact dermatitis,racial,American Indian or Alaska Native ,9,2,11
193493,Benign hypertensive renal disease,ethnic,Hispanic or Latino,10,1,11
192276,Chronic gouty nephropathy,ethnic,Hispanic or Latino,3,8,11
434628,Separation anxiety,ethnic,Hispanic or Latino,6,5,11
78097,Metastatic tumour of bone,racial,White,11,0,11
4113027,Dietary intake observations,racial,Other Race,7,5,12
196369,Adrenogenital disorder,ethnic,Hispanic or Latino,6,5,11
4287544,Manic bipolar I disorder,racial,Black or African American ,1,11,12
437264,Tobacco dependence syndrome,racial,Filipino,1,10,11
438168,Aneurysm of heart,ethnic,Hispanic or Latino,8,3,11
75614,Acrodermatitis continua,racial,Other Race,5,6,11
4006788,Percutaneous transluminal coronary balloon angioplasty,ethnic,Hispanic or Latino,5,6,11
4141492,Other ill-defined heart disease,racial,Unknown,9,2,11
137065,Nonstageable pressure ulcer,ethnic,Hispanic or Latino,11,1,12
197006,Residual hemorrhoidal skin tags,ethnic,Hispanic or Latino,7,4,11
140173,Telogen effluvium,ethnic,Hispanic or Latino,11,0,11
73923,"Contusion, upper arm",racial,Unknown,10,2,12
432738,Iceland disease,racial,Black or African American ,10,2,12
376415,Hypermetropia,ethnic,Not Hispanic or Latino,4,8,12
134074,Oral soft tissue cellulitis,ethnic,Not Hispanic or Latino,3,8,11
443012,Diabetes mellitus during pregnancy - baby delivered,ethnic,Hispanic or Latino,11,0,11
79768,Neoplasm of urinary system,racial,Unknown,4,7,11
434207,"Insect bite, nonvenomous, of hand, without mention of infection",ethnic,Hispanic or Latino,6,5,11
436100,Narcolepsy,racial,White,0,11,11
140648,Onychomycosis due to dermatophyte,racial,Native Hawaiian or Other Pacific Islander ,8,4,12
375819,TM - Tympanic membrane disorder,ethnic,Hispanic or Latino,5,7,12
4059637,Work environment deleterious,racial,White,7,4,11
132393,Pressure ulcer stage 1,racial,White,7,4,11
437243,Chronic paranoid schizophrenia with acute exacerbation,ethnic,Hispanic or Latino,0,11,11
77968,Hallux valgus AND bunion,racial,Other Race,8,4,12
4143915,Cholestasis,ethnic,Hispanic or Latino,10,2,12
432461,"Closed fracture clavicle, shaft",racial,White,8,3,11
434701,"Anemia in mother complicating pregnancy, childbirth AND/OR puerperium",racial,White,11,0,11
440360,Pure hyperglyceridemia,racial,Native Hawaiian or Other Pacific Islander ,9,2,11
436298,Adverse reaction to food,racial,Other Race,5,7,12
4298697,Multiple open wounds without complication,racial,Asian,4,7,11
440279,Accident,racial,Unknown,7,5,12
435785,Meningitis,racial,White,7,4,11
317510,Leukaemia,ethnic,Hispanic or Latino,3,8,11
433657,Fall from furniture,racial,White,7,4,11
199767,Neoplasm of uncertain behaviour of liver and/or biliary passages,racial,Unknown,2,9,11
78472,Microscopic haematuria,racial,Other Race,7,5,12
4161978,Patient on oxygen,racial,Other Race,9,2,11
201899,Unilateral recurrent inguinal hernia,ethnic,Not Hispanic or Latino,2,10,12
372599,Severe mixed bipolar I disorder without psychotic features,ethnic,Hispanic or Latino,3,8,11
444247,Venous thrombosis,ethnic,Not Hispanic or Latino,5,7,12
314659,Arteritis,racial,Unknown,10,1,11
375549,Double pterygium,racial,White,4,7,11
439014,Panuveitis,racial,White,11,0,11
444132,Knee injury,racial,Other Race,3,8,11
73840,Primary localised osteoarthrosis of shoulder region,ethnic,Not Hispanic or Latino,7,5,12
78560,Congenital deformity and malformation of feet and toes,ethnic,Hispanic or Latino,4,7,11
321661,Spinal stenosis of thoracic region,ethnic,Hispanic or Latino,11,0,11
192956,Cholecystitis,racial,Unknown,8,3,11
434172,Insomnia with sleep apnoea,racial,Unknown,0,11,11
432310,Meningitis due to cryptococcus,racial,White,0,11,11
30361,Hypoglycemic disorder,racial,White,9,2,11
433000,Patellar tendonitis,ethnic,Not Hispanic or Latino,5,6,11
435889,Decubitus ulcer of ankle,racial,Unknown,4,7,11
320744,Complete atrioventricular block,racial,White,4,8,12
440921,Traumatic injury,ethnic,Not Hispanic or Latino,3,8,11
432590,Delusional disorder,ethnic,Not Hispanic or Latino,4,7,11
4048727,Neoplasm screening,racial,Unknown,6,5,11
76791,Acquired deformity of hip,ethnic,Not Hispanic or Latino,1,10,11
443774,"Disease condition determination, uncontrolled",racial,Unknown,9,2,11
80813,Lumbosacral spondylosis without myelopathy,racial,Asian,9,2,11
441793,Infection due to Class Cestoda and/or Class Trematoda and/or Phylum Nemata,ethnic,Hispanic or Latino,6,5,11
373200,Chronic fungal otitis externa,ethnic,Hispanic or Latino,8,4,12
435553,Watery eye,racial,White,7,5,12
76835,Closed dislocation of elbow,ethnic,Hispanic or Latino,5,7,12
443431,Disorder of menstruation,racial,Asian,11,0,11
314059,Right bundle branch block,racial,Asian,5,7,12
433527,Endometriosis,ethnic,Not Hispanic or Latino,11,0,11
138278,Sprains and strains of joints and adjacent muscles,racial,Black or African American ,5,7,12
442011,Mechanical complication due to cardiac pacemaker electrode,ethnic,Hispanic or Latino,10,1,11
4005743,Female sterility,racial,White,11,0,11
73819,Painful breasts,racial,Asian,11,1,12
193308,Congenital anomaly of spleen,racial,White,5,6,11
439727,HIV - Human immunodeficiency virus infection,racial,Other Race,8,3,11
197381,Epigastric pain,racial,American Indian or Alaska Native ,11,1,12
436944,Chronic paranoid schizophrenia,ethnic,Not Hispanic or Latino,0,11,11
439141,Abnormal increase in weight,racial,Black or African American ,6,5,11
443257,Swellings and lumps,racial,Black or African American ,10,2,12
4152813,Family disruption,racial,Unknown,2,9,11
318521,Displacement of thoracic intervertebral disc without myelopathy,ethnic,Hispanic or Latino,11,1,12
439391,Physical abuse of adult,racial,White,11,0,11
197924,Bile duct calculus with acute cholecystitis and obstruction,racial,Unknown,7,5,12
4167406,Eye disorder screening,ethnic,Not Hispanic or Latino,8,3,11
380103,Retinal detachment with retinal defect,racial,White,3,8,11
137053,Seborrheic dermatitis,racial,Black or African American ,5,7,12
4185302,Chronic myocardial ischemia,ethnic,Not Hispanic or Latino,2,10,12
432801,"Injury undetermined whether accidentally or purposely inflicted, fall from natural site",racial,Unknown,10,2,12
194475,Singultus,racial,Unknown,0,11,11
197913,Disorder of function of stomach,racial,American Indian or Alaska Native ,8,4,12
76836,Sprain of knee and leg,racial,Black or African American ,5,7,12
200848,Dribbling of urine,ethnic,Hispanic or Latino,1,10,11
435093,Closed fracture of femur,ethnic,Not Hispanic or Latino,2,10,12
74513,Open wound of foot without mention of complication,ethnic,Not Hispanic or Latino,7,4,11
434329,Spinocerebellar disease,ethnic,Hispanic or Latino,11,1,12
74322,Benign neoplasm of scrotum,ethnic,Hispanic or Latino,0,11,11
194079,Post-surgical malabsorption,ethnic,Not Hispanic or Latino,7,5,12
140190,Disorder of back,racial,White,8,4,12
4210151,HIV counseling,ethnic,Not Hispanic or Latino,5,6,11
432582,Neoplastic disease of uncertain behavior,ethnic,Not Hispanic or Latino,2,9,11
434872,Infection by Trichomonas,ethnic,Hispanic or Latino,10,1,11
73338,Sprain of lateral collateral ligament of knee,racial,White,5,6,11
4100912,Screening for rheumatoid conditions,racial,White,11,0,11
4062484,Cervical neoplasia screening,racial,Filipino,11,0,11
435789,Megaloblastic anemia,ethnic,Hispanic or Latino,7,5,12
255334,Collagen disease,racial,Unknown,11,0,11
256440,Disorder of paranasal sinuses,racial,Black or African American ,7,5,12
436381,Gender identity disorder of childhood,ethnic,Hispanic or Latino,2,9,11
433753,Alcohol abuse,racial,Black or African American ,1,11,12
197237,Benign tumour of prostate,ethnic,Not Hispanic or Latino,0,11,11
434622,Deficiency anemias,ethnic,Not Hispanic or Latino,10,2,12
75689,Contusion of breast,ethnic,Hispanic or Latino,11,0,11
317302,Coronary sinus rhythm disorder,racial,Black or African American ,8,3,11
140259,Open wound of face without complication,ethnic,Not Hispanic or Latino,4,8,12
375826,Central hearing loss,ethnic,Not Hispanic or Latino,7,4,11
133835,Dermatitis,racial,Black or African American ,5,6,11
434549,Fall from toilet seat,ethnic,Hispanic or Latino,9,2,11
381570,Mechanical ptosis,ethnic,Hispanic or Latino,3,8,11
434007,Congenital factor VIII deficiency,ethnic,Hispanic or Latino,1,10,11
443723,Finding of cellular component of blood,ethnic,Hispanic or Latino,10,1,11
137989,Abnormal results of cardiovascular function studies,ethnic,Hispanic or Latino,4,7,11
443417,Villonodular synovitis of lower limb,ethnic,Hispanic or Latino,10,1,11
133729,Hyperparathyroidism,racial,Asian,10,1,11
77642,Arthralgia of the forearm,racial,Other Race,5,6,11
4331899,Child in family care,ethnic,Not Hispanic or Latino,4,7,11
193186,Cauda equina syndrome with neurogenic bladder,racial,Unknown,11,0,11
253954,PTB - Pulmonary tuberculosis,ethnic,Not Hispanic or Latino,8,3,11
436670,MD - Metabolic disorders,racial,Unknown,3,8,11
4247802,Muscular dystrophy,ethnic,Not Hispanic or Latino,2,9,11
437557,Eczematous dermatitis of eyelid,ethnic,Hispanic or Latino,11,0,11
441604,Acute appendicitis without peritonitis,racial,White,5,6,11
75576,Colon spasm,racial,Asian,9,2,11
4105187,Speech or language developmental disorder NOS,racial,Unknown,1,10,11
201756,Lumbar cord injury without spinal bone injury,racial,Black or African American ,0,11,11
4171430,Screening for malignant neoplasm of rectum,racial,Black or African American ,3,8,11
440927,High risk drug monitoring status,racial,Black or African American ,11,0,11
434119,Hidradenitis,racial,Unknown,9,2,11
200219,Abdominal pain,racial,Filipino,8,3,11
74892,Articular gout,racial,Native Hawaiian or Other Pacific Islander ,11,0,11
197332,Incomplete uterovaginal prolapse,racial,White,11,0,11
139900,Urticaria,racial,Native Hawaiian or Other Pacific Islander ,11,0,11
75576,Colon spasm,racial,Black or African American ,7,4,11
437843,Childhood conduct disorder,racial,White,2,9,11
375281,Acute suppurative otitis media - tympanic membrane intact,racial,American Indian or Alaska Native ,9,2,11
198199,Pyelonephritis,racial,Other Race,7,4,11
435797,Selective immunoglobulin dysfunction,ethnic,Not Hispanic or Latino,11,0,11
443909,"Decreased level, laboratory test",ethnic,Hispanic or Latino,6,5,11
198853,Congenital anomaly of ovary,ethnic,Not Hispanic or Latino,11,0,11
433735,Alcohol dependence with acute alcoholic intoxication,racial,White,1,10,11
373185,Drug-induced dyskinesia,racial,Unknown,7,4,11
75044,"Stiff joint NEC, of the hand",racial,White,7,4,11
77395,Current tear of semilunar cartilage,ethnic,Not Hispanic or Latino,5,6,11
132466,Lumbar sprain,racial,Other Race,6,5,11
23220,Chronic tonsillitis,racial,Unknown,7,4,11
141933,Alopecia areata,ethnic,Not Hispanic or Latino,6,5,11
440360,Pure hyperglyceridemia,racial,Filipino,4,7,11
321080,"Hypertension complicating pregnancy, childbirth and the puerperium",racial,White,10,1,11
440905,Toxic effect of venom,ethnic,Not Hispanic or Latino,8,2,10
439005,Chronic alcoholism in remission,racial,Unknown,1,10,11
435515,Hypo-osmolality and or hyponatremia,racial,Black or African American ,1,10,11
77987,Respiratory observations of chest,ethnic,Not Hispanic or Latino,8,2,10
79903,Effusion of joint,ethnic,Hispanic or Latino,6,5,11
4064375,Iron deficiency screening,racial,Native Hawaiian or Other Pacific Islander ,5,6,11
73819,Painful breasts,racial,Other Race,11,0,11
75941,Closed fracture of one rib,ethnic,Hispanic or Latino,7,4,11
4062488,Thyroid disorder screening,racial,Unknown,10,1,11
316135,AVB - Atrioventricular block,racial,White,0,11,11
30679,Benign tumour major salivary gland,racial,Unknown,9,2,11
135778,Toxic multinodular goitre,ethnic,Hispanic or Latino,11,0,11
75095,Closed fracture of ankle,racial,Black or African American ,8,3,11
380111,Acute atopic conjunctivitis,ethnic,Not Hispanic or Latino,5,5,10
79917,Acquired deformity of toe,racial,White,8,2,10
437831,"Recurrent manic episodes, in full remission",ethnic,Hispanic or Latino,4,7,11
376657,Lipoma of face,racial,White,4,7,11
313223,Wegener granulomatosis,ethnic,Hispanic or Latino,1,10,11
196163,Cervicitis and endocervicitis,racial,Unknown,11,0,11
25844,Ulcer of esophagus,ethnic,Hispanic or Latino,4,7,11
374919,Disseminated sclerosis,racial,Asian Indian,0,11,11
381839,Habit disorder,ethnic,Not Hispanic or Latino,3,8,11
136917,Primary malignant neoplasm of skin of face,ethnic,Hispanic or Latino,10,1,11
433257,Mesangiocapillary glomerulonephritis,ethnic,Hispanic or Latino,5,6,11
441838,Personality disorder,racial,White,2,8,10
439961,Superficial injury without infection,ethnic,Hispanic or Latino,8,2,10
318397,Chronic idiopathic thrombocytopenic purpura,racial,Unknown,7,4,11
377888,CHL - Conductive hearing loss,racial,Native Hawaiian or Other Pacific Islander ,0,11,11
440321,Helicobacter-associated disease,racial,Black or African American ,8,3,11
74322,Benign neoplasm of scrotum,racial,White,0,11,11
81379,Lateral epicondylitis,racial,Asian,8,3,11
380733,Otalgia,racial,Black or African American ,7,4,11
432791,Urticaria-angio-oedema,racial,Unknown,8,3,11
141253,Disease of thyroid gland,racial,Other Race,6,5,11
199764,Benign ovarian tumour,ethnic,Hispanic or Latino,11,0,11
381572,Abducens nerve palsy,racial,White,2,9,11
196456,Cholecystolithiasis,racial,Black or African American ,7,4,11
436666,Psychosexual disorder,racial,White,4,7,11
436675,Anorexia nervosa,ethnic,Hispanic or Latino,10,1,11
372425,Congenital abnormality of ear,ethnic,Hispanic or Latino,7,4,11
318222,Acute adenitis,racial,Unknown,6,5,11
378253,HA - Headache,racial,Filipino,7,4,11
195873,Leukorrhagia,racial,Other Race,11,0,11
254068,Upper respiratory disease,racial,Unknown,8,3,11
4168217,Generalized hyperhidrosis,ethnic,Not Hispanic or Latino,5,6,11
438879,Closed bimalleolar fracture,racial,White,6,5,11
4101602,Henoch-Schonlein purpura,racial,Unknown,10,1,11
4272867,General well-being finding,racial,Other Race,4,7,11
196456,Cholecystolithiasis,racial,American Indian or Alaska Native ,10,1,11
444243,Neurotic disorder,racial,Unknown,5,5,10
432312,Anatomical narrow angle glaucoma,racial,White,0,11,11
316211,Acquired spondylolisthesis,racial,Other Race,1,10,11
440032,CMV - Cytomegalovirus infection,ethnic,Hispanic or Latino,0,11,11
434500,Closed fracture of neck of femur,ethnic,Not Hispanic or Latino,9,2,11
316998,Left bundle branch block,ethnic,Not Hispanic or Latino,8,2,10
194984,Hepatopathy,racial,Asian,8,2,10
78200,Benign mammary dysplasia,ethnic,Not Hispanic or Latino,11,0,11
441497,Brucellosis,ethnic,Hispanic or Latino,10,1,11
201756,Lumbar cord injury without spinal bone injury,ethnic,Hispanic or Latino,0,11,11
433125,Infection due to Staphylocccus aureus,ethnic,Not Hispanic or Latino,4,7,11
198853,Congenital anomaly of ovary,racial,Asian,11,0,11
256451,Bronchitis,racial,American Indian or Alaska Native ,7,4,11
432941,Disease of tongue,racial,Unknown,7,4,11
132489,Partial thickness burn of finger,racial,Unknown,9,2,11
444090,Disease of foot,ethnic,Not Hispanic or Latino,10,1,11
435875,"Complications of pregnancy, childbirth and the puerperium",ethnic,Not Hispanic or Latino,10,1,11
4098311,Borderline psychosis of childhood,ethnic,Hispanic or Latino,1,10,11
441946,Calcific tendinitis of shoulder,racial,Unknown,10,1,11
73843,Synovial cyst of popliteal space,ethnic,Not Hispanic or Latino,4,7,11
319041,Orthostatic hypotension,racial,Asian,0,11,11
442862,"Abrasion or friction burn of hand, without mention of infection",ethnic,Hispanic or Latino,4,7,11
312664,Influenza with respiratory manifestation other than pneumonia,racial,Black or African American ,4,7,11
201072,Benign prostatic hypertrophy without outflow obstruction,racial,Unknown,0,11,11
201956,Congenital anomaly of lower limb,ethnic,Hispanic or Latino,8,2,10
74698,Breech presentation,ethnic,Hispanic or Latino,10,1,11
72457,Closed fracture of sacrum AND/OR coccyx without spinal cord injury,racial,White,10,1,11
133727,Thyrotoxicosis without goiter OR other cause,racial,Other Race,8,2,10
442008,Injury at T7-T12 level with spinal cord injury AND without bone injury,ethnic,Hispanic or Latino,0,11,11
4340379,Hepatitis B carrier,racial,Black or African American ,6,5,11
198062,"Infectious colitis, enteritis and gastroenteritis",ethnic,Not Hispanic or Latino,6,5,11
4112831,Extrinsic asthma NOS,ethnic,Not Hispanic or Latino,9,2,11
381306,Deaf mutism,racial,Asian,5,5,10
438878,Abnormal results of liver function studies,racial,Asian,5,6,11
200662,Lymphosarcoma,racial,White,8,3,11
78257,Osteogenesis imperfecta,ethnic,Not Hispanic or Latino,1,10,11
438788,Hypertrophy of adenoids,racial,White,1,10,11
254980,Intrinsic asthma with asthma attack,racial,White,5,5,10
434316,von Willebrand disorder,ethnic,Hispanic or Latino,1,10,11
438447,Acute myocardial infarction of inferolateral wall,racial,White,1,10,11
193326,Urge incontinence of urine,racial,American Indian or Alaska Native ,11,0,11
4104710,Parkinson's disease NOS,racial,White,9,2,11
74194,Back sprain,ethnic,Not Hispanic or Latino,6,5,11
192440,Ureterocele,racial,White,11,0,11
4146248,Rheumatoid arthritis and other inflammatory polyarthropathies,racial,White,7,4,11
316127,Vitreous opacities,ethnic,Not Hispanic or Latino,6,5,11
80805,Primary localized osteoarthrosis of forearm,racial,White,4,7,11
25518,AS - Sickle cell trait,racial,White,4,7,11
4088930,Confirmation of pregnancy,racial,Asian,11,0,11
434894,Acute post-hemorrhagic anemia,racial,White,5,5,10
140654,Deep seated dermatophytosis,ethnic,Hispanic or Latino,4,7,11
141094,Lichen,ethnic,Hispanic or Latino,7,4,11
196217,Congenital malformation of diaphragm,racial,White,5,5,10
321887,Disorder of artery,ethnic,Not Hispanic or Latino,8,2,10
433909,Foreign body on external eye,racial,White,1,10,11
4211231,Panic disorder without agoraphobia,racial,Other Race,10,1,11
435443,[X]Fall involving wheelchair,ethnic,Hispanic or Latino,9,2,11
438480,"Abnormal glucose tolerance in mother complicating pregnancy, childbirth AND/OR puerperium",racial,Asian,11,0,11
441542,Anxiety,racial,Native Hawaiian or Other Pacific Islander ,10,1,11
433751,Prolonged depressive adjustment reaction,racial,Unknown,6,5,11
74816,Contusion of toe,ethnic,Not Hispanic or Latino,5,6,11
441428,Closed fracture of lateral malleolus,ethnic,Not Hispanic or Latino,7,4,11
192440,Ureterocele,ethnic,Hispanic or Latino,11,0,11
435242,Cerebellar ataxia,racial,Unknown,11,0,11
4008573,Advanced open-angle glaucoma,ethnic,Hispanic or Latino,7,4,11
432904,Blood in anterior chamber,racial,Unknown,9,2,11
4240902,Allergy to peanuts,racial,Unknown,2,8,10
4130036,Brain damage due to hypoxia,ethnic,Hispanic or Latino,4,7,11
439162,"Closed fracture ankle, medial malleolus",racial,White,10,1,11
78097,Metastatic tumour of bone,racial,Asian,11,0,11
194696,Menorrhalgia,racial,Black or African American ,11,0,11
381290,Ocular hypertension,racial,White,8,2,10
194081,Acute cystitis,racial,Asian,9,2,11
440612,Toxic effect of tobacco and nicotine,ethnic,Hispanic or Latino,5,5,10
193186,Cauda equina syndrome with neurogenic bladder,ethnic,Hispanic or Latino,11,0,11
312935,Venous hypertension,ethnic,Not Hispanic or Latino,4,7,11
438827,Foreign body granuloma of subcutaneous tissue,ethnic,Hispanic or Latino,7,4,11
260139,Acute bronchitis,racial,American Indian,5,5,10
195977,Contusion of trunk,racial,Unknown,8,3,11
81426,Closed fracture of clavicle,ethnic,Not Hispanic or Latino,5,5,10
77067,Bucket handle tear of lateral meniscus,ethnic,Not Hispanic or Latino,11,0,11
257907,Disorder of lung,racial,Black or African American ,1,10,11
72737,Microcalcifications of the breast,racial,Asian,11,0,11
199886,Simple endometrial hyperplasia,ethnic,Hispanic or Latino,11,0,11
28385,Disorder of posterior pituitary,racial,Unknown,10,1,11
441269,Autoimmune hemolytic anemia,racial,White,11,0,11
434916,"Amfetamine or psychostimulant dependence, continuous",ethnic,Hispanic or Latino,3,8,11
4195572,"Mild major depression, single episode",racial,Other Race,9,2,11
135360,Fainting,racial,Black or African American ,7,4,11
437113,Asthenia,racial,Unknown,7,4,11
201078,Senile atrophic vaginitis,racial,Other Race,11,0,11
441497,Brucellosis,racial,White,10,1,11
261782,Herpetic ulceration of vulva,ethnic,Not Hispanic or Latino,11,0,11
313761,Central retinal vein occlusion,racial,Unknown,6,5,11
4108982,Cataract associated with other syndromes,racial,Unknown,5,5,10
374914,Quadriplegia,ethnic,Not Hispanic or Latino,1,10,11
192687,Vulvovaginitis associated with another disease,racial,Unknown,11,0,11
315830,Variant angina,ethnic,Hispanic or Latino,10,1,11
141955,Pectus excavatum,ethnic,Hispanic or Latino,2,8,10
77067,Bucket handle tear of lateral meniscus,racial,Unknown,11,0,11
193518,Intestinal obstruction,racial,Unknown,5,6,11
256448,Chronic asthmatic bronchitis,racial,Asian,8,2,10
138519,Spondylosis without myelopathy,racial,Asian,4,7,11
4101068,Observation of ear discharge,racial,White,6,4,10
4272867,General well-being finding,racial,Asian,6,4,10
195079,Functional urinary incontinence,ethnic,Not Hispanic or Latino,8,2,10
200762,Autoimmune hepatitis,racial,White,7,3,10
77365,Disuse osteoporosis,ethnic,Hispanic or Latino,7,3,10
4204966,Regurgitant esophagitis,racial,White,3,7,10
138113,Cyst of thyroid,racial,Asian,10,0,10
440207,Hypoplastic left heart syndrome,ethnic,Hispanic or Latino,7,4,11
376224,Spina bifida without hydrocephalus,racial,Unknown,3,7,10
4096665,Diabetes mellitus with no mention of complication,racial,Unknown,5,5,10
437221,Chlamydia trachomatis infection,racial,White,10,1,11
77072,Joint effusion of ankle AND/OR foot,racial,Unknown,6,4,10
133424,Primary malignant neoplasm of thyroid gland,racial,Asian,9,1,10
440855,Closed fracture of base of metacarpal bone other than first metacarpal,ethnic,Hispanic or Latino,6,4,10
435081,Abnormal findings on diagnostic imaging of heart and coronary circulation,ethnic,Hispanic or Latino,5,5,10
141094,Lichen,racial,White,6,4,10
438244,Congenital hydrocephalus,ethnic,Not Hispanic or Latino,4,7,11
373212,Esophoria,ethnic,Hispanic or Latino,7,4,11
443943,Herpes zoster,racial,Unknown,8,2,10
441201,"[X]Fall from, out of or through building or structure",racial,Unknown,4,6,10
434942,Postseptal orbital cellulitis,racial,White,5,5,10
200771,Peptic ulcer without hemorrhage AND without perforation but with obstruction,ethnic,Hispanic or Latino,6,4,10
375827,Acute non-suppurative otitis media - serous,racial,Other Race,5,5,10
72715,Exostosis,ethnic,Not Hispanic or Latino,8,2,10
439254,"Bipolar affective disorder, current episode depression",ethnic,Hispanic or Latino,10,1,11
72986,Disease of lower leg,racial,American Indian or Alaska Native ,0,10,10
140480,Impetigo,racial,Other Race,5,5,10
136264,Open wound of floor of mouth without complication,ethnic,Hispanic or Latino,6,4,10
4046893,Lifestyle,ethnic,Not Hispanic or Latino,3,7,10
435508,Adrenal cortical hypofunction,racial,Black or African American ,0,10,10
256531,Head and neck swelling,racial,Black or African American ,7,3,10
4326601,Anorectal abscess,racial,Unknown,4,7,11
75580,Chronic ulcerative proctitis,racial,White,10,1,11
136788,Spinal stenosis of lumbar region,racial,American Indian or Alaska Native ,10,0,10
439697,Hypertensive renal disease with renal failure,racial,Black or African American ,4,7,11
444285,Acquired equinovarus deformity,racial,White,7,4,11
74728,Synovitis and tenosynovitis,racial,Unknown,8,2,10
378752,Corneal opacity,racial,White,8,2,10
78273,Closed fracture multiple ribs,racial,White,5,5,10
4258683,Faeces - impacted,ethnic,Hispanic or Latino,5,5,10
443415,Gestation greater than 24 weeks,ethnic,Not Hispanic or Latino,8,2,10
435511,Hypercalcemia,racial,Other Race,4,6,10
75614,Acrodermatitis continua,racial,Filipino,1,10,11
134898,Non-toxic single thyroid nodule,racial,Other Race,6,4,10
436477,Abnormal products of conception,ethnic,Hispanic or Latino,10,0,10
4005933,Urethral meatus underneath penis,ethnic,Not Hispanic or Latino,0,10,10
376399,Incipient cataract,ethnic,Hispanic or Latino,8,2,10
435120,Blister of toe with infection,ethnic,Hispanic or Latino,7,4,11
141941,Cervical spondylosis without myelopathy,racial,Asian,10,0,10
4066376,Pilonidal sinus with abscess,racial,Unknown,2,8,10
132932,Chronic ethmoidal sinusitis,racial,White,7,4,11
432868,Hemoglobinopathy,ethnic,Hispanic or Latino,5,5,10
441264,Primary thrombocytopenia,racial,Black or African American ,0,10,10
195847,Gastroparesis syndrome,ethnic,Not Hispanic or Latino,5,5,10
201418,"Flatulence, eructation and gas pain",racial,Other Race,9,1,10
4213085,Family history of prostate cancer,racial,White,0,10,10
30679,Benign tumour major salivary gland,racial,White,10,0,10
72245,Chlamydial infection of lower genitourinary tract,racial,White,9,1,10
135032,Dermatitis due to substances taken internally,ethnic,Hispanic or Latino,8,2,10
435569,Disorder of jaw,racial,White,1,10,11
133510,Rapidly progressive periodontitis,ethnic,Hispanic or Latino,7,4,11
312728,Congenital tricuspid atresia and stenosis,racial,Unknown,10,0,10
72457,Closed fracture of sacrum AND/OR coccyx without spinal cord injury,racial,Unknown,10,1,11
80182,Dermatomyositis,ethnic,Hispanic or Latino,7,4,11
76191,Disease of upper arm,racial,Unknown,10,0,10
436231,Abnormal findings diagnostic imaging of liver and biliary tract,racial,White,7,4,11
73300,Radial styloid tenosynovitis,ethnic,Not Hispanic or Latino,8,2,10
440953,Cysticercosis,racial,White,5,5,10
317893,Paroxysmal supraventricular tachycardia,racial,Native Hawaiian or Other Pacific Islander ,10,0,10
197672,Urinary incontinence,racial,American Indian or Alaska Native ,10,0,10
435751,Primary malignant neoplasm of fundus of stomach,racial,White,0,10,10
73089,Contusion of buttock,racial,Unknown,8,2,10
4138253,Malabsorption syndrome,ethnic,Not Hispanic or Latino,10,1,11
375815,Bullous keratopathy,ethnic,Hispanic or Latino,7,3,10
438350,Pneumocystosis,racial,White,0,10,10
4115370,Arthralgia NOS,racial,White,9,1,10
313792,PT - Paroxysmal tachycardia,racial,White,10,1,11
261889,Simple chronic bronchitis,racial,Black or African American ,2,8,10
4298854,HIV seropositivity,racial,Other Race,0,10,10
434316,von Willebrand disorder,racial,White,1,10,11
40389902,"Neoplasm of uncertain behavior of pleura, thymus and mediastinum",ethnic,Not Hispanic or Latino,0,10,10
432447,Atypical glandular cells on cervical Papanicolaou smear,ethnic,Not Hispanic or Latino,10,0,10
434821,SIRS - System inflammatory response syndrome,ethnic,Not Hispanic or Latino,5,5,10
437251,Benign neoplasm of pituitary gland and craniopharyngeal duct,racial,Asian,10,0,10
77592,Articular crepitus of temporomandibular joint,ethnic,Hispanic or Latino,4,6,10
77373,Congenital deformity of hip joint,ethnic,Not Hispanic or Latino,9,1,10
433647,Poisoning by central nervous system muscle tone depressant,ethnic,Hispanic or Latino,10,0,10
133436,Thyrotoxic crisis,racial,American Indian or Alaska Native ,10,0,10
376112,Diabetic polyneuropathy,racial,Filipino,1,9,10
4126282,Chlamydial urethritis,ethnic,Hispanic or Latino,6,4,10
436263,Broken tooth without complication,racial,Unknown,5,5,10
4092896,Stool contents abnormal,racial,Black or African American ,7,3,10
196328,Enteric paratyphosis,ethnic,Hispanic or Latino,2,8,10
197494,Viral hepatitis C,racial,Other Race,1,9,10
4098311,Borderline psychosis of childhood,racial,White,1,10,11
375504,Psychoactive substance-induced organic mental disorder,racial,White,4,7,11
433750,"Single major depressive episode, in full remission",ethnic,Not Hispanic or Latino,5,5,10
375550,Senile corneal changes,ethnic,Hispanic or Latino,4,6,10
444382,Thoracic radiculitis,racial,Other Race,7,3,10
4108817,"Tricuspid valve disorders, non-rheumatic",racial,White,3,7,10
254591,Secondary malignant tumour of lung,racial,Asian,3,7,10
435904,Derangement of anterior horn of medial meniscus,ethnic,Hispanic or Latino,5,5,10
434169,Abnormal findings on diagnostic imaging of breast,racial,American Indian or Alaska Native ,10,0,10
78835,Palindromic rheumatism of the lower leg,racial,Asian,6,4,10
436166,Mild hyperemesis gravidarum,ethnic,Not Hispanic or Latino,10,0,10
313236,Cough variant asthma,racial,Native Hawaiian or Other Pacific Islander ,8,2,10
40389902,"Neoplasm of uncertain behavior of pleura, thymus and mediastinum",racial,Asian,0,10,10
437449,Victim of child abuse,racial,White,6,4,10
441126,Monosomy and deletion from autosome,ethnic,Not Hispanic or Latino,8,2,10
433946,Fall on same level due to impact against another person,ethnic,Not Hispanic or Latino,8,2,10
4064375,Iron deficiency screening,racial,Filipino,5,5,10
198470,Unilateral inguinal hernia with obstruction but no gangrene,ethnic,Hispanic or Latino,1,10,11
437241,Qualitative platelet defect,ethnic,Not Hispanic or Latino,3,7,10
442308,Abrasion AND/OR friction burn of thigh without infection,ethnic,Not Hispanic or Latino,5,5,10
433647,Poisoning by central nervous system muscle tone depressant,racial,Unknown,10,0,10
440035,European cryptococcosis,ethnic,Hispanic or Latino,10,0,10
138826,Acne varioliformis,ethnic,Hispanic or Latino,2,8,10
75365,Oliguria and anuria,ethnic,Hispanic or Latino,5,5,10
259055,Extrinsic asthma with asthma attack,racial,Other Race,4,6,10
81611,Diverticular disease of colon,racial,Black or African American ,8,2,10
441830,Disorder of fluid AND/OR electrolyte,ethnic,Not Hispanic or Latino,8,2,10
434494,Closed fracture of the proximal humerus,ethnic,Not Hispanic or Latino,4,6,10
434172,Insomnia with sleep apnoea,racial,White,0,10,10
4016352,Tuberculosis contact,ethnic,Not Hispanic or Latino,7,4,11
443790,Multi-infarct dementia with delusions,ethnic,Not Hispanic or Latino,10,0,10
4096198,Vitamin B-complex deficiency,racial,White,10,1,11
372599,Severe mixed bipolar I disorder without psychotic features,racial,White,2,8,10
4188027,Food allergy,ethnic,Not Hispanic or Latino,4,7,11
433125,Infection due to Staphylocccus aureus,racial,Unknown,7,3,10
80225,Sprain of ligament of lumbosacral joint,ethnic,Not Hispanic or Latino,8,2,10
73231,Arthralgia of temporomandibular joint,racial,Unknown,8,2,10
437222,Respiratory syncytial virus infection,racial,White,2,8,10
381036,Multiple AND bilateral precerebral artery stenosis,ethnic,Not Hispanic or Latino,8,2,10
377535,Sleep walking disorder,racial,White,6,4,10
438557,Abnormal glucose level,racial,Native Hawaiian or Other Pacific Islander ,7,4,11
432454,Excessive thirst,ethnic,Not Hispanic or Latino,3,7,10
192963,Disease of pancreas,ethnic,Not Hispanic or Latino,7,3,10
440674,Gout,racial,American Indian or Alaska Native ,2,8,10
198216,Retroverted incarcerated gravid uterus - delivered,ethnic,Hispanic or Latino,10,0,10
258482,Abscess of Bartholin's gland,racial,Unknown,10,0,10
4168226,Micturition frequency and polyuria,racial,White,9,1,10
133835,Dermatitis,racial,Other Race,4,6,10
4079876,Familial combined hyperlipidemia,racial,American Indian,4,7,11
432895,Cortical senile cataract,ethnic,Not Hispanic or Latino,2,8,10
433134,Histoplasmosis,ethnic,Hispanic or Latino,0,10,10
434742,Congenital abnormality of skull and face bones,racial,Asian,5,5,10
133551,Vesicular eczema of hands and/or feet,racial,Unknown,7,3,10
437464,"Injury undetermined whether accidentally or purposely inflicted, fall from residential premises",racial,Unknown,6,4,10
200775,Endometrial hyperplasia,racial,White,10,0,10
4105330,Chronic undifferentiated schizophrenia,racial,Asian,8,2,10
435752,Primary malignant neoplasm of duodenum,ethnic,Hispanic or Latino,0,10,10
137820,Postoperative hypothyroidism,ethnic,Not Hispanic or Latino,6,4,10
437082,Marie-Strumpell spondylitis,racial,Black or African American ,0,10,10
72995,Joint contracture of hand,racial,White,4,7,11
381312,Neural hearing loss,racial,White,6,4,10
137053,Seborrheic dermatitis,racial,Other Race,5,5,10
435510,Hypocalcemia,ethnic,Not Hispanic or Latino,5,5,10
194992,Coeliac disease,racial,White,4,6,10
437409,Intracranial injury,ethnic,Not Hispanic or Latino,4,7,11
197988,General abdominal pain-symptom,racial,Asian,8,2,10
134398,Periodontal disease,racial,White,3,7,10
135772,Goiter,racial,Asian,10,0,10
73341,Closed fracture of head of radius,racial,Unknown,8,2,10
135892,Erythematous condition,ethnic,Not Hispanic or Latino,6,4,10
438527,"Juvenile osteochondrosis of lower extremity, excluding foot",racial,Unknown,4,7,11
320744,Complete atrioventricular block,racial,Unknown,9,1,10
375557,Cerebral embolism,racial,White,8,2,10
443783,Chronic disease,racial,American Indian or Alaska Native ,1,10,11
194286,"Malignant neoplasm of corpus uteri, excluding isthmus",racial,Other Race,10,0,10
316501,Disorder of blood vessels affecting skin,ethnic,Hispanic or Latino,4,6,10
195245,Reflex sympathetic dystrophy,racial,White,0,10,10
434329,Spinocerebellar disease,racial,White,10,0,10
198246,Congenital hiatus hernia,ethnic,Hispanic or Latino,7,4,11
199958,Open wound of hip AND thigh without complication,ethnic,Hispanic or Latino,4,6,10
443350,Lower urinary tract symptoms,racial,American Indian or Alaska Native ,0,10,10
4024000,Urinary system finding,racial,White,5,5,10
75576,Colon spasm,racial,Other Race,9,1,10
438120,Opioid dependence,racial,Other Race,7,4,11
435751,Primary malignant neoplasm of fundus of stomach,ethnic,Hispanic or Latino,0,10,10
432730,Dysphonia,ethnic,Not Hispanic or Latino,7,3,10
192963,Disease of pancreas,racial,Unknown,7,3,10
4245252,Raised prostate specific antigen,racial,American Indian or Alaska Native ,0,10,10
374022,Hemiplegia,racial,American Indian or Alaska Native ,0,10,10
318521,Displacement of thoracic intervertebral disc without myelopathy,racial,Unknown,10,1,11
4171115,Low birth weight infant,racial,White,7,3,10
4305080,Abnormal breathing,racial,Unknown,8,2,10
196443,Gastric ulcer without hemorrhage AND without perforation but with obstruction,racial,White,8,2,10
435651,Atypical squamous cells on cervical Papanicolaou smear cannot exclude high grade squamous intraepithelial lesion,racial,Unknown,10,0,10
134453,Inflammation of bursa,ethnic,Not Hispanic or Latino,4,6,10
31821,Endocrinopathy,ethnic,Not Hispanic or Latino,7,4,11
139036,Systolic dysfunction,racial,Unknown,4,7,11
4276723,Finding of child weight centiles,racial,Other Race,4,7,11
80070,Uric acid urolithiasis,ethnic,Hispanic or Latino,4,6,10
441333,Geographic tongue,racial,White,4,6,10
197006,Residual hemorrhoidal skin tags,racial,White,5,4,9
199064,Chronic vascular insufficiency of intestine,ethnic,Hispanic or Latino,2,7,9
80552,Closed fracture of the scaphoid,ethnic,Not Hispanic or Latino,5,5,10
377280,Corneal disorder,ethnic,Hispanic or Latino,7,2,9
4064918,Diabetes mellitus screening,racial,Filipino,8,2,10
374338,Nondiabetic proliferative retinopathy,ethnic,Hispanic or Latino,3,7,10
436919,Primary malignant neoplasm of unspecified site,racial,Asian,4,6,10
438733,Profound mental handicap,ethnic,Not Hispanic or Latino,5,5,10
201626,Mid-cycle pain,racial,White,8,1,9
28179,Polyp of vocal cord or larynx,ethnic,Hispanic or Latino,8,1,9
195599,Post-hysterectomy vaginal vault prolapse,ethnic,Hispanic or Latino,10,0,10
433015,Congenital anomaly of aortic arch,ethnic,Hispanic or Latino,7,3,10
434170,Atypical squamous cells of undetermined significance on cervical Papanicolaou smear,racial,Other Race,10,0,10
435640,"Gestation period, 25 weeks",racial,White,2,7,9
81936,Monoarthritis,ethnic,Hispanic or Latino,5,4,9
374009,Organic mental disorder,racial,White,5,4,9
135778,Toxic multinodular goitre,racial,Unknown,10,0,10
197381,Epigastric pain,racial,Black or African American ,8,1,9
380818,Acquired deformity of head,ethnic,Hispanic or Latino,5,5,10
140259,Open wound of face without complication,racial,Unknown,3,7,10
258540,Marfan syndrome,racial,White,3,7,10
24609,Hypoglycaemia,racial,Black or African American ,5,4,9
199870,Renal vascular disorder,racial,White,3,7,10
4097560,Burkitt lymphoma of intra-abdominal lymph nodes,racial,Black or African American ,0,10,10
381548,Monoplegia,racial,White,5,4,9
314968,Varices,racial,Unknown,9,1,10
197239,Haemangioma of intra-abdominal structure,racial,White,7,3,10
74855,Genital herpes simplex,racial,Other Race,8,2,10
437839,Pica,racial,White,5,4,9
134460,Plantar fascial fibromatosis,racial,Black or African American ,4,6,10
434007,Congenital factor VIII deficiency,racial,White,1,9,10
433403,Viral meningitis,ethnic,Hispanic or Latino,8,2,10
260841,Perinatal subarachnoid hemorrhage,ethnic,Hispanic or Latino,7,2,9
81186,Contusion of wrist,racial,Unknown,5,5,10
74511,Open wound of knee and/or leg and/or ankle with complication,ethnic,Hispanic or Latino,10,0,10
75099,Coccyx sprain,ethnic,Hispanic or Latino,7,2,9
438170,Acute myocardial infarction of inferior wall,ethnic,Not Hispanic or Latino,0,10,10
137951,Acquired keratoderma,racial,Unknown,8,1,9
440389,MR - Mental retardation,racial,Other Race,8,1,9
372907,Macular scar,ethnic,Hispanic or Latino,4,5,9
438962,Herpes simplex with complication,ethnic,Not Hispanic or Latino,0,10,10
440814,Torticollis,racial,Unknown,6,4,10
441428,Closed fracture of lateral malleolus,racial,Unknown,10,0,10
4161977,Patient with cardiac pacemaker,racial,American Indian or Alaska Native ,10,0,10
440690,Social phobia,ethnic,Hispanic or Latino,7,3,10
443577,Asymmetric sensorineural hearing loss,racial,White,7,3,10
437992,Abnormal results of kidney function studies,racial,Unknown,2,7,9
442597,Meteorism,ethnic,Not Hispanic or Latino,7,2,9
80504,Acquired genu valgum,racial,Unknown,9,1,10
440438,Anodontia,ethnic,Not Hispanic or Latino,6,4,10
4110655,Pupil-involving third nerve palsy,ethnic,Hispanic or Latino,2,8,10
437851,Open angle with borderline intraocular pressure,racial,Unknown,9,1,10
440788,Hyperemesis gravidarum with metabolic disturbance - not delivered,racial,Unknown,10,0,10
436929,Malignant histiocytosis of extranodal AND/OR solid organ site,ethnic,Hispanic or Latino,1,8,9
374358,Dermatochalasis,ethnic,Not Hispanic or Latino,0,10,10
77987,Respiratory observations of chest,racial,Unknown,5,4,9
312723,Congenital heart disease,racial,Black or African American ,5,4,9
193306,Situs inversus,ethnic,Hispanic or Latino,4,6,10
433260,Mother delivered,racial,White,10,0,10
74739,Osteopathy from poliomyelitis,ethnic,Hispanic or Latino,2,7,9
438531,Chondromalacia,racial,White,8,1,9
137351,Epidermoid cyst of skin,racial,Other Race,8,2,10
441830,Disorder of fluid AND/OR electrolyte,racial,White,7,3,10
436816,Vaginal vault smear abnormal,racial,White,10,0,10
441918,"Emotional AND/OR mental disease in mother complicating pregnancy, childbirth AND/OR puerperium",racial,Unknown,10,0,10
4287544,Manic bipolar I disorder,racial,Other Race,4,6,10
195771,Secondary diabetes mellitus,racial,Black or African American ,0,10,10
194995,Disorder of ureter,racial,Unknown,2,7,9
441678,"Gestation period, 33 weeks",ethnic,Not Hispanic or Latino,5,5,10
443801,Exercise-induced asthma,racial,Black or African American ,8,2,10
135615,Pityriasis,ethnic,Not Hispanic or Latino,5,5,10
317376,Tachypnoeic,ethnic,Hispanic or Latino,2,7,9
443801,Exercise-induced asthma,racial,Asian,4,6,10
312337,Arterial embolic and thrombotic occlusion,ethnic,Hispanic or Latino,6,4,10
4303805,Allergic reaction to bite and/or sting,racial,White,6,4,10
381114,Microcephalus,racial,White,7,3,10
73571,Pathological fracture,racial,White,9,1,10
4138253,Malabsorption syndrome,racial,Asian,10,0,10
443111,Tenosynovitis of foot,ethnic,Not Hispanic or Latino,5,4,9
444283,Superficial foreign body of hand without major open wound AND without infection,ethnic,Hispanic or Latino,7,3,10
378140,Inflammatory and toxic neuropathy,ethnic,Hispanic or Latino,10,0,10
320682,Finding of white blood cell number,racial,White,7,2,9
254591,Secondary malignant tumour of lung,ethnic,Not Hispanic or Latino,10,0,10
434587,Primary malignant neoplasm of dorsal surface of tongue,ethnic,Hispanic or Latino,0,10,10
4097560,Burkitt lymphoma of intra-abdominal lymph nodes,ethnic,Not Hispanic or Latino,0,10,10
80573,Contusion of ankle,racial,Unknown,7,3,10
440155,Postartificial menopausal syndrome,racial,White,9,1,10
136950,5q minus syndrome,racial,Unknown,0,10,10
136950,5q minus syndrome,ethnic,Hispanic or Latino,0,10,10
433457,Agoraphobia without mention of panic attacks,racial,White,10,0,10
4149353,"Attention deficit hyperactivity disorder, predominantly inattentive type",racial,Other Race,7,2,9
318549,Cardiac septal defects,ethnic,Hispanic or Latino,10,0,10
4282316,Recurrent major depression,ethnic,Hispanic or Latino,4,6,10
439708,Disorders of initiating and maintaining sleep,racial,American Indian or Alaska Native ,3,7,10
436803,FRAXA - Fragile X syndrome,ethnic,Hispanic or Latino,2,8,10
436230,Blood chemistry abnormal,racial,American Indian or Alaska Native ,4,6,10
379006,Cerebral degeneration in childhood,ethnic,Hispanic or Latino,8,1,9
73576,Acquired chest and rib deformity,racial,White,2,8,10
4175226,Screening for malignant neoplasm of colon,racial,American Indian,4,6,10
136982,Trichiasis without entropion,ethnic,Hispanic or Latino,5,4,9
79240,Dislocation of joint prosthesis,ethnic,Hispanic or Latino,6,4,10
376103,Retinopathy,ethnic,Not Hispanic or Latino,7,3,10
433760,Dysreflexia,ethnic,Hispanic or Latino,8,1,9
196165,Cervical intraepithelial neoplasia grade 2,racial,Unknown,10,0,10
40480002,Aphasia as late effect of cerebrovascular disease,ethnic,Not Hispanic or Latino,10,0,10
78804,Schimmelbusch's disease,ethnic,Not Hispanic or Latino,10,0,10
372906,Both eyes total visual impairment,racial,Black or African American ,9,1,10
133569,Fasciitis,racial,Unknown,6,4,10
435651,Atypical squamous cells on cervical Papanicolaou smear cannot exclude high grade squamous intraepithelial lesion,ethnic,Not Hispanic or Latino,8,2,10
198850,Congenital hypoplasia of penis,racial,White,0,10,10
201612,ALD - Alcoholic liver disease,racial,Unknown,0,10,10
436953,Continuous chronic alcoholism,ethnic,Not Hispanic or Latino,1,8,9
434094,Spontaneous abortion with complication,racial,White,10,0,10
434587,Primary malignant neoplasm of dorsal surface of tongue,racial,White,0,10,10
433030,False-positive serological test for syphilis,racial,White,7,3,10
4092511,Malignant neoplasm of central part of female breast,ethnic,Hispanic or Latino,10,0,10
75580,Chronic ulcerative proctitis,ethnic,Hispanic or Latino,7,2,9
437127,Closed dislocation of acromioclavicular joint,racial,White,5,4,9
436803,FRAXA - Fragile X syndrome,racial,White,2,8,10
135340,Pressure ulcer stage 3,racial,Unknown,5,5,10
4105880,Contact of sexually transmissible disorder,racial,Other Race,6,4,10
77679,Spine or spinal cord injury due to birth trauma,racial,Unknown,0,10,10
436929,Malignant histiocytosis of extranodal AND/OR solid organ site,racial,White,1,8,9
442793,Diabetic complication,racial,Native Hawaiian or Other Pacific Islander ,7,2,9
134517,Open wound of mouth without complication,ethnic,Hispanic or Latino,5,4,9
443442,Finding of vaginal vault smear result,racial,Unknown,10,0,10
440202,Multiple congenital malformations,ethnic,Not Hispanic or Latino,2,7,9
439150,Hypersomnia with sleep apnea,racial,White,1,8,9
29056,Sialoadenitis,ethnic,Not Hispanic or Latino,5,5,10
439666,Contracture of multiple joints,ethnic,Hispanic or Latino,7,2,9
434008,White blood cell disorder,ethnic,Not Hispanic or Latino,8,2,10
192367,Dysplasia of cervix,ethnic,Not Hispanic or Latino,10,0,10
195873,Leukorrhagia,racial,Black or African American ,10,0,10
141825,Non-toxic goiter,ethnic,Hispanic or Latino,10,0,10
435517,Acidosis,ethnic,Not Hispanic or Latino,2,7,9
432526,Needs influenza immunisation,racial,Asian Indian,3,7,10
4160859,Methicillin resistant staphylococcus aureus carrier,ethnic,Not Hispanic or Latino,7,2,9
375256,Anterior subcapsular polar senile cataract,racial,White,8,1,9
433316,Giddiness,racial,Filipino,6,4,10
256717,Bronchospasm,racial,Other Race,7,2,9
437540,CRAO - Central retinal artery occlusion,racial,Unknown,0,10,10
432513,Animal bite wound,racial,White,8,2,10
433495,"Conductive hearing loss, bilateral",ethnic,Hispanic or Latino,6,4,10
381297,Xanthoma of eyelid,ethnic,Hispanic or Latino,10,0,10
135762,Acute myeloid leukaemia in remission,racial,Unknown,7,2,9
439162,"Closed fracture ankle, medial malleolus",ethnic,Hispanic or Latino,8,1,9
140176,Erythema nodosum,ethnic,Hispanic or Latino,6,4,10
436100,Narcolepsy,ethnic,Hispanic or Latino,1,9,10
376112,Diabetic polyneuropathy,racial,American Indian or Alaska Native ,5,5,10
437753,Seen by surgical fitting - service,racial,White,10,0,10
195498,Benign tumour of kidney,ethnic,Hispanic or Latino,5,5,10
438882,Closed fracture of neck of metacarpal bone,racial,White,1,9,10
4064383,Rheumatoid arthritis screening,racial,White,7,3,10
135930,Musculoskeletal system observation,racial,White,7,2,9
439406,Allergy to animal,ethnic,Not Hispanic or Latino,6,4,10
133468,Disease of extremity,racial,White,2,7,9
443238,Diabetic - poor control,racial,American Indian or Alaska Native ,0,10,10
435656,Neonatal jaundice,racial,Other Race,7,2,9
4069184,Infundibular pulmonic stenosis,ethnic,Hispanic or Latino,5,5,10
78838,Acquired deformity of knee,ethnic,Hispanic or Latino,5,5,10
374372,Otogenic otalgia,ethnic,Hispanic or Latino,8,2,10
74729,Ganglion and synovial cyst,racial,Black or African American ,7,3,10
438688,Sarcoidosis,ethnic,Hispanic or Latino,8,1,9
441460,Late effect of sprain AND/OR strain without tendon injury,ethnic,Hispanic or Latino,5,4,9
432250,Infective disorder,racial,White,5,4,9
195259,Entrapment of lateral cutaneous nerve of thigh,ethnic,Not Hispanic or Latino,4,6,10
4141622,Asthma NOS,ethnic,Not Hispanic or Latino,7,3,10
443452,Bleeding of unknown origin,racial,Unknown,5,5,10
376116,Central loss of vision,ethnic,Hispanic or Latino,1,9,10
444406,Acute subendocardial infarction,ethnic,Hispanic or Latino,5,4,9
378548,Polyotia,ethnic,Hispanic or Latino,5,4,9
140526,Congenital anomaly of endocrine gland,ethnic,Hispanic or Latino,6,4,10
195501,Polycystic ovaries,racial,Asian,10,0,10
374358,Dermatochalasis,racial,Native Hawaiian or Other Pacific Islander ,0,10,10
261324,Pneumonia due to Streptococcus,racial,Unknown,6,4,10
438368,Primary malignant neoplasm of thymus,ethnic,Not Hispanic or Latino,0,10,10
440529,Abnormal findings on diagnostic imaging of urinary organs,racial,Unknown,9,1,10
441969,Radiology result abnormal,racial,Unknown,8,1,9
4090255,Colloid bodies in retina,ethnic,Hispanic or Latino,9,1,10
436677,"Brief situational non-psychotic disorder, NOS",racial,Unknown,9,1,10
192438,Abdominal mass,racial,Other Race,10,0,10
193493,Benign hypertensive renal disease,racial,White,8,1,9
77679,Spine or spinal cord injury due to birth trauma,ethnic,Hispanic or Latino,0,10,10
440032,CMV - Cytomegalovirus infection,racial,White,0,10,10
138225,Disease of sebaceous glands,ethnic,Not Hispanic or Latino,8,1,9
442790,Growth and development,ethnic,Not Hispanic or Latino,5,4,9
4104710,Parkinson's disease NOS,racial,Unknown,9,1,10
140966,Benign neoplasm of skin of face,ethnic,Not Hispanic or Latino,8,1,9
373202,Corneal ulcer,ethnic,Hispanic or Latino,9,1,10
375260,Polyneuropathy in collagen vascular disease,ethnic,Hispanic or Latino,4,5,9
196569,Contusion of abdominal wall,ethnic,Hispanic or Latino,4,5,9
432730,Dysphonia,racial,Unknown,5,4,9
435080,Biliuria,ethnic,Hispanic or Latino,4,6,10
316999,Cardiac arrhythmia,racial,Native Hawaiian or Other Pacific Islander ,1,9,10
438688,Sarcoidosis,racial,White,8,1,9
377290,Legal blindness USA,ethnic,Not Hispanic or Latino,7,3,10
436333,Orf virus disease,ethnic,Hispanic or Latino,6,4,10
78909,"Contusion, shoulder and upper arm, multiple sites",ethnic,Hispanic or Latino,5,4,9
432452,Anemia of prematurity,ethnic,Hispanic or Latino,5,4,9
432347,Chronic disease of tonsils AND/OR adenoids,racial,White,6,4,10
437127,Closed dislocation of acromioclavicular joint,racial,Unknown,0,10,10
4013916,Closed fracture of clavicle NOS,ethnic,Hispanic or Latino,5,4,9
316429,Ectopics,ethnic,Not Hispanic or Latino,6,4,10
4060985,BMI 30+ - obesity,racial,Asian Indian,5,4,9
4290927,Impairment level: low vision of both eyes,ethnic,Not Hispanic or Latino,4,5,9
441788,Human papilloma virus infection,ethnic,Not Hispanic or Latino,10,0,10
381504,Post-herpetic trigeminal neuralgia,racial,Unknown,9,1,10
195306,Gastroduodenitis,racial,American Indian or Alaska Native ,8,1,9
436466,Balanoposthitis,racial,Other Race,0,10,10
442588,OSA - Obstructive sleep apnoea,racial,Native Hawaiian or Other Pacific Islander ,1,9,10
196160,Fistula of intestine,ethnic,Not Hispanic or Latino,10,0,10
4108905,Congenital malformation of the urinary system,ethnic,Hispanic or Latino,4,6,10
436700,Eye displaced forwards,ethnic,Hispanic or Latino,7,3,10
80767,Breast irregular nodularity,racial,American Indian or Alaska Native ,10,0,10
75053,Fracture of bone,racial,White,6,4,10
4263325,Actinic cheilitis,racial,White,5,5,10
432597,Schizoaffective schizophrenia,racial,Other Race,3,7,10
4239721,Seafood allergy,ethnic,Not Hispanic or Latino,5,4,9
134438,CD - Contact dermatitis,racial,Native Hawaiian or Other Pacific Islander ,1,8,9
376961,Disturbance of consciousness,racial,Other Race,2,7,9
4209151,Repair of musculotendinous cuff of shoulder,ethnic,Hispanic or Latino,7,3,10
195851,"Gastric ulcer without hemorrhage, without perforation AND without obstruction",racial,Asian,6,4,10
24660,Acute tonsillitis,racial,Asian,5,5,10
443597,Chronic kidney disease stage 3,racial,Native Hawaiian or Other Pacific Islander ,3,7,10
25518,AS - Sickle cell trait,ethnic,Hispanic or Latino,5,5,10
443677,Open wound of knee and/or leg and/or ankle,ethnic,Not Hispanic or Latino,4,5,9
197601,Spermatocele,ethnic,Hispanic or Latino,0,10,10
4167406,Eye disorder screening,racial,Other Race,4,5,9
438477,Atrophy of testis,racial,White,0,10,10
77650,Aseptic necrosis of bone,ethnic,Hispanic or Latino,5,4,9
195906,Disorder of lumbar spine,racial,Unknown,1,9,10
433316,Giddiness,racial,Native Hawaiian or Other Pacific Islander ,7,2,9
74469,Light-for-dates without mention of fetal malnutrition,ethnic,Hispanic or Latino,8,2,10
443409,On examination - left lower abdominal mass,racial,Other Race,10,0,10
437528,"Bipolar affective disorder, currently depressed, moderate",racial,Black or African American ,0,10,10
435082,Closed fracture nasal bone,racial,Unknown,2,7,9
381842,Petit mal status,racial,Unknown,0,10,10
374923,Bell palsy,racial,Other Race,5,4,9
199767,Neoplasm of uncertain behaviour of liver and/or biliary passages,ethnic,Not Hispanic or Latino,1,9,10
4115173,Atrial premature complex,racial,Unknown,5,5,10
440081,Barbiturate dependence,racial,Unknown,2,7,9
438368,Primary malignant neoplasm of thymus,racial,Asian,0,10,10
79897,Obstetric non-purulent mastitis - delivered with postnatal complication,ethnic,Not Hispanic or Latino,10,0,10
133728,Congenital hypothyroidism,ethnic,Hispanic or Latino,10,0,10
315296,Preinfarction syndrome,ethnic,Not Hispanic or Latino,5,5,10
435081,Abnormal findings on diagnostic imaging of heart and coronary circulation,racial,White,5,5,10
200764,Bile duct calculus without mention of cholecystitis and no obstruction,racial,White,4,5,9
81250,Carcinoma in situ of breast,ethnic,Not Hispanic or Latino,9,0,9
257905,Mucopurulent chronic bronchitis,racial,Unknown,5,4,9
4180784,Cancer of parotid gland,ethnic,Not Hispanic or Latino,9,0,9
441260,Drug withdrawal syndrome,ethnic,Hispanic or Latino,6,3,9
434462,VSD - Ventricular septal defect,racial,Unknown,4,5,9
134144,Cleft palate with cleft lip,racial,Other Race,0,9,9
435088,Senility,racial,White,5,4,9
81144,Sprain of medial collateral ligament of knee,ethnic,Not Hispanic or Latino,5,4,9
443909,"Decreased level, laboratory test",ethnic,Not Hispanic or Latino,5,4,9
196925,Secondary malignant neoplasm of retroperitoneum and peritoneum,racial,Unknown,9,0,9
436235,Taste sense altered,ethnic,Not Hispanic or Latino,8,1,9
379822,Cyst of eyelid,racial,Unknown,7,2,9
201618,Disease of intestine,ethnic,Not Hispanic or Latino,8,1,9
141056,Acute ethmoidal sinusitis,ethnic,Not Hispanic or Latino,7,2,9
377889,Hearing loss,racial,Native Hawaiian or Other Pacific Islander ,2,7,9
4150307,Dental restoration observation,racial,Other Race,5,4,9
440005,Complication of medical care,racial,White,7,2,9
40490423,Incontinence without sensory awareness,racial,Asian,2,7,9
433942,Accident whilst engaged in household activity,ethnic,Not Hispanic or Latino,6,3,9
253797,Post-inflammatory pulmonary fibrosis,racial,Other Race,4,5,9
433735,Alcohol dependence with acute alcoholic intoxication,racial,Unknown,0,9,9
77630,Disease of shoulder,racial,Asian,5,4,9
196925,Secondary malignant neoplasm of retroperitoneum and peritoneum,ethnic,Hispanic or Latino,9,0,9
135303,Cyst of oral soft tissue,ethnic,Hispanic or Latino,6,3,9
435739,Late syphilis,racial,Unknown,2,7,9
443400,Peritoneal cancer,racial,White,5,4,9
195294,Thrombosed hemorrhoids,racial,White,7,2,9
436088,Nondependent opioid abuse in remission,racial,White,5,4,9
4082311,B-CLL - B-cell chronic lymphocytic leukemia,racial,Unknown,0,9,9
376104,Posttraumatic headache,racial,Unknown,8,1,9
436398,Glaucoma associated with ocular disorder,ethnic,Hispanic or Latino,4,5,9
195590,Urethral stricture,racial,Unknown,1,8,9
379806,Migraine variants,racial,Unknown,8,1,9
73649,Contusion of finger,ethnic,Not Hispanic or Latino,7,2,9
77072,Joint effusion of ankle AND/OR foot,ethnic,Not Hispanic or Latino,4,5,9
4092879,Absent kidney,racial,Asian,0,9,9
381301,Chronic serous otitis media,racial,Unknown,3,6,9
377861,Disorder of refraction AND/OR accommodation,racial,American Indian or Alaska Native ,5,4,9
440693,Continuous opioid dependence,racial,American Indian,9,0,9
378839,Spina bifida with hydrocephalus,ethnic,Not Hispanic or Latino,0,9,9
72778,Open wound of toe(s) without mention of complication,racial,Unknown,5,4,9
201418,"Flatulence, eructation and gas pain",racial,Asian,7,2,9
77352,Pyogenic arthritis of the lower leg,racial,White,8,1,9
440693,Continuous opioid dependence,racial,Black or African American ,4,5,9
77646,Disorder of bone and articular cartilage,racial,White,4,5,9
314666,Healed coronary,racial,American Indian or Alaska Native ,5,4,9
195588,Cystitis,racial,Asian,8,1,9
381592,Chronic mucoid otitis media,ethnic,Not Hispanic or Latino,7,2,9
78234,Arthralgia of the hand,racial,Asian,7,2,9
433911,Contusion of eye AND ocular adnexa,racial,White,1,8,9
141932,Senile hyperkeratosis,racial,Asian,1,8,9
4114746,Climacteric arthritis NOS,ethnic,Hispanic or Latino,8,1,9
77365,Disuse osteoporosis,racial,White,6,3,9
40389897,"Neoplasm of uncertain behaviour of trachea, bronchus and lung",ethnic,Hispanic or Latino,4,5,9
193520,Urinary bladder stone,ethnic,Hispanic or Latino,2,7,9
435517,Acidosis,ethnic,Hispanic or Latino,2,7,9
31610,Disorder of oesophagus,racial,White,5,4,9
200450,Disease of urethra,racial,Unknown,7,2,9
436477,Abnormal products of conception,racial,White,9,0,9
138826,Acne varioliformis,racial,White,2,7,9
381952,Injury to brachial plexus as birth trauma,ethnic,Not Hispanic or Latino,0,9,9
378414,Separation of retinal layers,racial,Other Race,5,4,9
79873,Urolith,ethnic,Not Hispanic or Latino,4,5,9
375292,Perforation of tympanic membrane,racial,Asian,7,2,9
317305,Stricture of artery,ethnic,Hispanic or Latino,3,6,9
432923,SAH - Subarachnoid haemorrhage,racial,White,9,0,9
434592,B-cell lymphoma,ethnic,Hispanic or Latino,9,0,9
193020,Incomplete emptying of bladder,ethnic,Hispanic or Latino,5,4,9
312922,Coronary bypass graft observation,racial,Other Race,8,1,9
81611,Diverticular disease of colon,racial,Native Hawaiian or Other Pacific Islander ,0,9,9
4318408,Subdural haematoma,racial,Unknown,1,8,9
314381,Kawasaki syndrome,ethnic,Hispanic or Latino,5,4,9
442310,Acute heart failure,ethnic,Hispanic or Latino,4,5,9
132391,Furuncle of face,ethnic,Hispanic or Latino,3,6,9
141825,Non-toxic goiter,racial,White,9,0,9
432868,Hemoglobinopathy,racial,White,5,4,9
375528,Spastic hemiplegia,racial,White,1,8,9
138994,MDS - Myelodysplastic syndrome,racial,Other Race,9,0,9
440076,SS - Short stature,racial,Unknown,4,5,9
194018,"Functional enuresis, NOS",ethnic,Not Hispanic or Latino,7,2,9
4082311,B-CLL - B-cell chronic lymphocytic leukemia,ethnic,Hispanic or Latino,0,9,9
435626,Tibial collateral ligament bursitis,ethnic,Hispanic or Latino,1,8,9
376106,Disorder of the central nervous system,ethnic,Hispanic or Latino,7,2,9
377877,Convergent squint,ethnic,Not Hispanic or Latino,4,5,9
193322,Right lower quadrant pain,racial,Other Race,6,3,9
72748,Strain of rotator cuff of shoulder,racial,Black or African American ,0,9,9
432910,Disorder of lacrimal system,racial,White,9,0,9
29735,Candidiasis of mouth,racial,Other Race,5,4,9
436166,Mild hyperemesis gravidarum,racial,White,9,0,9
317510,Leukaemia,racial,White,3,6,9
4012570,High risk sexual behavior,racial,Black or African American ,8,1,9
441788,Human papilloma virus infection,racial,Unknown,9,0,9
256571,FB - Nasal foreign body,ethnic,Hispanic or Latino,4,5,9
435411,Injury at C5-C7 level with spinal cord injury AND without bone injury,racial,White,0,9,9
372423,Reduction deformities of brain,ethnic,Not Hispanic or Latino,8,1,9
197494,Viral hepatitis C,racial,Black or African American ,2,7,9
139899,Pemphigoid,racial,White,1,8,9
77670,Chest pain,racial,Filipino,2,7,9
372435,Periventricular leukomalacia,racial,Other Race,9,0,9
436919,Primary malignant neoplasm of unspecified site,racial,Unknown,7,2,9
372646,"Peripheral pterygium, stationary",ethnic,Hispanic or Latino,8,1,9
200164,Urine-induced contact dermatitis,racial,Black or African American ,5,4,9
78093,Primary malignant neoplasm of pleura,ethnic,Hispanic or Latino,0,9,9
432306,Gender identity disorder of adolescence,racial,White,4,5,9
77592,Articular crepitus of temporomandibular joint,racial,White,4,5,9
256909,Primary pulmonary coccidioidomycosis,racial,Black or African American ,0,9,9
374905,Non-organic sleep disorder,ethnic,Not Hispanic or Latino,5,4,9
373478,Presbyopia,racial,Other Race,8,1,9
4014230,Ankle sprain NOS,racial,Unknown,3,6,9
72712,Synovial cyst,ethnic,Hispanic or Latino,8,1,9
193262,Inflammatory disorder of penis,racial,White,0,9,9
76545,Closed traumatic dislocation of patella,racial,White,5,4,9
432876,Bipolar I disorder,racial,Other Race,8,1,9
442256,Disorder of bursae of shoulder region,racial,Asian,5,4,9
372629,Nonexudative age-related macular degeneration,ethnic,Not Hispanic or Latino,1,8,9
441818,Haemangioma,racial,Unknown,9,0,9
193519,Impaired renal function disorder,ethnic,Not Hispanic or Latino,5,4,9
377559,Vernal conjunctivitis,racial,White,5,4,9
373189,Encephalomyelitis,ethnic,Hispanic or Latino,5,4,9
317376,Tachypnoeic,racial,White,2,7,9
141651,Stevens-Johnson syndrome,ethnic,Hispanic or Latino,0,9,9
321042,Cardiac arrest,ethnic,Not Hispanic or Latino,8,1,9
28974,Candidiasis of oesophagus,racial,White,5,4,9
436314,Accidental puncture AND/OR laceration during a procedure,ethnic,Hispanic or Latino,5,4,9
77340,Genitourinary tract infection in pregnancy,racial,Unknown,9,0,9
437064,Chondrocalcinosis,ethnic,Hispanic or Latino,6,3,9
139888,Threatened premature labor - not delivered,ethnic,Not Hispanic or Latino,9,0,9
438028,Poisoning by drug AND/OR medicinal substance,racial,Unknown,4,5,9
40480943,Lateral cystocele,ethnic,Hispanic or Latino,8,1,9
441259,Non-thrombocytopenic purpura,racial,Unknown,4,5,9
24977,Mucocele of salivary gland,racial,White,6,3,9
443897,Disruption of perineal wound in the puerperium,racial,White,9,0,9
374649,Strabismic amblyopia,ethnic,Hispanic or Latino,7,2,9
200848,Dribbling of urine,racial,White,1,8,9
40490423,Incontinence without sensory awareness,ethnic,Not Hispanic or Latino,2,7,9
138845,Rheumatism,ethnic,Hispanic or Latino,9,0,9
434164,Glycosuria,ethnic,Not Hispanic or Latino,6,3,9
373852,Neuralgia,racial,Asian,4,5,9
136185,Abnormal granulation tissue,ethnic,Not Hispanic or Latino,4,5,9
78505,"Localised, primary osteoarthritis of the ankle and/or foot",racial,White,7,2,9
439013,Insomnia disorder related to another mental disorder,racial,Unknown,5,4,9
80189,Displacement of lumbar intervertebral disc without myelopathy,racial,American Indian or Alaska Native ,9,0,9
4180784,Cancer of parotid gland,racial,Asian,9,0,9
141371,PR - Pityriasis rosea,racial,Unknown,7,2,9
439975,Injury at C1-C4 level with spinal cord injury AND without bone injury,racial,White,5,4,9
134461,Tietze disease,racial,Asian,7,2,9
74698,Breech presentation,racial,White,7,2,9
78093,Primary malignant neoplasm of pleura,racial,White,0,9,9
79864,Hematuria syndrome,ethnic,Not Hispanic or Latino,2,7,9
4071485,Foetus or neonate affected by caesarean section,ethnic,Hispanic or Latino,9,0,9
141816,Acute lymphoid leukaemia in remission,ethnic,Hispanic or Latino,2,7,9
78619,"Contusion, knee",racial,Black or African American ,7,2,9
4088930,Confirmation of pregnancy,racial,Other Race,9,0,9
441391,"Acquired forearm deformity, excluding fingers",racial,White,3,6,9
433456,Acute pain,racial,Black or African American ,7,2,9
432968,Anemia during pregnancy - baby delivered,ethnic,Hispanic or Latino,9,0,9
195401,Superficial bruising of hip,racial,White,5,4,9
378544,Subdural and cerebral hemorrhage due to birth trauma,racial,White,9,0,9
141693,Elevated blood-pressure reading without diagnosis of hypertension,racial,Native Hawaiian or Other Pacific Islander ,4,5,9
4299574,Factitious skin disease,ethnic,Not Hispanic or Latino,7,2,9
72737,Microcalcifications of the breast,racial,Unknown,9,0,9
434281,Aspergillosis,racial,Unknown,9,0,9
4014296,Twins - both live born,racial,White,7,2,9
4176890,Male sterility,racial,White,0,9,9
376131,Tympanic membrane conductive hearing loss,ethnic,Hispanic or Latino,1,8,9
4100529,Misuse of drugs NOS,ethnic,Not Hispanic or Latino,1,8,9
200780,Disease of uterus,ethnic,Hispanic or Latino,9,0,9
315922,Patent ductus arteriosus,ethnic,Not Hispanic or Latino,8,1,9
199856,Varicose veins of lower extremity with inflammation,racial,Other Race,9,0,9
196152,Peritonitis,racial,White,2,7,9
197605,Inflammatory disorder of male genital organ,ethnic,Hispanic or Latino,0,9,9
193326,Urge incontinence of urine,racial,Other Race,5,4,9
439382,Disorder of hypothalamus,ethnic,Hispanic or Latino,9,0,9
78517,Arthralgia of multiple joints,racial,Asian,5,4,9
436954,Drug abuse,racial,Asian,0,9,9
444285,Acquired equinovarus deformity,ethnic,Hispanic or Latino,5,4,9
321080,"Hypertension complicating pregnancy, childbirth and the puerperium",ethnic,Not Hispanic or Latino,8,1,9
373474,Seeing double,racial,Unknown,4,5,9
440005,Complication of medical care,ethnic,Hispanic or Latino,7,2,9
195590,Urethral stricture,ethnic,Not Hispanic or Latino,7,2,9
435940,"Closed fracture of humerus, shaft",racial,Unknown,8,1,9
437947,Complication of obstetrical surgical wound,ethnic,Hispanic or Latino,9,0,9
254387,Upper respiratory tract hypersensitivity reaction,racial,Black or African American ,5,4,9
4087756,Late latent syphilis,ethnic,Not Hispanic or Latino,3,6,9
73075,Contusion of upper limb,racial,White,7,2,9
314963,Giant cell arteritis,racial,White,2,7,9
435950,Closed Colles' fracture,ethnic,Not Hispanic or Latino,6,3,9
440088,Academic underachievement disorder,ethnic,Not Hispanic or Latino,3,6,9
136580,Dehiscence of surgical wound,racial,White,5,4,9
253815,Ulceration of vulva,racial,Unknown,9,0,9
196454,Colostomy and enterostomy malfunction,ethnic,Hispanic or Latino,5,4,9
436246,Low libido,ethnic,Not Hispanic or Latino,4,5,9
432301,Opioid dependence in remission,ethnic,Not Hispanic or Latino,6,3,9
192353,Disorder of gallbladder,ethnic,Not Hispanic or Latino,2,7,9
436238,Elevated levels of transaminase and lactic acid dehydrogenase,racial,Filipino,8,1,9
192684,"Renal hypertension complicating pregnancy, childbirth and the puerperium - not delivered",racial,White,1,8,9
78619,"Contusion, knee",racial,Other Race,3,6,9
436235,Taste sense altered,racial,Unknown,9,0,9
442615,Carotid artery stenosis,racial,American Indian or Alaska Native ,3,6,9
4115173,Atrial premature complex,racial,White,5,4,9
140266,Superficial bruising of back,ethnic,Not Hispanic or Latino,7,2,9
4050572,Implantation of automatic cardiac defibrillator,racial,Other Race,9,0,9
376965,Hypertensive retinopathy,racial,White,4,5,9
435226,"Bipolar affective disorder, current episode mixed",racial,White,6,3,9
4295261,Postmenopausal state,racial,Asian,9,0,9
73241,Anal and rectal polyp,ethnic,Not Hispanic or Latino,7,2,9
4086928,IUCD status,racial,Other Race,9,0,9
80512,Acquired kyphosis,racial,White,9,0,9
380102,Corneal edema,ethnic,Hispanic or Latino,4,5,9
73241,Anal and rectal polyp,racial,Unknown,5,4,9
436962,Sleeplessness,racial,American Indian,7,2,9
135772,Goiter,racial,Black or African American ,6,3,9
435543,Primary angle-closure glaucoma,ethnic,Hispanic or Latino,8,1,9
74723,Arthropathy associated with a neurological disorder,ethnic,Not Hispanic or Latino,3,6,9
436254,Closed fractures of multiple bones of lower limb,ethnic,Hispanic or Latino,7,2,9
433540,Polyhydramnios with antenatal problem,ethnic,Hispanic or Latino,9,0,9
197023,Bilateral inguinal hernia,ethnic,Not Hispanic or Latino,0,9,9
379020,Entropion,ethnic,Hispanic or Latino,4,5,9
132583,Postablative hypothyroidism,racial,White,9,0,9
441192,Accidentally struck by or against objects or persons,racial,Unknown,2,7,9
314131,Degeneration of cervical intervertebral disc,racial,Asian,0,9,9
443563,Arteriosclerosis in coronary artery bypass graft,racial,Black or African American ,9,0,9
376691,Delimited old retinal detachment,ethnic,Hispanic or Latino,2,7,9
4303805,Allergic reaction to bite and/or sting,ethnic,Hispanic or Latino,5,4,9
79061,Colonic constipation,racial,White,5,4,9
376105,Krampfe salaam attacks,racial,Other Race,9,0,9
201899,Unilateral recurrent inguinal hernia,racial,Other Race,0,9,9
139750,Primary malignant neoplasm of skin,racial,White,5,4,9
375538,"Degeneration of macula due to cyst, hole or pseudohole",racial,White,4,5,9
135157,Observation of cardiovascular device,ethnic,Hispanic or Latino,8,1,9
438112,Neoplastic disease,ethnic,Hispanic or Latino,6,3,9
75512,Carcinoma in situ of colon,racial,White,8,1,9
442023,Poisoning of undetermined intent,ethnic,Hispanic or Latino,6,3,9
314665,Atrial flutter,racial,American Indian or Alaska Native ,9,0,9
40481374,Allergic rhinitis due to food,ethnic,Hispanic or Latino,1,8,9
194395,Bleeding diverticulosis,ethnic,Hispanic or Latino,4,5,9
440035,European cryptococcosis,racial,White,9,0,9
380510,Congenital abnormality of eyelid,racial,White,5,4,9
375479,Kaposi's sarcoma of soft tissues,ethnic,Hispanic or Latino,0,9,9
74125,Inflammatory polyarthropathy,racial,White,7,2,9
4179214,Family history of malignant neoplasm of gastrointestinal tract,racial,Unknown,5,4,9
194092,Uterine prolapse without vaginal wall prolapse,ethnic,Not Hispanic or Latino,9,0,9
141411,Scalp injury,racial,White,4,5,9
436812,Tongue tie,ethnic,Not Hispanic or Latino,1,8,9
381575,Disorder of external ear,racial,Unknown,8,1,9
197717,Open wound of anterior abdominal wall without complication,racial,Unknown,4,5,9
381952,Injury to brachial plexus as birth trauma,racial,Unknown,0,9,9
4114746,Climacteric arthritis NOS,racial,Unknown,8,1,9
193522,Acute prostatitis,ethnic,Not Hispanic or Latino,0,8,8
136025,Gp B streptococcal septicemia,ethnic,Hispanic or Latino,7,1,8
442604,Hypertensive heart disease,racial,Other Race,6,2,8
432308,Mononeuritis of lower limb,racial,Unknown,7,2,9
194802,Foreign body in vulva and vagina,ethnic,Hispanic or Latino,8,0,8
372629,Nonexudative age-related macular degeneration,racial,Asian,0,8,8
441189,Pertussis vaccine adverse reaction,ethnic,Hispanic or Latino,7,1,8
200783,Previous cesarean section,ethnic,Not Hispanic or Latino,8,0,8
443012,Diabetes mellitus during pregnancy - baby delivered,racial,Unknown,8,0,8
373204,Conjunctival xerosis,ethnic,Hispanic or Latino,2,7,9
435839,Lymphatic oedema,ethnic,Not Hispanic or Latino,5,4,9
374948,Acute nonsuppurative otitis media,ethnic,Not Hispanic or Latino,3,5,8
79091,Unstable lie,racial,White,8,0,8
141693,Elevated blood-pressure reading without diagnosis of hypertension,racial,Filipino,3,5,8
193242,Perforation of intestine,ethnic,Hispanic or Latino,5,4,9
440538,Closed fracture of lower end of radius AND ulna,ethnic,Hispanic or Latino,2,7,9
4091768,Burkitt lymphoma of intrathoracic lymph nodes,ethnic,Hispanic or Latino,8,0,8
77965,Nodular tendinous disease of finger,racial,Black or African American ,4,5,9
443211,Benign prostatic hypertrophy with outflow obstruction,racial,White,0,8,8
4107528,Lermoyez syndrome,ethnic,Hispanic or Latino,8,0,8
437400,Closed fracture of shaft of ulna,ethnic,Hispanic or Latino,2,7,9
4164222,Tendon contracture,racial,White,6,2,8
198191,Acquired hypertrophic pyloric stenosis,ethnic,Hispanic or Latino,7,2,9
4138253,Malabsorption syndrome,racial,White,6,2,8
196160,Fistula of intestine,racial,White,8,0,8
442792,Pes anserinus bursitis,racial,Unknown,1,7,8
432851,Secondary malignant neoplastic disease,ethnic,Hispanic or Latino,8,0,8
75210,Carcinoma in situ of rectum,racial,Asian,0,8,8
379032,Acute mastoiditis with complications,racial,White,0,8,8
72990,Localised osteoarthrosis uncertain if primary OR secondary,racial,Unknown,8,1,9
439248,"Mixed bipolar affective disorder, moderate",ethnic,Hispanic or Latino,7,2,9
436209,Fracture of fibula,ethnic,Not Hispanic or Latino,5,3,8
437046,Complete abortion,ethnic,Not Hispanic or Latino,8,0,8
435141,Haemorrhage AND/OR haematoma complicating procedure,ethnic,Hispanic or Latino,4,4,8
436682,Moderate mental handicap,ethnic,Not Hispanic or Latino,2,6,8
196019,"Tuberculosis of intestines, peritoneum and mesenteric glands",ethnic,Hispanic or Latino,8,0,8
377282,Conjunctivitis with mucocutaneous disorder,racial,Unknown,7,2,9
377294,Exotropia,racial,Unknown,1,8,9
24609,Hypoglycaemia,racial,Asian,5,3,8
28127,"Multiple endocrine neoplasia, type 1",racial,Unknown,8,0,8
441793,Infection due to Class Cestoda and/or Class Trematoda and/or Phylum Nemata,racial,White,2,7,9
4158567,Post percutaneous transluminal coronary angioplasty,racial,Other Race,5,4,9
438979,Primary malignant neoplasm of hepatic flexure of colon,ethnic,Hispanic or Latino,8,0,8
192242,Acute hepatitis C,racial,Black or African American ,0,8,8
435723,Wound seroma,racial,White,7,2,9
73075,Contusion of upper limb,racial,Unknown,5,3,8
438168,Aneurysm of heart,racial,White,8,1,9
4058247,Anaemia during pregnancy/childbirth/puerperium NOS,racial,White,8,0,8
443228,"Abrasion or friction burn of foot and toe, without mention of infection",racial,Unknown,5,3,8
436001,Emotional abuse of adult,ethnic,Hispanic or Latino,8,0,8
376094,Arteriosclerotic dementia with delirium,ethnic,Hispanic or Latino,5,4,9
4116861,Neuromyopathy,ethnic,Hispanic or Latino,4,4,8
76548,Closed dislocation of hip,racial,White,4,5,9
4066820,Ingestion dermatitis due to food,ethnic,Not Hispanic or Latino,5,4,9
200962,Primary malignant neoplasm of prostate,racial,Black or African American ,0,8,8
443897,Disruption of perineal wound in the puerperium,ethnic,Hispanic or Latino,8,0,8
443883,Acute disease,racial,White,4,5,9
4104853,Epileptic seizures - clonic,ethnic,Not Hispanic or Latino,8,0,8
252663,Pneumonitis due to inhalation of food or vomitus,racial,White,2,6,8
4103642,Amputated toe,racial,Other Race,8,0,8
440846,"Blood coagulation disorder, categorized by value of screening test",ethnic,Not Hispanic or Latino,1,7,8
136516,Congenital pes planus,ethnic,Not Hispanic or Latino,5,3,8
376969,Orofacial dyskinesia,ethnic,Hispanic or Latino,7,2,9
375252,Disorder of eye,racial,Asian,6,2,8
197230,Malignant neoplasm of uterus,ethnic,Not Hispanic or Latino,8,0,8
443178,"Insect bite, nonvenomous, of face",ethnic,Hispanic or Latino,3,5,8
26459,Acute oesophagitis,ethnic,Hispanic or Latino,4,5,9
441827,Disorder of amino acid and organic acid metabolism,ethnic,Not Hispanic or Latino,0,8,8
443767,Diabetic oculopathy,racial,American Indian or Alaska Native ,8,0,8
196738,Male genital organ disease,racial,Other Race,0,8,8
74130,Thoracic spondylosis without myelopathy,racial,Unknown,5,4,9
437969,Acquired pes planus,racial,Black or African American ,2,7,9
80951,Candidiasis of urogenital site,racial,Other Race,4,5,9
440940,Methicillin resistant Staphylococcus aureus infection,ethnic,Not Hispanic or Latino,5,3,8
137345,Pressure ulcer stage 4,ethnic,Hispanic or Latino,4,5,9
433577,Hammer toe,ethnic,Not Hispanic or Latino,6,2,8
200444,Post-cholecystectomy syndrome,ethnic,Hispanic or Latino,5,4,9
442862,"Abrasion or friction burn of hand, without mention of infection",racial,White,5,4,9
437530,Disorders of lipoid metabolism,racial,Unknown,8,1,9
320752,Influenza with non-respiratory manifestation,ethnic,Not Hispanic or Latino,4,5,9
438134,Excessive sleep,racial,Other Race,2,7,9
4278672,Fracture of forearm,ethnic,Hispanic or Latino,4,4,8
198201,Chronic salpingo-oophoritis,ethnic,Hispanic or Latino,8,0,8
4069184,Infundibular pulmonic stenosis,racial,White,4,5,9
77650,Aseptic necrosis of bone,racial,White,8,0,8
321661,Spinal stenosis of thoracic region,racial,Unknown,8,0,8
196438,Acquired arteriovenous fistula of liver,ethnic,Hispanic or Latino,3,5,8
137856,Atypical facial pain,ethnic,Hispanic or Latino,4,5,9
4112831,Extrinsic asthma NOS,racial,Unknown,6,2,8
436681,Insomnia disorder related to known organic factor,racial,White,5,4,9
381572,Abducens nerve palsy,ethnic,Hispanic or Latino,2,7,9
79911,Effusion of joint of upper arm,ethnic,Hispanic or Latino,4,4,8
314965,Embolism and thrombosis of an arm or leg artery,ethnic,Hispanic or Latino,8,0,8
4056329,Vaginitis and vulvovaginitis NOS,ethnic,Not Hispanic or Latino,8,1,9
381316,CVA - Cerebrovascular accident,racial,Black or African American ,8,1,9
4175226,Screening for malignant neoplasm of colon,racial,Asian Indian,6,2,8
78605,Superficial bruising of elbow,racial,Unknown,6,2,8
4329847,MI - Myocardial infarction,racial,White,1,7,8
198260,Perinatal adrenal haemorrhage,racial,White,0,8,8
4171075,Bite of animal,ethnic,Hispanic or Latino,4,4,8
201344,Vesico-intestinal fistula,ethnic,Hispanic or Latino,7,2,9
141932,Senile hyperkeratosis,racial,Other Race,7,2,9
140842,Changes in skin texture,racial,Asian,2,7,9
440927,High risk drug monitoring status,racial,Unknown,8,1,9
434902,Autistic disorder of childhood onset,racial,Filipino,0,8,8
375801,Demyelinating disease of central nervous system,ethnic,Hispanic or Latino,8,0,8
141232,MM - Malignant melanoma of skin,racial,Unknown,7,1,8
436920,Reticulosarcoma,ethnic,Hispanic or Latino,8,0,8
195926,Slowing of urinary stream,ethnic,Hispanic or Latino,2,7,9
440386,Transsexualism,racial,Black or African American ,0,8,8
192364,Nephrotic syndrome associated with another disorder,racial,Unknown,6,2,8
4179925,Basic learning problem,ethnic,Not Hispanic or Latino,1,7,8
4079876,Familial combined hyperlipidemia,racial,Asian Indian,5,4,9
378140,Inflammatory and toxic neuropathy,racial,White,8,0,8
314379,First degree atrioventricular block,racial,Unknown,0,8,8
198260,Perinatal adrenal haemorrhage,ethnic,Not Hispanic or Latino,0,8,8
4175807,Rheumatic disease of tricuspid valve,racial,White,4,5,9
135033,Hair and hair follicle diseases,racial,Asian,4,4,8
373488,Pupil-sparing third nerve palsy,racial,White,4,4,8
76153,Low compliance bladder,racial,Black or African American ,5,4,9
437899,Acute and subacute bacterial endocarditis,ethnic,Hispanic or Latino,6,2,8
376400,Combined form of senile cataract,racial,Other Race,3,5,8
4052837,Open wound of breast,ethnic,Not Hispanic or Latino,8,0,8
79740,Overlapping malignant neoplasm of colon,ethnic,Hispanic or Latino,8,0,8
4292726,Contact - infectious disease,racial,Other Race,4,4,8
435411,Injury at C5-C7 level with spinal cord injury AND without bone injury,ethnic,Not Hispanic or Latino,0,8,8
440372,Acquired thrombocytopenia,ethnic,Hispanic or Latino,0,8,8
80141,Functional diarrhea,ethnic,Not Hispanic or Latino,7,1,8
81878,Benign paroxysmal positional vertigo,racial,Other Race,7,2,9
434926,Iridocyclitis,ethnic,Hispanic or Latino,5,4,9
438406,"Major depressive disorder, single episode, severe with psychotic features",racial,White,5,3,8
375291,Bullous myringitis,ethnic,Hispanic or Latino,4,4,8
441481,Adult victim of abuse,racial,White,5,4,9
194152,Renal agenesis and dysgenesis,racial,Unknown,8,0,8
4038835,HD - Hodgkin's disease,ethnic,Not Hispanic or Latino,8,0,8
4103416,Drug dependence NOS,racial,Unknown,4,4,8
439702,Residual infantile autism,ethnic,Hispanic or Latino,0,8,8
315273,MS - Mitral stenosis,racial,White,8,1,9
439166,Closed fracture of radius,racial,Unknown,6,2,8
433600,"Problem, abnormal test",ethnic,Hispanic or Latino,8,0,8
320425,Heart block,ethnic,Hispanic or Latino,1,8,9
4194232,Absence seizure,ethnic,Not Hispanic or Latino,8,0,8
316428,Hypertrophic obstructive cardiomyopathy,racial,Unknown,4,4,8
4064375,Iron deficiency screening,racial,American Indian or Alaska Native ,6,2,8
132736,Bacteremia,racial,White,1,7,8
74052,Labyrinthitis,racial,White,5,3,8
133284,Impetigo herpetiformis,ethnic,Hispanic or Latino,4,5,9
436667,Stammer,ethnic,Hispanic or Latino,1,7,8
440547,Closed fracture of shaft of metacarpal bone,ethnic,Hispanic or Latino,5,3,8
79173,Closed dislocation of jaw,ethnic,Hispanic or Latino,8,1,9
195834,Atherosclerosis of renal artery,racial,White,4,4,8
436110,Glaucoma associated with ocular inflammation,racial,White,0,8,8
434029,Chronic iridocyclitis,ethnic,Hispanic or Latino,1,7,8
441259,Non-thrombocytopenic purpura,racial,White,6,2,8
439005,Chronic alcoholism in remission,ethnic,Not Hispanic or Latino,4,4,8
138455,Stomatitis,racial,White,5,3,8
78560,Congenital deformity and malformation of feet and toes,racial,White,2,6,8
442623,Abrasion AND/OR friction burn of scalp without infection,ethnic,Not Hispanic or Latino,4,4,8
436155,Redundant prepuce and phimosis,racial,Black or African American ,0,8,8
201956,Congenital anomaly of lower limb,racial,Unknown,6,2,8
432571,Malignant lymphoma,racial,Other Race,1,7,8
23325,Heartburn,racial,Black or African American ,3,5,8
77076,Diastasis of muscle,ethnic,Hispanic or Latino,1,8,9
444108,Finding related to sleep,ethnic,Hispanic or Latino,8,0,8
443933,Nicotiana tabacum poisoning,racial,Native Hawaiian or Other Pacific Islander ,8,0,8
199062,"Acute gastric ulcer without hemorrhage, without perforation AND without obstruction",racial,White,0,8,8
198216,Retroverted incarcerated gravid uterus - delivered,racial,White,8,0,8
133280,Alopecia,racial,Asian,1,8,9
380734,External ear conductive hearing loss,racial,Unknown,8,0,8
443360,Eye mass,racial,White,5,4,9
256716,Asthma with status asthmaticus,racial,Unknown,4,5,9
439928,Gangrenous disorder,racial,Unknown,1,7,8
443556,Primary focal hyperhidrosis,racial,White,5,3,8
200836,Congenital anomaly of gastrointestinal tract,racial,Unknown,6,2,8
376981,Amblyopia,racial,Unknown,5,4,9
75389,Current tear of lateral cartilage AND/OR meniscus of knee,ethnic,Not Hispanic or Latino,8,1,9
373101,Injury of ulnar nerve,racial,White,2,7,9
434628,Separation anxiety,racial,White,3,5,8
138278,Sprains and strains of joints and adjacent muscles,racial,Other Race,5,3,8
140949,Scabies,racial,Asian,4,4,8
314658,Cardiomegaly,racial,Other Race,8,1,9
381028,Acute suppurative otitis media - tympanic membrane ruptured,ethnic,Not Hispanic or Latino,4,5,9
80951,Candidiasis of urogenital site,racial,Black or African American ,7,2,9
4052931,Abandoned child,racial,White,5,3,8
138379,"Chronic lymphoid leukemia, disease",ethnic,Hispanic or Latino,7,2,9
197601,Spermatocele,racial,White,0,8,8
201111,Congenital renal dysplasia,racial,White,6,2,8
137829,Erythroid aplasia,racial,White,1,8,9
197237,Benign tumour of prostate,racial,White,0,8,8
4001998,Pulmonary apoplexy,ethnic,Hispanic or Latino,8,0,8
443378,Anabolic steroids adverse reaction,ethnic,Hispanic or Latino,0,8,8
313224,Anomalous atrioventricular excitation,ethnic,Hispanic or Latino,0,8,8
141253,Disease of thyroid gland,racial,Asian,5,4,9
132685,Severe pre-eclampsia - not delivered,racial,White,8,0,8
200687,Renal disorder associated with type I diabetes mellitus,racial,Asian,0,8,8
441827,Disorder of amino acid and organic acid metabolism,racial,Asian,0,8,8
433163,Deficiency of macronutrients,ethnic,Not Hispanic or Latino,7,1,8
442565,Gestational edema without hypertension,ethnic,Not Hispanic or Latino,8,0,8
75689,Contusion of breast,racial,White,8,0,8
318448,"Incomplete atrioventricular block, second degree",ethnic,Hispanic or Latino,2,7,9
75010,Fibroadenosis of breast,ethnic,Not Hispanic or Latino,8,0,8
444287,Carbuncle of neck,ethnic,Hispanic or Latino,1,7,8
4202322,Amputated big toe,racial,Unknown,1,8,9
197028,Calculus of lower urinary tract,ethnic,Hispanic or Latino,1,7,8
438701,UKP - Disseminated malignancy of unknown primary,ethnic,Hispanic or Latino,2,7,9
199913,Acquired deformity of ankle AND/OR foot,racial,Unknown,3,5,8
201688,Urinary hesitancy,racial,Unknown,2,6,8
200769,"Chronic gastric ulcer without hemorrhage, without perforation AND without obstruction",ethnic,Hispanic or Latino,8,0,8
76506,Effusion of joint of lower leg,ethnic,Not Hispanic or Latino,5,4,9
140803,Idiopathic angio-oedema-urticaria,racial,White,7,2,9
194083,Vaginitis and vulvovaginitis,racial,American Indian or Alaska Native ,8,0,8
140966,Benign neoplasm of skin of face,racial,Unknown,5,3,8
312723,Congenital heart disease,racial,Other Race,5,3,8
438390,Benign tumour of vulva,racial,White,8,0,8
432590,Delusional disorder,racial,Asian,3,5,8
141651,Stevens-Johnson syndrome,racial,White,0,8,8
441189,Pertussis vaccine adverse reaction,racial,White,7,2,9
138682,Herpes zoster auricularis,ethnic,Hispanic or Latino,8,1,9
76240,Closed fracture of pubis,ethnic,Hispanic or Latino,5,3,8
196359,Primary malignant neoplasm of uterine cervix,racial,Unknown,8,0,8
318445,Post cardiac operation functional disturbance,ethnic,Not Hispanic or Latino,8,0,8
377091,Fits - convulsions,racial,Filipino,8,0,8
438750,Old total retinal detachment,racial,White,4,4,8
374655,Mastoiditis,racial,White,6,2,8
437966,Calcium deposits in tendon,ethnic,Not Hispanic or Latino,8,1,9
440647,Sexually transmitted infectious disease,racial,Unknown,5,3,8
139902,Allergic urticaria,racial,Asian,5,4,9
433659,Delayed healing of surgical wound,ethnic,Hispanic or Latino,5,4,9
4146239,Pruritus of genital organs,ethnic,Not Hispanic or Latino,8,1,9
434374,Anisocoria,racial,Unknown,4,5,9
75623,Old disruption of anterior cruciate ligament,racial,Unknown,4,4,8
374341,Huntington's chorea,ethnic,Not Hispanic or Latino,1,8,9
4052837,Open wound of breast,racial,Other Race,8,0,8
132706,Nail disease,racial,Black or African American ,7,2,9
438390,Benign tumour of vulva,ethnic,Hispanic or Latino,8,0,8
379822,Cyst of eyelid,racial,White,6,2,8
438905,Sequelae of injury of spinal cord,racial,White,0,8,8
79061,Colonic constipation,racial,Unknown,8,1,9
438209,Pregnancy care of habitual aborter,ethnic,Hispanic or Latino,8,0,8
75382,Closed fractures of tarsal AND metatarsal bones,racial,White,5,3,8
4158567,Post percutaneous transluminal coronary angioplasty,racial,American Indian or Alaska Native ,1,8,9
434029,Chronic iridocyclitis,racial,White,1,7,8
133284,Impetigo herpetiformis,racial,White,4,4,8
198802,Occlusion of ureter,racial,White,6,2,8
138824,Contact dermatitis due to metal,ethnic,Hispanic or Latino,7,2,9
434904,Persistent hypersomnia,ethnic,Hispanic or Latino,2,7,9
375552,Pterygium,racial,Asian,4,5,9
441829,Hyperosmolality and or hypernatremia,racial,Unknown,7,2,9
4008573,Advanced open-angle glaucoma,racial,White,5,4,9
374645,Phantom limb syndrome,ethnic,Hispanic or Latino,4,4,8
134517,Open wound of mouth without complication,racial,White,5,4,9
4066376,Pilonidal sinus with abscess,ethnic,Not Hispanic or Latino,0,8,8
4062636,Bacterial disease screening,racial,Other Race,8,0,8
433811,Hydronephrosis,racial,Other Race,4,5,9
438882,Closed fracture of neck of metacarpal bone,ethnic,Hispanic or Latino,2,7,9
319845,Pulmonary valve disease,racial,White,4,4,8
140803,Idiopathic angio-oedema-urticaria,racial,Unknown,3,5,8
72708,Traumatic arthropathy of the shoulder region,ethnic,Hispanic or Latino,8,1,9
135157,Observation of cardiovascular device,racial,White,8,0,8
436110,Glaucoma associated with ocular inflammation,ethnic,Hispanic or Latino,0,8,8
441655,Disorder of sweat gland,racial,White,4,4,8
196157,Induratio penis plastica,racial,Unknown,0,8,8
372629,Nonexudative age-related macular degeneration,racial,White,7,1,8
436421,"Mixed conductive and sensorineural hearing loss, bilateral",ethnic,Hispanic or Latino,3,5,8
375428,Second cranial nerve injury,ethnic,Hispanic or Latino,0,8,8
433071,Contusion of multiple sites,ethnic,Not Hispanic or Latino,8,0,8
435521,Psychophysiologic disorder,racial,White,4,4,8
435904,Derangement of anterior horn of medial meniscus,racial,White,3,5,8
436546,Strain of subscapularis muscle,ethnic,Hispanic or Latino,7,2,9
196438,Acquired arteriovenous fistula of liver,racial,White,3,5,8
198400,Haemangioma of skin and subcutaneous tissue,ethnic,Not Hispanic or Latino,5,4,9
141104,Intervertebral disc disorder of lumbar region with myelopathy,racial,Asian,4,5,9
40479575,Dysphasia as late effect of cerebrovascular disease,racial,White,7,1,8
314368,Mitral stenosis with insufficiency,ethnic,Hispanic or Latino,8,0,8
373101,Injury of ulnar nerve,ethnic,Hispanic or Latino,3,5,8
375529,Infantile cerebral palsy,racial,Asian,7,2,9
133569,Fasciitis,ethnic,Not Hispanic or Latino,4,5,9
4176874,Infantile melanodontia,ethnic,Not Hispanic or Latino,1,8,9
441868,Optic disc oedema,racial,White,8,0,8
437655,Cryptorchism,racial,Black or African American ,0,8,8
440905,Toxic effect of venom,racial,Unknown,5,3,8
438959,Amoebiasis,ethnic,Hispanic or Latino,5,3,8
381864,Subjective tinnitus,racial,White,6,2,8
440855,Closed fracture of base of metacarpal bone other than first metacarpal,racial,White,6,2,8
434465,Nonallopathic lesion of rib cage,ethnic,Hispanic or Latino,5,3,8
443545,Nonvenomous insect bite,racial,Asian,4,5,9
443115,Closed fracture finger proximal phalanx,ethnic,Not Hispanic or Latino,2,6,8
440814,Torticollis,ethnic,Not Hispanic or Latino,6,2,8
437663,Fever,racial,American Indian or Alaska Native ,4,4,8
135333,Pressure sore,ethnic,Not Hispanic or Latino,5,4,9
75210,Carcinoma in situ of rectum,ethnic,Hispanic or Latino,0,8,8
436278,Superficial bruising of thigh,racial,Unknown,6,2,8
197028,Calculus of lower urinary tract,racial,Unknown,1,7,8
72986,Disease of lower leg,racial,White,7,1,8
81112,Arthralgia of the lower leg,racial,American Indian,4,4,8
380102,Corneal edema,racial,Unknown,4,5,9
444031,Chronic heart failure,ethnic,Hispanic or Latino,2,7,9
4272867,General well-being finding,racial,Black or African American ,3,5,8
197609,"Cervical, vaginal and vulval inflammatory diseases",ethnic,Hispanic or Latino,8,0,8
141323,Acute maxillary sinusitis,racial,Black or African American ,5,4,9
376224,Spina bifida without hydrocephalus,ethnic,Not Hispanic or Latino,0,8,8
312622,BVO - Branch retinal occlusion,racial,White,7,2,9
434887,Disorders of bilirubin excretion,racial,Unknown,0,8,8
76191,Disease of upper arm,ethnic,Not Hispanic or Latino,4,4,8
439025,Dacryocystitis,ethnic,Hispanic or Latino,5,4,9
377873,Lid lag,ethnic,Hispanic or Latino,4,4,8
196019,"Tuberculosis of intestines, peritoneum and mesenteric glands",racial,Unknown,8,0,8
201347,Pelvic pain syndrome,racial,White,8,0,8
74606,Benign bone tumor,racial,White,5,4,9
432441,Finding of length of gestation,racial,Black or African American ,2,6,8
4038835,HD - Hodgkin's disease,racial,Other Race,8,0,8
201606,Crohn's disease,racial,Unknown,3,5,8
434633,Disorder of autonomic nervous system,racial,White,5,4,9
439961,Superficial injury without infection,racial,White,6,2,8
141663,Osteomyelitis,ethnic,Not Hispanic or Latino,5,4,9
4334644,Decubitus ulcer of lower back,racial,Unknown,8,0,8
4145627,Biliary calculus,racial,Unknown,6,2,8
193814,Chronic parametritis and pelvic cellulitis,ethnic,Hispanic or Latino,8,0,8
444371,Abrasion AND/OR friction burn of finger without infection,racial,White,3,5,8
80495,Palindromic rheumatism of the pelvic region and thigh,racial,Other Race,8,0,8
444433,Open wound of toe with complication,racial,Unknown,8,0,8
440647,Sexually transmitted infectious disease,ethnic,Not Hispanic or Latino,4,4,8
30770,Chronic peptic ulcer with hemorrhage but without obstruction,ethnic,Hispanic or Latino,8,0,8
139895,"Thyroid dysfunction during pregnancy, childbirth and the puerperium",ethnic,Hispanic or Latino,8,1,9
376337,Disease of nervous system,racial,White,5,3,8
442167,Neoplasm of uncertain behaviour of craniopharyngeal duct,ethnic,Hispanic or Latino,5,4,9
432301,Opioid dependence in remission,racial,White,3,5,8
433556,Derangement of posterior horn of lateral meniscus,ethnic,Hispanic or Latino,7,2,9
78011,Sprain of metacarpophalangeal joint,ethnic,Hispanic or Latino,4,5,9
432588,Megaloblastic anemia due to vitamin B>12< deficiency,ethnic,Not Hispanic or Latino,7,2,9
375415,Injury of head region,racial,Black or African American ,2,7,9
435810,After-cataract,racial,Unknown,5,4,9
4090651,Dialysis observation,racial,Black or African American ,7,2,9
312998,Pain in thoracic spine,racial,Other Race,8,0,8
381444,Black eye,racial,Unknown,5,4,9
4285139,Social maladjustment,ethnic,Hispanic or Latino,1,7,8
4152047,Lipid screening,racial,Other Race,3,5,8
441532,Monoclonal paraproteinaemia,racial,White,2,5,7
433000,Patellar tendonitis,racial,Unknown,1,7,8
4014296,Twins - both live born,ethnic,Hispanic or Latino,6,2,8
199859,Bilateral recurrent inguinal hernia,ethnic,Not Hispanic or Latino,0,8,8
201131,Pelvic mass,racial,Other Race,8,0,8
441460,Late effect of sprain AND/OR strain without tendon injury,racial,White,4,4,8
321689,Apneic,racial,Unknown,6,2,8
313791,Bundle branch block,racial,Unknown,7,1,8
317003,Compression of vein,ethnic,Not Hispanic or Latino,0,8,8
376709,Discharge of eye,ethnic,Not Hispanic or Latino,4,4,8
443257,Swellings and lumps,racial,Asian,6,2,8
313224,Anomalous atrioventricular excitation,racial,White,0,8,8
136760,Transient hypertension of pregnancy - not delivered,ethnic,Not Hispanic or Latino,7,1,8
195316,Atypical endometrial hyperplasia,ethnic,Hispanic or Latino,8,0,8
28060,Strept throat,racial,Filipino,5,2,7
436233,Delayed milestone,racial,Unknown,1,7,8
4281232,Type B viral hepatitis,racial,White,5,3,8
141955,Pectus excavatum,racial,White,2,6,8
4115379,"Localised, primary osteoarthritis of the pelvic region and thigh",racial,Black or African American ,8,0,8
320429,Rheumatic aortic stenosis with regurgitation,racial,Unknown,7,1,8
377550,Compression of brain,racial,White,8,0,8
436100,Narcolepsy,racial,Unknown,8,0,8
196044,Primary malignant neoplasm of stomach,racial,Unknown,8,0,8
193239,Diverticulitis of small intestine,ethnic,Hispanic or Latino,7,1,8
317003,Compression of vein,racial,Asian,0,8,8
436238,Elevated levels of transaminase and lactic acid dehydrogenase,racial,American Indian or Alaska Native ,8,0,8
432739,Red blood cell disorder,racial,Unknown,5,2,7
199958,Open wound of hip AND thigh without complication,racial,White,3,5,8
252663,Pneumonitis due to inhalation of food or vomitus,ethnic,Not Hispanic or Latino,0,8,8
197018,Chronic gastric ulcer with hemorrhage but without obstruction,racial,White,8,0,8
192671,GI - Gastrointestinal haemorrhage,racial,Other Race,7,1,8
80805,Primary localized osteoarthrosis of forearm,ethnic,Not Hispanic or Latino,6,2,8
432308,Mononeuritis of lower limb,ethnic,Not Hispanic or Latino,4,4,8
441261,Episodic acute alcoholic intoxication in alcoholism,racial,White,2,5,7
26459,Acute oesophagitis,racial,White,4,4,8
4119298,Late onset asthma,ethnic,Hispanic or Latino,4,4,8
194083,Vaginitis and vulvovaginitis,racial,Native Hawaiian or Other Pacific Islander ,8,0,8
4108975,Borderline glaucoma NOS,racial,White,7,1,8
4108533,Unspecified otalgia,ethnic,Not Hispanic or Latino,6,2,8
439981,Wound dehiscence,ethnic,Hispanic or Latino,6,2,8
137627,Prickly heat,racial,Unknown,2,5,7
433455,Teeth grinding whilst asleep,racial,Other Race,7,1,8
432626,Glaucoma associated with vascular disorder,ethnic,Hispanic or Latino,5,2,7
80004,Hand injury,racial,Unknown,3,5,8
257907,Disorder of lung,racial,Other Race,4,4,8
4108664,Hypertensive heart disease NOS,ethnic,Hispanic or Latino,8,0,8
27674,N&V - Nausea and vomiting,racial,American Indian or Alaska Native ,8,0,8
441542,Anxiety,racial,Filipino,6,2,8
433659,Delayed healing of surgical wound,racial,White,5,2,7
374562,Acute poliomyelitis with paralysis except bulbar,ethnic,Hispanic or Latino,8,0,8
138539,Shprintzen-Goldberg syndrome,ethnic,Hispanic or Latino,2,6,8
4141492,Other ill-defined heart disease,ethnic,Not Hispanic or Latino,8,0,8
378160,Otorrhea,racial,White,2,5,7
374357,Acquired stenosis of nasolacrimal duct,racial,Other Race,2,6,8
318773,Dilated cardiomyopathy secondary to alcohol,ethnic,Hispanic or Latino,0,8,8
136495,Lichenification and lichen simplex chronicus,ethnic,Not Hispanic or Latino,6,2,8
76836,Sprain of knee and leg,racial,Other Race,3,5,8
192673,Vascular insufficiency of intestine,ethnic,Hispanic or Latino,7,1,8
4088920,Womb absent,racial,Other Race,8,0,8
136788,Spinal stenosis of lumbar region,racial,Other Race,4,4,8
438827,Foreign body granuloma of subcutaneous tissue,racial,White,4,4,8
4304916,Gastrointestinal tract finding,racial,White,5,2,7
435789,Megaloblastic anemia,racial,White,5,3,8
136237,Cardiovascular system problem,racial,Unknown,4,4,8
201322,Internal hemorrhoids without complication,racial,Other Race,6,2,8
434170,Atypical squamous cells of undetermined significance on cervical Papanicolaou smear,racial,Black or African American ,8,0,8
30515,Oesophagostenosis,racial,White,4,4,8
434872,Infection by Trichomonas,racial,White,7,1,8
312337,Arterial embolic and thrombotic occlusion,ethnic,Not Hispanic or Latino,8,0,8
315078,Palpitations,racial,American Indian or Alaska Native ,8,0,8
261325,Pulmonary emphysema,racial,Other Race,4,4,8
373200,Chronic fungal otitis externa,racial,White,6,2,8
439080,Dyspareunia,racial,Other Race,8,0,8
257315,Bacterial pneumonia,racial,Asian,4,4,8
378160,Otorrhea,racial,Unknown,4,4,8
432554,Human immunodeficiency virus II infection,ethnic,Not Hispanic or Latino,4,4,8
4101199,Hearing problem,racial,Black or African American ,4,4,8
438557,Abnormal glucose level,racial,American Indian,2,6,8
201518,Primary malignant neoplasm of lower limb,ethnic,Hispanic or Latino,0,8,8
432352,Idiopathic fibrosing alveolitis,racial,Unknown,1,7,8
441692,Finding of serum tumour marker level,ethnic,Hispanic or Latino,7,1,8
440389,MR - Mental retardation,racial,Asian,1,7,8
80156,Asymptomatic bacteriuria in pregnancy,ethnic,Not Hispanic or Latino,7,1,8
196473,Hypertrophy of uterus,racial,Unknown,8,0,8
256571,FB - Nasal foreign body,racial,White,4,4,8
314054,Aortic valve disease,racial,Other Race,1,7,8
196523,Diarrhea,racial,American Indian or Alaska Native ,4,4,8
201518,Primary malignant neoplasm of lower limb,racial,Unknown,0,8,8
432791,Urticaria-angio-oedema,ethnic,Not Hispanic or Latino,5,3,8
73291,Palindromic rheumatism of the ankle and/or foot,racial,Black or African American ,7,1,8
441334,Glossodynia,racial,White,6,2,8
198401,Neoplasm of uncertain behavior of bladder,racial,White,4,4,8
201927,Cellulitis and abscess of leg,racial,American Indian or Alaska Native ,4,4,8
432352,Idiopathic fibrosing alveolitis,ethnic,Hispanic or Latino,1,7,8
4096271,Methadone analog adverse reaction,ethnic,Hispanic or Latino,0,8,8
138539,Shprintzen-Goldberg syndrome,racial,White,2,6,8
432739,Red blood cell disorder,ethnic,Not Hispanic or Latino,4,4,8
375825,Referred otalgia,racial,White,5,3,8
201965,Shock,ethnic,Hispanic or Latino,7,1,8
437093,Congenital ptosis of upper eyelid,racial,White,7,1,8
40481374,Allergic rhinitis due to food,racial,White,3,5,8
76725,Fissure in ano,racial,Unknown,7,1,8
4170137,Non-suppurative otitis media,racial,Other Race,4,4,8
443580,Systolic heart failure,racial,Unknown,4,4,8
78838,Acquired deformity of knee,racial,White,4,4,8
441737,Bruising,racial,Black or African American ,5,2,7
199866,Acute gastritis,racial,Filipino,5,2,7
375475,Meningoencephalitis due to acquired toxoplasmosis,ethnic,Hispanic or Latino,1,7,8
74104,Fetal condition affecting obstetrical care of mother,ethnic,Hispanic or Latino,8,0,8
381297,Xanthoma of eyelid,racial,Unknown,8,0,8
24970,Chronic laryngitis,ethnic,Not Hispanic or Latino,7,1,8
4148407,Family history: Cardiovascular disease,ethnic,Not Hispanic or Latino,3,5,8
261327,Empyema of pleura without fistula,racial,White,5,3,8
72404,Joint stiffness,racial,White,5,2,7
381252,Benign neoplasm of eye,racial,White,5,2,7
195321,Postmenopausal bleeding,racial,American Indian or Alaska Native ,8,0,8
75065,Acquired deformity of spine,ethnic,Hispanic or Latino,5,2,7
259849,Pneumonia with infectious diseases EC,racial,Unknown,6,2,8
80571,Open wound of foot with complication,ethnic,Hispanic or Latino,5,2,7
320429,Rheumatic aortic stenosis with regurgitation,ethnic,Hispanic or Latino,7,1,8
436075,Adjustment disorder with anxious mood,racial,Unknown,4,4,8
138463,Oral aphthae,racial,Asian,4,4,8
137065,Nonstageable pressure ulcer,racial,Unknown,8,0,8
135888,Decubitus ulcer,racial,White,2,5,7
433033,Abnormal cervical Papanicolaou smear,racial,Unknown,8,0,8
376691,Delimited old retinal detachment,racial,Unknown,1,7,8
372324,Eustachian tube disorder,racial,Other Race,6,2,8
314664,Long Q-T syndrome,ethnic,Hispanic or Latino,7,1,8
315085,Enlargement of lymph nodes,racial,Other Race,5,3,8
193326,Urge incontinence of urine,racial,Asian,5,2,7
438905,Sequelae of injury of spinal cord,ethnic,Not Hispanic or Latino,0,8,8
443447,Iatrogenic hypotension,ethnic,Hispanic or Latino,5,3,8
192353,Disorder of gallbladder,racial,Unknown,4,4,8
441321,Chronic nasopharyngitis,ethnic,Hispanic or Latino,5,3,8
380731,OE - Otitis externa,ethnic,Not Hispanic or Latino,2,6,8
198400,Haemangioma of skin and subcutaneous tissue,racial,Unknown,7,1,8
135893,Decubitus ulcer of heel,ethnic,Not Hispanic or Latino,5,2,7
78579,Closed fracture of first cervical vertebra,ethnic,Hispanic or Latino,8,0,8
27017,Defective dental restoration,ethnic,Hispanic or Latino,2,6,8
261326,Viral pneumonia,ethnic,Not Hispanic or Latino,2,6,8
74125,Inflammatory polyarthropathy,racial,Unknown,4,4,8
135061,Congenital anomaly of musculoskeletal system,ethnic,Hispanic or Latino,4,4,8
196061,Benign tumour of stomach,racial,White,7,1,8
4096271,Methadone analog adverse reaction,racial,White,0,8,8
4285139,Social maladjustment,racial,White,1,7,8
199876,Prolapse of female genital organs,racial,White,8,0,8
440366,Delay in sexual development AND/OR puberty,ethnic,Hispanic or Latino,3,5,8
439846,LVF - Left ventricular failure,racial,Asian,0,8,8
433596,Abnormal sputum,ethnic,Not Hispanic or Latino,2,5,7
432595,Amyloidosis,racial,White,8,0,8
138525,Pain in limb,racial,Native Hawaiian or Other Pacific Islander ,6,2,8
40490423,Incontinence without sensory awareness,racial,Unknown,6,2,8
376973,Cataract secondary to ocular disease,racial,White,5,2,7
376117,Cataract in degenerative disorder,racial,Asian,8,0,8
197675,Bowel incontinence,ethnic,Not Hispanic or Latino,4,4,8
72576,Benign tumour of breast,racial,Unknown,8,0,8
201265,Splenic disorder,racial,White,7,1,8
80186,Recurrent dislocation of shoulder region,racial,White,4,4,8
4062484,Cervical neoplasia screening,racial,American Indian,8,0,8
374562,Acute poliomyelitis with paralysis except bulbar,racial,Unknown,8,0,8
193277,Deliveries by caesarean,racial,White,8,0,8
78909,"Contusion, shoulder and upper arm, multiple sites",racial,White,4,4,8
4062795,Twin pregnancy unspecified,ethnic,Hispanic or Latino,8,0,8
313209,Left bundle branch hemiblock,racial,Unknown,5,2,7
443524,Mixed incontinence,racial,Asian,7,1,8
194083,Vaginitis and vulvovaginitis,racial,Filipino,8,0,8
4062650,Malnutrition screening,ethnic,Not Hispanic or Latino,4,4,8
72501,Superficial foreign body of foot without major open wound AND without infection,racial,White,4,4,8
4286333,Carcinoma in situ,racial,White,7,1,8
313989,Chronic lymphadenitis,racial,White,5,2,7
435626,Tibial collateral ligament bursitis,racial,Black or African American ,0,8,8
374027,Lesion of ulnar nerve,ethnic,Not Hispanic or Latino,2,5,7
4029488,Hepatic encephalopathy,ethnic,Not Hispanic or Latino,1,7,8
4114610,Allergic arthritis NOS,ethnic,Hispanic or Latino,6,2,8
439219,Poisoning due to venomous spider,ethnic,Hispanic or Latino,7,1,8
314381,Kawasaki syndrome,racial,White,5,3,8
440216,Abnormal glucose tolerance test,racial,Black or African American ,4,4,8
75128,Injury of chest wall,ethnic,Not Hispanic or Latino,3,5,8
139850,Acute frontal sinusitis,racial,Other Race,5,3,8
135526,Myelopathy,racial,Unknown,2,6,8
438112,Neoplastic disease,racial,White,7,1,8
133857,Acquired deformity of limb,racial,Unknown,5,3,8
375252,Disorder of eye,racial,Black or African American ,5,3,8
437540,CRAO - Central retinal artery occlusion,racial,White,3,5,8
141249,Benign tumour of thyroid gland,racial,Unknown,8,0,8
135618,Prurigo,racial,Unknown,5,3,8
75099,Coccyx sprain,racial,White,5,2,7
314054,Aortic valve disease,racial,Asian,2,6,8
318736,Migraine,racial,American Indian or Alaska Native ,7,1,8
76887,Disorders of urogenital prostheses or implants,racial,Unknown,5,2,7
138389,Benign neoplasm of scalp and skin of neck,racial,Unknown,5,3,8
435912,Endocardial cushion defect,racial,Other Race,8,0,8
435836,Disorder of nasopharynx,racial,Unknown,2,6,8
379806,Migraine variants,ethnic,Not Hispanic or Latino,7,1,8
433244,Tooth loss,ethnic,Hispanic or Latino,2,6,8
137967,"Muscle, ligament and fascia disorders",ethnic,Not Hispanic or Latino,7,1,8
434944,Scleritis,ethnic,Hispanic or Latino,6,2,8
4087756,Late latent syphilis,racial,Black or African American ,2,5,7
74135,Disorder of synovium,racial,Unknown,7,1,8
434169,Abnormal findings on diagnostic imaging of breast,racial,Black or African American ,8,0,8
133364,Second degree burn of back,ethnic,Hispanic or Latino,8,0,8
80816,Intervertebral disc degeneration,racial,Black or African American ,1,7,8
140480,Impetigo,racial,Black or African American ,4,4,8
438878,Abnormal results of liver function studies,racial,Other Race,5,3,8
139057,Disease of oral soft tissues,racial,Asian,5,2,7
78518,Observation of shoulder joint,racial,White,7,1,8
435914,Metatarsus varus,racial,White,5,3,8
4319150,Pulled elbow,ethnic,Hispanic or Latino,2,5,7
81112,Arthralgia of the lower leg,racial,Filipino,8,0,8
4283532,Psychogenic headache,racial,Unknown,8,0,8
132466,Lumbar sprain,racial,Black or African American ,1,7,8
4113650,Noninflammatory cervical disorder,ethnic,Hispanic or Latino,7,1,8
196158,Disease of penis,ethnic,Not Hispanic or Latino,0,8,8
253790,Pneumonia due to Klebsiella pneumoniae,ethnic,Not Hispanic or Latino,8,0,8
441946,Calcific tendinitis of shoulder,ethnic,Not Hispanic or Latino,5,2,7
196726,Cholelithiasis AND acute cholecystitis without obstruction,racial,White,7,1,8
374035,Keratitis,ethnic,Hispanic or Latino,6,2,8
439237,Assault,racial,White,7,1,8
253790,Pneumonia due to Klebsiella pneumoniae,racial,Asian,8,0,8
80874,Open wound of multiple sites of one upper limb without complication,racial,White,5,3,8
372424,Congenital anolmaly of eye,ethnic,Hispanic or Latino,5,2,7
138384,Acquired hypothyroidism,racial,Black or African American ,4,4,8
314971,Chronic respiratory failure,racial,Black or African American ,7,1,8
4004785,Fetal alcohol syndrome,ethnic,Not Hispanic or Latino,4,4,8
434319,Premature orgasm - male,racial,White,0,8,8
194149,Hirschsprung disease,ethnic,Hispanic or Latino,4,4,8
381859,Infective OE,racial,American Indian or Alaska Native ,6,2,8
444361,Nonvenomous insect bite of toe without infection,ethnic,Hispanic or Latino,5,3,8
196149,Acute appendicitis with generalized peritonitis,ethnic,Hispanic or Latino,1,7,8
40491340,Closed fracture of tibia,ethnic,Not Hispanic or Latino,2,6,8
432513,Animal bite wound,ethnic,Hispanic or Latino,7,1,8
318169,Varicose veins of lower extremity,racial,Other Race,8,0,8
378421,Alcoholic peripheral neuropathy,racial,White,1,7,8
432546,Herpes zoster dermatitis of eyelids,ethnic,Hispanic or Latino,4,4,8
132344,Gingival and periodontal disease,ethnic,Not Hispanic or Latino,6,2,8
4331070,Family history of polyp of colon,ethnic,Hispanic or Latino,3,5,8
81942,Enthesopathy of ankle AND/OR tarsus,racial,Unknown,7,1,8
439219,Poisoning due to venomous spider,racial,White,6,2,8
377802,Late effects of poliomyelitis,ethnic,Not Hispanic or Latino,1,7,8
4282316,Recurrent major depression,racial,White,1,7,8
436336,Herpes zoster with nervous system complication,racial,Other Race,2,5,7
140318,"Septicemia due to streptococcus, group A",ethnic,Hispanic or Latino,2,5,7
261880,Atelectasis,racial,Unknown,7,1,8
321590,Right bundle branch block AND left posterior fascicular block,ethnic,Hispanic or Latino,0,8,8
192675,Biliary cirrhosis,racial,White,4,4,8
314965,Embolism and thrombosis of an arm or leg artery,racial,White,7,1,8
194699,Liver disorder in pregnancy,racial,White,8,0,8
434084,Abscess of vulva,ethnic,Not Hispanic or Latino,8,0,8
439847,Intracranial hemorrhage,racial,White,2,5,7
25518,AS - Sickle cell trait,ethnic,Not Hispanic or Latino,3,5,8
192242,Acute hepatitis C,racial,Other Race,8,0,8
4048191,Enlargement of tonsil or adenoid,ethnic,Not Hispanic or Latino,6,2,8
320425,Heart block,racial,Unknown,0,8,8
437943,Pulp abscess of finger,racial,White,3,5,8
141213,Scarlet fever,racial,Unknown,5,3,8
435802,Blepharospasm,ethnic,Not Hispanic or Latino,8,0,8
4296204,First degree burn,racial,White,6,2,8
81403,Osteopetrosis,racial,White,8,0,8
194700,"Diabetes mellitus in mother complicating pregnancy, childbirth AND/OR puerperium",ethnic,Not Hispanic or Latino,8,0,8
135526,Myelopathy,ethnic,Not Hispanic or Latino,1,7,8
313011,Congenital abnormality of cardiac position,ethnic,Hispanic or Latino,1,7,8
4164792,Hemophilus influenzae laryngitis,racial,White,5,3,8
195321,Postmenopausal bleeding,racial,Other Race,8,0,8
137213,Fungal dermatosis,racial,Asian,4,4,8
433288,Derangement of anterior horn of lateral meniscus,ethnic,Hispanic or Latino,2,5,7
194788,Open wound of anterior abdominal wall with complication,racial,Unknown,4,4,8
192376,Rhesus isoimmunization with antenatal problem,ethnic,Not Hispanic or Latino,8,0,8
380669,Benign neoplasm of eyelid including canthus,ethnic,Hispanic or Latino,5,3,8
434742,Congenital abnormality of skull and face bones,racial,Other Race,7,1,8
78512,Joint contracture of the ankle and/or foot,racial,White,2,5,7
75051,Derangement of posterior horn of medial meniscus,racial,Unknown,6,2,8
201313,Hypertensive renal disease,racial,Unknown,4,4,8
193277,Deliveries by caesarean,ethnic,Hispanic or Latino,8,0,8
374221,Injury of brachial plexus,ethnic,Hispanic or Latino,3,5,8
374028,AAMD - Age related macular degeneration,racial,Filipino,8,0,8
379032,Acute mastoiditis with complications,ethnic,Hispanic or Latino,0,8,8
434298,Metastasis to upper limb lymph node,ethnic,Hispanic or Latino,8,0,8
432851,Secondary malignant neoplastic disease,racial,White,8,0,8
4256640,Body mass index 40+ - severely obese,racial,Unknown,4,4,8
141648,Contact dermatitis due to cosmetics,racial,White,7,1,8
377861,Disorder of refraction AND/OR accommodation,racial,Filipino,2,6,8
28461,Hypertrophy of salivary gland,ethnic,Hispanic or Latino,1,7,8
4062484,Cervical neoplasia screening,racial,Native Hawaiian or Other Pacific Islander ,8,0,8
260123,Acute inflammation of sinus,racial,Native Hawaiian or Other Pacific Islander ,5,3,8
257683,Postnasal drip,racial,Asian,7,1,8
434916,"Amfetamine or psychostimulant dependence, continuous",racial,White,0,8,8
437176,Late effect of accidental fall,racial,White,4,4,8
133510,Rapidly progressive periodontitis,racial,White,4,4,8
4100365,Schizophrenic disorders,racial,White,5,2,7
316428,Hypertrophic obstructive cardiomyopathy,ethnic,Not Hispanic or Latino,7,1,8
140480,Impetigo,racial,Asian,2,6,8
436166,Mild hyperemesis gravidarum,racial,Unknown,8,0,8
433946,Fall on same level due to impact against another person,racial,White,7,1,8
252365,MGN - Membranous glomerulonephritis,racial,Unknown,4,4,8
134668,Chronic maxillary sinusitis,ethnic,Not Hispanic or Latino,3,5,8
318566,Flushing,racial,White,6,2,8
4268980,Finding of general development,ethnic,Hispanic or Latino,8,0,8
4014231,Foot sprain NOS,ethnic,Hispanic or Latino,3,5,8
4177115,Malignant tumour of testis,ethnic,Hispanic or Latino,0,8,8
434490,Shivering,racial,Unknown,6,2,8
138225,Disease of sebaceous glands,racial,Unknown,5,3,8
318776,Rheumatic mitral regurgitation,ethnic,Hispanic or Latino,1,7,8
438727,Atypical depressive disorder,racial,Black or African American ,5,3,8
192684,"Renal hypertension complicating pregnancy, childbirth and the puerperium - not delivered",ethnic,Hispanic or Latino,1,7,8
439141,Abnormal increase in weight,racial,American Indian or Alaska Native ,0,8,8
4215003,Myasthenic crisis,racial,White,2,5,7
25780,Lorain - Levi dwarfism,ethnic,Hispanic or Latino,5,3,8
75650,Proteinuria,racial,American Indian,4,4,8
444272,Contact dermatitis due to drugs AND/OR medicine,racial,White,4,4,8
437530,Disorders of lipoid metabolism,ethnic,Not Hispanic or Latino,6,2,8
313023,Neonatal chronic respiratory disease,racial,Asian,1,7,8
76550,Sprain of metatarsophalangeal joint,ethnic,Hispanic or Latino,5,3,8
81403,Osteopetrosis,racial,Unknown,2,6,8
194992,Coeliac disease,ethnic,Not Hispanic or Latino,4,4,8
78786,Pleurisy,ethnic,Not Hispanic or Latino,6,2,8
4250023,Severe major depression with psychotic features,racial,Filipino,8,0,8
437113,Asthenia,racial,Other Race,2,5,7
4286333,Carcinoma in situ,racial,Unknown,2,5,7
314379,First degree atrioventricular block,racial,Asian,4,4,8
378414,Separation of retinal layers,racial,Unknown,4,4,8
435739,Late syphilis,racial,White,1,6,7
76786,Derangement of knee,racial,Other Race,5,2,7
4109698,Acute conjunctivitis NOS,racial,White,4,4,8
435511,Hypercalcemia,racial,Black or African American ,5,2,7
435987,Peanut-induced anaphylaxis,racial,White,2,5,7
375827,Acute non-suppurative otitis media - serous,racial,Black or African American ,2,5,7
437246,Vitamin B deficiency,racial,Other Race,6,1,7
319049,Acute respiratory failure,ethnic,Not Hispanic or Latino,1,6,7
139900,Urticaria,racial,Black or African American ,5,2,7
440794,Elderly primigravida - delivered,ethnic,Hispanic or Latino,7,0,7
80806,Climacteric arthritis of multiple sites,racial,Unknown,7,1,8
381562,"Impairment level: better eye: moderate impairment: lesser eye: blind, not further specified",racial,Unknown,7,1,8
433942,Accident whilst engaged in household activity,racial,Other Race,5,2,7
4305303,Sleep deprivation,racial,Unknown,7,1,8
4031190,Swallowed foreign body,racial,White,4,4,8
443452,Bleeding of unknown origin,racial,White,5,2,7
441692,Finding of serum tumour marker level,racial,Asian,6,1,7
75389,Current tear of lateral cartilage AND/OR meniscus of knee,racial,Unknown,5,2,7
434465,Nonallopathic lesion of rib cage,racial,White,4,3,7
28403,Acromegaly and gigantism,racial,White,1,7,8
444272,Contact dermatitis due to drugs AND/OR medicine,ethnic,Hispanic or Latino,2,5,7
438722,Non megaloblastic anemia associated with nutritional deficiency,racial,Unknown,5,2,7
4192786,Potential infectious contact,ethnic,Hispanic or Latino,7,0,7
257007,Allergic rhinitis,racial,American Indian,7,1,8
4209151,Repair of musculotendinous cuff of shoulder,racial,White,5,2,7
444457,Benign tumour of rectum,ethnic,Hispanic or Latino,0,7,7
140487,Dermatitis herpetiformis,racial,White,5,2,7
26727,Vomiting blood,racial,Unknown,5,2,7
197921,Renal osteodystrophy,racial,White,7,1,8
194802,Foreign body in vulva and vagina,racial,White,7,0,7
198194,Female genital organ symptoms,racial,American Indian or Alaska Native ,7,0,7
4053599,Open wound of forearm,racial,Unknown,4,3,7
200843,Observation of frequency of urination,racial,Black or African American ,5,2,7
81336,Rectal prolapse,racial,White,7,0,7
432347,Chronic disease of tonsils AND/OR adenoids,racial,Unknown,5,2,7
375819,TM - Tympanic membrane disorder,racial,White,3,4,7
197022,Unilateral recurrent inguinal hernia with obstruction but no gangrene,ethnic,Hispanic or Latino,0,7,7
195314,Nephrotic syndrome,racial,Filipino,0,7,7
200765,Chronic cholecystitis,racial,White,6,1,7
138821,Seborrhea,racial,Unknown,7,1,8
4308509,Impaired fasting glycaemia,racial,American Indian or Alaska Native ,1,7,8
72576,Benign tumour of breast,ethnic,Not Hispanic or Latino,7,0,7
437643,Gait abnormality,racial,American Indian or Alaska Native ,5,2,7
435325,Umbilical cord complication,ethnic,Hispanic or Latino,4,4,8
141249,Benign tumour of thyroid gland,racial,White,4,3,7
433471,Retinal neovascularization,ethnic,Hispanic or Latino,5,2,7
436466,Balanoposthitis,racial,Black or African American ,0,7,7
376965,Hypertensive retinopathy,racial,Unknown,4,3,7
72418,Scoliosis deformity of spine,ethnic,Not Hispanic or Latino,4,4,8
434207,"Insect bite, nonvenomous, of hand, without mention of infection",racial,White,4,4,8
79116,Disorder of tendon of shoulder region,racial,Unknown,7,0,7
373101,Injury of ulnar nerve,ethnic,Not Hispanic or Latino,1,6,7
26441,Bleeding ulcer of esophagus,ethnic,Hispanic or Latino,2,5,7
257905,Mucopurulent chronic bronchitis,racial,White,5,2,7
432296,Coagulation factor deficiency syndrome,ethnic,Not Hispanic or Latino,7,1,8
4234604,Disruption of cesarean wound in the puerperium,racial,White,7,0,7
439702,Residual infantile autism,ethnic,Not Hispanic or Latino,0,7,7
4124693,Hypertrophic cardiomyopathy,racial,White,7,0,7
442287,Rest pain,ethnic,Hispanic or Latino,4,3,7
433740,Immunodeficiency disorder,racial,White,2,5,7
443728,Mass of chest wall,racial,Black or African American ,7,0,7
375519,Alcohol withdrawal syndrome,ethnic,Hispanic or Latino,1,7,8
318443,Arteriosclerotic vascular disease,ethnic,Not Hispanic or Latino,7,1,8
380397,Keratoconjunctivitis,racial,White,5,2,7
439702,Residual infantile autism,racial,American Indian or Alaska Native ,0,7,7
201131,Pelvic mass,racial,Native Hawaiian or Other Pacific Islander ,0,7,7
380394,Idiopathic progressive polyneuropathy,racial,White,2,5,7
440279,Accident,ethnic,Not Hispanic or Latino,4,4,8
135688,Abrasion AND/OR friction burn of foot with infection,ethnic,Hispanic or Latino,4,4,8
437584,Ataxia,ethnic,Not Hispanic or Latino,6,1,7
432803,[X]Fall on and from ladder,ethnic,Hispanic or Latino,1,6,7
443211,Benign prostatic hypertrophy with outflow obstruction,racial,Unknown,0,7,7
315085,Enlargement of lymph nodes,racial,Black or African American ,4,4,8
433456,Acute pain,racial,Asian,2,5,7
76836,Sprain of knee and leg,racial,Asian,3,4,7
200781,Unilateral small kidney,ethnic,Hispanic or Latino,4,4,8
314171,Low blood pressure reading,ethnic,Hispanic or Latino,4,3,7
438332,Disease of possible viral origin,racial,American Indian or Alaska Native ,4,3,7
432574,Diffuse malignant lymphoma - histiocytic,ethnic,Hispanic or Latino,4,3,7
137735,Second degree burn of forearm,ethnic,Hispanic or Latino,5,2,7
4064918,Diabetes mellitus screening,racial,American Indian,4,4,8
443422,Scleroderma,racial,Asian,7,0,7
437671,Abnormal feces,ethnic,Not Hispanic or Latino,4,3,7
4169009,FH: CVA,ethnic,Not Hispanic or Latino,3,4,7
436681,Insomnia disorder related to known organic factor,racial,Unknown,5,2,7
4008089,Dysentery,racial,Unknown,7,0,7
443877,Nonvenomous insect bite of shoulder without infection,ethnic,Hispanic or Latino,5,2,7
433071,Contusion of multiple sites,racial,Unknown,4,3,7
80800,Polymyositis,racial,Unknown,7,0,7
25297,Acute pharyngitis,racial,Native Hawaiian or Other Pacific Islander ,5,2,7
138102,Benign tumour of skin,racial,Black or African American ,2,5,7
434311,Disorder of the urea cycle metabolism,ethnic,Not Hispanic or Latino,0,7,7
380403,External hordeolum,racial,Black or African American ,4,4,8
440238,Closed fracture of metatarsal bone,racial,Black or African American ,1,6,7
199867,CPH - Chronic persistent hepatitis,racial,White,6,1,7
197206,Balantidiasis,racial,Unknown,0,7,7
81878,Benign paroxysmal positional vertigo,racial,Asian,7,1,8
376422,Mucopurulent conjunctivitis,racial,Other Race,2,5,7
140480,Impetigo,racial,Filipino,1,7,8
137053,Seborrheic dermatitis,racial,Filipino,6,1,7
438865,Complete trisomy 18 syndrome,ethnic,Not Hispanic or Latino,0,7,7
133551,Vesicular eczema of hands and/or feet,ethnic,Not Hispanic or Latino,2,5,7
40490434,Abnormal arterial blood gas,ethnic,Hispanic or Latino,4,4,8
432296,Coagulation factor deficiency syndrome,racial,White,7,0,7
133294,Prepatellar bursitis,racial,Unknown,4,3,7
26052,Primary malignant neoplasm of larynx,racial,White,0,7,7
201337,Disorder of bladder and bladder neck,racial,Unknown,5,2,7
376411,Central pterygium,ethnic,Hispanic or Latino,4,4,8
380120,Strabismus in neuromuscular disorder,racial,White,1,7,8
4243973,Laparoscopic appendectomy,ethnic,Hispanic or Latino,4,4,8
74250,Burn of foot,ethnic,Hispanic or Latino,4,4,8
259055,Extrinsic asthma with asthma attack,racial,Asian,3,4,7
374360,Disorder of optic nerve,ethnic,Hispanic or Latino,6,1,7
316376,Eosinophilia,ethnic,Not Hispanic or Latino,2,5,7
197484,Diarrhea of presumed infectious origin,ethnic,Not Hispanic or Latino,5,2,7
4103640,Amputated foot,racial,Unknown,1,7,8
75637,Acquired postural kyphosis,ethnic,Not Hispanic or Latino,7,1,8
376105,Krampfe salaam attacks,ethnic,Not Hispanic or Latino,1,7,8
373784,Acute allergic serous otitis media,ethnic,Hispanic or Latino,7,1,8
4088777,Vagina observation,racial,Unknown,7,0,7
4234604,Disruption of cesarean wound in the puerperium,racial,Unknown,7,0,7
252663,Pneumonitis due to inhalation of food or vomitus,racial,Asian,0,7,7
198678,Intestinal infectious disease,racial,Black or African American ,2,5,7
440676,Neoplasm of uncertain behaviour of brain and spinal cord,ethnic,Hispanic or Latino,7,0,7
201136,Infection of navel cord,racial,Asian,0,7,7
4110047,Chronic bronchitis NOS,racial,White,5,2,7
193552,Furuncle of skin AND/OR subcutaneous tissue,racial,Other Race,5,2,7
4201717,Ileostomy present,ethnic,Hispanic or Latino,4,4,8
432611,Explosive personality disorder,racial,White,1,7,8
375801,Demyelinating disease of central nervous system,racial,Unknown,7,0,7
434303,Benign neoplasm of rectum and anal canal,ethnic,Hispanic or Latino,4,3,7
4101609,Ebstein anomaly of right atrioventricular valve,ethnic,Hispanic or Latino,6,1,7
433946,Fall on same level due to impact against another person,racial,Asian,5,2,7
80946,Tinea manus,ethnic,Not Hispanic or Latino,5,2,7
436583,[X]Falls,racial,American Indian or Alaska Native ,7,0,7
75385,"Closed fracture distal humerus, lateral epicondyle",ethnic,Hispanic or Latino,6,1,7
440840,Neonatal candidiasis,racial,White,4,4,8
78228,Joint derangement,racial,Unknown,4,4,8
4141492,Other ill-defined heart disease,racial,White,7,0,7
80141,Functional diarrhea,racial,Unknown,7,0,7
133436,Thyrotoxic crisis,racial,Native Hawaiian or Other Pacific Islander ,0,7,7
316429,Ectopics,racial,Other Race,2,5,7
198401,Neoplasm of uncertain behavior of bladder,ethnic,Hispanic or Latino,4,4,8
132397,Pilonidal cyst with no abscess,racial,Unknown,4,4,8
373786,Abnormal vision,ethnic,Not Hispanic or Latino,4,3,7
133364,Second degree burn of back,racial,Unknown,7,0,7
434549,Fall from toilet seat,racial,Unknown,6,1,7
198551,"Embryonic cyst of cervix, vagina and external female genitalia",ethnic,Hispanic or Latino,7,0,7
438865,Complete trisomy 18 syndrome,racial,Asian,0,7,7
4102348,Common migraine NOS,racial,White,4,3,7
199913,Acquired deformity of ankle AND/OR foot,racial,Black or African American ,0,7,7
75897,Polyarthropathy,racial,White,4,4,8
314479,Primary apnea in the newborn,ethnic,Hispanic or Latino,3,4,7
313502,Benign hypertensive heart disease without congestive heart failure,ethnic,Not Hispanic or Latino,2,5,7
77340,Genitourinary tract infection in pregnancy,ethnic,Not Hispanic or Latino,7,1,8
432910,Disorder of lacrimal system,ethnic,Not Hispanic or Latino,7,0,7
321042,Cardiac arrest,racial,American Indian or Alaska Native ,7,0,7
197988,General abdominal pain-symptom,racial,American Indian or Alaska Native ,4,3,7
199859,Bilateral recurrent inguinal hernia,ethnic,Hispanic or Latino,1,7,8
373202,Corneal ulcer,racial,Unknown,7,1,8
133551,Vesicular eczema of hands and/or feet,racial,Asian,7,1,8
195862,Urethritis,ethnic,Not Hispanic or Latino,1,6,7
440538,Closed fracture of lower end of radius AND ulna,racial,White,1,6,7
4150614,Communication disorder,ethnic,Hispanic or Latino,1,6,7
4166080,Decompression of median nerve,ethnic,Hispanic or Latino,6,1,7
81984,Sprain of shoulder and upper arm,racial,Black or African American ,2,5,7
259153,Throat soreness,racial,Filipino,4,4,8
195588,Cystitis,racial,Black or African American ,6,1,7
435131,Victim of neglect,ethnic,Hispanic or Latino,5,2,7
81151,Sprain of ankle joint,racial,Asian,6,1,7
442427,Cervical post-laminectomy syndrome,racial,White,6,1,7
132932,Chronic ethmoidal sinusitis,ethnic,Not Hispanic or Latino,2,5,7
435889,Decubitus ulcer of ankle,racial,White,2,5,7
318773,Dilated cardiomyopathy secondary to alcohol,racial,Unknown,0,7,7
4108079,Perceptive hearing loss NOS,racial,White,4,4,8
4290971,Amoebic ulcer of skin,ethnic,Hispanic or Latino,7,0,7
80045,Primary malignant neoplasm of anus,ethnic,Not Hispanic or Latino,3,4,7
195079,Functional urinary incontinence,racial,Black or African American ,6,1,7
27674,N&V - Nausea and vomiting,racial,Asian,5,2,7
438673,Tuberculosis of bones and joints,ethnic,Hispanic or Latino,0,7,7
440068,Psychosexual dysfunction,racial,White,0,7,7
260130,Partial bilateral paralysis of vocal cords,ethnic,Hispanic or Latino,1,7,8
141213,Scarlet fever,ethnic,Not Hispanic or Latino,4,4,8
435657,Sleep problem,racial,Unknown,2,5,7
200764,Bile duct calculus without mention of cholecystitis and no obstruction,racial,Unknown,2,5,7
4094448,Pregnancy test negative,racial,Black or African American ,7,0,7
260131,Bronchial disorder,racial,Unknown,5,2,7
200445,Chronic prostatitis,ethnic,Not Hispanic or Latino,0,7,7
194526,Injury of trunk,racial,White,4,4,8
199877,Mucous polyp of cervix,racial,Other Race,7,0,7
374341,Huntington's chorea,racial,Unknown,0,7,7
141090,PG - Pyogenic granuloma,ethnic,Not Hispanic or Latino,2,5,7
319049,Acute respiratory failure,racial,Unknown,2,5,7
441827,Disorder of amino acid and organic acid metabolism,ethnic,Hispanic or Latino,7,1,8
4181357,Malignant tumour of renal pelvis,racial,White,0,7,7
201136,Infection of navel cord,racial,White,4,3,7
4208970,History of physical abuse,racial,White,7,0,7
444262,Tuberculosis of subcutaneous cellular tissue,racial,White,7,1,8
259153,Throat soreness,racial,American Indian or Alaska Native ,5,2,7
436108,Acute closed-angle glaucoma,ethnic,Hispanic or Latino,4,4,8
199064,Chronic vascular insufficiency of intestine,racial,Unknown,0,7,7
4119298,Late onset asthma,racial,Unknown,4,4,8
196328,Enteric paratyphosis,racial,White,2,5,7
313761,Central retinal vein occlusion,racial,White,3,4,7
443913,Congenital anomaly of trachea,racial,Unknown,0,7,7
137989,Abnormal results of cardiovascular function studies,racial,White,2,5,7
79742,Primary genital syphilis,ethnic,Hispanic or Latino,0,7,7
374371,Stenosis of precerebral artery,ethnic,Hispanic or Latino,5,2,7
434889,"Hysterical neurosis, conversion type",racial,White,7,1,8
444262,Tuberculosis of subcutaneous cellular tissue,ethnic,Hispanic or Latino,7,1,8
372309,Mononeuritis,racial,Other Race,2,5,7
440977,Megaloblastic anemia due to folate deficiency,racial,White,5,2,7
439120,Aseptic necrosis of head AND/OR neck of femur,racial,Unknown,4,4,8
79903,Effusion of joint,racial,White,6,1,7
321119,Coarctation of aorta,ethnic,Hispanic or Latino,6,1,7
372828,Zoster ophthalmicus,ethnic,Hispanic or Latino,2,5,7
316814,Hyperventilation,racial,White,6,1,7
443228,"Abrasion or friction burn of foot and toe, without mention of infection",ethnic,Not Hispanic or Latino,4,3,7
435226,"Bipolar affective disorder, current episode mixed",ethnic,Hispanic or Latino,7,0,7
317576,Coronary arteriosclerosis,racial,Native Hawaiian or Other Pacific Islander ,7,1,8
78512,Joint contracture of the ankle and/or foot,ethnic,Hispanic or Latino,1,7,8
376707,Acute conjunctivitis,racial,Native Hawaiian or Other Pacific Islander ,1,7,8
434323,Disorder of sulphur-bearing amino acid metabolism,ethnic,Hispanic or Latino,2,5,7
439382,Disorder of hypothalamus,racial,White,7,0,7
74725,Displacement of cervical intervertebral disc without myelopathy,racial,Asian,7,0,7
4169009,FH: CVA,racial,White,4,4,8
4064377,Depression screening,racial,Alaska Native,2,5,7
197806,Primary malignant neoplasm of gallbladder,ethnic,Hispanic or Latino,6,1,7
192854,Interstitial uterine fibroid,racial,Black or African American ,7,0,7
380394,Idiopathic progressive polyneuropathy,ethnic,Hispanic or Latino,0,7,7
313217,Atrial fibrillation,racial,Black or African American ,2,5,7
381306,Deaf mutism,racial,Unknown,7,0,7
4210149,Substance abuse counseling,racial,Other Race,1,7,8
374041,External ophthalmoplegia,ethnic,Hispanic or Latino,7,1,8
140487,Dermatitis herpetiformis,ethnic,Hispanic or Latino,5,2,7
437496,Acute peripheral vestibulopathy,racial,White,1,7,8
30284,Motion sickness,racial,White,4,3,7
381551,Drug-related polyneuropathy,ethnic,Hispanic or Latino,0,7,7
433658,Adverse reaction to penicillins,ethnic,Hispanic or Latino,5,2,7
76273,Open wound of shoulder region without complication,ethnic,Hispanic or Latino,6,1,7
373212,Esophoria,racial,White,5,2,7
436134,Disorder of sclera,racial,White,4,3,7
435120,Blister of toe with infection,racial,White,5,2,7
72708,Traumatic arthropathy of the shoulder region,racial,White,7,1,8
81378,Chondromalacia of patella,racial,Unknown,4,3,7
196735,Acute pyelonephritis without medullary necrosis,ethnic,Not Hispanic or Latino,5,2,7
72457,Closed fracture of sacrum AND/OR coccyx without spinal cord injury,ethnic,Not Hispanic or Latino,7,0,7
72374,Unstable lie with antenatal problem,racial,White,7,0,7
438155,Optic disc glaucomatous atrophy,racial,White,4,3,7
78234,Arthralgia of the hand,racial,Black or African American ,2,5,7
199859,Bilateral recurrent inguinal hernia,racial,Black or African American ,0,7,7
195862,Urethritis,racial,Unknown,1,6,7
200845,Urinary precipitancy,racial,Black or African American ,6,1,7
77630,Disease of shoulder,racial,Filipino,7,0,7
438329,Late effect of motor vehicle accident,racial,White,7,1,8
200144,Unilateral simple femoral hernia,ethnic,Hispanic or Latino,5,2,7
316995,Coronary occlusion,racial,White,4,3,7
30978,Hereditary leptocytosis,racial,Unknown,3,4,7
437496,Acute peripheral vestibulopathy,ethnic,Hispanic or Latino,2,5,7
4109880,Varicose veins of the leg with ulcer,racial,Other Race,4,4,8
440386,Transsexualism,racial,Unknown,0,7,7
75065,Acquired deformity of spine,racial,White,5,2,7
437557,Eczematous dermatitis of eyelid,racial,White,7,0,7
320420,Vitreous degeneration,ethnic,Not Hispanic or Latino,6,1,7
435080,Biliuria,racial,White,2,5,7
197803,"Malignant neoplasm, overlapping lesion of stomach",ethnic,Hispanic or Latino,5,2,7
197440,Nonvenomous insect bite of trunk without infection,ethnic,Hispanic or Latino,4,3,7
4280828,"Carrier, infectious agent",ethnic,Not Hispanic or Latino,3,4,7
4182210,Dementia,ethnic,Hispanic or Latino,7,0,7
137792,Kaposi's varicelliform eruption,ethnic,Not Hispanic or Latino,3,4,7
381842,Petit mal status,ethnic,Hispanic or Latino,4,4,8
195873,Leukorrhagia,racial,Asian,7,1,8
135473,Dermatophytosis,racial,Other Race,4,4,8
437828,Disorder of calcium metabolism,racial,White,3,4,7
75365,Oliguria and anuria,racial,White,3,4,7
439777,Anemia,racial,Alaska Native,0,7,7
74739,Osteopathy from poliomyelitis,racial,Unknown,0,7,7
317895,Hypertension due to renovascular disease,racial,Unknown,7,0,7
258981,Kaposi's sarcoma of skin,ethnic,Hispanic or Latino,0,7,7
375519,Alcohol withdrawal syndrome,racial,White,1,7,8
201136,Infection of navel cord,ethnic,Not Hispanic or Latino,0,7,7
437655,Cryptorchism,racial,Asian,0,7,7
444211,Disease of thigh,racial,Black or African American ,7,0,7
439666,Contracture of multiple joints,racial,White,6,1,7
4092511,Malignant neoplasm of central part of female breast,racial,Unknown,7,0,7
376966,Exudative age-related macular degeneration,racial,White,4,3,7
441589,Endocarditis,racial,White,7,1,8
437896,Disorder of language,racial,White,2,5,7
77673,Sign or symptom of the urinary system,ethnic,Not Hispanic or Latino,2,5,7
78786,Pleurisy,racial,Unknown,6,1,7
436233,Delayed milestone,ethnic,Not Hispanic or Latino,2,5,7
78473,Solitary cyst of breast,racial,Asian,7,0,7
436252,Closed fracture of shaft of tibia,racial,Unknown,5,2,7
199878,Light and infrequent menstruation,racial,Other Race,7,0,7
439666,Contracture of multiple joints,ethnic,Not Hispanic or Latino,4,3,7
318776,Rheumatic mitral regurgitation,racial,Unknown,0,7,7
201909,Female infertility,ethnic,Not Hispanic or Latino,7,0,7
372886,Refractory migraine with aura,racial,White,7,0,7
375528,Spastic hemiplegia,ethnic,Not Hispanic or Latino,0,7,7
261889,Simple chronic bronchitis,racial,Other Race,4,3,7
436953,Continuous chronic alcoholism,racial,Black or African American ,0,7,7
439002,Eating disorder,ethnic,Not Hispanic or Latino,6,1,7
75971,Open wound of multiple sites of one upper limb with tendon involvement,ethnic,Hispanic or Latino,1,6,7
317302,Coronary sinus rhythm disorder,racial,Native Hawaiian or Other Pacific Islander ,0,7,7
4222138,Allergic contact dermatitis of eyelid,racial,White,7,1,8
315832,Angina decubitus,ethnic,Hispanic or Latino,6,1,7
253482,Cortical blindness,racial,Unknown,0,7,7
444457,Benign tumour of rectum,racial,White,0,7,7
255848,Pneumonia,racial,Filipino,4,4,8
194079,Post-surgical malabsorption,ethnic,Hispanic or Latino,4,3,7
134118,Atrophic condition of skin,racial,Asian,2,5,7
80805,Primary localized osteoarthrosis of forearm,racial,Unknown,5,2,7
201965,Shock,racial,White,6,1,7
381570,Mechanical ptosis,racial,Unknown,0,7,7
439975,Injury at C1-C4 level with spinal cord injury AND without bone injury,ethnic,Hispanic or Latino,7,0,7
4184877,Amputated finger,ethnic,Hispanic or Latino,0,7,7
201343,Acute alcoholic liver disease,racial,White,2,5,7
434701,"Anemia in mother complicating pregnancy, childbirth AND/OR puerperium",racial,Unknown,7,0,7
253321,Stridor,ethnic,Not Hispanic or Latino,4,4,8
444417,"Gestation period, 29 weeks",ethnic,Hispanic or Latino,0,7,7
437831,"Recurrent manic episodes, in full remission",racial,Unknown,0,7,7
380510,Congenital abnormality of eyelid,ethnic,Hispanic or Latino,7,1,8
197318,Cholesterolosis of gallbladder,ethnic,Not Hispanic or Latino,3,4,7
434822,Complication of internal prosthetic device,ethnic,Hispanic or Latino,2,5,7
372423,Reduction deformities of brain,racial,Other Race,5,2,7
78497,Cellulitis and abscess of toe,racial,Other Race,5,2,7
4329847,MI - Myocardial infarction,ethnic,Hispanic or Latino,1,6,7
376946,Senile delirium,racial,Unknown,7,0,7
28461,Hypertrophy of salivary gland,racial,White,1,6,7
440276,"Infection AND/OR inflammatory reaction due to internal prosthetic device, implant AND/OR graft",ethnic,Not Hispanic or Latino,5,2,7
198263,Right upper quadrant pain,racial,Black or African American ,5,2,7
138525,Pain in limb,racial,Filipino,2,5,7
77644,Adhesive capsulitis of shoulder,racial,American Indian or Alaska Native ,4,3,7
372903,Retinal edema,racial,Other Race,7,1,8
433134,Histoplasmosis,racial,White,0,7,7
4181357,Malignant tumour of renal pelvis,ethnic,Hispanic or Latino,0,7,7
136982,Trichiasis without entropion,racial,White,3,4,7
136575,Nonvenomous insect bite with infection,ethnic,Not Hispanic or Latino,7,1,8
373488,Pupil-sparing third nerve palsy,racial,Unknown,5,2,7
4124693,Hypertrophic cardiomyopathy,ethnic,Hispanic or Latino,7,0,7
434782,Closed fracture of tibia AND fibula,racial,White,6,1,7
4170576,Pressure ulcer,racial,Asian,1,6,7
197806,Primary malignant neoplasm of gallbladder,racial,White,6,1,7
440068,Psychosexual dysfunction,ethnic,Hispanic or Latino,0,7,7
79116,Disorder of tendon of shoulder region,ethnic,Not Hispanic or Latino,4,4,8
4096783,Total prostatectomy,ethnic,Hispanic or Latino,0,7,7
443378,Anabolic steroids adverse reaction,racial,Unknown,0,7,7
78890,Sprain of elbow and forearm,racial,Unknown,7,1,8
443891,Cementum caries,racial,White,4,4,8
438208,Atrophy of vulva,ethnic,Hispanic or Latino,7,0,7
4013457,"Closed fracture of proximal humerus, unspecified part",ethnic,Hispanic or Latino,5,2,7
320116,Acute pericarditis,racial,White,1,6,7
4147961,Screening for malignant neoplasm of breast,racial,Native Hawaiian or Other Pacific Islander ,7,0,7
4028641,Pregnancy and drug dependence,racial,Unknown,7,0,7
26727,Vomiting blood,ethnic,Not Hispanic or Latino,4,3,7
196796,Congenital biliary atresia,ethnic,Not Hispanic or Latino,4,3,7
4206460,Problem,racial,Unknown,3,4,7
4310682,Multiple open wounds with complication,ethnic,Not Hispanic or Latino,2,5,7
438791,Pulmonary congestion and hypostasis,ethnic,Hispanic or Latino,6,1,7
377811,Primary malignant neoplasm of retina (primary),ethnic,Hispanic or Latino,1,6,7
4302252,High risk pregnancy care,racial,Filipino,7,0,7
196149,Acute appendicitis with generalized peritonitis,racial,White,1,7,8
440697,Nonaggressive unsocial conduct disorder,racial,White,3,4,7
200873,Open wound of lateral abdominal wall with complication,ethnic,Hispanic or Latino,7,0,7
444069,Abrasion AND/OR friction burn of leg with infection,ethnic,Hispanic or Latino,4,3,7
372610,Post-concussion syndrome,ethnic,Not Hispanic or Latino,4,2,6
194158,Perinatal gastrointestinal hemorrhage,racial,White,2,4,6
374025,Retinal haemorrhages,racial,Unknown,4,2,6
316501,Disorder of blood vessels affecting skin,racial,Unknown,2,5,7
73673,Disorder of prosthetic joint,racial,Unknown,4,2,6
373204,Conjunctival xerosis,racial,White,1,6,7
437474,Postoperative infection,ethnic,Not Hispanic or Latino,6,1,7
74777,Closed fracture of astragalus,ethnic,Hispanic or Latino,4,3,7
74132,Degeneration of lumbosacral intervertebral disc,racial,American Indian or Alaska Native ,7,0,7
442862,"Abrasion or friction burn of hand, without mention of infection",ethnic,Not Hispanic or Latino,2,5,7
435516,Lipoprotein deficiency disorder,racial,Other Race,2,4,6
313792,PT - Paroxysmal tachycardia,ethnic,Not Hispanic or Latino,5,2,7
439382,Disorder of hypothalamus,ethnic,Not Hispanic or Latino,7,0,7
440519,Premature - weight 1000g-2499g or gestation of 28-37weeks,ethnic,Not Hispanic or Latino,1,5,6
433783,Pulmonary artery aneurysm,racial,White,7,0,7
30437,Gastroesophageal reflux disease with esophagitis,racial,Black or African American ,4,3,7
79936,Polyuria,racial,Other Race,1,5,6
4001998,Pulmonary apoplexy,racial,Unknown,7,0,7
438399,Chronic schizophrenia with acute exacerbations,racial,Unknown,0,7,7
196168,Irregular menstrual bleeding,racial,American Indian or Alaska Native ,7,0,7
133147,Primary malignant neoplasm of skin of trunk,ethnic,Hispanic or Latino,5,2,7
435657,Sleep problem,racial,White,2,4,6
442603,Malignant hypertensive heart AND renal disease,racial,White,4,3,7
437038,Blood in urine,racial,Filipino,4,2,6
40481819,Early satiety,racial,White,5,2,7
435912,Endocardial cushion defect,racial,White,2,4,6
4147414,Varicose veins of legs in pregnancy,ethnic,Hispanic or Latino,7,0,7
381854,Disorder of conjunctiva,ethnic,Hispanic or Latino,4,2,6
441553,Myoclonus,racial,Unknown,2,4,6
435875,"Complications of pregnancy, childbirth and the puerperium",racial,Unknown,6,1,7
442270,Disease of duodenum,racial,White,2,4,6
376111,Unqualified visual loss of one eye,ethnic,Not Hispanic or Latino,4,3,7
381316,CVA - Cerebrovascular accident,racial,Other Race,3,4,7
201618,Disease of intestine,racial,White,2,5,7
381295,Age-related cataract,racial,Other Race,4,2,6
4261613,Educational problem,racial,Other Race,1,6,7
4247802,Muscular dystrophy,racial,Unknown,7,0,7
4096347,Gouty arthropathy,racial,Black or African American ,4,2,6
375252,Disorder of eye,racial,Other Race,2,4,6
437943,Pulp abscess of finger,racial,Unknown,2,4,6
312950,IgE-mediated allergic asthma,racial,Native Hawaiian or Other Pacific Islander ,1,5,6
138148,Plantar nerve lesion,racial,Unknown,5,1,6
435315,Torsion of testis,ethnic,Hispanic or Latino,0,7,7
200873,Open wound of lateral abdominal wall with complication,racial,Unknown,7,0,7
439702,Residual infantile autism,racial,White,0,7,7
440829,Fetus and newborn affected by noxious influences transmitted via placenta or breast milk,ethnic,Not Hispanic or Latino,1,5,6
444438,Leucoplakia of tongue,ethnic,Hispanic or Latino,2,5,7
81379,Lateral epicondylitis,racial,Other Race,4,3,7
377811,Primary malignant neoplasm of retina (primary),racial,White,1,6,7
434146,Common ventricle,ethnic,Hispanic or Latino,7,0,7
194079,Post-surgical malabsorption,racial,Asian,7,0,7
136237,Cardiovascular system problem,ethnic,Not Hispanic or Latino,1,5,6
141666,Acute osteomyelitis of lower leg,ethnic,Hispanic or Latino,2,5,7
435636,Juvenile osteochondritis of hip AND/OR pelvis,racial,White,0,7,7
432285,Recurrent major depressive episodes,racial,Native Hawaiian or Other Pacific Islander ,2,5,7
436409,Abnormal pupil,racial,White,3,4,7
195007,Female stress incontinence,racial,American Indian or Alaska Native ,7,0,7
256909,Primary pulmonary coccidioidomycosis,racial,White,7,0,7
4112954,Unspecified spontaneous abortion without mention of complication,ethnic,Hispanic or Latino,7,0,7
372721,Congenital anomaly of cerebrovascular system,racial,Unknown,4,2,6
75344,Intervertebral disc disorder,racial,Black or African American ,0,7,7
4168213,Chest pain on breathing,racial,Black or African American ,2,4,6
432742,Closed skull fracture without intracranial injury,ethnic,Hispanic or Latino,2,5,7
4304916,Gastrointestinal tract finding,ethnic,Hispanic or Latino,7,0,7
438399,Chronic schizophrenia with acute exacerbations,ethnic,Hispanic or Latino,0,7,7
77960,Joint observation,racial,White,5,2,7
261324,Pneumonia due to Streptococcus,racial,White,5,1,6
4166776,Dupuytren contracture,racial,Unknown,3,4,7
199074,Acute pancreatitis,racial,Black or African American ,5,1,6
198198,Vaginal polyp,ethnic,Hispanic or Latino,7,0,7
81937,Traumatic arthropathy of the hand,ethnic,Hispanic or Latino,7,0,7
260130,Partial bilateral paralysis of vocal cords,racial,White,1,6,7
193239,Diverticulitis of small intestine,racial,Unknown,7,0,7
134116,Dermatitis due to drug AND/OR medicine taken internally,racial,Unknown,6,1,7
135032,Dermatitis due to substances taken internally,racial,White,5,2,7
253797,Post-inflammatory pulmonary fibrosis,racial,Asian,6,1,7
439248,"Mixed bipolar affective disorder, moderate",racial,Unknown,7,0,7
72714,Chronic polyarticular juvenile rheumatoid arthritis,ethnic,Hispanic or Latino,4,3,7
30234,Cervical sprain,racial,Black or African American ,4,2,6
435227,Nutritional deficiency,ethnic,Not Hispanic or Latino,4,3,7
377849,Retinal deposits,racial,White,6,1,7
442011,Mechanical complication due to cardiac pacemaker electrode,racial,White,6,1,7
4024361,Paralysis of glottis,racial,Asian,7,0,7
437677,Abnormal findings on diagnostic imaging of lung,racial,Black or African American ,2,5,7
436386,Severe depressed bipolar I disorder with psychotic features,racial,Black or African American ,0,7,7
197036,Vesicoureteral reflux,racial,Unknown,6,1,7
372608,Amnestic disorder,racial,Black or African American ,7,0,7
257683,Postnasal drip,racial,Black or African American ,3,4,7
199886,Simple endometrial hyperplasia,racial,White,7,0,7
75121,Burn of lower leg,ethnic,Hispanic or Latino,7,0,7
80816,Intervertebral disc degeneration,racial,Asian,4,3,7
137053,Seborrheic dermatitis,racial,American Indian or Alaska Native ,5,1,6
373474,Seeing double,ethnic,Not Hispanic or Latino,5,1,6
259865,Cyst of Bartholin's gland duct,racial,Black or African American ,7,0,7
81112,Arthralgia of the lower leg,racial,Native Hawaiian or Other Pacific Islander ,2,4,6
4283532,Psychogenic headache,ethnic,Not Hispanic or Latino,7,0,7
440916,Burn to wrist/hand - blister,ethnic,Hispanic or Latino,4,2,6
199877,Mucous polyp of cervix,racial,Asian,7,0,7
444071,Furuncle of forearm,ethnic,Not Hispanic or Latino,4,3,7
440372,Acquired thrombocytopenia,racial,White,1,6,7
438527,"Juvenile osteochondrosis of lower extremity, excluding foot",ethnic,Not Hispanic or Latino,3,4,7
434311,Disorder of the urea cycle metabolism,racial,White,2,5,7
133726,Carcinoma in situ of skin of face,ethnic,Hispanic or Latino,6,1,7
432513,Animal bite wound,ethnic,Not Hispanic or Latino,5,2,7
255334,Collagen disease,racial,White,7,0,7
436232,"Polycystic kidney disease, adult type",ethnic,Hispanic or Latino,7,0,7
79115,"Spondylopathy, NOS",racial,White,7,0,7
201111,Congenital renal dysplasia,racial,Unknown,7,0,7
441963,Prader-Willi syndrome,racial,White,0,7,7
139882,Endometriosis in scar of skin,ethnic,Hispanic or Latino,7,0,7
196454,Colostomy and enterostomy malfunction,racial,White,2,4,6
200149,Placenta previa with hemorrhage - not delivered,ethnic,Hispanic or Latino,7,0,7
434904,Persistent hypersomnia,racial,Other Race,0,7,7
141663,Osteomyelitis,racial,Unknown,4,3,7
433749,Heparin-induced thrombocytopenia,ethnic,Not Hispanic or Latino,0,7,7
444200,Neoplasm of nervous system,racial,White,5,2,7
312935,Venous hypertension,racial,White,2,5,7
433585,Klippel-Feil sequence,racial,White,2,5,7
79742,Primary genital syphilis,racial,White,0,7,7
192239,Post-herpetic polyneuropathy,racial,Other Race,0,7,7
433657,Fall from furniture,racial,Unknown,4,2,6
433031,Hallucinations,ethnic,Not Hispanic or Latino,3,4,7
374013,Secondary Parkinson's disease,racial,Black or African American ,0,7,7
138858,Pale complexion,racial,White,5,2,7
140949,Scabies,racial,Black or African American ,2,4,6
198263,Right upper quadrant pain,racial,American Indian or Alaska Native ,5,1,6
436252,Closed fracture of shaft of tibia,racial,White,4,2,6
432677,Habitual aborter-not pregnant,ethnic,Hispanic or Latino,7,0,7
433446,Mucopolysaccharidosis,ethnic,Hispanic or Latino,3,4,7
255677,Open wound of nose without complication,ethnic,Hispanic or Latino,2,4,6
197223,Enterobiasis,racial,Unknown,1,5,6
314423,"Benign essential hypertension complicating pregnancy, childbirth and the puerperium - not delivered",ethnic,Not Hispanic or Latino,7,0,7
381839,Habit disorder,racial,Unknown,1,6,7
74114,Cellulitis and abscess of foot excluding toe,racial,Other Race,1,6,7
4100369,Unspecified schizoaffective schizophrenia,ethnic,Not Hispanic or Latino,7,0,7
81902,Urinary tract infectious disease,racial,Native Hawaiian or Other Pacific Islander ,7,0,7
437477,[X]Fall involving playground equipment,ethnic,Hispanic or Latino,4,3,7
319843,Mitral valve disorder,racial,Black or African American ,7,0,7
443933,Nicotiana tabacum poisoning,racial,Unknown,4,3,7
433783,Pulmonary artery aneurysm,ethnic,Not Hispanic or Latino,7,0,7
200452,Disease of female genital organ,ethnic,Not Hispanic or Latino,7,0,7
378752,Corneal opacity,racial,Unknown,4,2,6
132408,Back problem,racial,Black or African American ,4,2,6
433600,"Problem, abnormal test",racial,White,6,1,7
372608,Amnestic disorder,ethnic,Not Hispanic or Latino,7,0,7
78593,Open wound of wrist without complication,ethnic,Hispanic or Latino,3,4,7
74211,Superficial injury of finger without infection,ethnic,Hispanic or Latino,3,4,7
439294,"Malignant neoplasm of head, neck and face",racial,White,3,4,7
442603,Malignant hypertensive heart AND renal disease,ethnic,Hispanic or Latino,4,3,7
439971,Poisoning by anticoagulant,ethnic,Hispanic or Latino,4,3,7
437947,Complication of obstetrical surgical wound,racial,White,7,0,7
439285,"Hodgkin disease, lymphocytic depletion of intra-abdominal lymph nodes",racial,Unknown,7,0,7
318712,Peripheral circulatory disorder associated with type I diabetes mellitus,racial,Other Race,1,6,7
79938,Closed fracture of scapula,ethnic,Hispanic or Latino,6,1,7
320682,Finding of white blood cell number,ethnic,Not Hispanic or Latino,5,2,7
259848,Chronic rhinitis,racial,Native Hawaiian or Other Pacific Islander ,3,4,7
4093344,Prostate observation,racial,Filipino,1,6,7
433656,Abnormal patient reaction,ethnic,Hispanic or Latino,5,1,6
73341,Closed fracture of head of radius,ethnic,Not Hispanic or Latino,2,4,6
258453,Acute upper respiratory infection of multiple sites,racial,Unknown,6,1,7
133737,Acute thyroiditis,ethnic,Hispanic or Latino,7,0,7
193306,Situs inversus,racial,White,1,5,6
375504,Psychoactive substance-induced organic mental disorder,racial,Unknown,1,6,7
4179925,Basic learning problem,racial,Unknown,5,1,6
435785,Meningitis,racial,Unknown,2,5,7
73045,Hand sprain,racial,Black or African American ,1,5,6
4100091,Child attention deficit disorder NOS,ethnic,Hispanic or Latino,2,5,7
74729,Ganglion and synovial cyst,racial,Asian,4,2,6
139850,Acute frontal sinusitis,racial,Black or African American ,2,5,7
378414,Separation of retinal layers,racial,Black or African American ,7,0,7
4064905,Venereal disease screening,racial,American Indian or Alaska Native ,5,1,6
437175,"Fall on same level from slipping, tripping or stumbling",ethnic,Not Hispanic or Latino,5,2,7
444090,Disease of foot,racial,Unknown,5,2,7
80249,Sprain of acromioclavicular ligament,ethnic,Hispanic or Latino,2,4,6
439694,Hypertensive heart and renal disease with both (congestive) heart failure and renal failure,racial,Other Race,0,7,7
434902,Autistic disorder of childhood onset,racial,Other Race,2,5,7
444198,Intracranial hemorrhage following injury with loss of consciousness,racial,American Indian or Alaska Native ,0,7,7
80568,Traumatic amputation of finger without mention of complication,racial,Unknown,0,7,7
135061,Congenital anomaly of musculoskeletal system,racial,White,4,3,7
4298697,Multiple open wounds without complication,racial,Black or African American ,3,4,7
4147466,Panic disorder with agoraphobia,racial,Unknown,7,0,7
4283532,Psychogenic headache,ethnic,Hispanic or Latino,6,1,7
442609,Friction blister without infection,ethnic,Not Hispanic or Latino,2,5,7
440385,Obstructive hydrocephalus,racial,Asian,4,3,7
137626,Seborrhoeic eczema of scalp,racial,Unknown,2,5,7
75051,Derangement of posterior horn of medial meniscus,ethnic,Not Hispanic or Latino,7,0,7
318736,Migraine,racial,American Indian,7,0,7
135777,Neoplasm of uncertain behaviour of skin,racial,Other Race,7,0,7
378442,Conductive hearing loss of combined sites,ethnic,Hispanic or Latino,1,5,6
199875,Vaginal wall prolapse without uterine prolapse,ethnic,Hispanic or Latino,7,0,7
439653,Partial epilepsy without mention of impairment of consciousness,ethnic,Hispanic or Latino,1,5,6
435553,Watery eye,ethnic,Not Hispanic or Latino,7,0,7
434146,Common ventricle,racial,White,7,0,7
443262,Lack or loss of sexual desire,ethnic,Hispanic or Latino,3,4,7
434153,Chromosomopathy,ethnic,Not Hispanic or Latino,2,4,6
443262,Lack or loss of sexual desire,racial,White,3,4,7
4100369,Unspecified schizoaffective schizophrenia,racial,White,5,2,7
194993,Intestinal malabsorption,racial,White,5,2,7
436802,Complete trisomy 13 syndrome,ethnic,Hispanic or Latino,7,0,7
4059157,Family circumstance NOS,racial,Unknown,5,1,6
201527,Neoplasm of uncertain behaviour of prostate,ethnic,Hispanic or Latino,0,7,7
312437,Dyspnea,racial,American Indian or Alaska Native ,7,0,7
4111255,Unspecified labyrinthitis,ethnic,Hispanic or Latino,1,5,6
4114314,Screening for osteoporosis,racial,Black or African American ,6,1,7
380818,Acquired deformity of head,racial,White,4,2,6
318772,Disease of pericardium,racial,Unknown,5,1,6
254387,Upper respiratory tract hypersensitivity reaction,racial,Asian,2,4,6
434272,Varicella infection,racial,Unknown,3,4,7
133280,Alopecia,racial,Other Race,4,2,6
434502,Closed fracture of phalanx of toe,racial,Other Race,4,2,6
314962,Raynaud disease,racial,Unknown,4,2,6
436348,Primary malignant neoplasm of anal canal,ethnic,Hispanic or Latino,2,4,6
437359,Osteochondritis dissecans,ethnic,Hispanic or Latino,5,2,7
376417,Middle ear conductive hearing loss,racial,Unknown,7,0,7
439081,Premenstrual tension syndrome,racial,Unknown,7,0,7
4261613,Educational problem,racial,Unknown,1,5,6
316127,Vitreous opacities,racial,Unknown,5,1,6
433527,Endometriosis,racial,Unknown,7,0,7
197044,Female infertility associated with anovulation,racial,Unknown,7,0,7
372912,Visual discomfort,racial,Unknown,4,3,7
72778,Open wound of toe(s) without mention of complication,ethnic,Not Hispanic or Latino,5,1,6
192885,Tarsal tunnel syndrome,racial,White,5,2,7
195867,Noninflammatory vaginal disorders,racial,Asian,7,0,7
436962,Sleeplessness,racial,Native Hawaiian or Other Pacific Islander ,5,1,6
74470,Congenital anomaly of upper limb,ethnic,Hispanic or Latino,4,3,7
138682,Herpes zoster auricularis,racial,Unknown,7,0,7
312723,Congenital heart disease,racial,Filipino,0,7,7
79115,"Spondylopathy, NOS",ethnic,Not Hispanic or Latino,7,0,7
4201717,Ileostomy present,racial,White,4,3,7
134331,Cauda equina syndrome without neurogenic bladder,ethnic,Hispanic or Latino,6,1,7
133794,Chronic gingivitis,racial,Asian,6,1,7
77421,Open wound of hand except fingers without complication,racial,Other Race,0,7,7
260841,Perinatal subarachnoid hemorrhage,racial,White,5,2,7
195245,Reflex sympathetic dystrophy,racial,Black or African American ,7,0,7
76835,Closed dislocation of elbow,racial,White,4,3,7
133141,Tinea pedis,racial,Filipino,1,5,6
433446,Mucopolysaccharidosis,racial,White,3,4,7
80180,Osteoarthritis,racial,Asian Indian,7,0,7
75103,Sprain of jaw,racial,White,4,3,7
443913,Congenital anomaly of trachea,ethnic,Not Hispanic or Latino,0,7,7
316127,Vitreous opacities,racial,Asian,4,2,6
75004,Frank hematuria,racial,Asian,1,6,7
440985,Phobia,ethnic,Not Hispanic or Latino,5,2,7
4165091,Lack of exercise,racial,Other Race,4,3,7
376981,Amblyopia,racial,White,2,5,7
432941,Disease of tongue,ethnic,Not Hispanic or Latino,5,2,7
377252,Neurofibromatosis type 1,ethnic,Not Hispanic or Latino,0,7,7
313878,Respiratory symptoms,racial,Native Hawaiian or Other Pacific Islander ,4,3,7
193530,Follicular cyst of ovary,ethnic,Not Hispanic or Latino,7,0,7
440203,Fetus OR newborn affected by condition of umbilical cord,ethnic,Hispanic or Latino,3,4,7
194149,Hirschsprung disease,racial,White,3,4,7
375281,Acute suppurative otitis media - tympanic membrane intact,racial,Filipino,3,4,7
318445,Post cardiac operation functional disturbance,racial,Unknown,7,0,7
134438,CD - Contact dermatitis,racial,American Indian,5,1,6
4108905,Congenital malformation of the urinary system,ethnic,Not Hispanic or Latino,4,3,7
434887,Disorders of bilirubin excretion,ethnic,Not Hispanic or Latino,4,3,7
201618,Disease of intestine,racial,Asian,7,0,7
376564,Superficial injury of eye,ethnic,Hispanic or Latino,4,2,6
4103642,Amputated toe,racial,Black or African American ,1,6,7
436077,Developmental delay,racial,Asian,4,2,6
374886,Benign neoplasm of ear,ethnic,Hispanic or Latino,5,2,7
199867,CPH - Chronic persistent hepatitis,ethnic,Not Hispanic or Latino,5,1,6
432967,Anemia during pregnancy - baby not yet delivered,racial,Asian,7,0,7
197237,Benign tumour of prostate,racial,Unknown,0,7,7
434633,Disorder of autonomic nervous system,ethnic,Hispanic or Latino,3,4,7
73291,Palindromic rheumatism of the ankle and/or foot,racial,Asian,5,2,7
199991,Complication of transplanted kidney,ethnic,Hispanic or Latino,4,2,6
194696,Menorrhalgia,racial,Asian,7,0,7
440053,Infestation by insect,ethnic,Hispanic or Latino,4,2,6
140842,Changes in skin texture,racial,Other Race,4,2,6
439150,Hypersomnia with sleep apnea,racial,Unknown,6,1,7
135473,Dermatophytosis,racial,Asian,5,1,6
200461,Endometriosis of uterus,racial,White,7,0,7
441829,Hyperosmolality and or hypernatremia,ethnic,Not Hispanic or Latino,5,1,6
79939,Sprain of tarsometatarsal joint AND/OR ligament,ethnic,Hispanic or Latino,6,1,7
438749,Posterior subcapsular polar senile cataract,ethnic,Hispanic or Latino,4,2,6
376121,Recurrent pterygium,ethnic,Hispanic or Latino,3,4,7
195453,"Colitis, enteritis and gastroenteritis presumed infectious",racial,Other Race,3,4,7
4319150,Pulled elbow,racial,White,3,4,7
136198,Cervical spondylosis with myelopathy,racial,Unknown,1,5,6
433163,Deficiency of macronutrients,racial,Other Race,7,0,7
4030270,Proliferative polycythemia,ethnic,Not Hispanic or Latino,3,4,7
4012491,Difficulty chewing,racial,Asian,2,5,7
196733,Urethral syndrome,racial,White,5,1,6
196163,Cervicitis and endocervicitis,ethnic,Not Hispanic or Latino,5,1,6
199744,Carcinoma liver and/or biliary system,ethnic,Not Hispanic or Latino,0,7,7
4016675,"Sprain, ankle joint, medial",ethnic,Not Hispanic or Latino,2,4,6
4050572,Implantation of automatic cardiac defibrillator,racial,Asian,0,7,7
4194895,Screening for disorder,racial,Other Race,3,4,7
435315,Torsion of testis,racial,White,0,7,7
4155526,Acute otitis media with effusion,racial,Unknown,4,3,7
196157,Induratio penis plastica,racial,White,0,7,7
377290,Legal blindness USA,racial,Other Race,1,6,7
80482,Suppurative arthritis,ethnic,Hispanic or Latino,4,3,7
436230,Blood chemistry abnormal,racial,Filipino,6,1,7
443545,Nonvenomous insect bite,racial,Other Race,3,4,7
192242,Acute hepatitis C,racial,American Indian or Alaska Native ,0,7,7
435372,Underweight,racial,Other Race,1,5,6
442752,Myalgia,racial,American Indian,7,0,7
314479,Primary apnea in the newborn,racial,White,2,5,7
438028,Poisoning by drug AND/OR medicinal substance,racial,White,2,5,7
440525,Prematurity of fetus,racial,Unknown,2,4,6
376417,Middle ear conductive hearing loss,ethnic,Hispanic or Latino,7,0,7
375527,Headache disorder,racial,White,2,5,7
440009,Complication of implant,racial,Unknown,5,1,6
440612,Toxic effect of tobacco and nicotine,racial,White,2,5,7
373852,Neuralgia,racial,Other Race,4,3,7
373766,Retinopathy of prematurity,racial,Black or African American ,1,6,7
444198,Intracranial hemorrhage following injury with loss of consciousness,ethnic,Not Hispanic or Latino,0,7,7
192438,Abdominal mass,racial,Unknown,7,0,7
436953,Continuous chronic alcoholism,racial,White,2,5,7
81169,Superficial foreign body of finger without major open wound AND without infection,ethnic,Hispanic or Latino,4,3,7
198978,Acute gonorrhea of lower genitourinary tract,racial,Unknown,7,0,7
4160859,Methicillin resistant staphylococcus aureus carrier,racial,Unknown,5,2,7
375827,Acute non-suppurative otitis media - serous,racial,Asian,4,2,6
4100091,Child attention deficit disorder NOS,racial,White,2,5,7
23798,Acute laryngopharyngitis,racial,Unknown,4,3,7
435517,Acidosis,racial,Black or African American ,1,5,6
4239301,Unwanted pregnancy,racial,Unknown,7,0,7
26711,Chronic pharyngitis,racial,Unknown,5,2,7
436532,Congenital cytomegalovirus infection,ethnic,Hispanic or Latino,1,5,6
443409,On examination - left lower abdominal mass,racial,Unknown,6,1,7
198101,Lipoma of skin and subcutaneous tissue (excluding face),racial,Asian,3,4,7
436409,Abnormal pupil,ethnic,Hispanic or Latino,3,4,7
439294,"Malignant neoplasm of head, neck and face",ethnic,Not Hispanic or Latino,3,4,7
253482,Cortical blindness,racial,White,4,2,6
73840,Primary localised osteoarthrosis of shoulder region,racial,Native Hawaiian or Other Pacific Islander ,7,0,7
433180,Hallucinogen dependence,ethnic,Hispanic or Latino,0,7,7
196217,Congenital malformation of diaphragm,ethnic,Not Hispanic or Latino,0,7,7
436802,Complete trisomy 13 syndrome,racial,White,7,0,7
138463,Oral aphthae,racial,Other Race,7,0,7
312723,Congenital heart disease,racial,Asian,5,1,6
374025,Retinal haemorrhages,racial,Black or African American ,1,6,7
197022,Unilateral recurrent inguinal hernia with obstruction but no gangrene,racial,White,0,7,7
440379,Episodic opioid dependence,racial,White,2,5,7
441641,FTND - Full term normal delivery,ethnic,Hispanic or Latino,7,0,7
439304,Retinal round hole without detachment,racial,Unknown,7,0,7
443774,"Disease condition determination, uncontrolled",racial,White,3,4,7
141323,Acute maxillary sinusitis,racial,Asian,6,1,7
436658,Vitamin deficiency,racial,Asian,5,2,7
432967,Anemia during pregnancy - baby not yet delivered,racial,Other Race,7,0,7
321462,Cardiac complications of care,racial,Asian,0,7,7
194081,Acute cystitis,racial,Black or African American ,5,1,6
78272,Sprain of wrist,racial,Other Race,3,4,7
132466,Lumbar sprain,racial,Asian,5,1,6
320682,Finding of white blood cell number,ethnic,Hispanic or Latino,4,3,7
4024361,Paralysis of glottis,ethnic,Not Hispanic or Latino,7,0,7
376335,Asymptomatic neurosyphilis,racial,White,0,7,7
433440,Dysthymia,racial,Other Race,5,2,7
194018,"Functional enuresis, NOS",racial,American Indian or Alaska Native ,7,0,7
134452,Miners' elbow,racial,Unknown,0,7,7
443753,Abrasion AND/OR friction burn of wrist without infection,ethnic,Not Hispanic or Latino,1,5,6
136264,Open wound of floor of mouth without complication,racial,White,3,4,7
436675,Anorexia nervosa,racial,Unknown,7,0,7
432910,Disorder of lacrimal system,racial,Asian,7,0,7
198475,Gallstone ileus,ethnic,Hispanic or Latino,5,2,7
4053600,Open wound of elbow,ethnic,Hispanic or Latino,3,4,7
4139420,Foreign body in auditory canal,racial,Black or African American ,3,4,7
40490888,Herniation of rectum into vagina,racial,Unknown,7,0,7
73231,Arthralgia of temporomandibular joint,ethnic,Not Hispanic or Latino,5,1,6
320827,Atresia and stenosis of aorta,ethnic,Hispanic or Latino,5,2,7
378161,Disorder of ear,ethnic,Not Hispanic or Latino,4,3,7
4059014,Spontaneous bruising,ethnic,Not Hispanic or Latino,5,1,6
438064,Bacterial infection due to Pseudomonas,ethnic,Hispanic or Latino,5,1,6
444417,"Gestation period, 29 weeks",racial,White,0,7,7
441407,Appetite loss - anorexia,racial,Other Race,5,1,6
78237,Bicipital tenosynovitis,racial,Unknown,5,1,6
433454,Adjustment disorder with mixed emotional features,ethnic,Not Hispanic or Latino,7,0,7
75614,Acrodermatitis continua,racial,Native Hawaiian or Other Pacific Islander ,3,4,7
200527,Splenomegaly,ethnic,Not Hispanic or Latino,2,5,7
318448,"Incomplete atrioventricular block, second degree",racial,Unknown,1,5,6
434309,Sexual precocity,racial,Unknown,7,0,7
77965,Nodular tendinous disease of finger,racial,Asian,4,2,6
437478,Bite of nonvenomous arthropod,racial,Black or African American ,4,3,7
201951,Gonadal dysgenesis,ethnic,Hispanic or Latino,7,0,7
443891,Cementum caries,ethnic,Hispanic or Latino,6,1,7
378256,Abnormal reflex,ethnic,Hispanic or Latino,3,4,7
442604,Hypertensive heart disease,racial,American Indian or Alaska Native ,0,7,7
76150,Ulcer of rectum,racial,White,4,3,7
375825,Referred otalgia,ethnic,Hispanic or Latino,7,0,7
374950,Oedema of eyelid,racial,Unknown,3,4,7
258785,Pneumococcal pneumonia,racial,Unknown,4,2,6
374040,Ill-defined disorder of eye,racial,Unknown,4,2,6
439285,"Hodgkin disease, lymphocytic depletion of intra-abdominal lymph nodes",ethnic,Hispanic or Latino,7,0,7
375822,Neonatal obstruction of nasolacrimal duct,racial,Unknown,2,5,7
196061,Benign tumour of stomach,racial,Unknown,5,1,6
73300,Radial styloid tenosynovitis,racial,Unknown,7,0,7
380415,Acute swimmer's ear,racial,Asian,2,5,7
376335,Asymptomatic neurosyphilis,ethnic,Hispanic or Latino,0,7,7
443260,Umbilical lump,racial,White,6,1,7
74723,Arthropathy associated with a neurological disorder,racial,Unknown,2,5,7
439297,Nuclear senile cataract,ethnic,Not Hispanic or Latino,1,5,6
194985,Postgastric surgery syndrome,racial,White,6,0,6
442623,Abrasion AND/OR friction burn of scalp without infection,racial,Unknown,2,4,6
432586,Mental disorder,ethnic,Not Hispanic or Latino,3,3,6
320746,Cardiomyopathy associated with another disorder,racial,Black or African American ,0,6,6
4102808,Transsexuality with homosexual history,racial,White,0,6,6
436370,"Combined drug dependence, excluding opioids",racial,White,6,0,6
441691,Atypical squamous cells of undetermined significance on vaginal Papanicolaou smear,racial,Unknown,6,0,6
134870,Pityriasis versicolor,racial,Asian,4,2,6
136775,Contact dermatitis due to solar radiation,ethnic,Not Hispanic or Latino,5,1,6
438268,Closed dislocation of finger,ethnic,Hispanic or Latino,4,2,6
132932,Chronic ethmoidal sinusitis,racial,Unknown,2,4,6
436333,Orf virus disease,racial,White,3,3,6
434610,Hyperkalemia,racial,Black or African American ,5,1,6
439224,Drug allergy,racial,Other Race,2,4,6
73842,Enthesopathy of elbow region,racial,White,5,1,6
201075,Noninflammatory disorder of cervix,racial,Unknown,6,0,6
434327,Cannabis abuse,racial,Unknown,1,5,6
377254,"Multi-infarct dementia, uncomplicated",racial,Black or African American ,6,0,6
81378,Chondromalacia of patella,racial,Black or African American ,2,4,6
78516,Arthralgia of the upper arm,racial,Asian,4,2,6
319016,Retinal lattice degeneration,ethnic,Hispanic or Latino,3,3,6
133438,Chronic lymphoid leukaemia in remission,racial,White,4,2,6
74174,Urinary symptoms,ethnic,Hispanic or Latino,2,4,6
80225,Sprain of ligament of lumbosacral joint,racial,Unknown,3,3,6
76472,Dysplasia of anus,racial,White,1,5,6
373478,Presbyopia,racial,Black or African American ,6,0,6
374041,External ophthalmoplegia,racial,Unknown,6,0,6
443883,Acute disease,racial,Unknown,1,5,6
4175807,Rheumatic disease of tricuspid valve,racial,Unknown,5,1,6
194682,Bilateral inguinal hernia with obstruction but no gangrene,ethnic,Hispanic or Latino,0,6,6
313608,Closed fracture of T7-T12 level with spinal cord injury,ethnic,Hispanic or Latino,0,6,6
132702,Erythema multiforme,racial,White,2,4,6
25844,Ulcer of esophagus,racial,White,4,2,6
24609,Hypoglycaemia,racial,Other Race,4,2,6
76939,Neoplasm of uncertain behaviour of bone and articular cartilage,ethnic,Hispanic or Latino,6,0,6
442116,Allergy to eggs,racial,Unknown,2,4,6
441155,Closed trimalleolar fracture,ethnic,Hispanic or Latino,5,1,6
198551,"Embryonic cyst of cervix, vagina and external female genitalia",racial,White,6,0,6
319845,Pulmonary valve disease,racial,Unknown,6,0,6
81611,Diverticular disease of colon,racial,American Indian or Alaska Native ,4,2,6
193807,Anorectal fistula,racial,Unknown,2,4,6
200483,Disease of pelvis,racial,Unknown,2,4,6
77644,Adhesive capsulitis of shoulder,racial,Other Race,5,1,6
434056,Late effects of cerebrovascular disease,racial,American Indian or Alaska Native ,1,5,6
4168226,Micturition frequency and polyuria,racial,Unknown,3,3,6
198246,Congenital hiatus hernia,racial,White,4,2,6
81936,Monoarthritis,racial,White,2,4,6
432345,Hypertrophy of tongue papillae,ethnic,Hispanic or Latino,4,2,6
75512,Carcinoma in situ of colon,racial,Unknown,5,1,6
77644,Adhesive capsulitis of shoulder,racial,Asian,4,2,6
137944,Bullous dermatosis,ethnic,Not Hispanic or Latino,6,0,6
4083236,Alcoholism counselling,ethnic,Not Hispanic or Latino,6,0,6
4051114,FH: Diabetes mellitus,racial,Asian,5,1,6
140641,Verruca vulgaris,racial,Filipino,5,1,6
194755,Abdominal tenderness of left lower quadrant,ethnic,Hispanic or Latino,5,1,6
444388,Blister of leg without infection,ethnic,Hispanic or Latino,4,2,6
438066,Chlamydial infection,racial,Filipino,6,0,6
440069,Drug dependence,racial,Black or African American ,1,5,6
72712,Synovial cyst,racial,White,4,2,6
196444,Angiodysplasia of intestine,ethnic,Hispanic or Latino,5,1,6
441260,Drug withdrawal syndrome,racial,White,4,2,6
437525,Overweight,racial,Alaska Native,2,4,6
79768,Neoplasm of urinary system,racial,White,4,2,6
134331,Cauda equina syndrome without neurogenic bladder,ethnic,Not Hispanic or Latino,6,0,6
133141,Tinea pedis,racial,American Indian or Alaska Native ,5,1,6
200164,Urine-induced contact dermatitis,racial,Asian,1,5,6
443753,Abrasion AND/OR friction burn of wrist without infection,racial,Unknown,3,3,6
442775,Degeneration of thoracic intervertebral disc,ethnic,Not Hispanic or Latino,6,0,6
436176,Spontaneous abortion without complication,racial,Unknown,6,0,6
376102,Partial recent retinal detachment with single defect,ethnic,Hispanic or Latino,4,2,6
136025,Gp B streptococcal septicemia,racial,White,6,0,6
195316,Atypical endometrial hyperplasia,racial,White,6,0,6
378442,Conductive hearing loss of combined sites,racial,White,1,5,6
437400,Closed fracture of shaft of ulna,racial,White,1,5,6
443776,Brachial radiculitis,racial,Asian,4,2,6
441691,Atypical squamous cells of undetermined significance on vaginal Papanicolaou smear,ethnic,Not Hispanic or Latino,6,0,6
442793,Diabetic complication,racial,Filipino,3,3,6
201093,Infection of skin AND/OR subcutaneous tissue,racial,Asian,3,3,6
201951,Gonadal dysgenesis,racial,White,6,0,6
75954,Sprain of interphalangeal joint of finger,racial,White,4,2,6
194682,Bilateral inguinal hernia with obstruction but no gangrene,racial,White,0,6,6
375479,Kaposi's sarcoma of soft tissues,racial,Unknown,0,6,6
193983,Disorder of pancreatic internal secretion,racial,White,1,5,6
434173,Fever symptoms,racial,White,3,3,6
435640,"Gestation period, 25 weeks",ethnic,Hispanic or Latino,2,4,6
436235,Taste sense altered,racial,Black or African American ,6,0,6
375239,Cerebral degeneration,ethnic,Not Hispanic or Latino,6,0,6
438836,Poliomyelitis osteopathy of the lower leg,racial,White,4,2,6
73553,Arthropathy,racial,American Indian or Alaska Native ,6,0,6
444415,Severe epithelial dysplasia of bronchus,ethnic,Hispanic or Latino,4,2,6
132391,Furuncle of face,racial,White,1,5,6
198471,Complex endometrial hyperplasia,racial,White,6,0,6
433495,"Conductive hearing loss, bilateral",racial,White,3,3,6
200662,Lymphosarcoma,racial,Unknown,4,2,6
381035,Vertigo of central origin,racial,Unknown,2,4,6
376683,Non proliferative diabetic retinopathy,racial,Filipino,5,1,6
441805,Primary malignant neoplasm of endocervix,racial,Unknown,6,0,6
4193570,Abnormal results of hearing screening test,racial,Unknown,2,4,6
444070,Tachycardia,racial,Asian,4,2,6
4104555,Other and unspecified conjunctivitis,racial,White,4,2,6
377885,Disorder of eye movements,racial,Asian,4,2,6
134976,Complex dental caries,ethnic,Not Hispanic or Latino,2,4,6
380397,Keratoconjunctivitis,ethnic,Hispanic or Latino,4,2,6
253815,Ulceration of vulva,ethnic,Not Hispanic or Latino,6,0,6
193165,Adrenal disease,ethnic,Not Hispanic or Latino,6,0,6
440383,Depressive disorder,racial,American Indian,3,3,6
4114284,Chondrocalcinosis NOS,racial,Unknown,4,2,6
193261,Vaginospasm,ethnic,Hispanic or Latino,6,0,6
4100369,Unspecified schizoaffective schizophrenia,ethnic,Hispanic or Latino,4,2,6
375550,Senile corneal changes,racial,White,0,6,6
376525,Audiogram abnormal,racial,Unknown,3,3,6
435951,"Closed fracture of tibia and fibula, shaft",ethnic,Hispanic or Latino,3,3,6
75385,"Closed fracture distal humerus, lateral epicondyle",racial,White,5,1,6
433069,Open wound of external genital organs with complication,racial,Asian,2,4,6
320073,Neutrophil count below reference range,racial,Other Race,6,0,6
320827,Atresia and stenosis of aorta,racial,White,4,2,6
140273,"Contusion, forearm area",ethnic,Not Hispanic or Latino,4,2,6
378756,Conjunctival hemorrhage,racial,Asian,3,3,6
140173,Telogen effluvium,racial,White,6,0,6
314368,Mitral stenosis with insufficiency,racial,White,6,0,6
381278,Cluster headache,ethnic,Not Hispanic or Latino,5,1,6
375557,Cerebral embolism,racial,Unknown,6,0,6
437449,Victim of child abuse,racial,Unknown,5,1,6
199978,Contusion of lower limb,ethnic,Not Hispanic or Latino,4,2,6
440379,Episodic opioid dependence,ethnic,Not Hispanic or Latino,2,4,6
440631,Mycobacterial disease,racial,Asian,0,6,6
433457,Agoraphobia without mention of panic attacks,racial,Unknown,0,6,6
198715,Premature menopause,ethnic,Not Hispanic or Latino,6,0,6
75036,Primary localized osteoarthrosis of hand,racial,Other Race,6,0,6
4318408,Subdural haematoma,racial,White,1,5,6
30441,Sialolithiasis,ethnic,Hispanic or Latino,2,4,6
74052,Labyrinthitis,racial,Unknown,2,4,6
30437,Gastroesophageal reflux disease with esophagitis,racial,American Indian or Alaska Native ,6,0,6
77310,Deep vein phlebitis and thrombophlebitis of the leg,ethnic,Not Hispanic or Latino,1,5,6
25844,Ulcer of esophagus,racial,Unknown,2,4,6
134736,Backache,racial,Native Hawaiian or Other Pacific Islander ,4,2,6
437779,Streptococcal infectious disease,racial,White,1,5,6
137785,Verruca plantaris,racial,Other Race,3,3,6
437832,Malnutrition of mild degree (Gomez: 75% to less than 90% of standard weight),ethnic,Not Hispanic or Latino,6,0,6
4013916,Closed fracture of clavicle NOS,racial,White,2,4,6
197440,Nonvenomous insect bite of trunk without infection,racial,White,4,2,6
78474,Hypertrophy of breast,racial,Black or African American ,5,1,6
200687,Renal disorder associated with type I diabetes mellitus,racial,Black or African American ,0,6,6
4064905,Venereal disease screening,racial,Native Hawaiian or Other Pacific Islander ,6,0,6
435903,Juvenile osteochondrosis of foot,ethnic,Hispanic or Latino,1,5,6
4239301,Unwanted pregnancy,ethnic,Not Hispanic or Latino,6,0,6
378144,Disease of basal ganglia,racial,Unknown,0,6,6
432741,Abnormal immunology finding,racial,Asian,5,1,6
138790,Chronic periodontitis,ethnic,Hispanic or Latino,2,4,6
77395,Current tear of semilunar cartilage,racial,Other Race,5,1,6
139099,Ingrowing nail,racial,Black or African American ,4,2,6
436546,Strain of subscapularis muscle,racial,White,4,2,6
440631,Mycobacterial disease,ethnic,Not Hispanic or Latino,0,6,6
373775,Psychophysical visual disturbance,ethnic,Hispanic or Latino,6,0,6
372925,Cholesteatoma,ethnic,Hispanic or Latino,1,5,6
193016,Cystic disease of kidney,racial,Other Race,4,2,6
436730,"Appendicitis, unqualified",ethnic,Not Hispanic or Latino,1,5,6
440535,Abnormal radiographic examination,ethnic,Not Hispanic or Latino,2,4,6
442256,Disorder of bursae of shoulder region,racial,Black or African American ,2,4,6
440668,Benign tumour of tongue,ethnic,Hispanic or Latino,4,2,6
4079687,Tumor lysis syndrome,racial,White,0,6,6
440360,Pure hyperglyceridemia,racial,American Indian,3,3,6
4287237,Vascular hamartoma of skin,racial,Unknown,1,5,6
78472,Microscopic haematuria,racial,Filipino,1,5,6
78516,Arthralgia of the upper arm,racial,Other Race,2,4,6
433968,Candidiasis,racial,Black or African American ,4,2,6
4237140,Abnormal sexual function,ethnic,Hispanic or Latino,0,6,6
440374,Obsessive compulsive disorder,racial,Asian,5,1,6
439989,Insulin adverse reaction,ethnic,Hispanic or Latino,2,4,6
439382,Disorder of hypothalamus,racial,Black or African American ,6,0,6
438261,Neonatal jaundice due to delayed conjugation associated with another disease,ethnic,Hispanic or Latino,1,5,6
30968,Diabetes insipidus,ethnic,Not Hispanic or Latino,3,3,6
4296205,Second degree burn,ethnic,Not Hispanic or Latino,3,3,6
4104157,Genital observation,racial,White,5,1,6
441077,Stenosis of cervix,racial,White,6,0,6
440653,Infection by toxoplasma gondii,racial,Unknown,0,6,6
444391,Pain around eye,racial,Asian,5,1,6
197605,Inflammatory disorder of male genital organ,racial,White,0,6,6
443617,Conduct disorder,racial,Black or African American ,3,3,6
372610,Post-concussion syndrome,racial,Unknown,1,5,6
256215,"Lung agenesis, hypoplasia and dysplasia",ethnic,Hispanic or Latino,1,5,6
74189,Sprain of cruciate ligament of knee,racial,Unknown,3,3,6
440081,Barbiturate dependence,ethnic,Not Hispanic or Latino,5,1,6
444453,Benign tumour of soft tissue of leg,ethnic,Hispanic or Latino,2,4,6
437966,Calcium deposits in tendon,racial,Unknown,5,1,6
435836,Disorder of nasopharynx,racial,White,4,2,6
312648,Benign essential hypertension,racial,American Indian,5,1,6
4299535,Pregnancy confirmed,racial,Other Race,6,0,6
444415,Severe epithelial dysplasia of bronchus,racial,White,4,2,6
194395,Bleeding diverticulosis,racial,White,4,2,6
194265,Cryptosporidiasis,racial,Black or African American ,0,6,6
137944,Bullous dermatosis,racial,Unknown,6,0,6
440829,Fetus and newborn affected by noxious influences transmitted via placenta or breast milk,racial,Black or African American ,1,5,6
4131908,Diabetic peripheral vascular disease,racial,White,6,0,6
196168,Irregular menstrual bleeding,racial,Native Hawaiian or Other Pacific Islander ,6,0,6
4103894,Hordeolum and other deep inflammation of eyelid NOS,racial,Unknown,5,1,6
193520,Urinary bladder stone,racial,Unknown,1,5,6
140489,Acquired acanthosis nigricans,racial,Other Race,1,5,6
443295,Maternal care for diminished foetal movements,ethnic,Hispanic or Latino,6,0,6
440690,Social phobia,ethnic,Not Hispanic or Latino,3,3,6
4270866,Symptomatic dermographism,ethnic,Hispanic or Latino,4,2,6
442615,Carotid artery stenosis,racial,Other Race,5,1,6
377821,Neurological disorder associated with type I diabetes mellitus,racial,Asian,0,6,6
196436,Internal haemorrhoid,racial,Unknown,4,2,6
440021,Herpes simplex without complication,racial,Other Race,4,2,6
436671,Carcinoma in situ of anal canal,racial,White,0,6,6
374360,Disorder of optic nerve,racial,White,6,0,6
140526,Congenital anomaly of endocrine gland,racial,White,3,3,6
141917,Balanitis xerotica obliterans,ethnic,Not Hispanic or Latino,0,6,6
378752,Corneal opacity,racial,Other Race,0,6,6
436040,Infection by Strongyloides,ethnic,Hispanic or Latino,1,5,6
435150,Effects of heat AND/OR light,ethnic,Hispanic or Latino,6,0,6
4083236,Alcoholism counselling,racial,Unknown,6,0,6
374639,Chronic headache disorder,racial,White,6,0,6
133147,Primary malignant neoplasm of skin of trunk,racial,White,6,0,6
4168213,Chest pain on breathing,racial,Other Race,4,2,6
432801,"Injury undetermined whether accidentally or purposely inflicted, fall from natural site",racial,Asian,0,6,6
436098,Nondependent cocaine abuse in remission,ethnic,Hispanic or Latino,2,4,6
4062650,Malnutrition screening,racial,Black or African American ,3,3,6
76791,Acquired deformity of hip,racial,Unknown,3,3,6
195603,Vulval and/or perineal noninflammatory disorders,ethnic,Not Hispanic or Latino,6,0,6
440676,Neoplasm of uncertain behaviour of brain and spinal cord,racial,White,6,0,6
133088,Late amputation stump complication,ethnic,Hispanic or Latino,1,5,6
197917,Disorder of biliary tract,racial,Unknown,3,3,6
4105880,Contact of sexually transmissible disorder,racial,Asian,5,1,6
138717,Thyrotoxicosis with diffuse goitre,racial,White,3,3,6
257011,Acute upper respiratory infection,racial,American Indian,4,2,6
375277,Non-infectious pinna disorders,ethnic,Hispanic or Latino,2,4,6
252280,Neoplasm of respiratory tract,ethnic,Hispanic or Latino,2,4,6
443879,Epididymo-orchitis with abscess,ethnic,Hispanic or Latino,0,6,6
438731,Fat pad,racial,White,5,1,6
78243,Congenital spondylolysis of lumbosacral region,ethnic,Hispanic or Latino,3,3,6
441391,"Acquired forearm deformity, excluding fingers",racial,Unknown,0,6,6
372424,Congenital anolmaly of eye,racial,White,4,2,6
254591,Secondary malignant tumour of lung,racial,Unknown,0,6,6
434877,Hodgkin's disease of lymph nodes of axilla AND/OR upper limb,ethnic,Hispanic or Latino,6,0,6
257581,Exacerbation of asthma,racial,American Indian,5,1,6
201337,Disorder of bladder and bladder neck,ethnic,Not Hispanic or Latino,4,2,6
440921,Traumatic injury,racial,Black or African American ,0,6,6
377291,"Peripheral pterygium, progressive",ethnic,Not Hispanic or Latino,6,0,6
438536,Congenital anomaly of jaw,racial,Unknown,1,5,6
4113027,Dietary intake observations,racial,Filipino,3,3,6
4218874,Scimitar syndrome,ethnic,Hispanic or Latino,1,5,6
196523,Diarrhea,racial,Filipino,4,2,6
79069,Disease of rectum,ethnic,Not Hispanic or Latino,2,4,6
434896,Benign neoplasm of skin of upper limb and shoulder,racial,Unknown,5,1,6
193983,Disorder of pancreatic internal secretion,ethnic,Not Hispanic or Latino,1,5,6
4303805,Allergic reaction to bite and/or sting,ethnic,Not Hispanic or Latino,4,2,6
433260,Mother delivered,ethnic,Hispanic or Latino,6,0,6
4084229,Primary gout,racial,American Indian or Alaska Native ,4,2,6
261326,Viral pneumonia,racial,Unknown,1,5,6
374022,Hemiplegia,racial,Native Hawaiian or Other Pacific Islander ,0,6,6
200483,Disease of pelvis,ethnic,Not Hispanic or Latino,4,2,6
199856,Varicose veins of lower extremity with inflammation,racial,Filipino,0,6,6
4108079,Perceptive hearing loss NOS,racial,Unknown,4,2,6
440979,Acquired hemolytic anemia,racial,White,4,2,6
195012,Metrorrhagia,racial,Other Race,6,0,6
4152047,Lipid screening,racial,Asian,5,1,6
432517,Posttraumatic wound infection,ethnic,Not Hispanic or Latino,2,4,6
313608,Closed fracture of T7-T12 level with spinal cord injury,racial,White,0,6,6
252280,Neoplasm of respiratory tract,racial,White,2,4,6
376103,Retinopathy,racial,Other Race,4,2,6
442427,Cervical post-laminectomy syndrome,ethnic,Not Hispanic or Latino,6,0,6
134118,Atrophic condition of skin,racial,Black or African American ,4,2,6
440840,Neonatal candidiasis,ethnic,Hispanic or Latino,2,4,6
76472,Dysplasia of anus,ethnic,Hispanic or Latino,1,5,6
4013526,ESR raised,racial,Unknown,6,0,6
381036,Multiple AND bilateral precerebral artery stenosis,racial,Unknown,0,6,6
4055642,Other diseases of lung,ethnic,Not Hispanic or Latino,0,6,6
440431,Pneumonia due to Mycoplasma pneumoniae,racial,Unknown,6,0,6
4057825,Constipation NOS,ethnic,Not Hispanic or Latino,2,4,6
432801,"Injury undetermined whether accidentally or purposely inflicted, fall from natural site",ethnic,Not Hispanic or Latino,4,2,6
194133,Low back pain,racial,American Indian,6,0,6
193261,Vaginospasm,racial,White,6,0,6
79936,Polyuria,racial,Black or African American ,1,5,6
195771,Secondary diabetes mellitus,racial,Asian,5,1,6
76194,Osteoarthrosis involving multiple sites but not designated as generalized,racial,Black or African American ,6,0,6
140266,Superficial bruising of back,racial,Unknown,5,1,6
4114284,Chondrocalcinosis NOS,ethnic,Hispanic or Latino,4,2,6
80189,Displacement of lumbar intervertebral disc without myelopathy,racial,American Indian,0,6,6
438438,Acute myocardial infarction of anterolateral wall,racial,White,1,5,6
374372,Otogenic otalgia,racial,White,5,1,6
315831,Chronic pulmonary heart disease,racial,Asian,0,6,6
435524,Sleep disorder,racial,Black or African American ,2,4,6
313219,Phlebitis and thrombophlebitis,ethnic,Not Hispanic or Latino,4,2,6
31967,Nausea,racial,Asian,5,1,6
254058,Acute bronchiolitis due to respiratory syncytial virus,racial,Unknown,2,4,6
372634,Nonphysiologic vision loss,racial,Asian,4,2,6
435790,Spurious polycythaemia,racial,Unknown,1,5,6
73754,Restless legs,racial,Black or African American ,4,2,6
135303,Cyst of oral soft tissue,racial,White,4,2,6
134976,Complex dental caries,racial,Unknown,4,2,6
375292,Perforation of tympanic membrane,racial,Other Race,3,3,6
438398,Leukocytosis,racial,Asian,1,5,6
80498,Joint ankylosis of the ankle and/or foot,racial,White,6,0,6
436314,Accidental puncture AND/OR laceration during a procedure,racial,White,3,3,6
436040,Infection by Strongyloides,racial,Unknown,1,5,6
198471,Complex endometrial hyperplasia,ethnic,Hispanic or Latino,6,0,6
375428,Second cranial nerve injury,racial,White,0,6,6
441398,Anomaly of sex chromosome,ethnic,Hispanic or Latino,2,4,6
432966,Hypertrophy of vulva,ethnic,Hispanic or Latino,6,0,6
439907,Spontaneous tendon rupture,ethnic,Hispanic or Latino,5,1,6
441260,Drug withdrawal syndrome,ethnic,Not Hispanic or Latino,2,4,6
140654,Deep seated dermatophytosis,racial,White,2,4,6
441828,Disorganized schizophrenia,ethnic,Hispanic or Latino,1,5,6
433244,Tooth loss,racial,Unknown,1,5,6
320116,Acute pericarditis,ethnic,Hispanic or Latino,0,6,6
257007,Allergic rhinitis,racial,Asian Indian,5,1,6
4165091,Lack of exercise,racial,Filipino,2,4,6
198809,Acute cholecystitis,racial,Unknown,4,2,6
4131908,Diabetic peripheral vascular disease,ethnic,Hispanic or Latino,6,0,6
4129404,Open wound of upper arm,ethnic,Hispanic or Latino,2,4,6
4079687,Tumor lysis syndrome,ethnic,Not Hispanic or Latino,0,6,6
434889,"Hysterical neurosis, conversion type",racial,Unknown,6,0,6
75053,Fracture of bone,ethnic,Not Hispanic or Latino,3,3,6
27918,Eosinophilic esophagitis,racial,White,0,6,6
442441,Grand multiparity with antenatal problem,ethnic,Hispanic or Latino,6,0,6
4307254,Closed fracture,ethnic,Not Hispanic or Latino,1,5,6
201257,Disorder of endocrine ovary,ethnic,Hispanic or Latino,6,0,6
439128,Extreme immaturity,racial,White,5,1,6
4296024,Family disruption due to divorce,ethnic,Hispanic or Latino,1,5,6
140318,"Septicemia due to streptococcus, group A",racial,White,2,4,6
138148,Plantar nerve lesion,ethnic,Not Hispanic or Latino,6,0,6
435535,Aggressive type unsocialized behavior disorder,racial,Unknown,5,1,6
4204904,Education about sexually transmitted disease prevention,racial,Other Race,3,3,6
437993,Closed fracture of cervical spine,racial,Unknown,0,6,6
4065992,Cellulitis and abscess of finger unspecified,ethnic,Hispanic or Latino,3,3,6
438567,Adult failure to thrive syndrome,racial,White,2,4,6
192273,Benign tumour of adrenal gland,racial,Unknown,1,5,6
318169,Varicose veins of lower extremity,racial,Native Hawaiian or Other Pacific Islander ,6,0,6
136779,Disease of forearm,ethnic,Hispanic or Latino,4,2,6
75128,Injury of chest wall,racial,White,3,3,6
195212,Hypercortisolism,ethnic,Hispanic or Latino,3,3,6
440548,Closed fracture of lower end of femur,ethnic,Hispanic or Latino,4,2,6
196341,Dermatophytosis of the perianal area,racial,Asian,1,5,6
194079,Post-surgical malabsorption,racial,White,4,2,6
195300,Alcoholic gastritis,racial,Unknown,3,3,6
201211,Herpetic vulvovaginitis,ethnic,Hispanic or Latino,6,0,6
195861,Small kidney,ethnic,Hispanic or Latino,6,0,6
73241,Anal and rectal polyp,racial,Asian,6,0,6
81984,Sprain of shoulder and upper arm,racial,Asian,4,2,6
318775,Venous embolism,racial,American Indian or Alaska Native ,6,0,6
374912,Leukodystrophy,racial,White,5,1,6
73575,Deformity of toe,racial,Unknown,1,5,6
440794,Elderly primigravida - delivered,racial,White,6,0,6
436651,Hodgkin's disease of extranodal AND/OR solid organ site,racial,White,2,4,6
4100857,Pickwickian syndrome,racial,Asian,4,2,6
201344,Vesico-intestinal fistula,racial,Unknown,4,2,6
4102808,Transsexuality with homosexual history,ethnic,Hispanic or Latino,0,6,6
443587,Diastolic heart failure,racial,Black or African American ,1,5,6
76887,Disorders of urogenital prostheses or implants,ethnic,Not Hispanic or Latino,5,1,6
435739,Late syphilis,racial,Other Race,5,1,6
433596,Abnormal sputum,racial,Unknown,4,2,6
4215971,Obstructed incisional ventral hernia,ethnic,Hispanic or Latino,2,4,6
4062495,Glaucoma screening,racial,Black or African American ,4,2,6
314963,Giant cell arteritis,ethnic,Not Hispanic or Latino,1,5,6
318772,Disease of pericardium,racial,White,1,5,6
377286,VFD - Visual field defect,ethnic,Not Hispanic or Latino,2,4,6
381549,Migraine with aura,racial,Other Race,5,1,6
442299,Injury of female external genital organs,ethnic,Hispanic or Latino,0,6,6
4116861,Neuromyopathy,racial,White,4,2,6
378425,Eyelid inflammation,racial,Asian,4,2,6
374882,Benign connective tissue neoplasm,racial,Unknown,5,1,6
255841,Chronic bronchitis,racial,Native Hawaiian or Other Pacific Islander ,6,0,6
438536,Congenital anomaly of jaw,racial,Other Race,3,3,6
194611,CIN 3 - Cervical intraepithelial neoplasia grade 3,racial,Asian,6,0,6
199867,CPH - Chronic persistent hepatitis,ethnic,Hispanic or Latino,5,1,6
435656,Neonatal jaundice,racial,Asian,1,5,6
440457,Threatened abortion,racial,Unknown,6,0,6
381114,Microcephalus,ethnic,Not Hispanic or Latino,1,5,6
4006788,Percutaneous transluminal coronary balloon angioplasty,racial,White,2,4,6
77081,Tibialis tendinitis,ethnic,Hispanic or Latino,5,1,6
436370,"Combined drug dependence, excluding opioids",ethnic,Hispanic or Latino,6,0,6
440379,Episodic opioid dependence,racial,Unknown,4,2,6
199878,Light and infrequent menstruation,ethnic,Not Hispanic or Latino,4,2,6
73302,Curvature of spine,ethnic,Hispanic or Latino,2,4,6
81336,Rectal prolapse,ethnic,Not Hispanic or Latino,2,4,6
4206460,Problem,racial,Asian,2,4,6
372888,Sciatic nerve lesion,ethnic,Not Hispanic or Latino,5,1,6
81459,Unilateral traumatic amputation of foot with complication,racial,White,0,6,6
256439,Allergic rhinitis due to pollen,racial,Other Race,4,2,6
432285,Recurrent major depressive episodes,racial,Filipino,6,0,6
437663,Fever,racial,Filipino,3,3,6
4184877,Amputated finger,racial,White,0,6,6
376267,Superficial injury of conjunctiva,ethnic,Hispanic or Latino,2,4,6
377845,Anoxic encephalopathy,ethnic,Hispanic or Latino,6,0,6
437090,Hemolytic disease of fetus OR newborn due to ABO immunization,ethnic,Hispanic or Latino,1,5,6
134461,Tietze disease,racial,Black or African American ,3,3,6
200771,Peptic ulcer without hemorrhage AND without perforation but with obstruction,ethnic,Not Hispanic or Latino,1,5,6
444132,Knee injury,racial,Black or African American ,3,3,6
433540,Polyhydramnios with antenatal problem,racial,White,6,0,6
373185,Drug-induced dyskinesia,racial,White,6,0,6
439926,Malaise and fatigue,racial,Native Hawaiian or Other Pacific Islander ,2,4,6
78011,Sprain of metacarpophalangeal joint,racial,White,3,3,6
195300,Alcoholic gastritis,racial,White,2,4,6
435903,Juvenile osteochondrosis of foot,racial,White,1,5,6
441132,Laboratory finding abnormal,ethnic,Hispanic or Latino,2,4,6
194410,Male genital organ disorder associated with another disorder,ethnic,Hispanic or Latino,0,6,6
439166,Closed fracture of radius,ethnic,Not Hispanic or Latino,2,4,6
443400,Peritoneal cancer,ethnic,Hispanic or Latino,2,4,6
75650,Proteinuria,racial,Filipino,4,2,6
193530,Follicular cyst of ovary,racial,Unknown,6,0,6
195856,Cholangitis,ethnic,Hispanic or Latino,5,1,6
194093,Postcoital bleeding,ethnic,Not Hispanic or Latino,4,2,6
80498,Joint ankylosis of the ankle and/or foot,ethnic,Hispanic or Latino,6,0,6
432441,Finding of length of gestation,racial,Other Race,2,4,6
435532,Episodic chronic alcoholism,ethnic,Hispanic or Latino,0,6,6
437041,Mother not delivered,racial,Filipino,6,0,6
258785,Pneumococcal pneumonia,racial,White,4,2,6
4114472,Ear problem,ethnic,Hispanic or Latino,4,2,6
4103416,Drug dependence NOS,ethnic,Not Hispanic or Latino,6,0,6
134304,Benign tumour of parathyroid gland,racial,White,6,0,6
436209,Fracture of fibula,racial,Unknown,3,3,6
198528,Acquired unequal leg length,ethnic,Not Hispanic or Latino,2,4,6
76819,Congenital unilateral subluxation of hip,racial,White,1,5,6
200444,Post-cholecystectomy syndrome,racial,White,4,2,6
4110945,Benign hypertensive heart disease NOS,ethnic,Hispanic or Latino,2,4,6
4122116,Tooth eruption disturbances,ethnic,Hispanic or Latino,5,1,6
436539,Closed fracture of patella,racial,Unknown,3,3,6
438469,"Duodenal ulcer without hemorrhage, without perforation AND without obstruction",ethnic,Hispanic or Latino,6,0,6
436134,Disorder of sclera,ethnic,Hispanic or Latino,5,1,6
443178,"Insect bite, nonvenomous, of face",racial,White,2,4,6
4055642,Other diseases of lung,racial,Black or African American ,0,6,6
441321,Chronic nasopharyngitis,racial,White,3,3,6
437995,Closed ill-defined fractures of upper limb,racial,Other Race,6,0,6
133737,Acute thyroiditis,racial,White,6,0,6
197675,Bowel incontinence,racial,Unknown,4,2,6
433675,Toxic effect of chemical,ethnic,Hispanic or Latino,2,4,6
78518,Observation of shoulder joint,racial,Unknown,5,1,6
77076,Diastasis of muscle,racial,White,1,5,6
438329,Late effect of motor vehicle accident,ethnic,Not Hispanic or Latino,5,1,6
317305,Stricture of artery,racial,Unknown,0,6,6
195339,Decubitus ulcer of hip,racial,White,0,6,6
376382,Tension-type headache,racial,Black or African American ,4,2,6
75667,Sprain of calcaneofibular ligament,ethnic,Hispanic or Latino,5,1,6
75650,Proteinuria,racial,Native Hawaiian or Other Pacific Islander ,4,2,6
320073,Neutrophil count below reference range,racial,Asian,4,2,6
136834,Closed intertrochanteric fracture,racial,White,4,2,6
434084,Abscess of vulva,racial,Unknown,6,0,6
200774,Detrusor and sphincter dyssynergia,ethnic,Hispanic or Latino,6,0,6
444070,Tachycardia,racial,Other Race,5,1,6
194265,Cryptosporidiasis,ethnic,Not Hispanic or Latino,0,6,6
441541,Lymphocytopenia,ethnic,Hispanic or Latino,2,4,6
437064,Chondrocalcinosis,racial,Unknown,4,2,6
435613,Cellulitis,racial,Filipino,6,0,6
201387,Doubling of uterus,ethnic,Hispanic or Latino,6,0,6
372425,Congenital abnormality of ear,racial,Unknown,5,1,6
4194232,Absence seizure,ethnic,Hispanic or Latino,1,5,6
4100369,Unspecified schizoaffective schizophrenia,racial,Black or African American ,6,0,6
81144,Sprain of medial collateral ligament of knee,racial,Unknown,5,1,6
254061,Pleural effusion,racial,Other Race,1,4,5
381316,CVA - Cerebrovascular accident,racial,Asian,0,5,5
435613,Cellulitis,racial,Black or African American ,5,1,6
374372,Otogenic otalgia,racial,Unknown,5,1,6
380731,OE - Otitis externa,racial,Unknown,1,4,5
193814,Chronic parametritis and pelvic cellulitis,racial,White,5,0,5
200461,Endometriosis of uterus,ethnic,Hispanic or Latino,5,0,5
201352,Cholelithiasis AND acute cholecystitis with obstruction,ethnic,Hispanic or Latino,2,3,5
200450,Disease of urethra,ethnic,Not Hispanic or Latino,2,3,5
72471,Sprain of carpometacarpal joint,ethnic,Hispanic or Latino,2,3,5
317248,Disorder of hematopoietic structure,racial,Black or African American ,1,4,5
315361,Orthopnea,racial,White,3,2,5
200391,Peripheral autonomic neuropathy disease EC,racial,Native Hawaiian or Other Pacific Islander ,0,5,5
78524,Acquired deformity of finger,racial,White,2,4,6
433390,Immunosuppressant adverse reaction,ethnic,Hispanic or Latino,4,2,6
442019,Complication of procedure,ethnic,Hispanic or Latino,3,2,5
4139915,Acute pyelitis,racial,Unknown,4,1,5
381174,Contusion of globe of eye,ethnic,Hispanic or Latino,4,1,5
4196960,Varicocele,ethnic,Not Hispanic or Latino,0,5,5
372324,Eustachian tube disorder,racial,Black or African American ,2,3,5
441334,Glossodynia,racial,Unknown,4,1,5
133295,Inflammatory spondylopathy,racial,White,2,3,5
441190,Injury of unknown intent due to fall from height,ethnic,Not Hispanic or Latino,5,1,6
436954,Drug abuse,racial,Black or African American ,1,4,5
317248,Disorder of hematopoietic structure,racial,Other Race,2,3,5
313590,Perinatal respiratory failure,ethnic,Hispanic or Latino,2,3,5
376679,PMA - Progressive muscular atrophy,racial,White,0,5,5
444391,Pain around eye,racial,Other Race,3,2,5
201527,Neoplasm of uncertain behaviour of prostate,racial,White,0,5,5
438882,Closed fracture of neck of metacarpal bone,ethnic,Not Hispanic or Latino,1,4,5
433171,Selective IgA immunodeficiency,ethnic,Not Hispanic or Latino,4,1,5
40480639,Dissecting aneurysm of thoracoabdominal aorta,racial,White,0,5,5
436944,Chronic paranoid schizophrenia,racial,Asian,0,5,5
194683,Obstructed umbilical hernia,ethnic,Hispanic or Latino,4,2,6
132408,Back problem,racial,Other Race,3,2,5
4139681,Allergy to dairy product,ethnic,Not Hispanic or Latino,5,1,6
441207,Drug reaction,racial,Other Race,5,1,6
321080,"Hypertension complicating pregnancy, childbirth and the puerperium",racial,Unknown,5,0,5
4293175,"Mental state, behaviour and/or psychosocial function finding",racial,Asian,1,5,6
4103580,Unspecified senile cataract,racial,White,2,3,5
195599,Post-hysterectomy vaginal vault prolapse,racial,Unknown,5,0,5
4149353,"Attention deficit hyperactivity disorder, predominantly inattentive type",racial,Black or African American ,1,5,6
434281,Aspergillosis,racial,White,1,5,6
4283532,Psychogenic headache,racial,White,5,1,6
435219,Schizophrenia in remission,ethnic,Not Hispanic or Latino,0,5,5
439975,Injury at C1-C4 level with spinal cord injury AND without bone injury,ethnic,Not Hispanic or Latino,1,5,6
435553,Watery eye,racial,Asian,5,0,5
372906,Both eyes total visual impairment,racial,Other Race,0,5,5
76797,Congenital deformity of genital organ,ethnic,Hispanic or Latino,1,4,5
75637,Acquired postural kyphosis,racial,Asian,5,0,5
375527,Headache disorder,ethnic,Not Hispanic or Latino,4,2,6
4149560,Hand sprain unspecified,ethnic,Hispanic or Latino,4,2,6
439154,Abnormal findings on diagnostic imaging of skull and head,racial,Unknown,2,3,5
434011,Transvestism,ethnic,Not Hispanic or Latino,5,0,5
375283,Angular blepharoconjunctivitis,racial,Unknown,5,1,6
378087,Secondary malignant neoplasm of brain and spinal cord,ethnic,Hispanic or Latino,1,4,5
4102739,Screening for cardiovascular system disease,ethnic,Not Hispanic or Latino,1,5,6
438064,Bacterial infection due to Pseudomonas,racial,Unknown,5,0,5
373487,AION - Acute ischaemic optic neuropathy,racial,White,5,0,5
435149,Complication of internal device,ethnic,Hispanic or Latino,1,4,5
201688,Urinary hesitancy,racial,Other Race,5,1,6
192438,Abdominal mass,ethnic,Not Hispanic or Latino,5,0,5
312336,Arterial aneurysm,racial,White,2,4,6
194788,Open wound of anterior abdominal wall with complication,ethnic,Hispanic or Latino,1,4,5
74132,Degeneration of lumbosacral intervertebral disc,racial,Black or African American ,2,3,5
376707,Acute conjunctivitis,racial,Filipino,2,4,6
4140734,Amniocentesis for possible chromosomal abnormality,ethnic,Hispanic or Latino,5,0,5
437881,Malignant otitis externa,racial,White,4,2,6
254980,Intrinsic asthma with asthma attack,racial,Unknown,1,4,5
199978,Contusion of lower limb,racial,Unknown,2,3,5
4201745,Disease of digestive system,racial,White,4,2,6
23164,Disease of anterior pituitary,ethnic,Hispanic or Latino,5,1,6
4296205,Second degree burn,racial,Unknown,2,4,6
376106,Disorder of the central nervous system,racial,White,4,2,6
436381,Gender identity disorder of childhood,racial,White,1,5,6
373127,Herpes simplex disciform keratitis,racial,Unknown,5,1,6
75941,Closed fracture of one rib,racial,White,2,3,5
193525,Abdominal pregnancy,ethnic,Not Hispanic or Latino,5,0,5
80205,Perinatal condition,racial,White,5,0,5
193422,Primary malignant neoplasm of body of stomach,ethnic,Hispanic or Latino,2,4,6
433288,Derangement of anterior horn of lateral meniscus,racial,White,1,5,6
194526,Injury of trunk,racial,Unknown,4,2,6
433257,Mesangiocapillary glomerulonephritis,racial,White,4,2,6
444419,Quadriparesis,racial,White,0,5,5
372721,Congenital anomaly of cerebrovascular system,racial,White,1,5,6
4171430,Screening for malignant neoplasm of rectum,racial,American Indian or Alaska Native ,4,1,5
259865,Cyst of Bartholin's gland duct,racial,Unknown,5,0,5
197950,Cellulitis and abscess of trunk,racial,Other Race,4,2,6
433996,Catatonic schizophrenia,ethnic,Hispanic or Latino,4,1,5
433996,Catatonic schizophrenia,racial,White,4,1,5
442299,Injury of female external genital organs,racial,White,0,5,5
436988,Enophthalmos due to atrophy of orbital tissue,ethnic,Hispanic or Latino,5,0,5
139757,Malignant melanoma of skin of lower limb,racial,White,4,2,6
440703,Trigeminal nerve disorder,ethnic,Hispanic or Latino,2,3,5
81426,Closed fracture of clavicle,racial,Other Race,2,3,5
4166080,Decompression of median nerve,racial,White,4,1,5
194685,Chronic non-obstructive atrophic pyelonephritis,racial,White,1,5,6
434328,"Nondependent cannabis abuse, episodic",ethnic,Hispanic or Latino,3,2,5
80187,Medial epicondylitis,ethnic,Not Hispanic or Latino,4,2,6
192286,Intestinal disaccharidase deficiency,racial,Other Race,2,4,6
312327,Acute myocardial infarction,racial,Asian,4,1,5
196444,Angiodysplasia of intestine,racial,Unknown,4,1,5
438701,UKP - Disseminated malignancy of unknown primary,racial,White,1,5,6
436839,Closed fracture of metacarpal bone,racial,Other Race,5,0,5
444413,Pyrexial convulsion,racial,Unknown,3,2,5
140190,Disorder of back,ethnic,Not Hispanic or Latino,4,1,5
372409,Sciatica neuralgia,racial,American Indian or Alaska Native ,5,1,6
373101,Injury of ulnar nerve,racial,Unknown,2,3,5
4129342,Nephrectomy of remaining or solitary kidney,racial,White,4,2,6
319825,Rheumatic heart disease,racial,Unknown,0,5,5
197921,Renal osteodystrophy,racial,Unknown,5,1,6
381292,Chronic allergic conjunctivitis,racial,Filipino,2,4,6
81685,Fracture of clavicle due to birth trauma,racial,White,2,4,6
4097272,Lipoma NOS,racial,White,3,2,5
442790,Growth and development,racial,Black or African American ,2,4,6
199151,Must strain to pass urine,racial,White,1,5,6
375791,Uncomplicated senile dementia,racial,Native Hawaiian or Other Pacific Islander ,0,5,5
135923,CP - Cleft palate,ethnic,Not Hispanic or Latino,2,3,5
192667,Atrophic gastritis,racial,Native Hawaiian or Other Pacific Islander ,5,0,5
440925,Suicide,ethnic,Hispanic or Latino,5,1,6
434459,Ganglion of tendon sheath,ethnic,Not Hispanic or Latino,4,1,5
314962,Raynaud disease,ethnic,Not Hispanic or Latino,5,0,5
375525,Athetoid cerebral palsy,racial,Other Race,5,0,5
198197,Male infertility,ethnic,Not Hispanic or Latino,0,5,5
374040,Ill-defined disorder of eye,racial,Asian,3,2,5
434467,Ostium secundum type atrial septal defect,racial,Other Race,1,5,6
77354,Primary localised osteoarthrosis of lower leg,racial,American Indian or Alaska Native ,5,0,5
434613,Generalized anxiety disorder,racial,American Indian or Alaska Native ,3,2,5
141004,Lesion of radial nerve,ethnic,Hispanic or Latino,1,5,6
438058,Rape - assault,racial,White,5,1,6
133278,Disorder of hair,ethnic,Not Hispanic or Latino,5,1,6
440973,Benign neoplasm of long bones of lower limb,racial,White,5,1,6
4171594,Family history of cancer,racial,White,4,2,6
199870,Renal vascular disorder,ethnic,Not Hispanic or Latino,1,5,6
437942,Caesarean delivery - delivered,ethnic,Not Hispanic or Latino,5,0,5
312935,Venous hypertension,racial,Black or African American ,0,5,5
435543,Primary angle-closure glaucoma,racial,Unknown,5,0,5
77644,Adhesive capsulitis of shoulder,racial,Black or African American ,5,0,5
138996,Carcinoma in situ of skin,ethnic,Not Hispanic or Latino,2,4,6
317002,Hypopiesis,racial,Other Race,4,1,5
193525,Abdominal pregnancy,racial,Unknown,5,0,5
443401,Congenital connective tissue disorder,ethnic,Not Hispanic or Latino,0,5,5
435081,Abnormal findings on diagnostic imaging of heart and coronary circulation,ethnic,Not Hispanic or Latino,3,2,5
194995,Disorder of ureter,ethnic,Not Hispanic or Latino,4,1,5
196438,Acquired arteriovenous fistula of liver,ethnic,Not Hispanic or Latino,1,4,5
132333,Acute perichondritis of pinna,ethnic,Hispanic or Latino,0,5,5
318566,Flushing,ethnic,Hispanic or Latino,4,2,6
4108242,Atrial fibrillation and flutter NOS,ethnic,Hispanic or Latino,2,4,6
192276,Chronic gouty nephropathy,racial,Other Race,0,5,5
4107924,Retinal detachment with defect NOS,racial,White,0,5,5
78228,Joint derangement,ethnic,Not Hispanic or Latino,1,5,6
380733,Otalgia,racial,Asian,5,1,6
4102166,Multiparous,ethnic,Hispanic or Latino,5,0,5
441793,Infection due to Class Cestoda and/or Class Trematoda and/or Phylum Nemata,racial,Unknown,4,1,5
435151,Physical child abuse,ethnic,Hispanic or Latino,0,5,5
435236,Acute exacerbation of chronic schizoaffective schizophrenia,ethnic,Hispanic or Latino,5,0,5
443409,On examination - left lower abdominal mass,ethnic,Not Hispanic or Latino,5,1,6
137054,Skin striae,ethnic,Hispanic or Latino,2,4,6
4332993,Childhood schizophrenia NOS,ethnic,Hispanic or Latino,1,5,6
256451,Bronchitis,racial,American Indian,4,2,6
4050793,FH: Infectious disease,ethnic,Hispanic or Latino,5,1,6
444406,Acute subendocardial infarction,racial,White,3,2,5
28779,Oesophageal varices with bleeding,racial,American Indian or Alaska Native ,5,0,5
433968,Candidiasis,racial,Other Race,3,2,5
4147414,Varicose veins of legs in pregnancy,racial,White,5,0,5
434592,B-cell lymphoma,racial,Unknown,5,0,5
373151,Primary malignant neoplasm of conjunctiva (primary),ethnic,Hispanic or Latino,0,5,5
434896,Benign neoplasm of skin of upper limb and shoulder,ethnic,Not Hispanic or Latino,2,4,6
437982,Semen observations,ethnic,Hispanic or Latino,0,5,5
434046,Unilateral mixed conductive and sensorineural hearing loss with unrestricted hearing on the contralateral side,ethnic,Hispanic or Latino,3,2,5
132412,Failed back syndrome,racial,White,1,4,5
197320,ARF - Acute renal failure,racial,Other Race,4,1,5
195245,Reflex sympathetic dystrophy,ethnic,Hispanic or Latino,2,3,5
438223,Sunburn of second degree,ethnic,Hispanic or Latino,2,3,5
440076,SS - Short stature,racial,Black or African American ,0,5,5
373852,Neuralgia,racial,Black or African American ,5,0,5
436976,Posterior subcapsular polar cataract,ethnic,Hispanic or Latino,3,2,5
77030,Disease of breast,racial,Black or African American ,5,0,5
79240,Dislocation of joint prosthesis,racial,Unknown,5,0,5
440058,Malignant lymphoma of extranodal AND/OR solid organ site,ethnic,Hispanic or Latino,5,1,6
140176,Erythema nodosum,racial,White,4,1,5
444115,Disorder of bursa,racial,Unknown,3,2,5
377368,Congenital absence of brain,ethnic,Hispanic or Latino,5,0,5
436670,MD - Metabolic disorders,racial,Other Race,5,1,6
376399,Incipient cataract,racial,Unknown,5,0,5
379019,Inflammation of conjunctiva,racial,American Indian or Alaska Native ,2,4,6
434011,Transvestism,racial,White,5,0,5
432923,SAH - Subarachnoid haemorrhage,ethnic,Not Hispanic or Latino,4,1,5
377845,Anoxic encephalopathy,racial,Unknown,5,0,5
75103,Sprain of jaw,racial,Unknown,4,2,6
196436,Internal haemorrhoid,ethnic,Not Hispanic or Latino,1,5,6
378756,Conjunctival hemorrhage,racial,Other Race,4,2,6
80177,Pyogenic arthritis of the pelvic region and thigh,racial,White,1,5,6
440695,Encopresis,racial,Unknown,3,2,5
442074,Focal membranoproliferative glomerulonephritis,racial,White,5,0,5
437655,Cryptorchism,racial,Other Race,0,5,5
319038,Postmyocardial infarction syndrome,ethnic,Hispanic or Latino,2,4,6
4308509,Impaired fasting glycaemia,racial,Filipino,2,4,6
195834,Atherosclerosis of renal artery,ethnic,Not Hispanic or Latino,1,4,5
25297,Acute pharyngitis,racial,American Indian,5,0,5
137345,Pressure ulcer stage 4,racial,Unknown,1,4,5
192673,Vascular insufficiency of intestine,racial,Unknown,5,0,5
439658,Gestosis,racial,White,4,1,5
321107,AR - Congenital aortic regurgitation,ethnic,Not Hispanic or Latino,0,5,5
441460,Late effect of sprain AND/OR strain without tendon injury,ethnic,Not Hispanic or Latino,4,2,6
440878,Open wound of jaw without complication,ethnic,Hispanic or Latino,5,1,6
195339,Decubitus ulcer of hip,racial,Unknown,5,0,5
4258683,Faeces - impacted,racial,White,4,2,6
377886,Chronic purulent otitis media,ethnic,Not Hispanic or Latino,2,4,6
196796,Congenital biliary atresia,racial,Asian,4,1,5
379784,Senile dementia with depression,ethnic,Not Hispanic or Latino,5,1,6
23325,Heartburn,racial,Asian,4,2,6
4014231,Foot sprain NOS,racial,White,1,4,5
197327,Female urinary-genital tract fistula,ethnic,Hispanic or Latino,5,0,5
78586,Sprain of interphalangeal joint of toe,racial,White,3,2,5
372914,Optic atrophy,ethnic,Not Hispanic or Latino,2,3,5
30441,Sialolithiasis,racial,White,2,4,6
141825,Non-toxic goiter,ethnic,Not Hispanic or Latino,5,0,5
437881,Malignant otitis externa,ethnic,Hispanic or Latino,4,2,6
378743,Mild nonproliferative retinopathy,ethnic,Not Hispanic or Latino,2,4,6
434328,"Nondependent cannabis abuse, episodic",racial,White,3,2,5
195864,Diverticulum of bladder,ethnic,Hispanic or Latino,4,1,5
442074,Focal membranoproliferative glomerulonephritis,ethnic,Hispanic or Latino,5,0,5
376115,Cystoid macular retinal degeneration,racial,White,3,2,5
198464,Incisional hernia,ethnic,Not Hispanic or Latino,5,1,6
136185,Abnormal granulation tissue,racial,Unknown,4,1,5
376111,Unqualified visual loss of one eye,racial,Unknown,3,2,5
192885,Tarsal tunnel syndrome,ethnic,Hispanic or Latino,4,2,6
137275,Disorder of muscle,racial,White,5,0,5
135473,Dermatophytosis,racial,Black or African American ,2,3,5
40480639,Dissecting aneurysm of thoracoabdominal aorta,ethnic,Hispanic or Latino,0,5,5
433455,Teeth grinding whilst asleep,racial,White,3,2,5
313867,Double outlet right ventricle,ethnic,Hispanic or Latino,2,3,5
72995,Joint contracture of hand,racial,Unknown,4,2,6
4215971,Obstructed incisional ventral hernia,racial,Unknown,1,4,5
437359,Osteochondritis dissecans,racial,White,4,2,6
4319325,Acquired deformity of trunk,racial,Other Race,4,1,5
140214,Eruption of skin,racial,Filipino,5,1,6
4130036,Brain damage due to hypoxia,ethnic,Not Hispanic or Latino,0,5,5
133835,Dermatitis,racial,American Indian or Alaska Native ,1,5,6
74138,Pathological fracture of vertebra,ethnic,Not Hispanic or Latino,5,1,6
443580,Systolic heart failure,ethnic,Not Hispanic or Latino,2,3,5
197928,Menstruation absent,racial,American Indian or Alaska Native ,5,0,5
313221,Rheumatic aortic stenosis,racial,Unknown,0,5,5
433846,Ankylosis of joint of lower leg,ethnic,Hispanic or Latino,5,0,5
31967,Nausea,racial,Black or African American ,4,1,5
136760,Transient hypertension of pregnancy - not delivered,racial,Unknown,5,0,5
76153,Low compliance bladder,racial,Filipino,5,0,5
435754,Ca ascending colon,racial,Asian,5,0,5
4171434,Immunization refused,racial,Asian,5,1,6
443401,Congenital connective tissue disorder,racial,Asian,0,5,5
434500,Closed fracture of neck of femur,racial,Asian,5,0,5
443879,Epididymo-orchitis with abscess,racial,White,0,5,5
321876,Disease of capillaries,ethnic,Hispanic or Latino,5,1,6
373198,Unqualified visual loss of both eyes,ethnic,Not Hispanic or Latino,2,4,6
261600,Pulmonary oedema - acute,ethnic,Hispanic or Latino,5,1,6
72992,Allergic arthritis,ethnic,Hispanic or Latino,2,3,5
134442,Thibierge-Weissenbach syndrome,ethnic,Not Hispanic or Latino,4,1,5
200843,Observation of frequency of urination,racial,American Indian or Alaska Native ,4,1,5
4223530,Spondylitis,racial,White,2,4,6
133298,Musculoskeletal disorder of the neck,racial,Other Race,2,3,5
433456,Acute pain,racial,Other Race,2,4,6
442105,Benign tumor of soft tissue,ethnic,Hispanic or Latino,1,4,5
435613,Cellulitis,racial,American Indian or Alaska Native ,4,2,6
440922,Diabetic on insulin,racial,Asian,1,4,5
192731,Digestive symptom,racial,Other Race,4,1,5
376686,Polyneuropathy associated with another disorder,racial,Black or African American ,1,5,6
437334,Cervical incompetence with antenatal problem,ethnic,Hispanic or Latino,5,0,5
135772,Goiter,racial,Other Race,5,0,5
433592,Congenital leg bone bowing,racial,White,3,2,5
199991,Complication of transplanted kidney,racial,White,4,2,6
436802,Complete trisomy 13 syndrome,racial,Black or African American ,5,0,5
75046,Old bucket handle tear of medial meniscus,ethnic,Hispanic or Latino,0,5,5
133655,Burn of forearm,racial,White,4,1,5
4126282,Chlamydial urethritis,racial,White,5,1,6
318445,Post cardiac operation functional disturbance,racial,White,2,3,5
198197,Male infertility,racial,Unknown,0,5,5
132333,Acute perichondritis of pinna,racial,White,0,5,5
201313,Hypertensive renal disease,ethnic,Not Hispanic or Latino,2,4,6
4252594,Subconjunctival injection,racial,Unknown,4,1,5
381444,Black eye,ethnic,Not Hispanic or Latino,3,2,5
4129404,Open wound of upper arm,racial,White,1,4,5
439800,"Conduct disorder, adolescent-onset type",racial,White,1,4,5
443593,Ulcer of thigh,ethnic,Hispanic or Latino,4,1,5
79127,Congenital spondylolisthesis,ethnic,Not Hispanic or Latino,5,0,5
4142479,Hyperthyroidism,racial,Unknown,4,1,5
194871,Trichomonal vulvovaginitis,ethnic,Not Hispanic or Latino,5,0,5
381292,Chronic allergic conjunctivitis,racial,American Indian or Alaska Native ,3,2,5
381548,Monoplegia,ethnic,Hispanic or Latino,5,0,5
4287237,Vascular hamartoma of skin,racial,White,4,2,6
436816,Vaginal vault smear abnormal,racial,Unknown,5,0,5
440785,Vomiting of pregnancy,racial,White,5,0,5
80512,Acquired kyphosis,racial,Unknown,3,2,5
4037738,Visual alteration,ethnic,Hispanic or Latino,4,2,6
4097272,Lipoma NOS,ethnic,Hispanic or Latino,3,2,5
432303,Cocaine abuse,racial,White,2,4,6
135061,Congenital anomaly of musculoskeletal system,ethnic,Not Hispanic or Latino,1,4,5
439014,Panuveitis,racial,Unknown,4,1,5
78235,Disorder of coccyx,ethnic,Not Hispanic or Latino,4,2,6
197717,Open wound of anterior abdominal wall without complication,racial,White,4,2,6
436953,Continuous chronic alcoholism,ethnic,Hispanic or Latino,1,5,6
441547,Oppositional defiant disorder,racial,Black or African American ,2,4,6
76819,Congenital unilateral subluxation of hip,ethnic,Hispanic or Latino,1,5,6
75036,Primary localized osteoarthrosis of hand,ethnic,Not Hispanic or Latino,3,2,5
4215003,Myasthenic crisis,ethnic,Not Hispanic or Latino,0,5,5
380055,Primary malignant neoplasm of brain,ethnic,Not Hispanic or Latino,2,3,5
199875,Vaginal wall prolapse without uterine prolapse,racial,White,5,0,5
201909,Female infertility,racial,Other Race,5,0,5
442116,Allergy to eggs,ethnic,Not Hispanic or Latino,0,5,5
436802,Complete trisomy 13 syndrome,ethnic,Not Hispanic or Latino,5,0,5
316428,Hypertrophic obstructive cardiomyopathy,racial,Asian,5,0,5
4103580,Unspecified senile cataract,racial,Unknown,4,2,6
197039,Male genital organ vascular diseases,ethnic,Hispanic or Latino,0,5,5
77650,Aseptic necrosis of bone,racial,Unknown,1,4,5
4201412,Speech therapy,ethnic,Hispanic or Latino,2,3,5
4051568,Family history of mental disorder,racial,White,4,1,5
314059,Right bundle branch block,racial,Black or African American ,0,5,5
380120,Strabismus in neuromuscular disorder,ethnic,Hispanic or Latino,1,4,5
4311159,Midline cystocele,racial,Other Race,5,0,5
138278,Sprains and strains of joints and adjacent muscles,racial,Asian,3,2,5
436675,Anorexia nervosa,racial,White,2,3,5
375239,Cerebral degeneration,racial,Asian,5,0,5
30978,Hereditary leptocytosis,racial,Other Race,5,1,6
257683,Postnasal drip,racial,Other Race,4,2,6
435754,Ca ascending colon,ethnic,Not Hispanic or Latino,5,0,5
438209,Pregnancy care of habitual aborter,racial,Unknown,5,0,5
4048727,Neoplasm screening,racial,Other Race,2,4,6
377556,Sudden visual loss,racial,White,3,2,5
440464,Complication following molar AND/OR ectopic pregnancy,ethnic,Hispanic or Latino,5,0,5
441818,Haemangioma,racial,Other Race,3,2,5
137275,Disorder of muscle,ethnic,Hispanic or Latino,5,1,6
438134,Excessive sleep,racial,Unknown,2,4,6
375824,Abnormal auditory perception,ethnic,Not Hispanic or Latino,3,2,5
4117739,Joint derangement NOS,ethnic,Not Hispanic or Latino,5,0,5
134735,Chronic osteomyelitis,racial,Unknown,5,0,5
441267,Cystic fibrosis,ethnic,Hispanic or Latino,2,4,6
74606,Benign bone tumor,racial,Unknown,5,0,5
440710,IRMA - Intraretinal microvascular abnormality,ethnic,Hispanic or Latino,1,5,6
79914,Polydactyly of toes,racial,White,5,1,6
433263,Complications following abortion and ectopic and molar pregnancies,ethnic,Hispanic or Latino,5,0,5
133711,Overlapping malignant neoplasm of female breast,ethnic,Hispanic or Latino,5,0,5
4050572,Implantation of automatic cardiac defibrillator,racial,Filipino,0,5,5
137005,Tracheostomy complication,ethnic,Hispanic or Latino,5,0,5
260315,Tuberculosis of lung with cavitation,ethnic,Hispanic or Latino,2,4,6
439937,C-reactive protein abnormal,racial,Other Race,3,2,5
132841,Malignant lymphoma of lymph nodes of multiple sites,ethnic,Hispanic or Latino,2,3,5
437878,Persistent mydriasis,ethnic,Hispanic or Latino,5,1,6
4107924,Retinal detachment with defect NOS,ethnic,Hispanic or Latino,0,5,5
434173,Fever symptoms,ethnic,Hispanic or Latino,3,2,5
4115062,Other internal knee derangement NOS,racial,White,4,1,5
380839,TS - Tuberous sclerosis,racial,White,5,1,6
441641,FTND - Full term normal delivery,racial,White,5,1,6
193693,Viral hepatitis without hepatic coma,ethnic,Hispanic or Latino,1,4,5
438555,Cyanosis,ethnic,Hispanic or Latino,2,3,5
254163,Pulmonary aspiration of gastric contents,racial,White,0,5,5
258780,Chronic obstructive bronchitis,racial,Filipino,0,5,5
193253,Nephritis,racial,Native Hawaiian or Other Pacific Islander ,1,4,5
79914,Polydactyly of toes,ethnic,Not Hispanic or Latino,5,1,6
193255,"Noninflammatory disorders of the ovary, fallopian tube and broad ligament",racial,Unknown,5,0,5
375260,Polyneuropathy in collagen vascular disease,ethnic,Not Hispanic or Latino,5,0,5
30133,Acute laryngitis,racial,Other Race,1,4,5
4051114,FH: Diabetes mellitus,racial,Black or African American ,3,2,5
376525,Audiogram abnormal,ethnic,Not Hispanic or Latino,3,2,5
4210149,Substance abuse counseling,racial,Unknown,4,2,6
135350,Acute osteomyelitis of the ankle and/or foot,racial,White,1,5,6
436541,Closed fracture of ulna,ethnic,Hispanic or Latino,4,1,5
75095,Closed fracture of ankle,racial,Asian,5,1,6
376415,Hypermetropia,racial,Unknown,4,1,5
134442,Thibierge-Weissenbach syndrome,racial,Other Race,0,5,5
201899,Unilateral recurrent inguinal hernia,racial,Filipino,0,5,5
442530,Broken tooth injury with complication,ethnic,Hispanic or Latino,1,4,5
316084,Lymphadenitis,racial,Other Race,5,1,6
433592,Congenital leg bone bowing,ethnic,Hispanic or Latino,3,2,5
137626,Seborrhoeic eczema of scalp,racial,Asian,2,4,6
374347,Blepharoconjunctivitis,racial,Unknown,3,2,5
441554,FA - Friedreich ataxia,racial,White,5,0,5
439253,"Bipolar affective disorder, currently depressed, mild",racial,Black or African American ,1,5,6
141248,Benign neoplasm of skin of lip,ethnic,Hispanic or Latino,4,2,6
432312,Anatomical narrow angle glaucoma,racial,Unknown,5,1,6
432863,Acquired coagulation factor deficiency,racial,White,5,1,6
4067435,"Joint disorder NOS, of unspecified site",ethnic,Hispanic or Latino,3,2,5
437334,Cervical incompetence with antenatal problem,racial,White,5,1,6
132822,Foot-and-mouth disease,ethnic,Hispanic or Latino,1,4,5
195312,Functional voiding disorder,racial,Asian,4,1,5
373638,Superficial injury of cornea,ethnic,Not Hispanic or Latino,2,4,6
75382,Closed fractures of tarsal AND metatarsal bones,racial,Unknown,5,0,5
313005,Congenital stenosis of pulmonary valve,ethnic,Hispanic or Latino,3,2,5
440457,Threatened abortion,ethnic,Not Hispanic or Latino,5,0,5
442753,Furuncle of trunk,racial,Other Race,1,4,5
138502,Vitiligo,racial,Asian,4,2,6
314171,Low blood pressure reading,racial,White,4,2,6
438244,Congenital hydrocephalus,racial,Asian,3,2,5
436072,Bipolar disorder in partial remission,racial,Other Race,5,0,5
4117739,Joint derangement NOS,racial,Black or African American ,5,0,5
260125,Acute bronchiolitis,racial,Filipino,1,5,6
194175,Left upper quadrant pain,racial,Other Race,2,4,6
321080,"Hypertension complicating pregnancy, childbirth and the puerperium",racial,Black or African American ,5,0,5
373766,Retinopathy of prematurity,racial,Asian,4,1,5
138896,Open wound of forehead without complication,ethnic,Not Hispanic or Latino,4,2,6
77025,Diverticulitis of colon,racial,Black or African American ,4,1,5
140214,Eruption of skin,racial,Native Hawaiian or Other Pacific Islander ,2,3,5
374044,Droopy eyelid,racial,Asian,1,4,5
381858,Dacryoadenitis,ethnic,Hispanic or Latino,2,4,6
379820,No colour perception,ethnic,Hispanic or Latino,2,3,5
4062491,Anemia screening,racial,Unknown,5,1,6
199859,Bilateral recurrent inguinal hernia,racial,White,1,5,6
200774,Detrusor and sphincter dyssynergia,racial,White,5,0,5
192674,Allergic gastroenteritis and colitis,ethnic,Hispanic or Latino,4,2,6
376679,PMA - Progressive muscular atrophy,ethnic,Hispanic or Latino,0,5,5
439003,Disorder of branched chain amino acid metabolism,ethnic,Hispanic or Latino,0,5,5
76150,Ulcer of rectum,ethnic,Hispanic or Latino,2,3,5
438155,Optic disc glaucomatous atrophy,racial,Other Race,0,5,5
441554,FA - Friedreich ataxia,ethnic,Hispanic or Latino,5,0,5
440686,Residual schizophrenia in remission,racial,White,4,1,5
78907,Superficial injury of foot without infection,ethnic,Hispanic or Latino,4,2,6
319016,Retinal lattice degeneration,racial,White,2,3,5
432795,Traumatic AND/OR non-traumatic injury,racial,Asian,4,1,5
433716,Primary malignant neoplasm of testis,ethnic,Hispanic or Latino,0,5,5
73842,Enthesopathy of elbow region,ethnic,Hispanic or Latino,4,1,5
4015843,Gonorrhea carrier,racial,White,0,5,5
437082,Marie-Strumpell spondylitis,racial,Unknown,0,5,5
318443,Arteriosclerotic vascular disease,racial,American Indian or Alaska Native ,5,0,5
443877,Nonvenomous insect bite of shoulder without infection,racial,White,3,2,5
437058,Sunburn,ethnic,Not Hispanic or Latino,2,3,5
440372,Acquired thrombocytopenia,racial,Unknown,0,5,5
77395,Current tear of semilunar cartilage,racial,Black or African American ,2,3,5
81151,Sprain of ankle joint,racial,Filipino,4,1,5
312998,Pain in thoracic spine,racial,Native Hawaiian or Other Pacific Islander ,0,5,5
193250,Gastric hemorrhage,ethnic,Hispanic or Latino,2,3,5
444070,Tachycardia,racial,Black or African American ,2,3,5
133028,Scalp injuries due to birth trauma,ethnic,Hispanic or Latino,1,5,6
441085,Elderly primip,racial,Unknown,5,0,5
439989,Insulin adverse reaction,racial,White,2,4,6
439251,"Bipolar affective disorder, currently depressed, in full remission",ethnic,Not Hispanic or Latino,2,3,5
373748,Grand mal status,ethnic,Hispanic or Latino,2,4,6
373189,Encephalomyelitis,racial,White,2,4,6
439791,Emotional upset,ethnic,Not Hispanic or Latino,4,2,6
381864,Subjective tinnitus,racial,Unknown,5,1,6
433822,Complication related to pregnancy,racial,Unknown,5,0,5
438134,Excessive sleep,ethnic,Not Hispanic or Latino,2,3,5
373151,Primary malignant neoplasm of conjunctiva (primary),racial,White,0,5,5
257581,Exacerbation of asthma,racial,Native Hawaiian or Other Pacific Islander ,4,1,5
4239721,Seafood allergy,racial,Asian,1,4,5
443570,Cervicovaginal cytology: Low grade squamous intraepithelial lesion,racial,American Indian or Alaska Native ,5,0,5
77960,Joint observation,ethnic,Not Hispanic or Latino,4,1,5
75954,Sprain of interphalangeal joint of finger,ethnic,Hispanic or Latino,4,2,6
132834,White piedra,ethnic,Hispanic or Latino,3,2,5
440387,Cannabis dependence,ethnic,Hispanic or Latino,1,5,6
375283,Angular blepharoconjunctivitis,ethnic,Hispanic or Latino,5,1,6
442794,Poisoning by wasp sting,ethnic,Not Hispanic or Latino,5,1,6
78586,Sprain of interphalangeal joint of toe,ethnic,Hispanic or Latino,2,3,5
4147497,Nervous system and sense organ diseases,racial,Black or African American ,4,1,5
138525,Pain in limb,racial,American Indian,3,2,5
436091,BM - Bacterial meningitis,ethnic,Hispanic or Latino,4,1,5
435642,Disturbance in speech,ethnic,Hispanic or Latino,0,5,5
4171434,Immunization refused,racial,Other Race,4,1,5
381281,Degenerative progressive high myopia,ethnic,Hispanic or Latino,2,3,5
199744,Carcinoma liver and/or biliary system,racial,Asian,0,5,5
441701,Sprain of hip joint,racial,Other Race,3,2,5
192671,GI - Gastrointestinal haemorrhage,racial,Native Hawaiian or Other Pacific Islander ,0,5,5
436278,Superficial bruising of thigh,ethnic,Not Hispanic or Latino,2,4,6
375519,Alcohol withdrawal syndrome,ethnic,Not Hispanic or Latino,1,5,6
201131,Pelvic mass,racial,Asian,5,0,5
200219,Abdominal pain,racial,Native Hawaiian or Other Pacific Islander ,5,0,5
197607,Polymenorrhagia,racial,Asian,5,0,5
441417,Lack of coordination,racial,Unknown,5,0,5
4064382,Skin disease screening,racial,White,3,2,5
4263325,Actinic cheilitis,ethnic,Not Hispanic or Latino,5,1,6
439035,Otosclerosis,ethnic,Hispanic or Latino,4,2,6
192964,Renal infection,ethnic,Hispanic or Latino,5,1,6
196151,Functional disorder of intestine,ethnic,Hispanic or Latino,2,3,5
75670,Sprain pelvic ligament,ethnic,Not Hispanic or Latino,5,1,6
4014230,Ankle sprain NOS,ethnic,Not Hispanic or Latino,5,1,6
134441,Chronic ulcer of skin,racial,Asian,0,5,5
444125,Satisfactory for evaluation but limited by absence of an endocervical/transformation zone component from a patient with a cervix,ethnic,Hispanic or Latino,5,0,5
75897,Polyarthropathy,racial,Other Race,5,0,5
200144,Unilateral simple femoral hernia,racial,Unknown,5,0,5
440751,Peritonsillar abscess,ethnic,Not Hispanic or Latino,1,4,5
312950,IgE-mediated allergic asthma,racial,American Indian or Alaska Native ,4,1,5
198700,Liver secondary cancer,racial,Unknown,1,4,5
443295,Maternal care for diminished foetal movements,racial,White,5,0,5
4005933,Urethral meatus underneath penis,racial,Unknown,0,5,5
434615,Cystic fibrosis without meconium ileus,racial,White,0,5,5
435082,Closed fracture nasal bone,ethnic,Not Hispanic or Latino,2,3,5
434323,Disorder of sulphur-bearing amino acid metabolism,racial,White,1,4,5
201595,Thrombosed internal hemorrhoids,ethnic,Hispanic or Latino,2,3,5
441177,Second degree burn of upper limb,ethnic,Hispanic or Latino,3,2,5
4115062,Other internal knee derangement NOS,ethnic,Not Hispanic or Latino,4,1,5
4170384,Hydatidiform mole,racial,White,5,0,5
436941,Hypervitaminosis A,ethnic,Hispanic or Latino,2,3,5
432447,Atypical glandular cells on cervical Papanicolaou smear,racial,Asian,5,0,5
432768,Corneal foreign body,ethnic,Hispanic or Latino,2,2,4
193552,Furuncle of skin AND/OR subcutaneous tissue,racial,Black or African American ,3,2,5
80593,Urinary complication,racial,White,4,1,5
4025993,Ligation of gastric varices,racial,Unknown,5,0,5
4305841,Periodic limb movement disorder,ethnic,Hispanic or Latino,4,1,5
23731,Benign tumour of larynx,racial,White,4,1,5
201907,Oedema of male genital organs,racial,Unknown,0,5,5
320835,TOF - Tetralogy of Fallot,racial,Asian,0,5,5
438555,Cyanosis,ethnic,Not Hispanic or Latino,5,0,5
4004151,Small intestine atresia and stenosis,ethnic,Hispanic or Latino,2,2,4
372894,central serous retinopathy,ethnic,Not Hispanic or Latino,4,1,5
74719,Foot ulcer,racial,Black or African American ,1,4,5
438208,Atrophy of vulva,racial,White,5,0,5
27321,Persistent vomiting,ethnic,Not Hispanic or Latino,2,2,4
31610,Disorder of oesophagus,racial,Unknown,5,0,5
81878,Benign paroxysmal positional vertigo,racial,Black or African American ,2,2,4
318397,Chronic idiopathic thrombocytopenic purpura,racial,Other Race,5,0,5
138844,Foreign body granuloma of muscle,racial,White,0,5,5
374034,Visual disturbance,racial,American Indian or Alaska Native ,3,2,5
76939,Neoplasm of uncertain behaviour of bone and articular cartilage,racial,Unknown,5,0,5
378416,Retinal disorder,ethnic,Not Hispanic or Latino,3,2,5
434376,Acute myocardial infarction of anterior wall,ethnic,Hispanic or Latino,1,4,5
381114,Microcephalus,racial,Black or African American ,1,4,5
136773,Rosacea,racial,Black or African American ,0,5,5
4110787,Other otitis externa,racial,Unknown,4,1,5
440704,Chronic pain syndrome,racial,American Indian or Alaska Native ,0,5,5
193326,Urge incontinence of urine,racial,Black or African American ,4,1,5
432250,Infective disorder,racial,Unknown,4,1,5
444453,Benign tumour of soft tissue of leg,racial,White,2,3,5
134765,General body deterioration,racial,Unknown,0,5,5
440637,Relapsing fever,racial,White,3,2,5
432725,Congenital anomaly of integument,ethnic,Not Hispanic or Latino,4,1,5
432806,Fall from cliff,racial,Other Race,0,5,5
136057,Benign neoplasm of skin of trunk,racial,Unknown,4,1,5
313878,Respiratory symptoms,racial,Filipino,2,2,4
438559,Abnormal vaginal Papanicolaou smear,ethnic,Hispanic or Latino,5,0,5
73301,Synovitis/tenosynovitis - wrist,racial,Black or African American ,5,0,5
78804,Schimmelbusch's disease,racial,Other Race,5,0,5
254761,Cough,racial,American Indian,4,1,5
440519,Premature - weight 1000g-2499g or gestation of 28-37weeks,racial,Other Race,4,1,5
196433,Aneurysm of iliac artery,ethnic,Hispanic or Latino,0,5,5
444429,Herpes simplex infection,racial,Unknown,2,3,5
433595,Interstitial edema,racial,Filipino,4,1,5
195321,Postmenopausal bleeding,racial,Black or African American ,5,0,5
321318,Angina,racial,Native Hawaiian or Other Pacific Islander ,0,5,5
256449,Bronchiectasis,racial,Unknown,5,0,5
73290,Contracture of joint,ethnic,Hispanic or Latino,1,4,5
4100367,Simple schizophrenia NOS,ethnic,Not Hispanic or Latino,5,0,5
75941,Closed fracture of one rib,racial,Unknown,4,1,5
133141,Tinea pedis,racial,Native Hawaiian or Other Pacific Islander ,1,4,5
75344,Intervertebral disc disorder,racial,Unknown,5,0,5
73560,Calcaneal spur,racial,Filipino,3,2,5
140884,Blister of hand without infection,racial,White,1,4,5
138582,"Closed fracture scapula, acromion",ethnic,Hispanic or Latino,3,2,5
139841,Chronic frontal sinusitis,racial,Unknown,4,1,5
433752,Impulse control disorder,racial,Unknown,2,2,4
139757,Malignant melanoma of skin of lower limb,ethnic,Hispanic or Latino,3,2,5
133002,Acute osteomyelitis,racial,Unknown,1,4,5
200391,Peripheral autonomic neuropathy disease EC,racial,Asian,0,5,5
4179332,Parent-child problem,ethnic,Not Hispanic or Latino,4,1,5
434942,Postseptal orbital cellulitis,ethnic,Not Hispanic or Latino,1,4,5
439796,"Nondependent cocaine abuse, continuous",ethnic,Hispanic or Latino,2,3,5
4263748,Recurrent major depression in complete remission,racial,Other Race,5,0,5
441277,Mixed receptive-expressive language disorder,racial,White,0,5,5
75406,Crush injury of finger,racial,Unknown,3,2,5
377270,Hereditary retinal dystrophy,ethnic,Hispanic or Latino,5,0,5
314659,Arteritis,racial,White,3,2,5
313005,Congenital stenosis of pulmonary valve,racial,White,2,2,4
197044,Female infertility associated with anovulation,ethnic,Not Hispanic or Latino,5,0,5
434019,"Nondependent cannabis abuse, continuous",ethnic,Hispanic or Latino,3,2,5
193249,Acute erosive gastritis,racial,Unknown,4,1,5
440916,Burn to wrist/hand - blister,racial,White,5,0,5
4105330,Chronic undifferentiated schizophrenia,racial,Other Race,0,5,5
140884,Blister of hand without infection,ethnic,Hispanic or Latino,1,4,5
434944,Scleritis,racial,White,4,1,5
439770,Ketoacidosis in type I diabetes mellitus,ethnic,Not Hispanic or Latino,0,5,5
373179,Senile degeneration of brain,ethnic,Hispanic or Latino,0,5,5
40483107,Inflamed seborrheic keratosis,racial,White,4,1,5
134398,Periodontal disease,ethnic,Not Hispanic or Latino,1,4,5
4005743,Female sterility,racial,Unknown,5,0,5
381592,Chronic mucoid otitis media,racial,Unknown,2,3,5
374919,Disseminated sclerosis,racial,Other Race,5,0,5
441246,Hemangioma of intracranial structure,ethnic,Hispanic or Latino,4,1,5
76550,Sprain of metatarsophalangeal joint,racial,White,2,3,5
437995,Closed ill-defined fractures of upper limb,racial,White,1,4,5
378679,Acute poliomyelitis,ethnic,Hispanic or Latino,2,2,4
4137127,Transplantation of heart,racial,White,5,0,5
437992,Abnormal results of kidney function studies,racial,Black or African American ,2,3,5
133637,Second degree burn of lower limb,ethnic,Hispanic or Latino,4,1,5
432306,Gender identity disorder of adolescence,ethnic,Not Hispanic or Latino,5,0,5
136773,Rosacea,racial,American Indian or Alaska Native ,5,0,5
194685,Chronic non-obstructive atrophic pyelonephritis,ethnic,Not Hispanic or Latino,0,5,5
4173498,FH: Heart disorder,racial,Black or African American ,3,2,5
195072,Medullary sponge kidney,racial,American Indian or Alaska Native ,5,0,5
195363,Congenital anomaly of kidney,ethnic,Not Hispanic or Latino,2,2,4
194394,Hernia of anterior abdominal wall with gangrene,ethnic,Hispanic or Latino,4,1,5
4059284,Cirrhosis and chronic liver disease,racial,White,4,1,5
134074,Oral soft tissue cellulitis,racial,Black or African American ,1,4,5
4345458,Staphylococcal toxic shock syndrome,ethnic,Hispanic or Latino,5,0,5
4104555,Other and unspecified conjunctivitis,ethnic,Hispanic or Latino,2,2,4
313023,Neonatal chronic respiratory disease,racial,Unknown,0,5,5
77387,Closed fracture of vertebral column with spinal cord injury,ethnic,Hispanic or Latino,0,5,5
315286,Chronic ischemic heart disease,ethnic,Not Hispanic or Latino,0,5,5
437264,Tobacco dependence syndrome,racial,Asian Indian,0,5,5
195240,Monoplegia of lower limb,racial,Unknown,0,5,5
81937,Traumatic arthropathy of the hand,racial,White,5,0,5
197494,Viral hepatitis C,racial,Asian,1,4,5
376116,Central loss of vision,racial,White,0,5,5
438129,"Severe manic bipolar I disorder with psychotic features, mood-congruent",ethnic,Not Hispanic or Latino,1,4,5
78232,Shoulder joint pain,racial,Native Hawaiian or Other Pacific Islander ,4,1,5
314131,Degeneration of cervical intervertebral disc,racial,Other Race,4,1,5
4107528,Lermoyez syndrome,racial,Unknown,5,0,5
440358,Lipoma,racial,Other Race,0,5,5
437832,Malnutrition of mild degree (Gomez: 75% to less than 90% of standard weight),racial,Unknown,3,2,5
4085922,Infection screening,ethnic,Not Hispanic or Latino,2,2,4
441838,Personality disorder,ethnic,Not Hispanic or Latino,4,1,5
135930,Musculoskeletal system observation,racial,Unknown,4,1,5
4230642,Acquired deformity of chest,ethnic,Not Hispanic or Latino,4,1,5
193517,Bile duct calculus with no mention of cholecystitis and with obstruction,ethnic,Hispanic or Latino,1,4,5
376113,Recent subtotal retinal detachment,ethnic,Hispanic or Latino,2,3,5
4109274,Stenosis and insufficiency of lacrimal passages NOS,ethnic,Hispanic or Latino,5,0,5
81660,Cervicocranial syndrome,racial,White,5,0,5
31602,Disease of the larynx,racial,White,3,2,5
255348,Polymyalgia rheumatica,racial,Black or African American ,5,0,5
435666,Closed fracture of upper end of tibia,racial,Unknown,1,4,5
436298,Adverse reaction to food,racial,Asian,1,4,5
4055337,Gallbladder calculus without mention of cholecystitis,racial,Unknown,1,4,5
139188,Open wound of scalp without complication,ethnic,Not Hispanic or Latino,1,4,5
140486,Ulcer of calf,ethnic,Not Hispanic or Latino,0,5,5
199076,Fallopian tube pregnancy,ethnic,Hispanic or Latino,5,0,5
379020,Entropion,racial,White,0,5,5
141499,Septicemia,racial,White,2,3,5
436233,Delayed milestone,racial,Black or African American ,1,4,5
433556,Derangement of posterior horn of lateral meniscus,racial,White,5,0,5
138790,Chronic periodontitis,racial,White,2,2,4
316501,Disorder of blood vessels affecting skin,racial,White,2,2,4
201111,Congenital renal dysplasia,racial,Other Race,2,2,4
375249,Traction detachment of retina,racial,White,2,3,5
441712,Open wound of ocular adnexa,ethnic,Hispanic or Latino,1,4,5
4146235,Other cellulitis and abscess,racial,White,1,4,5
435088,Senility,racial,Unknown,3,2,5
75337,Cellulitis and abscess of buttock,racial,Black or African American ,2,3,5
374912,Leukodystrophy,ethnic,Hispanic or Latino,4,1,5
4091319,Streptococcal sore throat with scarlatina NOS,racial,White,2,3,5
256215,"Lung agenesis, hypoplasia and dysplasia",racial,White,0,5,5
253549,Connective tissue disease,ethnic,Hispanic or Latino,5,0,5
199839,External haemorrhoids without complication,racial,Black or African American ,2,2,4
437899,Acute and subacute bacterial endocarditis,racial,White,4,1,5
78605,Superficial bruising of elbow,ethnic,Not Hispanic or Latino,2,3,5
377270,Hereditary retinal dystrophy,racial,Unknown,5,0,5
138278,Sprains and strains of joints and adjacent muscles,racial,American Indian or Alaska Native ,2,3,5
75426,Burn of hand,ethnic,Hispanic or Latino,2,3,5
137856,Atypical facial pain,racial,White,2,3,5
24134,Nonspecific pain in the neck region,racial,American Indian or Alaska Native ,2,2,4
132393,Pressure ulcer stage 1,ethnic,Not Hispanic or Latino,2,3,5
435956,Closed fracture of base of neck of femur,racial,Unknown,5,0,5
199062,"Acute gastric ulcer without hemorrhage, without perforation AND without obstruction",racial,Unknown,3,2,5
132706,Nail disease,racial,American Indian or Alaska Native ,5,0,5
81539,Mitochondrial disease,racial,Unknown,0,5,5
193782,End stage renal disease,racial,Filipino,0,5,5
81099,Pyogenic arthritis of shoulder region,ethnic,Hispanic or Latino,5,0,5
432454,Excessive thirst,racial,Unknown,1,4,5
433599,Abnormal biochemistry finding,racial,Asian,4,1,5
4263370,R.I.N.D. syndrome,racial,American Indian or Alaska Native ,0,5,5
375260,Polyneuropathy in collagen vascular disease,racial,Unknown,5,0,5
132659,Acute apical periodontitis,racial,Asian,2,2,4
138841,Disorder of sacrum,ethnic,Not Hispanic or Latino,4,1,5
434016,"Nondependent opioid abuse, continuous",racial,Black or African American ,0,5,5
440382,LD - Learning difficulties,racial,Black or African American ,2,2,4
198700,Liver secondary cancer,racial,Asian,0,5,5
80504,Acquired genu valgum,ethnic,Not Hispanic or Latino,4,1,5
378742,Blind hypotensive eye,racial,Unknown,5,0,5
138713,Disease of parathyroid glands,racial,White,2,3,5
192286,Intestinal disaccharidase deficiency,racial,Asian,1,4,5
136496,Cellulitis and abscess of face,racial,Asian,0,5,5
377539,Syringomyelia and syringobulbia,ethnic,Not Hispanic or Latino,4,1,5
442068,Cellulitis and abscess of forearm,racial,Black or African American ,2,2,4
319927,Heart sounds abnormal,ethnic,Hispanic or Latino,2,2,4
199860,Hernia of abdominal cavity,racial,Black or African American ,1,4,5
195312,Functional voiding disorder,racial,Other Race,2,3,5
133727,Thyrotoxicosis without goiter OR other cause,racial,Black or African American ,5,0,5
74725,Displacement of cervical intervertebral disc without myelopathy,racial,Native Hawaiian or Other Pacific Islander ,5,0,5
373127,Herpes simplex disciform keratitis,ethnic,Hispanic or Latino,5,0,5
4143966,Essential hypertension NOS,racial,American Indian or Alaska Native ,0,5,5
132740,Positive skin test reaction,racial,American Indian or Alaska Native ,4,1,5
23731,Benign tumour of larynx,ethnic,Hispanic or Latino,4,1,5
4345578,Rhabdomyolysis,racial,White,2,2,4
80874,Open wound of multiple sites of one upper limb without complication,racial,Unknown,1,4,5
313867,Double outlet right ventricle,racial,White,2,3,5
24230,Laryngeal FB - foreign body,ethnic,Hispanic or Latino,0,5,5
443554,Congenital abnormality of lacrimal drainage system,ethnic,Hispanic or Latino,1,4,5
4025993,Ligation of gastric varices,ethnic,Hispanic or Latino,5,0,5
442425,Lumbar post-laminectomy syndrome,racial,American Indian or Alaska Native ,0,5,5
381575,Disorder of external ear,racial,White,1,4,5
442588,OSA - Obstructive sleep apnoea,racial,American Indian or Alaska Native ,5,0,5
200757,Abscess of peritoneum,ethnic,Hispanic or Latino,4,1,5
442565,Gestational edema without hypertension,racial,Filipino,5,0,5
433178,Anxiety disorder of childhood OR adolescence,ethnic,Hispanic or Latino,2,3,5
195977,Contusion of trunk,ethnic,Not Hispanic or Latino,4,1,5
376116,Central loss of vision,racial,Unknown,1,4,5
437167,Accident caused by firearm missile,ethnic,Hispanic or Latino,2,3,5
435226,"Bipolar affective disorder, current episode mixed",ethnic,Not Hispanic or Latino,0,5,5
434298,Metastasis to upper limb lymph node,racial,White,5,0,5
4062636,Bacterial disease screening,racial,Black or African American ,5,0,5
4016675,"Sprain, ankle joint, medial",racial,Unknown,2,2,4
316139,HF - Heart failure,racial,Asian,1,4,5
314958,Benign secondary hypertension,ethnic,Hispanic or Latino,2,3,5
443274,Psychostimulant dependence,ethnic,Hispanic or Latino,1,4,5
74777,Closed fracture of astragalus,racial,White,2,3,5
372635,Corneal degeneration,ethnic,Hispanic or Latino,3,2,5
4058247,Anaemia during pregnancy/childbirth/puerperium NOS,racial,Unknown,5,0,5
441737,Bruising,racial,American Indian or Alaska Native ,4,1,5
4218874,Scimitar syndrome,racial,White,1,4,5
73036,Closed fracture of olecranon process of ulna,racial,White,2,3,5
440021,Herpes simplex without complication,racial,Black or African American ,3,2,5
139110,Intervertebral disc disorder of thoracic region with myelopathy,ethnic,Hispanic or Latino,4,1,5
260134,Croup,racial,Other Race,2,2,4
195363,Congenital anomaly of kidney,racial,Unknown,4,1,5
4326601,Anorectal abscess,racial,Asian,4,1,5
194394,Hernia of anterior abdominal wall with gangrene,racial,Unknown,4,1,5
379820,No colour perception,racial,White,3,2,5
438242,Talipes equinovarus,ethnic,Hispanic or Latino,1,4,5
259055,Extrinsic asthma with asthma attack,racial,Filipino,2,3,5
380403,External hordeolum,racial,Other Race,2,3,5
438867,Generalized body aches,racial,Black or African American ,3,2,5
312940,Acute-on-chronic respiratory failure,ethnic,Hispanic or Latino,2,2,4
377845,Anoxic encephalopathy,ethnic,Not Hispanic or Latino,3,2,5
432582,Neoplastic disease of uncertain behavior,racial,Unknown,3,2,5
199151,Must strain to pass urine,ethnic,Not Hispanic or Latino,0,5,5
438469,"Duodenal ulcer without hemorrhage, without perforation AND without obstruction",ethnic,Not Hispanic or Latino,5,0,5
133295,Inflammatory spondylopathy,ethnic,Hispanic or Latino,2,3,5
77670,Chest pain,racial,Native Hawaiian or Other Pacific Islander ,2,3,5
437186,Hypothermia - accidental,ethnic,Hispanic or Latino,1,4,5
438155,Optic disc glaucomatous atrophy,racial,Unknown,2,2,4
439708,Disorders of initiating and maintaining sleep,racial,Filipino,0,5,5
4296024,Family disruption due to divorce,racial,White,1,4,5
40490434,Abnormal arterial blood gas,racial,White,2,3,5
437995,Closed ill-defined fractures of upper limb,ethnic,Not Hispanic or Latino,0,5,5
81723,Contusion of hand,racial,Other Race,3,2,5
199764,Benign ovarian tumour,racial,White,5,0,5
4107528,Lermoyez syndrome,racial,White,5,0,5
444438,Leucoplakia of tongue,racial,White,2,3,5
192372,Placenta praevia without haemorrhage - not delivered,racial,Unknown,5,0,5
197444,Vascular complication of medical care,racial,White,3,2,5
28060,Strept throat,racial,American Indian or Alaska Native ,2,3,5
433656,Abnormal patient reaction,racial,White,4,1,5
440548,Closed fracture of lower end of femur,racial,White,3,2,5
377556,Sudden visual loss,ethnic,Hispanic or Latino,2,2,4
133013,Congenital spinal cord anomaly,ethnic,Hispanic or Latino,1,4,5
437116,Closed fracture of distal end of radius,ethnic,Not Hispanic or Latino,2,2,4
195213,Aldosteronism,racial,Unknown,0,5,5
443883,Acute disease,ethnic,Not Hispanic or Latino,3,2,5
316447,Chronic hypotension,ethnic,Hispanic or Latino,4,1,5
141499,Septicemia,racial,Unknown,4,1,5
4176874,Infantile melanodontia,racial,Black or African American ,0,5,5
4223530,Spondylitis,ethnic,Hispanic or Latino,1,4,5
440129,Hypertrophy of nasal turbinates,racial,Unknown,2,2,4
4112954,Unspecified spontaneous abortion without mention of complication,racial,White,5,0,5
81660,Cervicocranial syndrome,ethnic,Hispanic or Latino,5,0,5
436263,Broken tooth without complication,ethnic,Not Hispanic or Latino,3,2,5
4140107,Double anastomosis of mammary arteries to coronary arteries,ethnic,Hispanic or Latino,5,0,5
320420,Vitreous degeneration,racial,Asian,4,1,5
377853,Chronic tension-type headache,ethnic,Not Hispanic or Latino,3,2,5
436366,Benign tumour of testis,racial,White,0,5,5
375260,Polyneuropathy in collagen vascular disease,racial,White,5,0,5
440053,Infestation by insect,racial,White,4,1,5
136496,Cellulitis and abscess of face,racial,Other Race,2,2,4
436940,Insulin resistance syndrome,racial,Other Race,2,3,5
4025514,Unspecified peptic ulcer,racial,Asian,0,5,5
440973,Benign neoplasm of long bones of lower limb,ethnic,Not Hispanic or Latino,5,0,5
141095,Acne,racial,American Indian or Alaska Native ,2,3,5
4101609,Ebstein anomaly of right atrioventricular valve,racial,White,5,0,5
439918,Poliomyelitis osteopathy of the ankle and/or foot,ethnic,Hispanic or Latino,2,2,4
4288676,Acute and chronic cholecystitis,racial,Unknown,5,0,5
376337,Disease of nervous system,ethnic,Not Hispanic or Latino,1,4,5
195864,Diverticulum of bladder,racial,Unknown,4,1,5
201352,Cholelithiasis AND acute cholecystitis with obstruction,racial,White,2,3,5
256451,Bronchitis,racial,Filipino,2,2,4
313011,Congenital abnormality of cardiac position,racial,White,0,5,5
437116,Closed fracture of distal end of radius,racial,Unknown,2,2,4
438725,Disorder of magnesium metabolism,ethnic,Not Hispanic or Latino,3,2,5
313590,Perinatal respiratory failure,racial,White,2,3,5
440465,Postpartum state,racial,Black or African American ,5,0,5
374371,Stenosis of precerebral artery,racial,White,5,0,5
435570,Pulp and periapical tissue disease,ethnic,Hispanic or Latino,3,2,5
4305303,Sleep deprivation,racial,White,3,2,5
4024000,Urinary system finding,racial,Unknown,1,4,5
201817,Benign tumour of female genital organs,ethnic,Hispanic or Latino,5,0,5
138379,"Chronic lymphoid leukemia, disease",racial,Other Race,0,5,5
434153,Chromosomopathy,racial,Unknown,4,1,5
4064381,Nephropathy screening,racial,Other Race,1,4,5
316226,Complete TGA,ethnic,Hispanic or Latino,2,2,4
80809,Rheumatoid arthritis,racial,American Indian or Alaska Native ,5,0,5
196625,Viral hepatitis A without hepatic coma,racial,Unknown,4,1,5
376121,Recurrent pterygium,racial,White,3,2,5
133299,Swelling of limb,racial,Black or African American ,2,3,5
436988,Enophthalmos due to atrophy of orbital tissue,racial,Unknown,5,0,5
40484010,Unilateral conductive hearing loss,ethnic,Hispanic or Latino,1,4,5
372604,Movement disorder,racial,White,4,1,5
194992,Coeliac disease,ethnic,Hispanic or Latino,2,3,5
26662,Testicular hypofunction,racial,Asian,0,5,5
72715,Exostosis,racial,Black or African American ,5,0,5
198678,Intestinal infectious disease,racial,Asian,4,1,5
313989,Chronic lymphadenitis,ethnic,Not Hispanic or Latino,4,1,5
372765,Open wound of head without complication,ethnic,Not Hispanic or Latino,1,4,5
436254,Closed fractures of multiple bones of lower limb,racial,White,3,2,5
4140107,Double anastomosis of mammary arteries to coronary arteries,racial,Unknown,5,0,5
4144997,Osteoarthritis NOS,ethnic,Not Hispanic or Latino,2,2,4
4346969,Joint mice in knee,racial,White,4,1,5
137054,Skin striae,racial,White,1,4,5
139057,Disease of oral soft tissues,racial,Black or African American ,2,2,4
201603,Disease of teeth AND/OR supporting structures,racial,Native Hawaiian or Other Pacific Islander ,4,1,5
4004151,Small intestine atresia and stenosis,racial,White,2,2,4
4218764,Gastroschisis,racial,White,1,4,5
256451,Bronchitis,racial,Native Hawaiian or Other Pacific Islander ,3,2,5
4109274,Stenosis and insufficiency of lacrimal passages NOS,racial,Unknown,5,0,5
4064918,Diabetes mellitus screening,racial,Asian Indian,1,4,5
4096347,Gouty arthropathy,racial,Native Hawaiian or Other Pacific Islander ,4,1,5
435459,Staphylococcal infectious disease,ethnic,Hispanic or Latino,2,2,4
134324,Lipodystrophy,ethnic,Not Hispanic or Latino,1,4,5
40481091,Partial edentulism,ethnic,Hispanic or Latino,1,4,5
444287,Carbuncle of neck,racial,Unknown,1,4,5
313504,Osler hemorrhagic telangiectasia syndrome,ethnic,Hispanic or Latino,5,0,5
138713,Disease of parathyroid glands,ethnic,Hispanic or Latino,4,1,5
4064206,O/E - tuning fork testing,ethnic,Hispanic or Latino,4,1,5
377291,"Peripheral pterygium, progressive",racial,White,1,4,5
134074,Oral soft tissue cellulitis,racial,Unknown,4,1,5
4002644,Rotator cuff shoulder syndrome and allied disorders,racial,Other Race,0,5,5
141370,Toxic erythema,ethnic,Hispanic or Latino,4,1,5
315830,Variant angina,racial,White,5,0,5
381551,Drug-related polyneuropathy,racial,Unknown,0,5,5
312337,Arterial embolic and thrombotic occlusion,racial,Unknown,5,0,5
442119,Adhesions of temporomandibular joint,racial,White,2,2,4
435789,Megaloblastic anemia,racial,Unknown,3,2,5
80824,Senile osteoporosis,racial,Black or African American ,5,0,5
77129,Closed fracture of pelvis,racial,White,4,1,5
436155,Redundant prepuce and phimosis,racial,Asian,0,5,5
376552,Cerebral laceration and contusion,racial,White,2,2,4
441840,Clinical finding,racial,Black or African American ,1,4,5
138389,Benign neoplasm of scalp and skin of neck,ethnic,Not Hispanic or Latino,2,2,4
374923,Bell palsy,racial,Asian,0,5,5
378144,Disease of basal ganglia,racial,White,4,1,5
443554,Congenital abnormality of lacrimal drainage system,racial,White,1,4,5
441155,Closed trimalleolar fracture,racial,Unknown,4,1,5
134460,Plantar fascial fibromatosis,racial,American Indian or Alaska Native ,1,4,5
4143966,Essential hypertension NOS,ethnic,Not Hispanic or Latino,0,5,5
434615,Cystic fibrosis without meconium ileus,ethnic,Hispanic or Latino,1,4,5
318566,Flushing,ethnic,Not Hispanic or Latino,4,1,5
254163,Pulmonary aspiration of gastric contents,ethnic,Not Hispanic or Latino,0,5,5
378256,Abnormal reflex,racial,White,2,2,4
436249,Closed fracture of femoral condyle of femur,racial,White,1,4,5
4213085,Family history of prostate cancer,racial,Unknown,0,5,5
4179214,Family history of malignant neoplasm of gastrointestinal tract,racial,Asian,5,0,5
444219,Osteitis deformans without bone tumor,ethnic,Hispanic or Latino,4,1,5
438242,Talipes equinovarus,racial,Asian,0,5,5
440039,Specific viral infections,ethnic,Hispanic or Latino,4,1,5
432870,Thrombocytopenia,racial,American Indian or Alaska Native ,3,2,5
321638,"Benign essential hypertension complicating pregnancy, childbirth and the puerperium",ethnic,Hispanic or Latino,5,0,5
4112816,Other respiratory system diseases,racial,Unknown,3,2,5
76790,Familial ligamentous laxity,ethnic,Hispanic or Latino,2,2,4
136495,Lichenification and lichen simplex chronicus,racial,Unknown,2,3,5
196724,Disease of diaphragm,ethnic,Hispanic or Latino,3,2,5
382034,Injury of sciatic nerve,ethnic,Hispanic or Latino,4,1,5
4013457,"Closed fracture of proximal humerus, unspecified part",racial,White,2,2,4
441039,Phlebitis of lower limb vein,racial,White,4,1,5
442167,Neoplasm of uncertain behaviour of craniopharyngeal duct,racial,White,2,3,5
257012,Chronic rhinosinusitis,racial,American Indian,4,1,5
437221,Chlamydia trachomatis infection,ethnic,Not Hispanic or Latino,5,0,5
197145,Open wound of pelvic region without complication,racial,White,5,0,5
4152053,Amfetamine or other psychostimulant dependence,ethnic,Hispanic or Latino,5,0,5
434063,Jaw to cranial base anomaly,ethnic,Hispanic or Latino,5,0,5
318443,Arteriosclerotic vascular disease,racial,White,2,3,5
380702,Cerebral cysts,ethnic,Not Hispanic or Latino,0,5,5
134743,Congenital ichthyosis of skin,ethnic,Not Hispanic or Latino,4,1,5
440230,Closed fracture of anatomical neck of humerus,ethnic,Hispanic or Latino,4,1,5
138379,"Chronic lymphoid leukemia, disease",racial,Unknown,3,2,5
434019,"Nondependent cannabis abuse, continuous",racial,White,2,2,4
137977,Icteric,racial,Other Race,4,1,5
432545,Bacterial disease,racial,Other Race,5,0,5
374221,Injury of brachial plexus,racial,White,3,2,5
435532,Episodic chronic alcoholism,racial,White,0,5,5
379832,Mixed conductive and sensorineural deafness,ethnic,Not Hispanic or Latino,2,2,4
4149382,Endocrine/metabolic screening,ethnic,Not Hispanic or Latino,4,1,5
435993,Foreign body in conjunctival sac,racial,White,1,4,5
433885,Closed supracondylar fracture of humerus,ethnic,Not Hispanic or Latino,2,2,4
435850,Cyst of jaw,ethnic,Hispanic or Latino,4,1,5
137627,Prickly heat,ethnic,Not Hispanic or Latino,3,2,5
375551,Blepharochalasis,ethnic,Hispanic or Latino,5,0,5
4182210,Dementia,racial,White,5,0,5
438244,Congenital hydrocephalus,racial,Black or African American ,1,4,5
441277,Mixed receptive-expressive language disorder,ethnic,Hispanic or Latino,0,5,5
78771,Labyrinthine dysfunction,ethnic,Hispanic or Latino,2,2,4
443458,Closed fracture of facial bone,ethnic,Hispanic or Latino,3,2,5
132706,Nail disease,racial,Other Race,2,3,5
257583,Allergic bronchopulmonary aspergillosis,racial,White,0,5,5
4104561,Ptosis of eyelid NOS,racial,White,4,1,5
376399,Incipient cataract,racial,White,2,2,4
437579,Paroxysmal ventricular tachycardia,racial,White,2,2,4
4064382,Skin disease screening,ethnic,Hispanic or Latino,2,2,4
4109253,Pterygium NOS,racial,White,1,4,5
4113650,Noninflammatory cervical disorder,racial,White,5,0,5
4137127,Transplantation of heart,ethnic,Hispanic or Latino,5,0,5
320827,Atresia and stenosis of aorta,racial,Unknown,5,0,5
436204,Subcutaneous hematoma,ethnic,Hispanic or Latino,3,2,5
315832,Angina decubitus,racial,Unknown,4,1,5
444384,Nonvenomous insect bite of leg with infection,ethnic,Hispanic or Latino,1,4,5
195213,Aldosteronism,ethnic,Not Hispanic or Latino,0,5,5
435534,"Nondependent alcohol abuse, continuous",racial,Other Race,0,5,5
381581,Chalazion,racial,Other Race,1,4,5
318459,Respiratory insufficiency,racial,Unknown,3,2,5
134144,Cleft palate with cleft lip,racial,Asian,5,0,5
4094448,Pregnancy test negative,racial,Other Race,5,0,5
4194895,Screening for disorder,racial,Asian,1,4,5
40480431,Speech and language developmental delay due to hearing loss,racial,Unknown,2,2,4
81670,Congenital anomaly of spine,racial,Unknown,0,5,5
136184,Pruritic disorder,racial,Black or African American ,3,2,5
261774,"Respiratory tuberculosis, not confirmed bacteriologically or histologically",racial,White,1,4,5
4059284,Cirrhosis and chronic liver disease,ethnic,Hispanic or Latino,4,1,5
378523,Residual foreign body in soft tissue,racial,Unknown,1,4,5
436551,Closed fracture trapezoid,racial,Other Race,5,0,5
440392,Retinal vascular occlusion,racial,White,4,1,5
438242,Talipes equinovarus,ethnic,Not Hispanic or Latino,0,5,5
443783,Chronic disease,racial,Native Hawaiian or Other Pacific Islander ,1,4,5
432598,Subchronic schizophrenia with acute exacerbations,ethnic,Hispanic or Latino,5,0,5
4102348,Common migraine NOS,ethnic,Hispanic or Latino,4,1,5
4340380,Hepatitis C carrier,racial,Other Race,1,4,5
78232,Shoulder joint pain,racial,Asian Indian,1,4,5
441126,Monosomy and deletion from autosome,racial,Asian,5,0,5
134312,Iatrogenic hypothyroidism,racial,Unknown,4,1,5
72418,Scoliosis deformity of spine,racial,American Indian or Alaska Native ,5,0,5
193422,Primary malignant neoplasm of body of stomach,racial,White,1,4,5
198802,Occlusion of ureter,ethnic,Hispanic or Latino,5,0,5
74135,Disorder of synovium,ethnic,Not Hispanic or Latino,4,1,5
256531,Head and neck swelling,racial,Native Hawaiian or Other Pacific Islander ,1,4,5
441482,Administrative reason for encounter,racial,Other Race,1,4,5
4051119,FH: Osteoporosis,ethnic,Hispanic or Latino,5,0,5
374009,Organic mental disorder,ethnic,Not Hispanic or Latino,3,2,5
4091319,Streptococcal sore throat with scarlatina NOS,ethnic,Hispanic or Latino,2,3,5
372907,Macular scar,racial,White,0,5,5
440155,Postartificial menopausal syndrome,ethnic,Not Hispanic or Latino,4,1,5
260123,Acute inflammation of sinus,racial,American Indian,3,2,5
440228,Closed fracture of lower end of humerus,ethnic,Not Hispanic or Latino,4,1,5
376564,Superficial injury of eye,racial,White,4,1,5
135852,Teething syndrome,racial,Asian,0,5,5
435613,Cellulitis,racial,Asian,2,3,5
133228,Dental caries,racial,American Indian or Alaska Native ,2,3,5
193795,Acute gastric ulcer with hemorrhage but without obstruction,racial,White,1,4,5
440653,Infection by toxoplasma gondii,racial,White,0,5,5
77156,Superficial foreign body of toe without major open wound but with infection,ethnic,Hispanic or Latino,4,1,5
24075,Esophageal stricture and stenosis,racial,Other Race,4,1,5
377889,Hearing loss,racial,American Indian or Alaska Native ,5,0,5
439237,Assault,racial,Unknown,4,1,5
435640,"Gestation period, 25 weeks",ethnic,Not Hispanic or Latino,1,4,5
74472,Congenital deformity of foot,ethnic,Not Hispanic or Latino,1,4,5
257583,Allergic bronchopulmonary aspergillosis,ethnic,Not Hispanic or Latino,0,5,5
201075,Noninflammatory disorder of cervix,racial,White,5,0,5
201817,Benign tumour of female genital organs,racial,White,5,0,5
435380,Closed fracture of radius AND ulna,racial,White,4,1,5
440431,Pneumonia due to Mycoplasma pneumoniae,ethnic,Not Hispanic or Latino,4,1,5
198289,Nonvenomous insect bite of hip without infection,racial,Unknown,5,0,5
433073,Superficial burn of back of hand,ethnic,Hispanic or Latino,4,1,5
140976,Toxic uninodular goiter,ethnic,Hispanic or Latino,4,1,5
433934,Accident caused by needle,ethnic,Hispanic or Latino,4,1,5
440547,Closed fracture of shaft of metacarpal bone,racial,White,3,2,5
196064,Carcinoma in situ of digestive organ,racial,White,2,2,4
79145,Ehlers-Danlos syndrome,racial,White,2,3,5
441737,Bruising,racial,Other Race,4,1,5
76548,Closed dislocation of hip,racial,Unknown,4,1,5
433320,Excessive crying of child,ethnic,Hispanic or Latino,2,2,4
380706,Regular astigmatism,ethnic,Hispanic or Latino,4,1,5
4144149,Cared for by family,ethnic,Hispanic or Latino,2,3,5
436551,Closed fracture trapezoid,ethnic,Hispanic or Latino,5,0,5
197223,Enterobiasis,ethnic,Not Hispanic or Latino,2,2,4
4050091,Open wound of penis,ethnic,Hispanic or Latino,0,5,5
80232,Closed fracture of calcaneus,ethnic,Hispanic or Latino,2,3,5
201072,Benign prostatic hypertrophy without outflow obstruction,ethnic,Not Hispanic or Latino,0,5,5
133810,Secondary hyperparathyroidism of renal origin,racial,Other Race,4,1,5
438546,Congenital anomaly of anterior chamber of eye,racial,Unknown,3,2,5
4170384,Hydatidiform mole,ethnic,Hispanic or Latino,5,0,5
135888,Decubitus ulcer,racial,Unknown,3,2,5
77734,Contusion of lower leg,ethnic,Not Hispanic or Latino,3,2,5
443446,Reflex sympathetic dystrophy of lower extremity,racial,White,4,1,5
435088,Senility,ethnic,Not Hispanic or Latino,1,4,5
73036,Closed fracture of olecranon process of ulna,ethnic,Hispanic or Latino,2,2,4
31602,Disease of the larynx,ethnic,Hispanic or Latino,2,3,5
443617,Conduct disorder,racial,Asian,1,4,5
132659,Acute apical periodontitis,racial,Black or African American ,3,2,5
72995,Joint contracture of hand,ethnic,Not Hispanic or Latino,1,4,5
435796,Dehydration,racial,Black or African American ,1,4,5
75044,"Stiff joint NEC, of the hand",ethnic,Not Hispanic or Latino,2,3,5
196341,Dermatophytosis of the perianal area,racial,Black or African American ,1,4,5
30770,Chronic peptic ulcer with hemorrhage but without obstruction,racial,White,4,1,5
4326681,Family history of malignant neoplasm of ovary,ethnic,Hispanic or Latino,5,0,5
438058,Rape - assault,ethnic,Hispanic or Latino,4,1,5
443556,Primary focal hyperhidrosis,racial,Unknown,4,1,5
374221,Injury of brachial plexus,racial,Unknown,0,5,5
195498,Benign tumour of kidney,racial,White,5,0,5
435151,Physical child abuse,racial,White,0,5,5
4173811,Congenital quadriplegia,racial,Black or African American ,0,5,5
134312,Iatrogenic hypothyroidism,ethnic,Not Hispanic or Latino,4,1,5
313989,Chronic lymphadenitis,ethnic,Hispanic or Latino,1,4,5
135208,Benign tumor of lip,ethnic,Hispanic or Latino,4,1,5
195072,Medullary sponge kidney,ethnic,Not Hispanic or Latino,5,0,5
4296204,First degree burn,racial,Unknown,5,0,5
440387,Cannabis dependence,racial,White,0,5,5
193795,Acute gastric ulcer with hemorrhage but without obstruction,ethnic,Hispanic or Latino,1,4,5
4148407,Family history: Cardiovascular disease,racial,Unknown,4,1,5
438138,Paralytic syndromes,ethnic,Hispanic or Latino,5,0,5
434626,Borderline personality disorder,racial,White,4,1,5
4066163,Ureteric colic,ethnic,Not Hispanic or Latino,4,1,5
4299535,Pregnancy confirmed,racial,Asian,5,0,5
78257,Osteogenesis imperfecta,ethnic,Hispanic or Latino,3,2,5
435131,Victim of neglect,racial,White,1,4,5
79061,Colonic constipation,ethnic,Not Hispanic or Latino,4,1,5
439262,"Single manic episode, severe, with psychosis",ethnic,Hispanic or Latino,0,5,5
4305303,Sleep deprivation,ethnic,Not Hispanic or Latino,3,2,5
138844,Foreign body granuloma of muscle,ethnic,Hispanic or Latino,0,5,5
438872,Hyperphagia,ethnic,Hispanic or Latino,3,2,5
438867,Generalized body aches,racial,American Indian or Alaska Native ,2,2,4
440276,"Infection AND/OR inflammatory reaction due to internal prosthetic device, implant AND/OR graft",racial,Unknown,2,2,4
432806,Fall from cliff,ethnic,Hispanic or Latino,0,5,5
197145,Open wound of pelvic region without complication,ethnic,Not Hispanic or Latino,5,0,5
381854,Disorder of conjunctiva,racial,White,3,2,5
199066,Female digestive-genital tract fistula,racial,White,5,0,5
133711,Overlapping malignant neoplasm of female breast,racial,White,5,0,5
136934,Primary hyperparathyroidism,racial,Other Race,5,0,5
140673,Hypothyroid,racial,Asian Indian,3,2,5
436972,Glaucoma associated with systemic syndromes,racial,American Indian or Alaska Native ,4,1,5
375525,Athetoid cerebral palsy,racial,White,3,2,5
4012297,Closed fracture of one or more phalanges of hand NOS,ethnic,Hispanic or Latino,3,2,5
73026,Abnormal respiratory sounds,ethnic,Not Hispanic or Latino,1,4,5
4171075,Bite of animal,racial,White,2,2,4
438855,Klinefelter's syndrome,ethnic,Hispanic or Latino,0,5,5
192683,Uterovaginal prolapse,racial,Unknown,5,0,5
373503,Intermittent cerebral ischaemia,racial,American Indian or Alaska Native ,5,0,5
436096,Chronic pain,racial,American Indian,0,5,5
4110945,Benign hypertensive heart disease NOS,racial,White,2,3,5
442609,Friction blister without infection,racial,Other Race,2,3,5
80177,Pyogenic arthritis of the pelvic region and thigh,ethnic,Hispanic or Latino,0,5,5
75010,Fibroadenosis of breast,racial,Unknown,5,0,5
193020,Incomplete emptying of bladder,racial,White,3,2,5
197237,Benign tumour of prostate,racial,Black or African American ,0,5,5
134116,Dermatitis due to drug AND/OR medicine taken internally,ethnic,Not Hispanic or Latino,2,2,4
197381,Epigastric pain,racial,Native Hawaiian or Other Pacific Islander ,2,3,5
441840,Clinical finding,racial,Other Race,4,1,5
436118,After-cataract with vision obscured,ethnic,Not Hispanic or Latino,3,2,5
433403,Viral meningitis,racial,White,3,2,5
436373,DSD - Developmental speech disorder,racial,American Indian or Alaska Native ,4,1,5
432621,Purulent endophthalmitis,ethnic,Hispanic or Latino,4,1,5
436667,Stammer,racial,Unknown,0,4,4
4094865,Ca intrahepatic bile ducts,ethnic,Hispanic or Latino,0,4,4
4096204,Disorders of amino acid transport and metabolism,racial,Asian,4,0,4
443754,"Lyell toxic epidermal necrolysis, subepidermal type",ethnic,Hispanic or Latino,0,4,4
78579,Closed fracture of first cervical vertebra,racial,White,4,0,4
261116,Acquired nasal deformity,ethnic,Hispanic or Latino,2,2,4
132740,Positive skin test reaction,racial,Native Hawaiian or Other Pacific Islander ,3,1,4
141508,Dermatophytosis of scalp or beard,racial,Black or African American ,1,3,4
24970,Chronic laryngitis,racial,Unknown,2,2,4
312902,Benign intracranial hypertension,ethnic,Hispanic or Latino,4,0,4
376124,Pinguecula,ethnic,Not Hispanic or Latino,2,2,4
141090,PG - Pyogenic granuloma,racial,Other Race,2,2,4
25780,Lorain - Levi dwarfism,racial,White,1,4,5
4049623,"Moderate major depression, single episode",racial,Black or African American ,1,3,4
4173498,FH: Heart disorder,racial,Other Race,2,2,4
141475,Second degree burn of foot,racial,White,2,2,4
432795,Traumatic AND/OR non-traumatic injury,racial,Other Race,1,3,4
201257,Disorder of endocrine ovary,racial,White,4,0,4
4278672,Fracture of forearm,racial,Unknown,1,3,4
133294,Prepatellar bursitis,ethnic,Not Hispanic or Latino,0,4,4
437784,Pfeiffer's disease,ethnic,Not Hispanic or Latino,2,2,4
376712,Purulent otitis media,racial,White,3,1,4
4015843,Gonorrhea carrier,ethnic,Hispanic or Latino,0,4,4
436108,Acute closed-angle glaucoma,racial,Black or African American ,4,0,4
199870,Renal vascular disorder,ethnic,Hispanic or Latino,2,2,4
435993,Foreign body in conjunctival sac,ethnic,Hispanic or Latino,1,4,5
439656,A/N care: grand multip,ethnic,Not Hispanic or Latino,4,0,4
437758,Dependance on enabling machine or device,racial,White,1,4,5
197028,Calculus of lower urinary tract,racial,White,0,4,4
4215884,Unilateral radical mastectomy,ethnic,Hispanic or Latino,4,0,4
135496,Acute leukemia in remission,racial,White,2,2,4
438438,Acute myocardial infarction of anterolateral wall,ethnic,Hispanic or Latino,1,3,4
381677,SBO - Spina bifida occulta,ethnic,Not Hispanic or Latino,1,4,5
437243,Chronic paranoid schizophrenia with acute exacerbation,ethnic,Not Hispanic or Latino,0,4,4
4100857,Pickwickian syndrome,racial,American Indian or Alaska Native ,2,2,4
375825,Referred otalgia,ethnic,Not Hispanic or Latino,1,4,5
74606,Benign bone tumor,ethnic,Not Hispanic or Latino,1,3,4
443454,Cerebral infarction,racial,Native Hawaiian or Other Pacific Islander ,0,4,4
316814,Hyperventilation,ethnic,Hispanic or Latino,3,1,4
4181604,Subcutaneous contraceptive implant,racial,Unknown,4,0,4
201688,Urinary hesitancy,ethnic,Not Hispanic or Latino,1,4,5
372604,Movement disorder,ethnic,Hispanic or Latino,2,2,4
440544,"Closed fracture radius and ulna, proximal",ethnic,Hispanic or Latino,1,3,4
319793,CCHS - Congenital central hypoventilation,racial,White,2,2,4
137951,Acquired keratoderma,racial,Asian,4,0,4
441172,Late effect of burn,ethnic,Hispanic or Latino,0,4,4
440358,Lipoma,racial,Asian,2,2,4
75052,Enthesopathy of wrist AND/OR carpus,ethnic,Not Hispanic or Latino,3,1,4
432863,Acquired coagulation factor deficiency,ethnic,Not Hispanic or Latino,4,1,5
434689,Incomplete abortion,ethnic,Hispanic or Latino,4,0,4
438917,Superficial foreign body without major open wound AND without infection,racial,White,2,2,4
258981,Kaposi's sarcoma of skin,racial,White,0,4,4
381573,Acute mastoiditis without complications,ethnic,Hispanic or Latino,4,0,4
4055742,Acute pericementitis,racial,White,1,3,4
436541,Closed fracture of ulna,racial,White,4,1,5
194382,External haemorrhoid,racial,Native Hawaiian or Other Pacific Islander ,4,0,4
312902,Benign intracranial hypertension,racial,Other Race,4,0,4
4002644,Rotator cuff shoulder syndrome and allied disorders,ethnic,Not Hispanic or Latino,0,4,4
444287,Carbuncle of neck,racial,White,0,4,4
201773,Enteritis,ethnic,Hispanic or Latino,2,2,4
432546,Herpes zoster dermatitis of eyelids,racial,Unknown,2,2,4
4108817,"Tricuspid valve disorders, non-rheumatic",ethnic,Not Hispanic or Latino,0,4,4
76745,Capsular breast contracture of breast implant,ethnic,Hispanic or Latino,4,0,4
432621,Purulent endophthalmitis,ethnic,Not Hispanic or Latino,4,1,5
73560,Calcaneal spur,racial,Asian,1,3,4
438242,Talipes equinovarus,racial,White,1,4,5
438066,Chlamydial infection,racial,Other Race,2,2,4
192855,CIS - Carcinoma in situ of bladder,racial,Unknown,0,4,4
199067,Inflammatory disease of female pelvic organs AND/OR tissues,ethnic,Not Hispanic or Latino,4,0,4
433095,Fall on or from steps,ethnic,Not Hispanic or Latino,2,2,4
4239721,Seafood allergy,racial,Unknown,4,1,5
377554,Hereditary peripheral neuropathy,ethnic,Hispanic or Latino,1,4,5
4196362,Genetic counselling,racial,Unknown,4,1,5
4064989,Lung function testing abnormal,racial,White,0,4,4
4169568,Rheumatic endocarditis,ethnic,Hispanic or Latino,1,4,5
444297,Vertiginous syndrome,racial,White,4,1,5
436957,Functional disorders of polymorphonuclear neutrophils,ethnic,Hispanic or Latino,3,1,4
132583,Postablative hypothyroidism,ethnic,Not Hispanic or Latino,4,0,4
440385,Obstructive hydrocephalus,racial,Black or African American ,2,2,4
438688,Sarcoidosis,ethnic,Not Hispanic or Latino,4,0,4
79903,Effusion of joint,racial,Unknown,1,4,5
376969,Orofacial dyskinesia,racial,White,2,2,4
23653,Foreign body in esophagus,ethnic,Hispanic or Latino,2,2,4
374168,Complex febrile seizure,ethnic,Hispanic or Latino,2,2,4
375547,Anisometropia,ethnic,Hispanic or Latino,2,2,4
80946,Tinea manus,racial,Unknown,2,2,4
252658,Intrinsic asthma without status asthmaticus,racial,Black or African American ,4,1,5
378087,Secondary malignant neoplasm of brain and spinal cord,racial,Unknown,0,4,4
439777,Anemia,racial,American Indian,4,0,4
436020,Actinomycotic infection,ethnic,Hispanic or Latino,4,0,4
77638,Displacement of intervertebral disc without myelopathy,racial,Other Race,4,1,5
195212,Hypercortisolism,racial,White,3,1,4
141405,Congenital absence of muscle AND/OR tendon,racial,White,3,1,4
4297375,Victim of abuse,ethnic,Hispanic or Latino,4,0,4
81696,Closed fracture of acetabulum,ethnic,Hispanic or Latino,1,4,5
442441,Grand multiparity with antenatal problem,racial,White,4,0,4
77072,Joint effusion of ankle AND/OR foot,racial,Other Race,1,4,5
374954,Optic neuritis,ethnic,Not Hispanic or Latino,4,1,5
438039,Injury caused by animal,ethnic,Hispanic or Latino,4,1,5
381252,Benign neoplasm of eye,racial,Other Race,4,0,4
438297,"Mechanical complication of cardiac device, implant AND/OR graft",ethnic,Hispanic or Latino,3,1,4
199767,Neoplasm of uncertain behaviour of liver and/or biliary passages,ethnic,Hispanic or Latino,4,1,5
319927,Heart sounds abnormal,ethnic,Not Hispanic or Latino,0,4,4
4062998,Infantile paralytic paralysis,ethnic,Hispanic or Latino,4,0,4
4062636,Bacterial disease screening,racial,American Indian,4,0,4
377848,Toxic maculopathy,racial,Unknown,4,0,4
4265600,Gastric ulcer,ethnic,Hispanic or Latino,4,1,5
443216,Graft versus host disease,racial,White,0,4,4
435149,Complication of internal device,racial,White,1,4,5
195769,Submucous uterine leiomyoma,ethnic,Hispanic or Latino,4,0,4
194981,Bilateral femoral hernia without obstruction AND without gangrene,ethnic,Hispanic or Latino,2,2,4
435325,Umbilical cord complication,racial,Unknown,2,2,4
139099,Ingrowing nail,racial,American Indian or Alaska Native ,4,1,5
197928,Menstruation absent,racial,Filipino,4,0,4
75382,Closed fractures of tarsal AND metatarsal bones,ethnic,Not Hispanic or Latino,4,1,5
440203,Fetus OR newborn affected by condition of umbilical cord,racial,White,2,2,4
4243973,Laparoscopic appendectomy,racial,White,1,3,4
138824,Contact dermatitis due to metal,racial,Unknown,2,2,4
438555,Cyanosis,racial,White,1,3,4
4215568,Sensory disturbance in limb,ethnic,Hispanic or Latino,3,1,4
442262,Blister of toe without infection,ethnic,Not Hispanic or Latino,2,2,4
439961,Superficial injury without infection,racial,Unknown,4,1,5
437113,Asthenia,ethnic,Not Hispanic or Latino,2,2,4
138864,Congenital anomaly of nail,ethnic,Hispanic or Latino,4,0,4
440846,"Blood coagulation disorder, categorized by value of screening test",racial,Unknown,2,2,4
74729,Ganglion and synovial cyst,racial,Other Race,2,2,4
435574,Abnormal form of root of tooth,ethnic,Hispanic or Latino,4,0,4
134870,Pityriasis versicolor,racial,Black or African American ,1,3,4
441589,Endocarditis,ethnic,Not Hispanic or Latino,3,1,4
73338,Sprain of lateral collateral ligament of knee,racial,Unknown,1,3,4
4060929,Orchitis and epididymitis NOS,ethnic,Hispanic or Latino,0,4,4
439654,Partial epilepsy with impairment of consciousness,racial,Native Hawaiian or Other Pacific Islander ,0,4,4
433623,Intracranial hemorrhage following injury with open intracranial wound AND brief loss of consciousness (less than one hour),ethnic,Hispanic or Latino,0,4,4
199066,Female digestive-genital tract fistula,ethnic,Hispanic or Latino,4,0,4
441267,Cystic fibrosis,racial,White,1,3,4
441851,Serous detachment of retinal pigment epithelium,racial,Unknown,4,0,4
443447,Iatrogenic hypotension,ethnic,Not Hispanic or Latino,0,4,4
375527,Headache disorder,racial,Unknown,4,0,4
382034,Injury of sciatic nerve,racial,Unknown,4,1,5
444100,Mood disorder,racial,Other Race,1,3,4
438719,Active rickets,ethnic,Hispanic or Latino,4,0,4
438268,Closed dislocation of finger,racial,White,2,2,4
197928,Menstruation absent,racial,American Indian,4,0,4
438867,Generalized body aches,racial,Asian,4,1,5
443587,Diastolic heart failure,racial,Native Hawaiian or Other Pacific Islander ,2,2,4
4146235,Other cellulitis and abscess,ethnic,Hispanic or Latino,1,4,5
374957,Acquired stenosis of external ear canal,racial,White,1,4,5
134618,Toxic diffuse goiter with thyrotoxic crisis,ethnic,Hispanic or Latino,4,0,4
432877,Socialised behaviour disorder,racial,White,0,4,4
314958,Benign secondary hypertension,racial,White,2,2,4
28457,Hypertrophy of tonsils,racial,Other Race,1,3,4
140020,Viral exanthem,racial,Other Race,2,2,4
134159,Precordial pain,racial,Filipino,1,3,4
76194,Osteoarthrosis involving multiple sites but not designated as generalized,racial,Other Race,4,0,4
80241,Closed fracture navicular,racial,White,4,1,5
437611,Ectopic pregnancy,ethnic,Hispanic or Latino,4,0,4
196463,Alcoholic cirrhosis,racial,American Indian or Alaska Native ,4,0,4
4302252,High risk pregnancy care,racial,Other Race,4,0,4
432256,Primary malignant neoplasm of Meckel diverticulum,ethnic,Hispanic or Latino,4,0,4
377830,Alcohol withdrawal delirium,ethnic,Hispanic or Latino,1,4,5
192854,Interstitial uterine fibroid,racial,American Indian or Alaska Native ,4,0,4
138717,Thyrotoxicosis with diffuse goitre,racial,Unknown,4,0,4
4345578,Rhabdomyolysis,racial,Unknown,4,0,4
139179,Open wound of lip without complication,ethnic,Not Hispanic or Latino,2,2,4
4107655,Observations relating to psychosocial functioning,racial,Other Race,2,2,4
434339,Adolescent - emotional problem,ethnic,Not Hispanic or Latino,1,3,4
72471,Sprain of carpometacarpal joint,racial,White,1,3,4
434319,Premature orgasm - male,racial,Unknown,0,4,4
4055742,Acute pericementitis,ethnic,Hispanic or Latino,1,3,4
4064989,Lung function testing abnormal,ethnic,Not Hispanic or Latino,0,4,4
25518,AS - Sickle cell trait,racial,Black or African American ,2,2,4
140489,Acquired acanthosis nigricans,racial,Filipino,2,2,4
378424,Astigmatism,racial,Unknown,1,3,4
136661,Nodular goiter,racial,White,4,0,4
440009,Complication of implant,racial,White,3,1,4
380109,Exophoria,ethnic,Hispanic or Latino,3,1,4
4064383,Rheumatoid arthritis screening,ethnic,Not Hispanic or Latino,3,1,4
4051238,Family history of deafness,racial,White,1,4,5
4079499,Convalescence after radiotherapy,ethnic,Hispanic or Latino,4,0,4
375551,Blepharochalasis,racial,Unknown,4,0,4
312902,Benign intracranial hypertension,ethnic,Not Hispanic or Latino,4,0,4
75667,Sprain of calcaneofibular ligament,racial,White,4,0,4
193255,"Noninflammatory disorders of the ovary, fallopian tube and broad ligament",ethnic,Not Hispanic or Latino,4,0,4
440032,CMV - Cytomegalovirus infection,racial,Black or African American ,4,0,4
258684,Pulmonary cryptococcosis,ethnic,Hispanic or Latino,0,4,4
435412,Second degree burn of breast,racial,White,4,0,4
196734,Disease of prostate,ethnic,Not Hispanic or Latino,0,4,4
138845,Rheumatism,racial,White,4,0,4
198803,Nodular hyperplasia of prostate gland,racial,Native Hawaiian or Other Pacific Islander ,0,4,4
24978,Chronic adenotonsillitis,ethnic,Hispanic or Latino,2,2,4
77373,Congenital deformity of hip joint,racial,Asian,4,0,4
432801,"Injury undetermined whether accidentally or purposely inflicted, fall from natural site",racial,White,3,1,4
441443,Injury of superior vena cava,racial,White,4,0,4
134743,Congenital ichthyosis of skin,racial,Black or African American ,4,0,4
76161,Impotence of organic origin,racial,American Indian,0,4,4
435372,Underweight,racial,Asian,3,1,4
4100912,Screening for rheumatoid conditions,racial,Unknown,4,0,4
372907,Macular scar,racial,Unknown,4,1,5
72714,Chronic polyarticular juvenile rheumatoid arthritis,racial,White,1,3,4
4215884,Unilateral radical mastectomy,racial,Unknown,4,0,4
374748,Perinatal anoxic-ischemic brain injury,racial,White,0,4,4
313224,Anomalous atrioventricular excitation,ethnic,Not Hispanic or Latino,1,3,4
379019,Inflammation of conjunctiva,racial,Filipino,2,2,4
4096783,Total prostatectomy,racial,Unknown,0,4,4
441092,Advanced maternal age gravida,racial,Black or African American ,4,0,4
434016,"Nondependent opioid abuse, continuous",racial,Other Race,4,0,4
436583,[X]Falls,racial,Native Hawaiian or Other Pacific Islander ,0,4,4
4147837,Generalized metabolic disorder,racial,Unknown,0,4,4
4204904,Education about sexually transmitted disease prevention,racial,Black or African American ,1,3,4
75652,Congenital valgus deformity of foot,racial,Unknown,0,4,4
76034,Herpes simplex whitlow,ethnic,Hispanic or Latino,2,2,4
437543,Multiple cranial nerve palsy,racial,White,1,3,4
73008,Enthesopathy,racial,Asian,2,2,4
436682,Moderate mental handicap,racial,Asian,0,4,4
436075,Adjustment disorder with anxious mood,racial,Black or African American ,0,4,4
4210149,Substance abuse counseling,racial,Asian,1,4,5
441834,"Bipolar affective disorder, currently manic, mild",ethnic,Hispanic or Latino,1,3,4
374655,Mastoiditis,racial,Unknown,4,1,5
4094865,Ca intrahepatic bile ducts,racial,White,0,4,4
442926,"Motor vehicle traffic accident involving collision with another motor vehicle, parked, driver of motor vehicle injured",ethnic,Hispanic or Latino,2,2,4
81377,Climacteric arthritis of the lower leg,racial,White,4,0,4
195209,Benign neoplasm of liver and/or biliary ducts,ethnic,Hispanic or Latino,3,1,4
79917,Acquired deformity of toe,racial,Unknown,2,2,4
312902,Benign intracranial hypertension,racial,White,4,0,4
4147494,Nonspecific mesenteric adenitis,ethnic,Not Hispanic or Latino,1,3,4
28457,Hypertrophy of tonsils,racial,Black or African American ,1,3,4
374221,Injury of brachial plexus,ethnic,Not Hispanic or Latino,0,4,4
72469,Closed dislocation of shoulder region,ethnic,Not Hispanic or Latino,2,2,4
74698,Breech presentation,ethnic,Not Hispanic or Latino,3,1,4
437246,Vitamin B deficiency,racial,Asian,4,0,4
4070287,Preauricular sinus and fistula,ethnic,Hispanic or Latino,1,3,4
432621,Purulent endophthalmitis,racial,Unknown,4,0,4
4079499,Convalescence after radiotherapy,racial,White,4,0,4
198201,Chronic salpingo-oophoritis,racial,White,4,0,4
442598,Fracture of radius AND ulna,ethnic,Hispanic or Latino,4,1,5
4016352,Tuberculosis contact,racial,Unknown,2,2,4
374357,Acquired stenosis of nasolacrimal duct,ethnic,Not Hispanic or Latino,2,2,4
195861,Small kidney,racial,White,4,0,4
24966,OV - Oesophageal varices,ethnic,Not Hispanic or Latino,0,4,4
438990,Benign neuroendocrine tumor,racial,White,4,0,4
75128,Injury of chest wall,racial,Black or African American ,0,4,4
4103640,Amputated foot,ethnic,Not Hispanic or Latino,1,4,5
198191,Acquired hypertrophic pyloric stenosis,racial,White,2,2,4
442282,Urinary casts,racial,Other Race,3,1,4
80573,Contusion of ankle,ethnic,Not Hispanic or Latino,4,1,5
440228,Closed fracture of lower end of humerus,racial,Unknown,3,1,4
74719,Foot ulcer,racial,Native Hawaiian or Other Pacific Islander ,1,4,5
436381,Gender identity disorder of childhood,racial,Unknown,0,4,4
317898,Malignant essential hypertension,racial,Black or African American ,0,4,4
440155,Postartificial menopausal syndrome,racial,Unknown,4,0,4
432661,Stomatitis,racial,Asian,3,1,4
441417,Lack of coordination,racial,Black or African American ,0,4,4
443274,Psychostimulant dependence,racial,White,1,3,4
261327,Empyema of pleura without fistula,ethnic,Hispanic or Latino,1,3,4
314754,Wheezing,racial,American Indian,2,2,4
26638,Primary malignant neoplasm of oesophagus,racial,White,0,4,4
377282,Conjunctivitis with mucocutaneous disorder,racial,White,4,1,5
195769,Submucous uterine leiomyoma,racial,White,4,0,4
433069,Open wound of external genital organs with complication,racial,Other Race,2,2,4
435524,Sleep disorder,racial,Other Race,4,1,5
4144783,Old healed fracture of bone,ethnic,Hispanic or Latino,4,0,4
434610,Hyperkalemia,racial,Native Hawaiian or Other Pacific Islander ,2,2,4
376125,Disorder of eyelid,racial,Unknown,4,0,4
314090,PET - Mild pre-eclamptic toxaemia,ethnic,Hispanic or Latino,4,0,4
314054,Aortic valve disease,racial,Native Hawaiian or Other Pacific Islander ,3,1,4
199192,Abrasion AND/OR friction burn of trunk without infection,ethnic,Not Hispanic or Latino,2,2,4
377848,Toxic maculopathy,ethnic,Hispanic or Latino,4,0,4
4114314,Screening for osteoporosis,racial,Filipino,4,0,4
319793,CCHS - Congenital central hypoventilation,ethnic,Hispanic or Latino,2,2,4
372309,Mononeuritis,racial,Asian,4,1,5
258453,Acute upper respiratory infection of multiple sites,ethnic,Not Hispanic or Latino,2,2,4
432791,Urticaria-angio-oedema,racial,Black or African American ,4,1,5
435244,Developmental disorder,ethnic,Not Hispanic or Latino,3,1,4
40490888,Herniation of rectum into vagina,ethnic,Not Hispanic or Latino,4,0,4
438178,Postmastectomy lymphedema syndrome,ethnic,Hispanic or Latino,4,0,4
198334,Campylobacter diarrhoea,ethnic,Hispanic or Latino,2,2,4
196991,Chronic renal disease,racial,American Indian or Alaska Native ,4,0,4
4210149,Substance abuse counseling,racial,Black or African American ,2,2,4
133384,Burn any degree involving less than 10 percent of body surface,ethnic,Hispanic or Latino,2,2,4
377885,Disorder of eye movements,racial,Black or African American ,3,1,4
4292726,Contact - infectious disease,racial,Black or African American ,0,4,4
373648,Superficial injury of eyelid AND/OR periocular area,ethnic,Hispanic or Latino,1,3,4
4100515,Cocaine type drug dependence,ethnic,Not Hispanic or Latino,0,4,4
30234,Cervical sprain,racial,American Indian or Alaska Native ,4,0,4
441201,"[X]Fall from, out of or through building or structure",racial,White,4,0,4
200662,Lymphosarcoma,ethnic,Not Hispanic or Latino,2,2,4
444219,Osteitis deformans without bone tumor,racial,Unknown,4,0,4
435642,Disturbance in speech,racial,White,0,4,4
4062637,TB - Tuberculosis screening,racial,American Indian,2,2,4
4310682,Multiple open wounds with complication,racial,Unknown,4,1,5
443865,Non-infective colitis,racial,Filipino,2,2,4
4071485,Foetus or neonate affected by caesarean section,racial,White,4,0,4
435516,Lipoprotein deficiency disorder,racial,Black or African American ,2,2,4
376964,Partial recent retinal detachment with giant tear,ethnic,Hispanic or Latino,1,4,5
374649,Strabismic amblyopia,racial,White,4,1,5
4015842,Viral hepatitis carrier,racial,White,2,2,4
437127,Closed dislocation of acromioclavicular joint,ethnic,Not Hispanic or Latino,0,4,4
194710,Placenta previa without hemorrhage,ethnic,Hispanic or Latino,4,0,4
80571,Open wound of foot with complication,racial,Unknown,4,0,4
79939,Sprain of tarsometatarsal joint AND/OR ligament,racial,White,4,0,4
80497,Disorder of cervical spine,racial,Unknown,3,1,4
374888,Dementia associated with another disease,racial,Filipino,4,0,4
199867,CPH - Chronic persistent hepatitis,racial,Unknown,4,1,5
198187,"Acute peptic ulcer without hemorrhage, without perforation AND without obstruction",racial,White,4,0,4
81250,Carcinoma in situ of breast,racial,Asian,4,0,4
443887,Superficial foreign body of ankle without major open wound AND without infection,ethnic,Hispanic or Latino,1,3,4
4104561,Ptosis of eyelid NOS,ethnic,Hispanic or Latino,4,0,4
200687,Renal disorder associated with type I diabetes mellitus,racial,American Indian or Alaska Native ,4,0,4
442862,"Abrasion or friction burn of hand, without mention of infection",racial,Unknown,1,4,5
440905,Toxic effect of venom,racial,Other Race,1,3,4
4201745,Disease of digestive system,ethnic,Hispanic or Latino,3,1,4
4109545,Unspecified cataracta complicata,ethnic,Hispanic or Latino,2,2,4
137829,Erythroid aplasia,ethnic,Not Hispanic or Latino,2,2,4
76745,Capsular breast contracture of breast implant,racial,White,4,0,4
321414,Hemoglobinuria,ethnic,Hispanic or Latino,2,2,4
197381,Epigastric pain,racial,Filipino,2,2,4
374748,Perinatal anoxic-ischemic brain injury,ethnic,Not Hispanic or Latino,0,4,4
433762,Disseminated chorioretinitis,racial,White,4,0,4
256215,"Lung agenesis, hypoplasia and dysplasia",ethnic,Not Hispanic or Latino,0,4,4
439304,Retinal round hole without detachment,racial,White,4,0,4
440637,Relapsing fever,ethnic,Hispanic or Latino,3,1,4
434854,FP - Food poisoning,racial,Unknown,2,2,4
377873,Lid lag,racial,White,4,0,4
442105,Benign tumor of soft tissue,racial,Unknown,1,4,5
198201,Chronic salpingo-oophoritis,racial,Unknown,4,0,4
81685,Fracture of clavicle due to birth trauma,ethnic,Hispanic or Latino,1,4,5
372912,Visual discomfort,ethnic,Not Hispanic or Latino,4,1,5
4256640,Body mass index 40+ - severely obese,racial,Black or African American ,4,0,4
377830,Alcohol withdrawal delirium,racial,White,0,4,4
441482,Administrative reason for encounter,racial,American Indian or Alaska Native ,4,0,4
380533,Neonatal seizures,ethnic,Hispanic or Latino,4,0,4
442609,Friction blister without infection,racial,Unknown,4,1,5
133351,Open wound of cheek without complication,ethnic,Hispanic or Latino,2,2,4
138340,Septicaemia due to Staphylococcus aureus,ethnic,Hispanic or Latino,0,4,4
134304,Benign tumour of parathyroid gland,racial,Unknown,4,0,4
4110047,Chronic bronchitis NOS,ethnic,Not Hispanic or Latino,1,4,5
135618,Prurigo,racial,Black or African American ,3,1,4
197028,Calculus of lower urinary tract,ethnic,Not Hispanic or Latino,0,4,4
4111255,Unspecified labyrinthitis,racial,Unknown,0,4,4
81893,Chronic ulcerative colitis,racial,Asian,1,4,5
196569,Contusion of abdominal wall,racial,Unknown,2,2,4
433556,Derangement of posterior horn of lateral meniscus,ethnic,Not Hispanic or Latino,4,0,4
312336,Arterial aneurysm,ethnic,Not Hispanic or Latino,1,4,5
441851,Serous detachment of retinal pigment epithelium,ethnic,Hispanic or Latino,4,0,4
440426,Vertigo as late effect of stroke,racial,Filipino,4,0,4
135772,Goiter,racial,American Indian or Alaska Native ,4,0,4
77030,Disease of breast,racial,Other Race,4,0,4
80045,Primary malignant neoplasm of anus,racial,Black or African American ,0,4,4
194993,Intestinal malabsorption,ethnic,Not Hispanic or Latino,4,1,5
193518,Intestinal obstruction,ethnic,Not Hispanic or Latino,1,3,4
77358,Observation of hand region,ethnic,Hispanic or Latino,1,3,4
378425,Eyelid inflammation,racial,Other Race,3,1,4
140648,Onychomycosis due to dermatophyte,racial,Filipino,2,2,4
4064989,Lung function testing abnormal,ethnic,Hispanic or Latino,2,2,4
440032,CMV - Cytomegalovirus infection,ethnic,Not Hispanic or Latino,4,0,4
441207,Drug reaction,racial,Asian,4,1,5
314664,Long Q-T syndrome,racial,Unknown,4,0,4
75617,Polyarticular osteoarthritis,racial,Native Hawaiian or Other Pacific Islander ,4,0,4
74470,Congenital anomaly of upper limb,racial,White,2,2,4
200771,Peptic ulcer without hemorrhage AND without perforation but with obstruction,racial,White,2,2,4
77650,Aseptic necrosis of bone,ethnic,Not Hispanic or Latino,4,0,4
198520,Lumbar spondylosis with myelopathy,ethnic,Not Hispanic or Latino,4,0,4
75623,Old disruption of anterior cruciate ligament,racial,Other Race,0,4,4
4169568,Rheumatic endocarditis,racial,White,1,4,5
4264281,Open fracture,ethnic,Hispanic or Latino,4,0,4
261116,Acquired nasal deformity,racial,White,2,2,4
253896,Traumatic pneumothorax without open wound into thorax,ethnic,Hispanic or Latino,0,4,4
436826,Closed fracture of shaft of radius,ethnic,Hispanic or Latino,3,1,4
195453,"Colitis, enteritis and gastroenteritis presumed infectious",racial,Asian,2,2,4
435658,Atypical squamous cells on vaginal Papanicolaou smear cannot exclude high grade squamous intraepithelial lesion,ethnic,Hispanic or Latino,4,0,4
201265,Splenic disorder,ethnic,Not Hispanic or Latino,1,3,4
4133029,Primigravida,racial,Native Hawaiian or Other Pacific Islander ,4,0,4
444375,"Contact dermatitis due to plants, except food",ethnic,Not Hispanic or Latino,2,2,4
197044,Female infertility associated with anovulation,racial,Other Race,4,0,4
316127,Vitreous opacities,racial,Other Race,2,2,4
435127,Sequelae of intracranial injury,racial,White,0,4,4
137083,Unilateral incomplete cleft palate,ethnic,Hispanic or Latino,0,4,4
440828,Renal pelvis and ureter obstructive defects,ethnic,Hispanic or Latino,0,4,4
433069,Open wound of external genital organs with complication,racial,Black or African American ,2,2,4
432452,Anemia of prematurity,racial,White,4,1,5
380513,Congenital cataract,ethnic,Not Hispanic or Latino,1,3,4
433617,Open fracture of femoral condyle of femur,ethnic,Hispanic or Latino,0,4,4
4060929,Orchitis and epididymitis NOS,racial,White,0,4,4
376382,Tension-type headache,racial,American Indian or Alaska Native ,3,1,4
432587,Polyclonal hypergammaglobulinemia,ethnic,Hispanic or Latino,2,2,4
442603,Malignant hypertensive heart AND renal disease,ethnic,Not Hispanic or Latino,4,0,4
4012297,Closed fracture of one or more phalanges of hand NOS,racial,White,2,2,4
141667,Laxity of ligament,ethnic,Hispanic or Latino,4,0,4
81064,Pseudopolyposis of colon,ethnic,Hispanic or Latino,2,2,4
81942,Enthesopathy of ankle AND/OR tarsus,ethnic,Not Hispanic or Latino,4,1,5
377849,Retinal deposits,ethnic,Not Hispanic or Latino,4,0,4
375529,Infantile cerebral palsy,racial,Native Hawaiian or Other Pacific Islander ,3,1,4
374649,Strabismic amblyopia,racial,Unknown,3,1,4
257660,Partial anomalous pulmonary venous connection,ethnic,Hispanic or Latino,0,4,4
40482203,Karyotype evaluation abnormal,racial,White,4,0,4
320536,Abnormal EKG finding,racial,American Indian or Alaska Native ,4,0,4
439005,Chronic alcoholism in remission,racial,Other Race,0,4,4
442609,Friction blister without infection,racial,Black or African American ,1,3,4
192279,Diabetic nephropathy,racial,Filipino,4,0,4
441840,Clinical finding,racial,Asian,4,1,5
440544,"Closed fracture radius and ulna, proximal",racial,White,1,3,4
433762,Disseminated chorioretinitis,ethnic,Hispanic or Latino,4,0,4
440786,Threatened premature labor,ethnic,Hispanic or Latino,4,0,4
380510,Congenital abnormality of eyelid,ethnic,Not Hispanic or Latino,0,4,4
439298,Bronchitis and pneumonitis due to chemical fumes,ethnic,Hispanic or Latino,2,2,4
4096204,Disorders of amino acid transport and metabolism,ethnic,Hispanic or Latino,4,0,4
437220,Primary malignant neoplasm of ventral surface of tongue,racial,White,0,4,4
433260,Mother delivered,ethnic,Not Hispanic or Latino,4,0,4
436812,Tongue tie,racial,Asian,0,4,4
440321,Helicobacter-associated disease,racial,Native Hawaiian or Other Pacific Islander ,2,2,4
30679,Benign tumour major salivary gland,racial,Black or African American ,4,0,4
136496,Cellulitis and abscess of face,racial,Black or African American ,1,3,4
435940,"Closed fracture of humerus, shaft",racial,White,3,1,4
196443,Gastric ulcer without hemorrhage AND without perforation but with obstruction,racial,Unknown,4,0,4
435636,Juvenile osteochondritis of hip AND/OR pelvis,ethnic,Not Hispanic or Latino,0,4,4
444129,Wrist injury,racial,Other Race,0,4,4
194286,"Malignant neoplasm of corpus uteri, excluding isthmus",racial,Unknown,4,0,4
435604,"Viral disease in mother complicating pregnancy, childbirth AND/OR puerperium",ethnic,Hispanic or Latino,4,1,5
433577,Hammer toe,racial,Other Race,4,1,5
438244,Congenital hydrocephalus,racial,Unknown,0,4,4
138604,"Contusion of face, scalp and neck, excluding eye(s)",racial,Asian,2,2,4
439971,Poisoning by anticoagulant,racial,White,2,2,4
380120,Strabismus in neuromuscular disorder,ethnic,Not Hispanic or Latino,0,4,4
437217,Coccidioidomycosis,racial,White,0,4,4
375415,Injury of head region,racial,American Indian or Alaska Native ,2,2,4
4093344,Prostate observation,racial,Alaska Native,0,4,4
4150614,Communication disorder,racial,White,0,4,4
444243,Neurotic disorder,racial,Asian,1,4,5
381548,Monoplegia,ethnic,Not Hispanic or Latino,0,4,4
4166776,Dupuytren contracture,ethnic,Not Hispanic or Latino,3,1,4
72992,Allergic arthritis,racial,Unknown,2,2,4
198995,Type 1 diabetes mellitus - poor control,racial,American Indian,4,0,4
319927,Heart sounds abnormal,racial,White,1,4,5
320536,Abnormal EKG finding,racial,Native Hawaiian or Other Pacific Islander ,2,2,4
4086918,Viral screening,racial,Asian Indian,2,2,4
374366,Sensorineural hearing loss,racial,Black or African American ,4,1,5
320206,Congenital atresia of pulmonary valve,ethnic,Hispanic or Latino,2,2,4
193251,Umbilical hernia without obstruction AND without gangrene,racial,Asian,2,2,4
433171,Selective IgA immunodeficiency,racial,Other Race,4,0,4
135888,Decubitus ulcer,ethnic,Not Hispanic or Latino,1,4,5
257315,Bacterial pneumonia,racial,Filipino,2,2,4
200171,Carbuncle of skin AND/OR subcutaneous tissue,ethnic,Not Hispanic or Latino,1,4,5
4095918,Other disorders of thyroid,racial,White,4,0,4
443115,Closed fracture finger proximal phalanx,racial,Unknown,2,2,4
201418,"Flatulence, eructation and gas pain",racial,Black or African American ,3,1,4
30284,Motion sickness,racial,Unknown,4,1,5
76797,Congenital deformity of genital organ,racial,White,0,4,4
141405,Congenital absence of muscle AND/OR tendon,ethnic,Hispanic or Latino,3,1,4
4100515,Cocaine type drug dependence,racial,Black or African American ,0,4,4
316822,Finding of heart murmur,racial,Filipino,3,1,4
443429,Endothelial corneal dystrophy,ethnic,Hispanic or Latino,4,0,4
138864,Congenital anomaly of nail,racial,White,3,1,4
443593,Ulcer of thigh,racial,Unknown,4,0,4
79118,Deformity of calcaneum,racial,White,2,2,4
320827,Atresia and stenosis of aorta,ethnic,Not Hispanic or Latino,4,0,4
195401,Superficial bruising of hip,racial,Unknown,4,0,4
432874,Lipidosis,racial,White,0,4,4
75924,Osteodystrophy,racial,White,1,4,5
140602,"Mechanical complication of internal orthopedic device, implant and graft",ethnic,Hispanic or Latino,2,2,4
4196362,Genetic counselling,ethnic,Not Hispanic or Latino,4,0,4
200051,Primary malignant neoplasm of ovary,racial,Other Race,4,0,4
437382,Urine observation,racial,Filipino,3,1,4
372828,Zoster ophthalmicus,racial,Other Race,0,4,4
436097,"Nondependent mixed drug abuse, continuous",ethnic,Hispanic or Latino,2,2,4
435127,Sequelae of intracranial injury,ethnic,Hispanic or Latino,0,4,4
80492,Knee joint contracture,ethnic,Hispanic or Latino,4,0,4
441284,Open-angle glaucoma,racial,Black or African American ,4,0,4
200771,Peptic ulcer without hemorrhage AND without perforation but with obstruction,racial,Asian,1,4,5
432284,Single major depressive episode,racial,Filipino,4,1,5
434303,Benign neoplasm of rectum and anal canal,racial,Unknown,4,0,4
198075,Venereal wart,racial,Other Race,4,1,5
433881,Additional general conditions of patient,ethnic,Not Hispanic or Latino,3,1,4
443216,Graft versus host disease,ethnic,Hispanic or Latino,0,4,4
440207,Hypoplastic left heart syndrome,racial,White,2,2,4
438719,Active rickets,racial,White,4,0,4
4305841,Periodic limb movement disorder,racial,White,1,3,4
440129,Hypertrophy of nasal turbinates,racial,Asian,1,3,4
437543,Multiple cranial nerve palsy,ethnic,Hispanic or Latino,1,3,4
435459,Staphylococcal infectious disease,racial,White,2,2,4
4061081,Other male genital organ diseases OS,ethnic,Hispanic or Latino,0,4,4
76836,Sprain of knee and leg,racial,Native Hawaiian or Other Pacific Islander ,1,3,4
30361,Hypoglycemic disorder,racial,Unknown,4,1,5
4005603,Congenital cystic kidney disease NOS,ethnic,Hispanic or Latino,0,4,4
434622,Deficiency anemias,racial,Asian,4,1,5
134159,Precordial pain,racial,American Indian or Alaska Native ,4,1,5
433585,Klippel-Feil sequence,ethnic,Hispanic or Latino,1,3,4
443616,Refractory migraine without aura,racial,White,4,0,4
438480,"Abnormal glucose tolerance in mother complicating pregnancy, childbirth AND/OR puerperium",racial,Black or African American ,4,0,4
192855,CIS - Carcinoma in situ of bladder,ethnic,Hispanic or Latino,0,4,4
440685,"Nondependent alcohol abuse, episodic",racial,Black or African American ,0,4,4
321319,Cardiomyopathy,racial,Asian,0,4,4
432877,Socialised behaviour disorder,ethnic,Hispanic or Latino,0,4,4
439003,Disorder of branched chain amino acid metabolism,ethnic,Not Hispanic or Latino,0,4,4
4204967,Laryngismus,ethnic,Hispanic or Latino,2,2,4
432256,Primary malignant neoplasm of Meckel diverticulum,racial,White,4,0,4
377539,Syringomyelia and syringobulbia,racial,White,4,0,4
4088920,Womb absent,racial,Asian,4,0,4
434097,Twin pregnancy with antenatal problem,racial,Asian,4,0,4
433617,Open fracture of femoral condyle of femur,racial,White,0,4,4
137005,Tracheostomy complication,racial,Unknown,4,0,4
437217,Coccidioidomycosis,ethnic,Hispanic or Latino,0,4,4
200762,Autoimmune hepatitis,racial,Unknown,4,0,4
381575,Disorder of external ear,ethnic,Not Hispanic or Latino,3,1,4
81380,Cervical syndrome,ethnic,Hispanic or Latino,4,0,4
442023,Poisoning of undetermined intent,racial,White,2,2,4
197444,Vascular complication of medical care,ethnic,Hispanic or Latino,4,0,4
4024361,Paralysis of glottis,racial,White,0,4,4
433675,Toxic effect of chemical,racial,White,2,2,4
444361,Nonvenomous insect bite of toe without infection,racial,White,3,1,4
441532,Monoclonal paraproteinaemia,ethnic,Not Hispanic or Latino,4,0,4
441874,Cerebral thrombosis,ethnic,Not Hispanic or Latino,3,1,4
442753,Furuncle of trunk,racial,Unknown,2,2,4
201079,Acute parametritis and pelvic cellulitis,racial,Unknown,4,0,4
80269,Mechanical complication of internal joint prosthesis,ethnic,Hispanic or Latino,4,0,4
193520,Urinary bladder stone,ethnic,Not Hispanic or Latino,0,4,4
75053,Fracture of bone,racial,Unknown,2,2,4
4053599,Open wound of forearm,ethnic,Not Hispanic or Latino,3,1,4
4051238,Family history of deafness,ethnic,Hispanic or Latino,1,4,5
29056,Sialoadenitis,racial,Asian,1,4,5
432881,Pancytopenia,racial,Other Race,4,0,4
313236,Cough variant asthma,racial,Filipino,2,2,4
441408,Vomiting,racial,Native Hawaiian or Other Pacific Islander ,1,3,4
437058,Sunburn,racial,Unknown,2,2,4
201916,Ureteric stone,ethnic,Not Hispanic or Latino,4,0,4
198678,Intestinal infectious disease,racial,Filipino,4,1,5
197981,Abdominal tenderness,ethnic,Not Hispanic or Latino,4,1,5
435236,Acute exacerbation of chronic schizoaffective schizophrenia,racial,White,4,0,4
439695,Hypertensive heart and renal disease with renal failure,racial,Other Race,4,0,4
198124,Disorder of kidney,racial,Native Hawaiian or Other Pacific Islander ,3,1,4
81106,Acquired genu varum,racial,Unknown,2,2,4
73754,Restless legs,racial,Asian,1,3,4
320206,Congenital atresia of pulmonary valve,racial,White,2,2,4
443754,"Lyell toxic epidermal necrolysis, subepidermal type",racial,White,0,4,4
437382,Urine observation,racial,Native Hawaiian or Other Pacific Islander ,4,1,5
4085075,At risk state,ethnic,Hispanic or Latino,2,2,4
373999,Diabetic oculopathy associated with type I diabetes mellitus,racial,Filipino,4,0,4
436348,Primary malignant neoplasm of anal canal,racial,White,0,4,4
378741,Brachial plexus lesion,ethnic,Not Hispanic or Latino,0,4,4
261327,Empyema of pleura without fistula,ethnic,Not Hispanic or Latino,4,0,4
132659,Acute apical periodontitis,racial,Other Race,2,2,4
433992,"Bipolar affective disorder, currently manic, moderate",racial,Black or African American ,0,4,4
373166,Benign neoplasm of lower jaw bone,racial,Unknown,4,0,4
437791,Chickenpox with complication,ethnic,Hispanic or Latino,2,2,4
195834,Atherosclerosis of renal artery,ethnic,Hispanic or Latino,4,0,4
436108,Acute closed-angle glaucoma,racial,White,2,2,4
439154,Abnormal findings on diagnostic imaging of skull and head,ethnic,Not Hispanic or Latino,2,2,4
440193,Wristdrop,ethnic,Hispanic or Latino,0,4,4
138717,Thyrotoxicosis with diffuse goitre,ethnic,Not Hispanic or Latino,4,1,5
435380,Closed fracture of radius AND ulna,ethnic,Not Hispanic or Latino,4,1,5
198928,Mechanical complication due to intrauterine contraceptive device,ethnic,Not Hispanic or Latino,4,1,5
74104,Fetal condition affecting obstetrical care of mother,racial,White,4,0,4
316135,AVB - Atrioventricular block,ethnic,Not Hispanic or Latino,1,3,4
438129,"Severe manic bipolar I disorder with psychotic features, mood-congruent",racial,White,1,3,4
72465,Closed fracture of one or more phalanges of hand,racial,Black or African American ,2,2,4
195314,Nephrotic syndrome,racial,Unknown,1,3,4
4147639,Cellulitis and abscess of toe NOS,ethnic,Not Hispanic or Latino,1,4,5
141372,Contact dermatitis due to solvents,ethnic,Not Hispanic or Latino,1,3,4
4114610,Allergic arthritis NOS,racial,White,3,1,4
440689,Agranulocytosis,ethnic,Not Hispanic or Latino,4,1,5
440748,Interstitial emphysema of lung,racial,Asian,0,4,4
434119,Hidradenitis,racial,Other Race,4,0,4
433623,Intracranial hemorrhage following injury with open intracranial wound AND brief loss of consciousness (less than one hour),racial,White,0,4,4
4340379,Hepatitis B carrier,racial,Unknown,2,2,4
138455,Stomatitis,racial,Unknown,2,2,4
321822,Peripheral circulatory disorder associated with diabetes mellitus,ethnic,Hispanic or Latino,1,4,5
141666,Acute osteomyelitis of lower leg,racial,Other Race,0,4,4
436155,Redundant prepuce and phimosis,racial,Other Race,0,4,4
4239975,Myocardial disease,ethnic,Hispanic or Latino,0,4,4
132822,Foot-and-mouth disease,racial,White,1,3,4
201355,Erosion and ectropion of the cervix,ethnic,Hispanic or Latino,4,0,4
315922,Patent ductus arteriosus,racial,Asian,4,0,4
4273391,Suicidal thoughts,racial,Unknown,4,0,4
4140207,Nephrosclerosis,ethnic,Hispanic or Latino,3,1,4
80497,Disorder of cervical spine,racial,Other Race,0,4,4
443949,Disease type AND/OR category unknown,ethnic,Hispanic or Latino,4,1,5
439981,Wound dehiscence,racial,White,2,2,4
436665,Manic-depressive psychosis,racial,Filipino,4,0,4
437758,Dependance on enabling machine or device,ethnic,Not Hispanic or Latino,1,4,5
198197,Male infertility,racial,Asian,0,4,4
436108,Acute closed-angle glaucoma,ethnic,Not Hispanic or Latino,4,0,4
73300,Radial styloid tenosynovitis,racial,Black or African American ,2,2,4
73840,Primary localised osteoarthrosis of shoulder region,racial,Other Race,4,1,5
4290927,Impairment level: low vision of both eyes,racial,Other Race,4,1,5
438882,Closed fracture of neck of metacarpal bone,racial,Unknown,2,2,4
133728,Congenital hypothyroidism,racial,White,4,0,4
439035,Otosclerosis,racial,Unknown,3,1,4
443698,Abnormal anal Papanicolaou smear,racial,White,4,0,4
4201387,Tracheostomy in situ,racial,Asian,1,4,5
374347,Blepharoconjunctivitis,racial,White,3,1,4
440846,"Blood coagulation disorder, categorized by value of screening test",racial,Black or African American ,4,0,4
433069,Open wound of external genital organs with complication,racial,American Indian or Alaska Native ,2,2,4
257581,Exacerbation of asthma,racial,American Indian or Alaska Native ,3,1,4
197518,Neoplasm of uncertain behavior of male genital organ,ethnic,Hispanic or Latino,1,4,5
27918,Eosinophilic esophagitis,ethnic,Hispanic or Latino,0,4,4
433031,Hallucinations,racial,Asian,3,1,4
4201472,Varicella contact,ethnic,Hispanic or Latino,4,1,5
379006,Cerebral degeneration in childhood,ethnic,Not Hispanic or Latino,4,0,4
375815,Bullous keratopathy,racial,Unknown,1,3,4
4061056,Endometriosis NOS,racial,White,4,0,4
260134,Croup,racial,Black or African American ,3,1,4
193322,Right lower quadrant pain,racial,American Indian or Alaska Native ,4,1,5
444406,Acute subendocardial infarction,racial,Unknown,2,2,4
80482,Suppurative arthritis,racial,White,2,2,4
134305,Acute lymphoid leukaemia,ethnic,Hispanic or Latino,0,4,4
441266,Thiamin deficiency,ethnic,Hispanic or Latino,2,2,4
432874,Lipidosis,ethnic,Hispanic or Latino,3,1,4
438990,Benign neuroendocrine tumor,ethnic,Hispanic or Latino,4,0,4
73562,Solitary sacroiliitis,racial,Unknown,3,1,4
24075,Esophageal stricture and stenosis,racial,White,2,2,4
136917,Primary malignant neoplasm of skin of face,racial,Unknown,4,0,4
434339,Adolescent - emotional problem,racial,Unknown,1,3,4
438959,Amoebiasis,racial,White,2,2,4
433760,Dysreflexia,ethnic,Not Hispanic or Latino,0,4,4
442774,Intermittent claudication,racial,Other Race,1,4,5
4171594,Family history of cancer,ethnic,Not Hispanic or Latino,4,1,5
138906,Superficial injury of face without infection,ethnic,Hispanic or Latino,2,2,4
433131,Mumps without complication,ethnic,Hispanic or Latino,4,1,5
137682,Skin sensation disturbance,racial,American Indian or Alaska Native ,4,0,4
435506,Benign neoplastic disease,ethnic,Hispanic or Latino,4,1,5
442603,Malignant hypertensive heart AND renal disease,racial,Black or African American ,4,0,4
133726,Carcinoma in situ of skin of face,racial,White,3,1,4
444419,Quadriparesis,ethnic,Hispanic or Latino,0,4,4
433033,Abnormal cervical Papanicolaou smear,ethnic,Not Hispanic or Latino,4,0,4
137063,Corns and callus,racial,Black or African American ,1,3,4
4098297,Unspecified latent schizophrenia,racial,Unknown,0,4,4
194395,Bleeding diverticulosis,racial,Unknown,3,1,4
433957,Progressive multifocal leukoencephalopathy,racial,White,0,4,4
73847,Observation of elbow joint,racial,White,1,4,5
260759,Malocclusion of teeth,ethnic,Hispanic or Latino,3,1,4
25582,Tracheesophageal fistula,ethnic,Hispanic or Latino,1,3,4
201070,Cholelithiasis AND cholecystitis without obstruction,racial,Unknown,4,1,5
78508,Arthralgia of the ankle and/or foot,racial,American Indian or Alaska Native ,4,0,4
432742,Closed skull fracture without intracranial injury,racial,Unknown,1,4,5
199076,Fallopian tube pregnancy,racial,White,2,2,4
4110655,Pupil-involving third nerve palsy,racial,White,2,2,4
80523,Congenital fusion of spine,racial,White,4,0,4
373499,Disorder of eye region,racial,Asian,4,0,4
198187,"Acute peptic ulcer without hemorrhage, without perforation AND without obstruction",ethnic,Hispanic or Latino,3,1,4
255919,Finding of head and neck region,racial,Black or African American ,1,4,5
380415,Acute swimmer's ear,racial,Black or African American ,4,0,4
195926,Slowing of urinary stream,racial,White,2,2,4
432417,Acquired hallux malleus,ethnic,Hispanic or Latino,4,0,4
4098297,Unspecified latent schizophrenia,ethnic,Hispanic or Latino,1,4,5
441408,Vomiting,racial,American Indian or Alaska Native ,2,2,4
437611,Ectopic pregnancy,racial,White,4,0,4
381858,Dacryoadenitis,racial,White,2,2,4
80182,Dermatomyositis,racial,White,3,1,4
192676,Cervical intraepithelial neoplasia grade 1,racial,Asian,4,0,4
435443,[X]Fall involving wheelchair,racial,Unknown,3,1,4
195083,Left lower quadrant pain,racial,American Indian or Alaska Native ,1,4,5
375806,Idiopathic peripheral neuropathy,racial,American Indian or Alaska Native ,3,1,4
433457,Agoraphobia without mention of panic attacks,ethnic,Not Hispanic or Latino,4,0,4
197095,Embryonic cyst of fallopian tube and broad ligament,racial,White,4,0,4
443571,Cervicovaginal cytology: High grade squamous intraepithelial lesion or carcinoma,racial,Other Race,4,0,4
4091320,Meningococcal infection NOS,ethnic,Hispanic or Latino,4,1,5
441443,Injury of superior vena cava,ethnic,Hispanic or Latino,4,0,4
432303,Cocaine abuse,ethnic,Hispanic or Latino,1,4,5
72245,Chlamydial infection of lower genitourinary tract,racial,Unknown,4,0,4
4230642,Acquired deformity of chest,racial,Other Race,4,0,4
442942,"Crush injury, toe(s)",ethnic,Hispanic or Latino,3,1,4
315833,Secondary cardiomyopathy,ethnic,Not Hispanic or Latino,0,4,4
254676,Lung involvement associated with another disorder,ethnic,Hispanic or Latino,4,0,4
137379,Musculoskeletal symptom,racial,Other Race,2,2,4
257315,Bacterial pneumonia,racial,Black or African American ,2,2,4
4237140,Abnormal sexual function,racial,White,0,4,4
375291,Bullous myringitis,racial,White,3,1,4
78831,Disease of ankle,racial,Other Race,4,0,4
4065355,Urticaria due to cold and heat,racial,White,4,0,4
378523,Residual foreign body in soft tissue,ethnic,Not Hispanic or Latino,1,3,4
40389897,"Neoplasm of uncertain behaviour of trachea, bronchus and lung",racial,White,0,4,4
437779,Streptococcal infectious disease,ethnic,Hispanic or Latino,1,3,4
4059637,Work environment deleterious,racial,Unknown,2,2,4
437220,Primary malignant neoplasm of ventral surface of tongue,ethnic,Not Hispanic or Latino,0,4,4
439658,Gestosis,ethnic,Hispanic or Latino,4,0,4
141648,Contact dermatitis due to cosmetics,ethnic,Hispanic or Latino,4,0,4
380727,Transient refractive change,ethnic,Hispanic or Latino,4,1,5
4273095,Acute tracheitis without obstruction,ethnic,Not Hispanic or Latino,1,4,5
196715,Budd-Chiari syndrome,ethnic,Hispanic or Latino,4,0,4
198198,Vaginal polyp,racial,White,4,0,4
321462,Cardiac complications of care,racial,Other Race,1,3,4
436665,Manic-depressive psychosis,racial,American Indian or Alaska Native ,4,1,5
196369,Adrenogenital disorder,racial,White,3,1,4
195873,Leukorrhagia,racial,Filipino,4,0,4
138225,Disease of sebaceous glands,racial,Asian,4,1,5
78235,Disorder of coccyx,racial,Other Race,3,1,4
4025176,Respiratory system diseases NOS,ethnic,Hispanic or Latino,1,4,5
141370,Toxic erythema,racial,White,3,1,4
198978,Acute gonorrhea of lower genitourinary tract,racial,Other Race,4,0,4
258684,Pulmonary cryptococcosis,racial,White,0,4,4
201061,Diaphragmatic hernia,racial,Black or African American ,1,3,4
443446,Reflex sympathetic dystrophy of lower extremity,ethnic,Hispanic or Latino,4,0,4
138340,Septicaemia due to Staphylococcus aureus,racial,White,0,4,4
137351,Epidermoid cyst of skin,racial,Black or African American ,2,2,4
443429,Endothelial corneal dystrophy,racial,Unknown,4,0,4
135061,Congenital anomaly of musculoskeletal system,racial,Unknown,0,4,4
79145,Ehlers-Danlos syndrome,ethnic,Hispanic or Latino,2,2,4
200149,Placenta previa with hemorrhage - not delivered,racial,White,4,0,4
254068,Upper respiratory disease,racial,Black or African American ,3,1,4
80070,Uric acid urolithiasis,racial,Asian,0,4,4
435516,Lipoprotein deficiency disorder,racial,Asian,4,1,5
193520,Urinary bladder stone,racial,White,0,4,4
4050793,FH: Infectious disease,racial,White,4,1,5
432791,Urticaria-angio-oedema,racial,Asian,4,0,4
440925,Suicide,ethnic,Not Hispanic or Latino,4,0,4
378427,Tear film insufficiency,racial,Native Hawaiian or Other Pacific Islander ,4,0,4
198985,Primary malignant neoplasm of kidney,racial,Other Race,1,3,4
4144274,Housing lack,racial,Black or African American ,2,2,4
381001,Subjective visual disturbance,racial,Unknown,1,4,5
441830,Disorder of fluid AND/OR electrolyte,racial,Asian,2,2,4
440938,Infection by Shigella,ethnic,Hispanic or Latino,2,2,4
134438,CD - Contact dermatitis,racial,Asian Indian,1,4,5
440084,Aphemesthaesia,ethnic,Hispanic or Latino,1,4,5
4096347,Gouty arthropathy,racial,Other Race,0,4,4
433178,Anxiety disorder of childhood OR adolescence,racial,White,1,3,4
257660,Partial anomalous pulmonary venous connection,racial,Unknown,0,4,4
433990,Subchronic catatonic schizophrenia,ethnic,Not Hispanic or Latino,0,4,4
439003,Disorder of branched chain amino acid metabolism,racial,Black or African American ,0,4,4
440814,Torticollis,racial,Other Race,2,2,4
438172,Atrial septal defect as current complication following acute myocardial infarction,ethnic,Hispanic or Latino,4,0,4
195851,"Gastric ulcer without hemorrhage, without perforation AND without obstruction",racial,Other Race,1,2,3
380669,Benign neoplasm of eyelid including canthus,racial,White,2,2,4
192276,Chronic gouty nephropathy,ethnic,Not Hispanic or Latino,4,0,4
440372,Acquired thrombocytopenia,ethnic,Not Hispanic or Latino,1,3,4
436539,Closed fracture of patella,racial,Black or African American ,0,4,4
432868,Hemoglobinopathy,ethnic,Not Hispanic or Latino,1,2,3
133013,Congenital spinal cord anomaly,ethnic,Not Hispanic or Latino,3,1,4
381570,Mechanical ptosis,racial,White,3,1,4
442068,Cellulitis and abscess of forearm,racial,Other Race,4,0,4
81112,Arthralgia of the lower leg,racial,Asian Indian,4,0,4
318852,Congenital malformation of vitreous body,ethnic,Not Hispanic or Latino,4,0,4
195209,Benign neoplasm of liver and/or biliary ducts,racial,White,2,1,3
433716,Primary malignant neoplasm of testis,racial,Unknown,0,4,4
73008,Enthesopathy,racial,Black or African American ,1,2,3
195501,Polycystic ovaries,racial,Other Race,4,0,4
380834,Coma,racial,White,1,3,4
78200,Benign mammary dysplasia,racial,Asian,4,0,4
22340,Esophageal varices without bleeding,ethnic,Not Hispanic or Latino,2,2,4
194788,Open wound of anterior abdominal wall with complication,ethnic,Not Hispanic or Latino,4,0,4
437557,Eczematous dermatitis of eyelid,ethnic,Not Hispanic or Latino,2,2,4
194996,Postoperative urethral stricture,ethnic,Hispanic or Latino,1,2,3
4110047,Chronic bronchitis NOS,racial,Black or African American ,0,4,4
374886,Benign neoplasm of ear,racial,Unknown,3,1,4
436166,Mild hyperemesis gravidarum,racial,Black or African American ,4,0,4
4331070,Family history of polyp of colon,racial,Unknown,1,2,3
437677,Abnormal findings on diagnostic imaging of lung,racial,Asian,2,1,3
4115062,Other internal knee derangement NOS,ethnic,Hispanic or Latino,0,4,4
377573,Pars tensa central perforation,ethnic,Hispanic or Latino,1,2,3
432252,Sequelae of infectious and parasitic diseases,racial,Unknown,0,4,4
443260,Umbilical lump,ethnic,Not Hispanic or Latino,4,0,4
4083236,Alcoholism counselling,ethnic,Hispanic or Latino,0,4,4
378424,Astigmatism,ethnic,Not Hispanic or Latino,2,2,4
434374,Anisocoria,racial,White,1,2,3
442068,Cellulitis and abscess of forearm,racial,American Indian or Alaska Native ,1,2,3
377001,Unruptured cerebral aneurysm,racial,Other Race,4,0,4
439221,"Adverse effect, due to correct medicinal substance properly administered",racial,Asian,2,2,4
372912,Visual discomfort,racial,White,2,1,3
78272,Sprain of wrist,racial,Black or African American ,2,2,4
198860,Congenital anomaly of lower alimentary tract,ethnic,Hispanic or Latino,4,0,4
196569,Contusion of abdominal wall,racial,White,1,2,3
4030398,Amputation of arm through shoulder,ethnic,Hispanic or Latino,1,3,4
74211,Superficial injury of finger without infection,racial,White,2,2,4
4326681,Family history of malignant neoplasm of ovary,racial,White,4,0,4
438917,Superficial foreign body without major open wound AND without infection,ethnic,Hispanic or Latino,2,2,4
4092845,Candidiasis NOS,ethnic,Hispanic or Latino,1,3,4
4089980,Early congenital syphilis - latent,ethnic,Hispanic or Latino,0,4,4
4002828,Acute osteomyelitis NOS,racial,White,0,4,4
75946,Sprain of proximal tibiofibular ligament,ethnic,Hispanic or Latino,4,0,4
444055,Thrombophlebitis of superficial veins of lower extremity,racial,White,3,1,4
137497,Dermatophytosis of the body,racial,American Indian or Alaska Native ,4,0,4
373463,Benign cough headache,ethnic,Hispanic or Latino,3,1,4
443622,Aneurysm of thoracic aorta,racial,Unknown,0,4,4
317376,Tachypnoeic,ethnic,Not Hispanic or Latino,1,3,4
316814,Hyperventilation,ethnic,Not Hispanic or Latino,3,1,4
76240,Closed fracture of pubis,racial,Unknown,4,0,4
197330,Finding of urethral sphincter function,ethnic,Hispanic or Latino,1,2,3
72618,Disorder of muscle,ethnic,Not Hispanic or Latino,1,2,3
139036,Systolic dysfunction,racial,White,1,3,4
40480943,Lateral cystocele,racial,White,4,0,4
443862,Complication of internal anastomosis,ethnic,Hispanic or Latino,4,0,4
192276,Chronic gouty nephropathy,racial,Black or African American ,4,0,4
198802,Occlusion of ureter,ethnic,Not Hispanic or Latino,1,2,3
200781,Unilateral small kidney,racial,White,0,4,4
197500,Primary malignant neoplasm of colon,racial,Other Race,0,4,4
74725,Displacement of cervical intervertebral disc without myelopathy,racial,Other Race,4,0,4
442287,Rest pain,racial,White,1,2,3
374645,Phantom limb syndrome,ethnic,Not Hispanic or Latino,0,4,4
434675,Complication of gastrostomy,ethnic,Not Hispanic or Latino,1,2,3
437176,Late effect of accidental fall,ethnic,Not Hispanic or Latino,3,1,4
436957,Functional disorders of polymorphonuclear neutrophils,racial,Other Race,4,0,4
78219,Cellulitis and abscess of hand excluding digits,racial,Asian,0,4,4
4177115,Malignant tumour of testis,racial,White,0,4,4
432417,Acquired hallux malleus,racial,White,3,1,4
30163,Cellulitis and abscess of neck,racial,Unknown,3,1,4
442010,Seafood-induced anaphylaxis,ethnic,Hispanic or Latino,2,2,4
438407,BN - Bulimia nervosa,ethnic,Not Hispanic or Latino,2,1,3
374940,Blepharophimosis syndrome,racial,White,1,3,4
4042836,Disease of head,ethnic,Hispanic or Latino,4,0,4
4185471,Disorder of pigmentation,racial,Black or African American ,1,2,3
25582,Tracheesophageal fistula,racial,White,0,4,4
435950,Closed Colles' fracture,racial,Other Race,4,0,4
443732,Disorder associated with type II diabetes melliltus,racial,Black or African American ,4,0,4
192273,Benign tumour of adrenal gland,ethnic,Not Hispanic or Latino,2,1,3
440193,Wristdrop,racial,White,0,4,4
4298824,Free skin graft,racial,Unknown,3,1,4
192367,Dysplasia of cervix,racial,Unknown,4,0,4
441827,Disorder of amino acid and organic acid metabolism,racial,Unknown,4,0,4
195770,Subserous uterine fibroid,racial,White,4,0,4
439314,Thrombophlebitis of the femoral vein,racial,Unknown,4,0,4
4095918,Other disorders of thyroid,ethnic,Hispanic or Latino,4,0,4
79936,Polyuria,racial,Asian,2,1,3
75924,Osteodystrophy,ethnic,Hispanic or Latino,1,3,4
4021168,Natural contraception,ethnic,Hispanic or Latino,4,0,4
196438,Acquired arteriovenous fistula of liver,racial,Asian,0,4,4
4144149,Cared for by family,racial,White,2,2,4
78272,Sprain of wrist,racial,Asian,4,0,4
138876,Closed fracture of T1-T6 level with spinal cord injury,ethnic,Hispanic or Latino,4,0,4
442310,Acute heart failure,racial,White,1,2,3
261782,Herpetic ulceration of vulva,racial,Unknown,4,0,4
200769,"Chronic gastric ulcer without hemorrhage, without perforation AND without obstruction",ethnic,Not Hispanic or Latino,4,0,4
135710,"Burn involving 30-39 percent of body surface, with 20-29 percent of body surface with full thickness burn",ethnic,Not Hispanic or Latino,0,4,4
441092,Advanced maternal age gravida,racial,Asian,4,0,4
440374,Obsessive compulsive disorder,racial,American Indian or Alaska Native ,1,3,4
439799,Leg cramps,racial,Asian,4,0,4
200391,Peripheral autonomic neuropathy disease EC,racial,Other Race,2,2,4
442747,Contact dermatitis due to food in contact with skin,racial,White,2,2,4
373404,Ophthalmic herpes simplex,ethnic,Hispanic or Latino,3,1,4
435325,Umbilical cord complication,racial,White,1,2,3
439685,"Malignant neoplasm, overlapping lesion of digestive system",ethnic,Hispanic or Latino,4,0,4
375800,Dystonia,ethnic,Hispanic or Latino,4,0,4
4046893,Lifestyle,racial,Black or African American ,1,3,4
4213085,Family history of prostate cancer,ethnic,Not Hispanic or Latino,0,4,4
436033,Syphilis,racial,Black or African American ,0,4,4
438120,Opioid dependence,racial,Native Hawaiian or Other Pacific Islander ,0,4,4
73017,Congenital anomaly of toe,ethnic,Hispanic or Latino,4,0,4
75426,Burn of hand,racial,White,1,2,3
196796,Congenital biliary atresia,ethnic,Hispanic or Latino,4,0,4
4318408,Subdural haematoma,racial,Black or African American ,1,3,4
438297,"Mechanical complication of cardiac device, implant AND/OR graft",racial,White,0,4,4
437982,Semen observations,racial,White,0,4,4
77030,Disease of breast,racial,Asian,4,0,4
73318,Polydactyly of fingers,ethnic,Hispanic or Latino,4,0,4
443525,Monoplegia of dominant upper limb as a late effect of cerebrovascular accident,ethnic,Hispanic or Latino,0,4,4
438567,Adult failure to thrive syndrome,ethnic,Not Hispanic or Latino,1,2,3
4143915,Cholestasis,racial,White,2,1,3
441261,Episodic acute alcoholic intoxication in alcoholism,ethnic,Not Hispanic or Latino,4,0,4
79884,Galactorrhea not associated with childbirth,racial,Black or African American ,4,0,4
439003,Disorder of branched chain amino acid metabolism,racial,White,0,4,4
4066036,Gastroduodenal fistula,ethnic,Hispanic or Latino,4,0,4
439246,"Mixed bipolar affective disorder, severe, with psychosis",racial,White,2,1,3
438116,Benign neoplasm of short bones of lower limb,ethnic,Hispanic or Latino,2,2,4
435792,Drug-induced sleep disorder,ethnic,Hispanic or Latino,2,2,4
4143915,Cholestasis,racial,Unknown,3,1,4
73819,Painful breasts,racial,American Indian or Alaska Native ,4,0,4
443788,Peritoneal adhesions with obstruction,ethnic,Hispanic or Latino,3,1,4
374934,Impairment level: one eye: severe impairment: other eye: near-normal vision,racial,Unknown,1,3,4
434885,Benign neoplasm of skull and facial bones,ethnic,Hispanic or Latino,2,2,4
77968,Hallux valgus AND bunion,racial,Native Hawaiian or Other Pacific Islander ,4,0,4
135287,Non-neoplastic naevus,racial,Filipino,4,0,4
437541,Glaucoma,racial,Filipino,2,1,3
138858,Pale complexion,racial,Unknown,1,2,3
192673,Vascular insufficiency of intestine,racial,White,3,1,4
200680,Tumour of urinary bladder,ethnic,Hispanic or Latino,1,2,3
433015,Congenital anomaly of aortic arch,ethnic,Not Hispanic or Latino,1,2,3
256571,FB - Nasal foreign body,ethnic,Not Hispanic or Latino,2,1,3
200779,Intrauterine polyp,racial,Unknown,4,0,4
194964,Aneurysm of splenic artery,racial,White,4,0,4
444234,Late effect of complications of trauma,ethnic,Hispanic or Latino,1,3,4
132702,Erythema multiforme,racial,Unknown,2,2,4
75103,Sprain of jaw,ethnic,Not Hispanic or Latino,4,0,4
441422,Closed fracture of humerus,racial,Asian,4,0,4
375504,Psychoactive substance-induced organic mental disorder,ethnic,Not Hispanic or Latino,1,2,3
432729,Crying infant,ethnic,Not Hispanic or Latino,2,2,4
440956,Primary malignant neoplasm of upper inner quadrant of female breast,racial,Unknown,4,0,4
372635,Corneal degeneration,racial,Unknown,2,1,3
376400,Combined form of senile cataract,racial,Native Hawaiian or Other Pacific Islander ,4,0,4
437038,Blood in urine,racial,American Indian,0,4,4
256215,"Lung agenesis, hypoplasia and dysplasia",racial,Other Race,4,0,4
312336,Arterial aneurysm,racial,Unknown,3,1,4
440350,"Malignant lymphoma - lymphocytic, intermediate differentiation",racial,White,0,4,4
79121,Aseptic necrosis of talus,racial,White,4,0,4
137520,Chronic thyroiditis,ethnic,Hispanic or Latino,3,1,4
78842,Acquired postural lordosis,ethnic,Hispanic or Latino,3,1,4
199876,Prolapse of female genital organs,ethnic,Not Hispanic or Latino,4,0,4
4107655,Observations relating to psychosocial functioning,racial,Black or African American ,2,2,4
134398,Periodontal disease,racial,Unknown,1,2,3
437537,Shyness disorder of childhood,ethnic,Hispanic or Latino,1,3,4
133727,Thyrotoxicosis without goiter OR other cause,racial,American Indian or Alaska Native ,4,0,4
136775,Contact dermatitis due to solar radiation,racial,Unknown,2,1,3
133728,Congenital hypothyroidism,racial,Unknown,4,0,4
197239,Haemangioma of intra-abdominal structure,racial,Unknown,1,2,3
4103403,Psychosexual disorder NOS,racial,White,1,3,4
438469,"Duodenal ulcer without hemorrhage, without perforation AND without obstruction",racial,Asian,4,0,4
4173498,FH: Heart disorder,racial,Unknown,2,1,3
312922,Coronary bypass graft observation,racial,Black or African American ,1,3,4
441262,"Amfetamine or psychostimulant dependence, episodic",ethnic,Not Hispanic or Latino,2,2,4
201093,Infection of skin AND/OR subcutaneous tissue,racial,Black or African American ,2,1,3
437243,Chronic paranoid schizophrenia with acute exacerbation,racial,Black or African American ,0,4,4
4318408,Subdural haematoma,ethnic,Not Hispanic or Latino,1,3,4
377298,Chronic otitis externa,ethnic,Not Hispanic or Latino,2,2,4
434549,Fall from toilet seat,racial,White,2,1,3
435457,Primary progressive tuberculosis,racial,White,0,4,4
138845,Rheumatism,racial,Unknown,4,0,4
434056,Late effects of cerebrovascular disease,racial,Native Hawaiian or Other Pacific Islander ,0,4,4
313224,Anomalous atrioventricular excitation,racial,Unknown,1,2,3
436532,Congenital cytomegalovirus infection,racial,White,1,2,3
434821,SIRS - System inflammatory response syndrome,racial,Other Race,2,2,4
31317,Can't get food down,racial,Filipino,0,4,4
4168217,Generalized hyperhidrosis,racial,Asian,3,1,4
443442,Finding of vaginal vault smear result,ethnic,Not Hispanic or Latino,4,0,4
198101,Lipoma of skin and subcutaneous tissue (excluding face),racial,Other Race,2,2,4
4066820,Ingestion dermatitis due to food,racial,Unknown,2,1,3
24970,Chronic laryngitis,racial,Other Race,3,1,4
72576,Benign tumour of breast,racial,Asian,4,0,4
141004,Lesion of radial nerve,racial,Unknown,1,2,3
440238,Closed fracture of metatarsal bone,racial,Other Race,4,0,4
376422,Mucopurulent conjunctivitis,racial,Black or African American ,1,2,3
433948,Accident caused by handgun,racial,White,0,4,4
196751,Haemorrhage from placenta previa,ethnic,Hispanic or Latino,4,0,4
444382,Thoracic radiculitis,racial,Black or African American ,2,2,4
80045,Primary malignant neoplasm of anus,racial,Unknown,2,2,4
433621,Sprain of sternoclavicular joint AND/OR ligament,racial,White,2,1,3
444256,Polyp of labia,ethnic,Hispanic or Latino,4,0,4
437744,Heat exhaustion,ethnic,Hispanic or Latino,1,2,3
73336,Closed traumatic dislocation ankle joint,ethnic,Hispanic or Latino,2,1,3
442775,Degeneration of thoracic intervertebral disc,racial,Unknown,3,1,4
197950,Cellulitis and abscess of trunk,racial,Black or African American ,1,3,4
4055758,Temporomandibular joint disorder NOS,racial,Unknown,3,1,4
377873,Lid lag,racial,Unknown,0,4,4
140027,Herpetic gingivostomatitis,racial,Asian,2,1,3
201620,Calculus of kidney,racial,American Indian or Alaska Native ,4,0,4
438205,Maternal syphilis during pregnancy - baby not yet delivered,ethnic,Hispanic or Latino,4,0,4
442444,"Motor vehicle traffic accident involving pedestrian hit by motor vehicle, pedestrian injured",ethnic,Hispanic or Latino,4,0,4
4225928,Heteronymous hemianopsia,ethnic,Hispanic or Latino,2,1,3
377556,Sudden visual loss,ethnic,Not Hispanic or Latino,4,0,4
443767,Diabetic oculopathy,racial,Asian Indian,4,0,4
197324,Disease of peritoneum,ethnic,Hispanic or Latino,2,2,4
441968,Acetonuria,ethnic,Not Hispanic or Latino,4,0,4
80232,Closed fracture of calcaneus,ethnic,Not Hispanic or Latino,0,4,4
201907,Oedema of male genital organs,ethnic,Not Hispanic or Latino,0,4,4
256197,Rheumatoid lung disease,racial,White,0,4,4
435141,Haemorrhage AND/OR haematoma complicating procedure,racial,White,4,0,4
4270866,Symptomatic dermographism,racial,White,3,1,4
80593,Urinary complication,ethnic,Hispanic or Latino,4,0,4
438409,Attention deficit hyperactivity disorder,racial,Native Hawaiian or Other Pacific Islander ,0,4,4
79189,Open wound of chest wall with complication,ethnic,Not Hispanic or Latino,0,4,4
442013,Burn,racial,Other Race,2,1,3
74125,Inflammatory polyarthropathy,ethnic,Not Hispanic or Latino,1,2,3
4060434,Unstable lie unspecified,ethnic,Hispanic or Latino,4,0,4
442936,"Motor vehicle traffic accident due to motor vehicle going out of control due to failure of mechanical part, without collision on the highway, passenger of motor vehicle injured",ethnic,Hispanic or Latino,3,1,4
23220,Chronic tonsillitis,ethnic,Not Hispanic or Latino,1,3,4
198400,Haemangioma of skin and subcutaneous tissue,racial,Other Race,1,3,4
435141,Haemorrhage AND/OR haematoma complicating procedure,racial,Unknown,0,4,4
4251787,Tuberculosis of rectum,ethnic,Hispanic or Latino,4,0,4
40481819,Early satiety,racial,Unknown,2,1,3
443360,Eye mass,racial,Unknown,3,1,4
435787,Vitamin B6 deficiency,racial,Unknown,4,0,4
375822,Neonatal obstruction of nasolacrimal duct,ethnic,Not Hispanic or Latino,2,1,3
197036,Vesicoureteral reflux,racial,Other Race,0,4,4
442295,Disorder of carbohydrate transport,ethnic,Hispanic or Latino,2,1,3
440612,Toxic effect of tobacco and nicotine,ethnic,Not Hispanic or Latino,1,3,4
135852,Teething syndrome,racial,Other Race,2,2,4
193250,Gastric hemorrhage,racial,White,0,4,4
194079,Post-surgical malabsorption,racial,Native Hawaiian or Other Pacific Islander ,0,4,4
4049623,"Moderate major depression, single episode",racial,Filipino,0,4,4
441818,Haemangioma,racial,Black or African American ,3,1,4
321109,Congenital anomaly of coronary artery,ethnic,Hispanic or Latino,1,2,3
433701,Mycosis,racial,Unknown,2,1,3
4147497,Nervous system and sense organ diseases,racial,Other Race,1,2,3
4006788,Percutaneous transluminal coronary balloon angioplasty,racial,Unknown,3,1,4
4100367,Simple schizophrenia NOS,racial,White,3,1,4
433031,Hallucinations,racial,Other Race,2,1,3
376387,Spasmodic torticollis,ethnic,Hispanic or Latino,2,2,4
78235,Disorder of coccyx,racial,Asian,3,1,4
442308,Abrasion AND/OR friction burn of thigh without infection,racial,Other Race,1,3,4
134404,Anal spasm,ethnic,Hispanic or Latino,2,2,4
193787,Varicose veins of lower extremity with ulcer AND inflammation,ethnic,Not Hispanic or Latino,1,3,4
4104042,Strabismus (squint) and other disorders of binocular eye movements,ethnic,Hispanic or Latino,4,0,4
199978,Contusion of lower limb,racial,Other Race,1,3,4
198240,Congenital buried penis,ethnic,Hispanic or Latino,0,4,4
319845,Pulmonary valve disease,ethnic,Not Hispanic or Latino,4,0,4
436366,Benign tumour of testis,ethnic,Hispanic or Latino,0,4,4
435080,Biliuria,ethnic,Not Hispanic or Latino,1,2,3
320749,Periarteritis nodosa,ethnic,Hispanic or Latino,3,1,4
434592,B-cell lymphoma,racial,White,4,0,4
201614,Calculus of bile duct with cholecystitis,racial,Unknown,2,2,4
441351,Early onset of delivery - delivered,ethnic,Hispanic or Latino,2,2,4
134442,Thibierge-Weissenbach syndrome,racial,Asian,4,0,4
437226,Malignant neoplasm of nasopharyngeal wall,racial,Asian,0,4,4
376946,Senile delirium,racial,Filipino,4,0,4
4168226,Micturition frequency and polyuria,ethnic,Not Hispanic or Latino,2,1,3
196168,Irregular menstrual bleeding,racial,Filipino,4,0,4
4037738,Visual alteration,racial,Unknown,2,1,3
79189,Open wound of chest wall with complication,racial,Black or African American ,0,4,4
440029,Viral disease,racial,American Indian or Alaska Native ,2,1,3
79897,Obstetric non-purulent mastitis - delivered with postnatal complication,racial,Unknown,4,0,4
443269,Elderly primiparous with labor,ethnic,Hispanic or Latino,4,0,4
73043,Open traumatic dislocation of shoulder,racial,Unknown,4,0,4
4171594,Family history of cancer,ethnic,Hispanic or Latino,2,1,3
256723,Pneumonia and influenza,racial,White,0,4,4
439777,Anemia,racial,Asian Indian,4,0,4
437226,Malignant neoplasm of nasopharyngeal wall,ethnic,Not Hispanic or Latino,0,4,4
201595,Thrombosed internal hemorrhoids,racial,White,1,3,4
77647,Mallet finger,ethnic,Not Hispanic or Latino,2,2,4
196733,Urethral syndrome,racial,Unknown,3,1,4
441818,Haemangioma,racial,Asian,1,2,3
77960,Joint observation,racial,Unknown,1,2,3
261255,Benign neoplasm of bronchus and lung,racial,White,2,2,4
442794,Poisoning by wasp sting,racial,Unknown,2,2,4
255677,Open wound of nose without complication,racial,Unknown,1,3,4
316501,Disorder of blood vessels affecting skin,ethnic,Not Hispanic or Latino,2,2,4
377845,Anoxic encephalopathy,racial,White,2,1,3
444401,Delusions,ethnic,Hispanic or Latino,3,1,4
441532,Monoclonal paraproteinaemia,racial,Asian,4,0,4
194693,Postprocedural pelvic peritoneal adhesions,ethnic,Hispanic or Latino,4,0,4
440631,Mycobacterial disease,ethnic,Hispanic or Latino,1,2,3
434750,Feeding difficulties and mismanagement,racial,Filipino,4,0,4
434908,Disorder of porphyrin and haem metabolism,racial,White,2,1,3
381384,Congenital absence of external ear,racial,White,2,1,3
40482203,Karyotype evaluation abnormal,ethnic,Hispanic or Latino,3,1,4
142026,Disorder of cardiovascular prostheses and implants,racial,White,2,2,4
435524,Sleep disorder,racial,Asian,3,1,4
252663,Pneumonitis due to inhalation of food or vomitus,racial,Unknown,2,1,3
378743,Mild nonproliferative retinopathy,racial,Other Race,1,3,4
25572,Disease of salivary gland,racial,Unknown,1,2,3
432620,Disorder of choroid of eye,ethnic,Hispanic or Latino,3,1,4
433403,Viral meningitis,racial,Unknown,4,0,4
197988,General abdominal pain-symptom,racial,Black or African American ,2,2,4
320136,Disease of respiratory system,racial,Other Race,1,2,3
201606,Crohn's disease,racial,Black or African American ,2,2,4
73564,Complete rupture of rotator cuff,ethnic,Not Hispanic or Latino,2,2,4
194684,Crohn's disease of large bowel,ethnic,Hispanic or Latino,3,1,4
436352,Primary malignant neoplasm of laryngeal cartilage,racial,White,0,4,4
80806,Climacteric arthritis of multiple sites,racial,White,2,2,4
4056329,Vaginitis and vulvovaginitis NOS,racial,Black or African American ,4,0,4
4179925,Basic learning problem,racial,Black or African American ,1,3,4
375538,"Degeneration of macula due to cyst, hole or pseudohole",racial,Unknown,4,0,4
201059,Hypertrophic gastritis,ethnic,Hispanic or Latino,2,2,4
253549,Connective tissue disease,racial,Unknown,4,0,4
434557,Tuberculosis,racial,White,0,4,4
376647,Primary malignant neoplasm of soft tissues,racial,White,4,0,4
81141,Closed fracture of ilium,ethnic,Hispanic or Latino,4,0,4
440112,Chloasma of eyelid,ethnic,Hispanic or Latino,2,1,3
81169,Superficial foreign body of finger without major open wound AND without infection,racial,Unknown,2,2,4
259865,Cyst of Bartholin's gland duct,racial,Other Race,4,0,4
375550,Senile corneal changes,racial,Unknown,4,0,4
377294,Exotropia,ethnic,Not Hispanic or Latino,2,2,4
4013916,Closed fracture of clavicle NOS,racial,Unknown,4,0,4
444105,Burn any degree involving 70-79 percent of body surface,racial,White,0,4,4
372604,Movement disorder,ethnic,Not Hispanic or Latino,4,0,4
436667,Stammer,racial,White,1,2,3
78516,Arthralgia of the upper arm,racial,American Indian or Alaska Native ,3,1,4
4065992,Cellulitis and abscess of finger unspecified,racial,White,1,2,3
4134875,Weil's disease,racial,White,0,4,4
197723,Open wound of lateral abdominal wall without complication,ethnic,Hispanic or Latino,2,1,3
195587,Cholelithiasis AND cholecystitis with obstruction,racial,White,4,0,4
433869,Congenital rubella syndrome,racial,White,0,4,4
201211,Herpetic vulvovaginitis,racial,White,4,0,4
196991,Chronic renal disease,racial,Native Hawaiian or Other Pacific Islander ,1,3,4
4308509,Impaired fasting glycaemia,racial,Native Hawaiian or Other Pacific Islander ,1,3,4
316135,AVB - Atrioventricular block,racial,Unknown,0,4,4
132344,Gingival and periodontal disease,racial,Asian,2,2,4
436581,Accidental poisoning,ethnic,Hispanic or Latino,0,4,4
194411,Unilateral simple inguinal hernia,racial,Asian,0,4,4
137820,Postoperative hypothyroidism,racial,Black or African American ,4,0,4
40479849,Sexual abuse of adult,ethnic,Hispanic or Latino,2,1,3
192433,Congenital hypertrophic pyloric stenosis,racial,White,1,3,4
196431,Hypersensitivity angiitis,ethnic,Hispanic or Latino,2,2,4
433822,Complication related to pregnancy,ethnic,Not Hispanic or Latino,3,1,4
442600,Manic bipolar I disorder in partial remission,ethnic,Hispanic or Latino,4,0,4
321882,Generalised atherosclerosis,racial,American Indian or Alaska Native ,3,1,4
436941,Hypervitaminosis A,racial,White,1,2,3
375277,Non-infectious pinna disorders,racial,Unknown,0,4,4
436097,"Nondependent mixed drug abuse, continuous",racial,White,2,2,4
199062,"Acute gastric ulcer without hemorrhage, without perforation AND without obstruction",ethnic,Not Hispanic or Latino,1,3,4
261774,"Respiratory tuberculosis, not confirmed bacteriologically or histologically",ethnic,Hispanic or Latino,1,2,3
136661,Nodular goiter,ethnic,Hispanic or Latino,4,0,4
4051564,FH: Metabolic disorder,ethnic,Not Hispanic or Latino,3,1,4
375404,Ocular laceration with prolapse AND/OR exposure of intraocular tissue,racial,White,0,4,4
433246,"Chronic duodenal ulcer without hemorrhage, without perforation AND without obstruction",ethnic,Not Hispanic or Latino,4,0,4
438796,Chronic duodenal ulcer with hemorrhage AND with perforation but without obstruction,ethnic,Hispanic or Latino,0,4,4
436088,Nondependent opioid abuse in remission,racial,Unknown,0,4,4
376065,Neurologic disorder associated with type II diabetes mellitus,racial,American Indian,2,1,3
80201,Longitudinal deficiency of phalanges of hand,racial,White,1,3,4
432463,"Closed fracture clavicle, lateral end",ethnic,Hispanic or Latino,3,1,4
432768,Corneal foreign body,racial,White,1,2,3
192376,Rhesus isoimmunization with antenatal problem,racial,Asian,4,0,4
4210151,HIV counseling,racial,Unknown,0,4,4
4012570,High risk sexual behavior,racial,Asian,0,4,4
4188027,Food allergy,racial,Black or African American ,2,2,4
440108,Thyrotoxic exophthalmos,ethnic,Hispanic or Latino,0,4,4
4005603,Congenital cystic kidney disease NOS,racial,White,0,4,4
434944,Scleritis,racial,Unknown,2,1,3
4047937,Neonatal urinary tract infection,racial,Unknown,4,0,4
4164707,Canceled operative procedure,racial,Black or African American ,2,1,3
437942,Caesarean delivery - delivered,racial,Unknown,4,0,4
437643,Gait abnormality,racial,Native Hawaiian or Other Pacific Islander ,2,2,4
4014231,Foot sprain NOS,ethnic,Not Hispanic or Latino,4,0,4
378421,Alcoholic peripheral neuropathy,ethnic,Not Hispanic or Latino,1,2,3
4067537,Other disc disorders of unspecified site,racial,White,2,2,4
200174,Disease of skin AND/OR subcutaneous tissue,racial,Native Hawaiian or Other Pacific Islander ,1,2,3
377552,Moderate nonproliferative diabetic retinopathy,racial,Other Race,4,0,4
432436,Symbolic dysfunction,ethnic,Hispanic or Latino,2,2,4
442612,Burn any degree involving 50-59 percent of body surface,racial,White,0,4,4
139902,Allergic urticaria,racial,Other Race,1,3,4
440530,Oropharyngeal dysphagia,ethnic,Not Hispanic or Latino,1,2,3
78890,Sprain of elbow and forearm,ethnic,Not Hispanic or Latino,2,1,3
133438,Chronic lymphoid leukaemia in remission,ethnic,Not Hispanic or Latino,4,0,4
444084,Extrinsic allergic alveolitis,ethnic,Hispanic or Latino,1,3,4
132736,Bacteremia,racial,Unknown,2,1,3
4110046,Obstructive chronic bronchitis NOS,racial,Black or African American ,0,4,4
132553,Herpangina,racial,Other Race,3,1,4
4103638,Amputated - transfemoral,racial,Asian,1,3,4
438555,Cyanosis,racial,Black or African American ,4,0,4
436076,Adjustment disorder with mixed disturbance of emotions AND conduct,racial,White,1,2,3
73819,Painful breasts,racial,Native Hawaiian or Other Pacific Islander ,4,0,4
198806,Abscess of prostate,ethnic,Hispanic or Latino,0,4,4
77963,Achilles tendinitis,racial,Black or African American ,4,0,4
4114772,Other specified arthropathy,racial,White,0,4,4
80552,Closed fracture of the scaphoid,racial,Unknown,4,0,4
197145,Open wound of pelvic region without complication,ethnic,Hispanic or Latino,3,1,4
137548,Cervical root lesion,racial,Black or African American ,0,4,4
40481920,Periumbilical pain,racial,Other Race,1,2,3
438699,Primary malignant neoplasm of rectosigmoid junction,racial,White,0,4,4
373775,Psychophysical visual disturbance,racial,White,3,1,4
434030,Glaucoma with lens disorder,ethnic,Hispanic or Latino,0,4,4
440426,Vertigo as late effect of stroke,racial,American Indian or Alaska Native ,4,0,4
433862,Congenital anomaly of tongue,ethnic,Hispanic or Latino,2,2,4
260315,Tuberculosis of lung with cavitation,racial,Unknown,0,4,4
440112,Chloasma of eyelid,racial,Black or African American ,4,0,4
197330,Finding of urethral sphincter function,racial,White,1,2,3
4100912,Screening for rheumatoid conditions,ethnic,Not Hispanic or Latino,4,0,4
196217,Congenital malformation of diaphragm,racial,Unknown,2,2,4
440558,Closed dislocation of interphalangeal joint of finger,ethnic,Hispanic or Latino,0,4,4
444410,Carcinoma in situ of skin of ear,ethnic,Hispanic or Latino,4,0,4
437655,Cryptorchism,racial,Filipino,0,4,4
72618,Disorder of muscle,racial,Unknown,4,0,4
438701,UKP - Disseminated malignancy of unknown primary,ethnic,Not Hispanic or Latino,4,0,4
4215568,Sensory disturbance in limb,racial,White,4,0,4
4059014,Spontaneous bruising,racial,Other Race,2,1,3
73904,Open wound of buttock without complication,ethnic,Hispanic or Latino,2,2,4
254061,Pleural effusion,racial,Black or African American ,2,2,4
135710,"Burn involving 30-39 percent of body surface, with 20-29 percent of body surface with full thickness burn",racial,White,0,4,4
439082,Menopausal syndrome,racial,American Indian or Alaska Native ,4,0,4
200769,"Chronic gastric ulcer without hemorrhage, without perforation AND without obstruction",racial,White,4,0,4
132466,Lumbar sprain,racial,American Indian or Alaska Native ,3,1,4
4064375,Iron deficiency screening,racial,American Indian,3,1,4
434902,Autistic disorder of childhood onset,racial,Native Hawaiian or Other Pacific Islander ,0,4,4
437677,Abnormal findings on diagnostic imaging of lung,racial,Other Race,2,2,4
436232,"Polycystic kidney disease, adult type",racial,White,4,0,4
377570,Toxic optic neuropathy,ethnic,Hispanic or Latino,0,4,4
434782,Closed fracture of tibia AND fibula,racial,Unknown,3,1,4
75652,Congenital valgus deformity of foot,ethnic,Not Hispanic or Latino,0,4,4
373784,Acute allergic serous otitis media,racial,White,3,1,4
4004785,Fetal alcohol syndrome,racial,White,4,0,4
315833,Secondary cardiomyopathy,racial,Black or African American ,0,4,4
192785,Second degree burn of abdominal wall,ethnic,Hispanic or Latino,3,1,4
77068,Secondary localised osteoarthrosis of lower leg,racial,White,2,1,3
75354,Osteochondropathy,racial,American Indian or Alaska Native ,4,0,4
321887,Disorder of artery,racial,Asian,3,1,4
434459,Ganglion of tendon sheath,racial,Unknown,3,1,4
195770,Subserous uterine fibroid,ethnic,Hispanic or Latino,4,0,4
134718,Hirsutism,racial,Unknown,4,0,4
77234,Benign tumour of colon,racial,Black or African American ,2,2,4
443698,Abnormal anal Papanicolaou smear,ethnic,Hispanic or Latino,4,0,4
435517,Acidosis,racial,White,2,2,4
199839,External haemorrhoids without complication,racial,Other Race,1,2,3
4061056,Endometriosis NOS,ethnic,Hispanic or Latino,4,0,4
438398,Leukocytosis,racial,American Indian or Alaska Native ,4,0,4
194406,Urinary tract obstruction,racial,Black or African American ,0,4,4
78505,"Localised, primary osteoarthritis of the ankle and/or foot",ethnic,Not Hispanic or Latino,1,3,4
4149560,Hand sprain unspecified,racial,White,2,1,3
437233,Plasmacytic myeloma,racial,Black or African American ,4,0,4
75721,Prosthetic joint mechanical failure,ethnic,Not Hispanic or Latino,0,4,4
440373,Subchronic schizophrenia,racial,White,3,1,4
443563,Arteriosclerosis in coronary artery bypass graft,racial,Asian,0,4,4
376094,Arteriosclerotic dementia with delirium,racial,Unknown,2,1,3
4099356,Haemangioma of unspecified site,racial,White,2,1,3
440377,Paralysis,ethnic,Not Hispanic or Latino,0,4,4
318800,GERD - Gastro-esophageal reflux disease,racial,American Indian,3,1,4
77156,Superficial foreign body of toe without major open wound but with infection,racial,White,3,1,4
374044,Droopy eyelid,racial,Black or African American ,2,2,4
440009,Complication of implant,ethnic,Not Hispanic or Latino,2,1,3
73302,Curvature of spine,racial,White,2,2,4
380834,Coma,ethnic,Hispanic or Latino,3,1,4
192276,Chronic gouty nephropathy,racial,Unknown,1,2,3
374049,Acute mucoid otitis media,ethnic,Hispanic or Latino,2,1,3
318443,Arteriosclerotic vascular disease,racial,Unknown,3,1,4
200052,Primary malignant neoplasm of uterine adnexa,ethnic,Hispanic or Latino,4,0,4
436249,Closed fracture of femoral condyle of femur,ethnic,Hispanic or Latino,1,2,3
193739,Ovarian failure,ethnic,Hispanic or Latino,4,0,4
377085,Congenital anomaly of brain,ethnic,Not Hispanic or Latino,0,4,4
133013,Congenital spinal cord anomaly,racial,White,1,2,3
194406,Urinary tract obstruction,racial,Asian,0,4,4
4050091,Open wound of penis,racial,White,0,4,4
380702,Cerebral cysts,racial,Asian,0,4,4
4171430,Screening for malignant neoplasm of rectum,racial,Filipino,1,2,3
198860,Congenital anomaly of lower alimentary tract,racial,White,4,0,4
136773,Rosacea,racial,Asian,1,2,3
318852,Congenital malformation of vitreous body,racial,White,4,0,4
432252,Sequelae of infectious and parasitic diseases,ethnic,Hispanic or Latino,0,4,4
73008,Enthesopathy,racial,Other Race,2,1,3
434298,Metastasis to upper limb lymph node,racial,Unknown,4,0,4
432312,Anatomical narrow angle glaucoma,ethnic,Not Hispanic or Latino,3,1,4
136198,Cervical spondylosis with myelopathy,racial,Black or African American ,4,0,4
315564,Aortic valve regurgitation,ethnic,Hispanic or Latino,1,2,3
4089980,Early congenital syphilis - latent,racial,White,0,4,4
4002828,Acute osteomyelitis NOS,ethnic,Hispanic or Latino,0,4,4
376964,Partial recent retinal detachment with giant tear,racial,Unknown,0,4,4
374957,Acquired stenosis of external ear canal,ethnic,Hispanic or Latino,1,3,4
253234,Upper respiratory inflammation due to fumes AND/OR vapors,ethnic,Hispanic or Latino,2,1,3
443344,Barrett esophagus,racial,Asian,2,2,4
4265600,Gastric ulcer,racial,White,3,1,4
75721,Prosthetic joint mechanical failure,racial,Black or African American ,0,4,4
436957,Functional disorders of polymorphonuclear neutrophils,ethnic,Not Hispanic or Latino,4,0,4
441049,Enamel caries,racial,White,3,1,4
377291,"Peripheral pterygium, progressive",racial,Unknown,1,2,3
435517,Acidosis,racial,Other Race,0,4,4
379801,Trigeminal neuralgia,racial,Asian,3,1,4
4109260,Other eyelid disorders,ethnic,Hispanic or Latino,2,1,3
377566,Palsy of conjugate gaze,ethnic,Hispanic or Latino,4,0,4
432895,Cortical senile cataract,racial,Asian,2,2,4
437741,Accidental burning caused by caustic and corrosive substance,ethnic,Hispanic or Latino,0,4,4
197239,Haemangioma of intra-abdominal structure,ethnic,Not Hispanic or Latino,4,0,4
440350,"Malignant lymphoma - lymphocytic, intermediate differentiation",ethnic,Hispanic or Latino,0,4,4
79121,Aseptic necrosis of talus,ethnic,Hispanic or Latino,4,0,4
4141201,Beta lactam resistant bacterial infection,ethnic,Hispanic or Latino,3,1,4
316447,Chronic hypotension,racial,White,3,1,4
257315,Bacterial pneumonia,racial,Other Race,2,2,4
193252,Diverticulosis of small intestine,ethnic,Hispanic or Latino,3,1,4
444129,Wrist injury,racial,Black or African American ,2,2,4
432966,Hypertrophy of vulva,racial,White,4,0,4
434633,Disorder of autonomic nervous system,ethnic,Not Hispanic or Latino,2,1,3
437969,Acquired pes planus,racial,Asian,1,2,3
432311,Angle-closure glaucoma - borderline,racial,Other Race,4,0,4
4103403,Psychosexual disorder NOS,ethnic,Hispanic or Latino,1,3,4
435242,Cerebellar ataxia,racial,White,1,3,4
435457,Primary progressive tuberculosis,ethnic,Hispanic or Latino,0,4,4
437384,Raised laboratory findings,ethnic,Hispanic or Latino,4,0,4
443428,Torus fracture of radius,ethnic,Hispanic or Latino,1,2,3
80571,Open wound of foot with complication,ethnic,Not Hispanic or Latino,3,1,4
4100529,Misuse of drugs NOS,racial,Black or African American ,1,3,4
374950,Oedema of eyelid,ethnic,Not Hispanic or Latino,3,1,4
435726,Mechanical complication of device,ethnic,Hispanic or Latino,2,2,4
376973,Cataract secondary to ocular disease,racial,Unknown,2,2,4
79098,Suppressed lactation,ethnic,Not Hispanic or Latino,0,4,4
4173498,FH: Heart disorder,racial,Asian,0,4,4
435372,Underweight,racial,American Indian,4,0,4
372425,Congenital abnormality of ear,racial,White,1,3,4
135204,Mycosis fungoides of extranodal AND/OR solid organ site,ethnic,Hispanic or Latino,4,0,4
438725,Disorder of magnesium metabolism,ethnic,Hispanic or Latino,3,1,4
441788,Human papilloma virus infection,racial,Asian,4,0,4
4003982,Other specified skin anomalies,racial,White,1,3,4
4108664,Hypertensive heart disease NOS,racial,Unknown,4,0,4
443111,Tenosynovitis of foot,racial,Black or African American ,1,3,4
77074,Joint pain,racial,American Indian or Alaska Native ,4,0,4
440385,Obstructive hydrocephalus,racial,Unknown,0,4,4
438469,"Duodenal ulcer without hemorrhage, without perforation AND without obstruction",racial,White,4,0,4
433320,Excessive crying of child,racial,White,1,2,3
4088920,Womb absent,racial,Black or African American ,4,0,4
4346969,Joint mice in knee,racial,Unknown,1,3,4
4167406,Eye disorder screening,racial,Asian,4,0,4
195314,Nephrotic syndrome,ethnic,Not Hispanic or Latino,0,4,4
132776,Injury involving multiple body regions,ethnic,Hispanic or Latino,2,2,4
199078,Vaginal wall prolapse,ethnic,Not Hispanic or Latino,4,0,4
196160,Fistula of intestine,racial,Black or African American ,4,0,4
436098,Nondependent cocaine abuse in remission,racial,White,0,4,4
197675,Bowel incontinence,racial,Asian,0,4,4
435849,Parietoalveolar pneumopathy,ethnic,Hispanic or Latino,1,3,4
433948,Accident caused by handgun,ethnic,Hispanic or Latino,0,4,4
137057,Paronychia,racial,Other Race,1,2,3
442286,Abscess of digit,racial,Other Race,2,1,3
74635,Lumbosacral root lesion,racial,Other Race,1,2,3
374384,Cerebral ischemia,racial,White,0,4,4
441896,Plicated tongue,ethnic,Hispanic or Latino,3,1,4
441547,Oppositional defiant disorder,racial,Unknown,0,4,4
201093,Infection of skin AND/OR subcutaneous tissue,racial,Other Race,4,0,4
314090,PET - Mild pre-eclamptic toxaemia,racial,White,4,0,4
198199,Pyelonephritis,racial,Black or African American ,3,1,4
437787,Secondary syphilis,ethnic,Not Hispanic or Latino,0,4,4
439685,"Malignant neoplasm, overlapping lesion of digestive system",racial,White,4,0,4
374948,Acute nonsuppurative otitis media,racial,Other Race,3,1,4
195847,Gastroparesis syndrome,racial,Black or African American ,1,2,3
132834,White piedra,racial,White,1,2,3
375800,Dystonia,racial,White,2,1,3
442747,Contact dermatitis due to food in contact with skin,ethnic,Hispanic or Latino,2,1,3
196369,Adrenogenital disorder,ethnic,Not Hispanic or Latino,1,3,4
254443,Sicca syndrome,racial,Other Race,4,0,4
444388,Blister of leg without infection,racial,White,2,1,3
440238,Closed fracture of metatarsal bone,racial,Asian,4,0,4
319921,Congenital pulmonary valve abnormality,ethnic,Hispanic or Latino,3,1,4
375527,Headache disorder,racial,Asian,4,0,4
197928,Menstruation absent,racial,Native Hawaiian or Other Pacific Islander ,4,0,4
4005823,Tobacco user,racial,American Indian or Alaska Native ,2,1,3
440956,Primary malignant neoplasm of upper inner quadrant of female breast,ethnic,Hispanic or Latino,4,0,4
77129,Closed fracture of pelvis,racial,Black or African American ,4,0,4
439928,Gangrenous disorder,racial,Other Race,1,3,4
4168217,Generalized hyperhidrosis,racial,Other Race,2,2,4
194964,Aneurysm of splenic artery,ethnic,Not Hispanic or Latino,2,2,4
443447,Iatrogenic hypotension,racial,White,3,1,4
440392,Retinal vascular occlusion,racial,Unknown,3,1,4
73318,Polydactyly of fingers,racial,White,4,0,4
374934,Impairment level: one eye: severe impairment: other eye: near-normal vision,ethnic,Hispanic or Latino,1,3,4
75614,Acrodermatitis continua,racial,Black or African American ,1,3,4
381306,Deaf mutism,racial,Black or African American ,4,0,4
434547,Complication of surgical procedure,ethnic,Hispanic or Latino,2,2,4
377280,Corneal disorder,racial,White,2,1,3
73847,Observation of elbow joint,ethnic,Hispanic or Latino,1,3,4
77025,Diverticulitis of colon,racial,Other Race,2,2,4
80070,Uric acid urolithiasis,racial,Unknown,4,0,4
435723,Wound seroma,racial,Unknown,4,0,4
436700,Eye displaced forwards,racial,White,3,1,4
200779,Intrauterine polyp,ethnic,Not Hispanic or Latino,4,0,4
195289,Goodpasture's syndrome,racial,White,2,1,3
4073997,Stretching of prepuce,ethnic,Hispanic or Latino,0,4,4
4179963,Family history of malignant neoplasm of breast,racial,Black or African American ,4,0,4
4100857,Pickwickian syndrome,racial,Filipino,1,3,4
434376,Acute myocardial infarction of anterior wall,racial,Unknown,0,4,4
4066376,Pilonidal sinus with abscess,racial,Black or African American ,0,4,4
439791,Emotional upset,racial,Unknown,3,1,4
135930,Musculoskeletal system observation,ethnic,Not Hispanic or Latino,4,0,4
4024000,Urinary system finding,ethnic,Not Hispanic or Latino,1,2,3
254443,Sicca syndrome,racial,American Indian or Alaska Native ,4,0,4
440083,Acute stress disorder,racial,Asian,4,0,4
321661,Spinal stenosis of thoracic region,ethnic,Not Hispanic or Latino,3,1,4
141038,Diastolic dysfunction,racial,Other Race,0,4,4
441246,Hemangioma of intracranial structure,racial,White,3,1,4
4157605,Infection due to resistant organism,ethnic,Hispanic or Latino,1,2,3
196156,Urethral diverticulum,ethnic,Hispanic or Latino,4,0,4
437902,Teeth development and eruption disorders,racial,Asian,0,4,4
74458,Enthesopathy of knee region,racial,Unknown,4,0,4
194964,Aneurysm of splenic artery,ethnic,Hispanic or Latino,4,0,4
78579,Closed fracture of first cervical vertebra,racial,Unknown,4,0,4
133367,Second degree burn of wrist,ethnic,Hispanic or Latino,4,0,4
372925,Cholesteatoma,racial,Asian,0,4,4
261255,Benign neoplasm of bronchus and lung,ethnic,Not Hispanic or Latino,2,2,4
441177,Second degree burn of upper limb,racial,Unknown,1,3,4
4104042,Strabismus (squint) and other disorders of binocular eye movements,racial,White,4,0,4
434467,Ostium secundum type atrial septal defect,racial,Asian,2,2,4
75897,Polyarthropathy,racial,Unknown,4,0,4
320749,Periarteritis nodosa,racial,White,3,1,4
436134,Disorder of sclera,ethnic,Not Hispanic or Latino,1,2,3
380094,Carpal tunnel syndrome,racial,American Indian or Alaska Native ,4,0,4
435887,Antepartum deep phlebothrombosis,ethnic,Not Hispanic or Latino,4,0,4
439653,Partial epilepsy without mention of impairment of consciousness,racial,Unknown,1,3,4
435506,Benign neoplastic disease,racial,White,4,0,4
81379,Lateral epicondylitis,racial,American Indian or Alaska Native ,4,0,4
440021,Herpes simplex without complication,racial,Asian,2,1,3
433911,Contusion of eye AND ocular adnexa,ethnic,Not Hispanic or Latino,2,2,4
79911,Effusion of joint of upper arm,racial,White,2,1,3
4292726,Contact - infectious disease,racial,Asian,2,2,4
443454,Cerebral infarction,racial,American Indian or Alaska Native ,0,4,4
372903,Retinal edema,ethnic,Not Hispanic or Latino,2,2,4
375824,Abnormal auditory perception,racial,Unknown,2,1,3
75863,Chronic interstitial cystitis,racial,Other Race,4,0,4
321638,"Benign essential hypertension complicating pregnancy, childbirth and the puerperium",racial,White,4,0,4
316084,Lymphadenitis,racial,Black or African American ,2,2,4
195584,Acute peptic ulcer without hemorrhage AND without perforation but with obstruction,ethnic,Hispanic or Latino,3,1,4
200452,Disease of female genital organ,racial,Unknown,4,0,4
313209,Left bundle branch hemiblock,ethnic,Not Hispanic or Latino,2,1,3
76565,Shoulder bruise,racial,Unknown,2,1,3
320744,Complete atrioventricular block,ethnic,Not Hispanic or Latino,2,1,3
76202,Non-traumatic rupture of Achilles tendon,racial,White,1,3,4
440366,Delay in sexual development AND/OR puberty,racial,White,1,3,4
76034,Herpes simplex whitlow,racial,White,2,2,4
26711,Chronic pharyngitis,racial,Asian,1,3,4
4288676,Acute and chronic cholecystitis,ethnic,Not Hispanic or Latino,1,2,3
381859,Infective OE,racial,Native Hawaiian or Other Pacific Islander ,2,1,3
4170137,Non-suppurative otitis media,racial,Black or African American ,1,3,4
4261613,Educational problem,racial,Black or African American ,0,4,4
444093,Patient status finding,racial,Black or African American ,1,2,3
73043,Open traumatic dislocation of shoulder,ethnic,Hispanic or Latino,4,0,4
441460,Late effect of sprain AND/OR strain without tendon injury,racial,Unknown,3,1,4
200349,Malignant lymphoma of intra-abdominal lymph nodes,ethnic,Hispanic or Latino,4,0,4
194693,Postprocedural pelvic peritoneal adhesions,racial,White,4,0,4
441507,"Early latent syphilis, positive serology, negative cerebrospinal fluid, less than 2 years after infection",racial,Unknown,0,4,4
256723,Pneumonia and influenza,ethnic,Not Hispanic or Latino,0,4,4
197609,"Cervical, vaginal and vulval inflammatory diseases",racial,White,4,0,4
444291,Cochlear hearing loss,ethnic,Not Hispanic or Latino,3,1,4
435987,Peanut-induced anaphylaxis,ethnic,Not Hispanic or Latino,1,3,4
201614,Calculus of bile duct with cholecystitis,ethnic,Hispanic or Latino,2,2,4
138176,Acute gingivitis,racial,Black or African American ,1,2,3
438130,Opioid abuse,racial,White,1,3,4
141248,Benign neoplasm of skin of lip,racial,White,2,1,3
437851,Open angle with borderline intraocular pressure,racial,White,3,1,4
80180,Osteoarthritis,racial,Native Hawaiian or Other Pacific Islander ,1,2,3
434301,Benign neoplasm of ribs and/or sternum and/or clavicle,ethnic,Hispanic or Latino,4,0,4
380727,Transient refractive change,racial,White,3,1,4
139737,Pediculosis corporis,ethnic,Hispanic or Latino,3,1,4
197518,Neoplasm of uncertain behavior of male genital organ,racial,White,1,3,4
435887,Antepartum deep phlebothrombosis,racial,Black or African American ,4,0,4
133299,Swelling of limb,racial,American Indian or Alaska Native ,1,2,3
138824,Contact dermatitis due to metal,racial,White,3,1,4
193239,Diverticulitis of small intestine,racial,White,2,2,4
375671,Concussion with loss of consciousness,ethnic,Hispanic or Latino,3,1,4
436445,Abrasion of teeth,ethnic,Not Hispanic or Latino,1,2,3
432525,Thyroid agent adverse reaction,racial,White,3,1,4
137682,Skin sensation disturbance,racial,Filipino,2,1,3
140966,Benign neoplasm of skin of face,racial,Other Race,4,0,4
4282684,Impairment level: low vision of one eye,ethnic,Not Hispanic or Latino,3,1,4
198191,Acquired hypertrophic pyloric stenosis,racial,Unknown,4,0,4
4215909,Artificial pacemaker rate check,ethnic,Hispanic or Latino,3,1,4
436670,MD - Metabolic disorders,racial,Black or African American ,4,0,4
28127,"Multiple endocrine neoplasia, type 1",racial,White,0,4,4
4102739,Screening for cardiovascular system disease,racial,Asian,0,4,4
256197,Rheumatoid lung disease,ethnic,Hispanic or Latino,0,4,4
373166,Benign neoplasm of lower jaw bone,ethnic,Not Hispanic or Latino,4,0,4
376063,Benign neoplasm of cerebral meninges,ethnic,Not Hispanic or Latino,1,3,4
312940,Acute-on-chronic respiratory failure,racial,Unknown,1,2,3
435787,Vitamin B6 deficiency,ethnic,Hispanic or Latino,4,0,4
4158567,Post percutaneous transluminal coronary angioplasty,racial,Filipino,0,4,4
4251787,Tuberculosis of rectum,racial,Unknown,4,0,4
440760,Inflammatory disorder of jaw,ethnic,Hispanic or Latino,2,2,4
192363,Obstruction of gallbladder,ethnic,Hispanic or Latino,4,0,4
319826,Secondary hypertension,racial,White,4,0,4
79119,Thoracic spondylosis with myelopathy,racial,Unknown,4,0,4
433740,Immunodeficiency disorder,ethnic,Not Hispanic or Latino,2,1,3
142032,Partial thickness burn of lower leg,ethnic,Hispanic or Latino,4,0,4
4053600,Open wound of elbow,racial,Unknown,3,1,4
139179,Open wound of lip without complication,racial,Unknown,1,2,3
435374,Closed fracture of distal end of ulna,ethnic,Hispanic or Latino,1,2,3
201621,Chronic cystitis,ethnic,Not Hispanic or Latino,4,0,4
435088,Senility,racial,Asian,1,3,4
435534,"Nondependent alcohol abuse, continuous",racial,American Indian or Alaska Native ,4,0,4
139899,Pemphigoid,ethnic,Not Hispanic or Latino,4,0,4
440703,Trigeminal nerve disorder,racial,White,1,3,4
437165,Motor vehicle traffic accident,racial,Black or African American ,2,1,3
381001,Subjective visual disturbance,racial,White,1,3,4
441025,Stenosis of lacrimal canaliculi,racial,White,2,2,4
80232,Closed fracture of calcaneus,racial,White,2,2,4
439262,"Single manic episode, severe, with psychosis",racial,Other Race,0,4,4
78907,Superficial injury of foot without infection,racial,White,4,0,4
194152,Renal agenesis and dysgenesis,ethnic,Not Hispanic or Latino,4,0,4
380407,Chronic infective otitis externa,ethnic,Hispanic or Latino,2,1,3
80241,Closed fracture navicular,ethnic,Hispanic or Latino,2,2,4
440750,Thrombophlebitis of deep veins of upper extremities,racial,Unknown,4,0,4
194526,Injury of trunk,ethnic,Not Hispanic or Latino,4,0,4
137785,Verruca plantaris,racial,Asian,0,4,4
141825,Non-toxic goiter,racial,Asian,4,0,4
436027,Coxsackie virus disease,racial,White,1,2,3
140641,Verruca vulgaris,racial,American Indian or Alaska Native ,1,3,4
318772,Disease of pericardium,ethnic,Not Hispanic or Latino,3,1,4
375404,Ocular laceration with prolapse AND/OR exposure of intraocular tissue,ethnic,Hispanic or Latino,0,4,4
200780,Disease of uterus,racial,White,4,0,4
315558,Atherosclerosis of arteries of the extremities,racial,Other Race,0,4,4
134118,Atrophic condition of skin,racial,American Indian or Alaska Native ,4,0,4
4311591,Cramp in limb,racial,Other Race,2,1,3
372892,Metabolic encephalopathy,ethnic,Hispanic or Latino,2,2,4
80201,Longitudinal deficiency of phalanges of hand,ethnic,Hispanic or Latino,1,3,4
40389897,"Neoplasm of uncertain behaviour of trachea, bronchus and lung",racial,Unknown,4,0,4
135858,Disorder of lip,racial,Asian,2,2,4
257012,Chronic rhinosinusitis,racial,Filipino,1,2,3
78888,Open fracture of ankle,racial,White,4,0,4
133726,Carcinoma in situ of skin of face,racial,Unknown,4,0,4
442119,Adhesions of temporomandibular joint,ethnic,Hispanic or Latino,1,2,3
76835,Closed dislocation of elbow,ethnic,Not Hispanic or Latino,3,1,4
4034214,Open wound of ear,ethnic,Hispanic or Latino,2,2,4
138255,Abnormal cardiovascular function,ethnic,Hispanic or Latino,4,0,4
436088,Nondependent opioid abuse in remission,ethnic,Not Hispanic or Latino,2,2,4
193522,Acute prostatitis,racial,Other Race,0,4,4
4056171,Prostatic hyperplasia NOS,racial,White,0,4,4
4141481,"Hand, foot and mouth disease",racial,Other Race,2,2,4
374317,Alcohol-induced psychosis,racial,White,1,3,4
135777,Neoplasm of uncertain behaviour of skin,racial,Black or African American ,0,4,4
198806,Abscess of prostate,racial,Unknown,0,4,4
80883,Nonvenomous insect bite of elbow with infection,ethnic,Hispanic or Latino,1,3,4
442019,Complication of procedure,racial,White,1,2,3
433246,"Chronic duodenal ulcer without hemorrhage, without perforation AND without obstruction",racial,White,4,0,4
443350,Lower urinary tract symptoms,racial,Alaska Native,0,4,4
141371,PR - Pityriasis rosea,racial,Black or African American ,2,1,3
192450,Not passing urine,racial,American Indian or Alaska Native ,0,4,4
257012,Chronic rhinosinusitis,racial,American Indian or Alaska Native ,1,2,3
4144274,Housing lack,racial,Unknown,1,3,4
4114772,Other specified arthropathy,ethnic,Hispanic or Latino,0,4,4
377680,Facial nerve injury as birth trauma,ethnic,Hispanic or Latino,2,1,3
80180,Osteoarthritis,racial,American Indian,4,0,4
201346,Oedema of penis,ethnic,Hispanic or Latino,0,4,4
132736,Bacteremia,ethnic,Not Hispanic or Latino,1,3,4
373748,Grand mal status,racial,Unknown,0,4,4
4268980,Finding of general development,racial,White,4,0,4
438796,Chronic duodenal ulcer with hemorrhage AND with perforation but without obstruction,racial,Unknown,0,4,4
376120,"Keratoconjunctivitis sicca, not specified as Sjogren's",ethnic,Not Hispanic or Latino,2,1,3
436027,Coxsackie virus disease,racial,Unknown,2,1,3
438039,Injury caused by animal,racial,White,2,1,3
442612,Burn any degree involving 50-59 percent of body surface,ethnic,Not Hispanic or Latino,0,4,4
137809,Primary malignant neoplasm of female breast,racial,Native Hawaiian or Other Pacific Islander ,4,0,4
139902,Allergic urticaria,racial,Black or African American ,1,2,3
318736,Migraine,racial,Filipino,2,2,4
434309,Sexual precocity,racial,Other Race,2,1,3
27918,Eosinophilic esophagitis,ethnic,Not Hispanic or Latino,0,4,4
376965,Hypertensive retinopathy,ethnic,Not Hispanic or Latino,2,2,4
442558,"Gestation period, 32 weeks",ethnic,Not Hispanic or Latino,0,4,4
433869,Congenital rubella syndrome,ethnic,Not Hispanic or Latino,0,4,4
432803,[X]Fall on and from ladder,racial,White,1,2,3
376713,Cerebral hemorrhage,racial,Other Race,2,1,3
134159,Precordial pain,racial,Other Race,1,2,3
4051568,Family history of mental disorder,ethnic,Hispanic or Latino,3,1,4
201059,Hypertrophic gastritis,racial,White,2,2,4
436352,Primary malignant neoplasm of laryngeal cartilage,ethnic,Hispanic or Latino,0,4,4
4134875,Weil's disease,ethnic,Not Hispanic or Latino,0,4,4
201344,Vesico-intestinal fistula,racial,White,3,1,4
138896,Open wound of forehead without complication,racial,Unknown,2,1,3
79072,Inflammatory disorder of breast,racial,Black or African American ,4,0,4
441834,"Bipolar affective disorder, currently manic, mild",racial,White,0,4,4
434557,Tuberculosis,ethnic,Hispanic or Latino,0,4,4
135526,Myelopathy,racial,Asian,0,4,4
374035,Keratitis,racial,Unknown,3,1,4
198194,Female genital organ symptoms,racial,American Indian,4,0,4
141667,Laxity of ligament,racial,White,4,0,4
197095,Embryonic cyst of fallopian tube and broad ligament,ethnic,Not Hispanic or Latino,4,0,4
376124,Pinguecula,racial,Other Race,4,0,4
316139,HF - Heart failure,racial,Filipino,0,4,4
435850,Cyst of jaw,racial,White,3,1,4
434005,Morbid obesity,racial,Alaska Native,0,4,4
315361,Orthopnea,racial,Unknown,4,0,4
4167069,Aneurysm clipping,ethnic,Hispanic or Latino,3,1,4
75650,Proteinuria,racial,American Indian or Alaska Native ,4,0,4
76161,Impotence of organic origin,racial,American Indian or Alaska Native ,0,4,4
253896,Traumatic pneumothorax without open wound into thorax,racial,Unknown,0,4,4
4164792,Hemophilus influenzae laryngitis,racial,Unknown,4,0,4
195587,Cholelithiasis AND cholecystitis with obstruction,ethnic,Hispanic or Latino,4,0,4
193322,Right lower quadrant pain,racial,Black or African American ,1,3,4
138821,Seborrhea,racial,Asian,3,1,4
261880,Atelectasis,ethnic,Not Hispanic or Latino,0,4,4
257778,Pertussis,racial,Unknown,2,1,3
443723,Finding of cellular component of blood,racial,Asian,4,0,4
433957,Progressive multifocal leukoencephalopathy,ethnic,Hispanic or Latino,0,4,4
135215,Hashimoto thyroiditis,ethnic,Not Hispanic or Latino,4,0,4
192680,Portal hypertension,ethnic,Not Hispanic or Latino,0,4,4
376683,Non proliferative diabetic retinopathy,racial,Black or African American ,3,1,4
193165,Adrenal disease,racial,Unknown,4,0,4
77968,Hallux valgus AND bunion,racial,Asian,2,2,4
4050572,Implantation of automatic cardiac defibrillator,racial,Black or African American ,0,4,4
4208970,History of physical abuse,ethnic,Not Hispanic or Latino,2,1,3
192433,Congenital hypertrophic pyloric stenosis,ethnic,Hispanic or Latino,1,2,3
40479849,Sexual abuse of adult,racial,White,2,1,3
30365,Panhypopituitarism,ethnic,Not Hispanic or Latino,4,0,4
435613,Cellulitis,racial,Other Race,2,2,4
436581,Accidental poisoning,racial,White,0,4,4
194382,External haemorrhoid,racial,Asian,2,1,3
444105,Burn any degree involving 70-79 percent of body surface,ethnic,Not Hispanic or Latino,0,4,4
74052,Labyrinthitis,ethnic,Not Hispanic or Latino,2,1,3
432571,Malignant lymphoma,racial,Black or African American ,0,4,4
81141,Closed fracture of ilium,racial,Unknown,4,0,4
435569,Disorder of jaw,racial,Other Race,4,0,4
432632,Noninfectious secondary iridocyclitis,ethnic,Hispanic or Latino,2,1,3
196158,Disease of penis,racial,Other Race,0,3,3
4273391,Suicidal thoughts,racial,Black or African American ,1,2,3
4199440,Congenital hip dysplasia,ethnic,Hispanic or Latino,3,0,3
440535,Abnormal radiographic examination,racial,Other Race,1,2,3
441604,Acute appendicitis without peritonitis,racial,Unknown,1,2,3
434327,Cannabis abuse,ethnic,Not Hispanic or Latino,1,2,3
133468,Disease of extremity,racial,Unknown,0,3,3
133406,Roseola infantum due to human herpesvirus 6,racial,White,1,2,3
436147,Glossitis,racial,Unknown,3,0,3
192360,Cyst and pseudocyst of pancreas,racial,Other Race,0,3,3
4021168,Natural contraception,racial,White,3,0,3
194878,Nodular lymphoma of extranodal AND/OR solid organ site,ethnic,Hispanic or Latino,2,1,3
432453,General clinical state finding,racial,Asian,2,1,3
192357,Paralytic ileus,racial,White,2,1,3
137820,Postoperative hypothyroidism,racial,Other Race,0,3,3
437986,FTT - Failure to thrive,racial,American Indian or Alaska Native ,3,0,3
198715,Premature menopause,racial,Other Race,3,0,3
4278083,Viral tracheitis,ethnic,Hispanic or Latino,0,3,3
435412,Second degree burn of breast,ethnic,Not Hispanic or Latino,3,0,3
4219847,Disease suspected,ethnic,Hispanic or Latino,3,0,3
439254,"Bipolar affective disorder, current episode depression",racial,Black or African American ,0,3,3
433750,"Single major depressive episode, in full remission",racial,Asian,0,3,3
433658,Adverse reaction to penicillins,racial,White,2,1,3
78831,Disease of ankle,racial,Black or African American ,2,1,3
440532,Heavy-for-dates infant regardless of gestation period,ethnic,Hispanic or Latino,3,0,3
312998,Pain in thoracic spine,racial,Black or African American ,3,0,3
138479,Thyroid dysfunction during pregnancy - baby not yet delivered,racial,American Indian or Alaska Native ,3,0,3
440358,Lipoma,racial,American Indian or Alaska Native ,3,0,3
380394,Idiopathic progressive polyneuropathy,ethnic,Not Hispanic or Latino,2,1,3
194175,Left upper quadrant pain,racial,Black or African American ,2,1,3
438039,Injury caused by animal,ethnic,Not Hispanic or Latino,1,2,3
438536,Congenital anomaly of jaw,racial,Asian,0,3,3
4269584,Finding relating to religious movement or belief,ethnic,Hispanic or Latino,2,1,3
437120,Closed dislocation of foot,ethnic,Hispanic or Latino,2,1,3
381174,Contusion of globe of eye,racial,White,2,1,3
4046500,Acute peptic ulcer with hemorrhage,racial,White,3,0,3
432451,Abnormal results of function studies of central nervous system,ethnic,Hispanic or Latino,3,0,3
4181604,Subcutaneous contraceptive implant,ethnic,Not Hispanic or Latino,3,0,3
432884,Amfetamine or psychostimulant dependence in remission,racial,White,0,3,3
78497,Cellulitis and abscess of toe,racial,Asian,1,2,3
441868,Optic disc oedema,racial,Unknown,3,0,3
4164707,Canceled operative procedure,racial,Other Race,2,1,3
138906,Superficial injury of face without infection,racial,White,1,2,3
433805,Abnormal jaw closure,ethnic,Hispanic or Latino,2,1,3
372604,Movement disorder,racial,Unknown,2,1,3
254669,Disease of vocal cords,ethnic,Hispanic or Latino,1,2,3
200836,Congenital anomaly of gastrointestinal tract,racial,White,2,1,3
438406,"Major depressive disorder, single episode, severe with psychotic features",ethnic,Not Hispanic or Latino,2,1,3
197304,Ulcer of lower limb,racial,American Indian or Alaska Native ,3,0,3
138841,Disorder of sacrum,racial,Other Race,2,1,3
135745,Exanthema subitum,ethnic,Not Hispanic or Latino,0,3,3
139200,"Crush injury, forearm",ethnic,Hispanic or Latino,0,3,3
138502,Vitiligo,racial,Native Hawaiian or Other Pacific Islander ,3,0,3
4023168,Home alone,racial,White,2,1,3
434610,Hyperkalemia,racial,American Indian or Alaska Native ,3,0,3
4099356,Haemangioma of unspecified site,ethnic,Hispanic or Latino,2,1,3
378548,Polyotia,racial,White,0,3,3
433701,Mycosis,ethnic,Not Hispanic or Latino,1,2,3
441737,Bruising,racial,Asian,2,1,3
193517,Bile duct calculus with no mention of cholecystitis and with obstruction,racial,Asian,3,0,3
381285,Peroneal muscular atrophy,racial,White,1,2,3
201061,Diaphragmatic hernia,racial,American Indian or Alaska Native ,3,0,3
436681,Insomnia disorder related to known organic factor,ethnic,Not Hispanic or Latino,1,2,3
441422,Closed fracture of humerus,racial,Black or African American ,3,0,3
436812,Tongue tie,racial,Other Race,0,3,3
321661,Spinal stenosis of thoracic region,racial,Asian,3,0,3
439846,LVF - Left ventricular failure,racial,Other Race,0,3,3
438297,"Mechanical complication of cardiac device, implant AND/OR graft",ethnic,Not Hispanic or Latino,0,3,3
374313,Neoplasm of uncertain behaviour of connective and other soft tissues,racial,White,1,2,3
200837,Congenital anomaly of fixation of intestine,racial,White,2,1,3
259043,Emphysematous bleb of lung,racial,White,2,1,3
436539,Closed fracture of patella,ethnic,Not Hispanic or Latino,2,1,3
26052,Primary malignant neoplasm of larynx,racial,Unknown,1,2,3
438872,Hyperphagia,racial,White,2,1,3
444234,Late effect of complications of trauma,racial,White,0,3,3
73291,Palindromic rheumatism of the ankle and/or foot,racial,American Indian or Alaska Native ,1,2,3
200579,Superficial injury of hip without infection,ethnic,Hispanic or Latino,3,0,3
194985,Postgastric surgery syndrome,ethnic,Hispanic or Latino,3,0,3
440072,Hypogammaglobulinemia,ethnic,Not Hispanic or Latino,2,1,3
75670,Sprain pelvic ligament,racial,Unknown,2,1,3
31317,Can't get food down,racial,American Indian,2,1,3
438304,Rat bite,ethnic,Hispanic or Latino,1,2,3
4147961,Screening for malignant neoplasm of breast,racial,American Indian,3,0,3
443430,HPV - Human papillomavirus test positive,racial,Asian,3,0,3
435224,Leukopenia,racial,Asian,2,1,3
31057,Disorder of pharynx,ethnic,Hispanic or Latino,2,1,3
198124,Disorder of kidney,racial,Filipino,2,1,3
4028641,Pregnancy and drug dependence,racial,Black or African American ,3,0,3
440379,Episodic opioid dependence,racial,Black or African American ,1,2,3
135975,Blister of finger without infection,ethnic,Hispanic or Latino,2,1,3
440076,SS - Short stature,racial,Other Race,0,3,3
443674,Traumatic amputation of toe(s) with complication,ethnic,Hispanic or Latino,0,3,3
133013,Congenital spinal cord anomaly,racial,Black or African American ,2,1,3
4113027,Dietary intake observations,racial,American Indian or Alaska Native ,1,2,3
438250,Congenital talipes varus,racial,White,2,1,3
200461,Endometriosis of uterus,ethnic,Not Hispanic or Latino,3,0,3
439800,"Conduct disorder, adolescent-onset type",ethnic,Not Hispanic or Latino,1,2,3
433992,"Bipolar affective disorder, currently manic, moderate",ethnic,Hispanic or Latino,3,0,3
4152047,Lipid screening,racial,Black or African American ,3,0,3
4170929,Watery eye,ethnic,Hispanic or Latino,3,0,3
4102348,Common migraine NOS,ethnic,Not Hispanic or Latino,1,2,3
443400,Peritoneal cancer,ethnic,Not Hispanic or Latino,3,0,3
377527,Presenile dementia with depression,racial,Other Race,3,0,3
74130,Thoracic spondylosis without myelopathy,ethnic,Not Hispanic or Latino,2,1,3
72748,Strain of rotator cuff of shoulder,racial,Asian,2,1,3
4098006,Iron deficiency anemia NOS,ethnic,Hispanic or Latino,2,1,3
433168,Iron deficiency anaemia secondary to inadequate dietary iron intake,ethnic,Not Hispanic or Latino,1,2,3
141050,Disease of hard tissues of teeth,ethnic,Hispanic or Latino,2,1,3
4179214,Family history of malignant neoplasm of gastrointestinal tract,racial,Other Race,2,1,3
4176878,Calculus of cystic duct with cholecystitis,racial,White,2,1,3
4098006,Iron deficiency anemia NOS,racial,White,2,1,3
377849,Retinal deposits,ethnic,Hispanic or Latino,2,1,3
433134,Histoplasmosis,ethnic,Not Hispanic or Latino,3,0,3
435170,Effects of thirst,ethnic,Hispanic or Latino,3,0,3
437409,Intracranial injury,racial,Asian,3,0,3
4222138,Allergic contact dermatitis of eyelid,racial,Unknown,2,1,3
201530,"Diabetes mellitus, adult onset, with hyperosmolar coma",ethnic,Not Hispanic or Latino,3,0,3
253788,Nasal polyp,racial,Black or African American ,1,2,3
441828,Disorganized schizophrenia,racial,White,1,2,3
4115379,"Localised, primary osteoarthritis of the pelvic region and thigh",racial,Asian,3,0,3
4004785,Fetal alcohol syndrome,racial,Black or African American ,0,3,3
4116761,Lateral meniscus derangement unspecified,ethnic,Hispanic or Latino,2,1,3
439926,Malaise and fatigue,racial,Filipino,1,2,3
434455,Acquired claw toes,ethnic,Hispanic or Latino,2,1,3
134741,Congenital anomaly of limb,racial,White,0,3,3
441039,Phlebitis of lower limb vein,ethnic,Not Hispanic or Latino,0,3,3
444388,Blister of leg without infection,racial,Unknown,2,1,3
4046804,Disorder of fluency,ethnic,Hispanic or Latino,0,3,3
78219,Cellulitis and abscess of hand excluding digits,racial,Other Race,2,1,3
194878,Nodular lymphoma of extranodal AND/OR solid organ site,racial,Asian,0,3,3
313800,Thrombotic microangiopathy,ethnic,Hispanic or Latino,3,0,3
437614,Early onset of delivery,racial,White,3,0,3
200763,Chronic hepatitis,racial,Black or African American ,3,0,3
72712,Synovial cyst,racial,Unknown,3,0,3
138519,Spondylosis without myelopathy,racial,Other Race,2,1,3
4005743,Female sterility,ethnic,Not Hispanic or Latino,3,0,3
440758,Posteruptive color change of tooth,ethnic,Hispanic or Latino,2,1,3
436333,Orf virus disease,racial,Unknown,2,1,3
432289,Drug-induced neutropenia,ethnic,Hispanic or Latino,1,2,3
441259,Non-thrombocytopenic purpura,ethnic,Not Hispanic or Latino,3,0,3
440230,Closed fracture of anatomical neck of humerus,racial,Unknown,3,0,3
141056,Acute ethmoidal sinusitis,racial,Unknown,2,1,3
253549,Connective tissue disease,racial,White,3,0,3
4108676,Other chronic ischaemic heart disease NOS,ethnic,Hispanic or Latino,0,3,3
442310,Acute heart failure,racial,Unknown,0,3,3
320347,Nodular lymphoma of lymph nodes of multiple sites,ethnic,Hispanic or Latino,1,2,3
4005933,Urethral meatus underneath penis,racial,Other Race,0,3,3
374028,AAMD - Age related macular degeneration,racial,Black or African American ,2,1,3
80523,Congenital fusion of spine,ethnic,Hispanic or Latino,3,0,3
438559,Abnormal vaginal Papanicolaou smear,racial,White,3,0,3
438284,Sprain of chondrosternal joint,ethnic,Hispanic or Latino,1,2,3
196365,Neoplasm of uncertain behaviour of adrenal gland,ethnic,Hispanic or Latino,2,1,3
4018734,Sprain of costal cartilage,racial,Black or African American ,2,1,3
436876,Toxic effect of lead compound,ethnic,Hispanic or Latino,1,2,3
4109691,Persistent alcohol abuse,ethnic,Hispanic or Latino,1,2,3
4334644,Decubitus ulcer of lower back,racial,White,2,1,3
438205,Maternal syphilis during pregnancy - baby not yet delivered,racial,White,3,0,3
440069,Drug dependence,racial,Other Race,1,2,3
443545,Nonvenomous insect bite,racial,Filipino,2,1,3
4170929,Watery eye,racial,Unknown,3,0,3
4143966,Essential hypertension NOS,ethnic,Hispanic or Latino,2,1,3
319921,Congenital pulmonary valve abnormality,racial,Unknown,3,0,3
442944,"Splinter of trunk, without major open wound or mention of infection",ethnic,Hispanic or Latino,2,1,3
318247,Apnea in the newborn,ethnic,Hispanic or Latino,1,2,3
372324,Eustachian tube disorder,racial,American Indian or Alaska Native ,3,0,3
436477,Abnormal products of conception,ethnic,Not Hispanic or Latino,3,0,3
76273,Open wound of shoulder region without complication,racial,White,2,1,3
135208,Benign tumor of lip,racial,White,2,1,3
192785,Second degree burn of abdominal wall,racial,White,3,0,3
442010,Seafood-induced anaphylaxis,racial,Unknown,1,2,3
201322,Internal hemorrhoids without complication,racial,American Indian or Alaska Native ,2,1,3
433131,Mumps without complication,racial,Unknown,3,0,3
198846,Enthesopathy of hip region,racial,American Indian or Alaska Native ,3,0,3
440846,"Blood coagulation disorder, categorized by value of screening test",racial,American Indian or Alaska Native ,0,3,3
4240902,Allergy to peanuts,racial,Black or African American ,1,2,3
4012491,Difficulty chewing,racial,Other Race,2,1,3
199062,"Acute gastric ulcer without hemorrhage, without perforation AND without obstruction",racial,Other Race,1,2,3
4114472,Ear problem,racial,White,1,2,3
441408,Vomiting,racial,Filipino,1,2,3
201111,Congenital renal dysplasia,ethnic,Not Hispanic or Latino,1,2,3
434008,White blood cell disorder,racial,Unknown,1,2,3
77139,Open wound of finger without complication,racial,Other Race,2,1,3
194574,Chronic type B viral hepatitis,racial,Unknown,0,3,3
4104862,Other forms of migraine,racial,White,3,0,3
440508,Congenital disease,racial,Other Race,0,3,3
4196206,beta^+^ Thalassemia,ethnic,Hispanic or Latino,3,0,3
433909,Foreign body on external eye,racial,Unknown,0,3,3
435388,"Cortex contusion with open intracranial wound, with more than 24 hours loss of consciousness and return to pre-existing conscious level",racial,Unknown,0,3,3
135778,Toxic multinodular goitre,ethnic,Not Hispanic or Latino,3,0,3
443949,Disease type AND/OR category unknown,racial,Unknown,3,0,3
141249,Benign tumour of thyroid gland,racial,Black or African American ,3,0,3
436091,BM - Bacterial meningitis,racial,Unknown,2,1,3
79898,Cellulitis and abscess of finger,racial,Asian,2,1,3
437257,Continuous acute alcoholic intoxication in alcoholism,ethnic,Hispanic or Latino,2,1,3
437175,"Fall on same level from slipping, tripping or stumbling",racial,Asian,2,1,3
138388,Secondary hyperparathyroidism,ethnic,Hispanic or Latino,2,1,3
40482247,Organic sleep apnea,racial,White,1,2,3
136917,Primary malignant neoplasm of skin of face,racial,White,2,1,3
436001,Emotional abuse of adult,racial,Unknown,3,0,3
260841,Perinatal subarachnoid hemorrhage,racial,Unknown,2,1,3
440693,Continuous opioid dependence,racial,American Indian or Alaska Native ,0,3,3
377575,Tinnitus,racial,American Indian or Alaska Native ,3,0,3
258785,Pneumococcal pneumonia,ethnic,Not Hispanic or Latino,1,2,3
194847,Mechanical complication due to urethral indwelling catheter,ethnic,Hispanic or Latino,0,3,3
437589,Pulpitis,racial,White,2,1,3
379009,Retinopathy of prematurity stage 3 - ridge with extraretinal fibrovascular proliferation,racial,White,2,1,3
198700,Liver secondary cancer,racial,Other Race,3,0,3
436232,"Polycystic kidney disease, adult type",racial,Other Race,3,0,3
80509,Bone cyst,ethnic,Not Hispanic or Latino,1,2,3
441541,Lymphocytopenia,racial,White,1,2,3
439162,"Closed fracture ankle, medial malleolus",ethnic,Not Hispanic or Latino,2,1,3
192363,Obstruction of gallbladder,racial,White,3,0,3
195482,Primary malignant neoplasm of intestinal tract,ethnic,Hispanic or Latino,3,0,3
193239,Diverticulitis of small intestine,ethnic,Not Hispanic or Latino,1,2,3
437262,Common peroneal nerve lesion,racial,White,3,0,3
255677,Open wound of nose without complication,racial,White,1,2,3
382014,Injury of facial nerve,racial,White,0,3,3
139895,"Thyroid dysfunction during pregnancy, childbirth and the puerperium",racial,Unknown,3,0,3
378163,Sounds seem unnaturally loud,ethnic,Hispanic or Latino,1,2,3
4167069,Aneurysm clipping,racial,White,3,0,3
135688,Abrasion AND/OR friction burn of foot with infection,racial,White,0,3,3
440454,Abortion without complication,racial,White,3,0,3
439800,"Conduct disorder, adolescent-onset type",ethnic,Hispanic or Latino,1,2,3
439166,Closed fracture of radius,racial,Black or African American ,3,0,3
73819,Painful breasts,racial,Black or African American ,3,0,3
4024567,Respiratory observation,ethnic,Not Hispanic or Latino,3,0,3
434890,Repetitive stereotyped movement,racial,White,0,3,3
436020,Actinomycotic infection,racial,Unknown,3,0,3
443782,Tremor,racial,Black or African American ,3,0,3
434311,Disorder of the urea cycle metabolism,ethnic,Hispanic or Latino,2,1,3
380094,Carpal tunnel syndrome,racial,Filipino,3,0,3
78560,Congenital deformity and malformation of feet and toes,ethnic,Not Hispanic or Latino,0,3,3
140357,Neoplasm of uncertain behaviour of endocrine gland,ethnic,Hispanic or Latino,3,0,3
4249474,Generalized seborrheic dermatitis of infants,ethnic,Not Hispanic or Latino,1,2,3
76836,Sprain of knee and leg,racial,American Indian or Alaska Native ,3,0,3
439928,Gangrenous disorder,ethnic,Not Hispanic or Latino,0,3,3
197654,Congenital cystic disease of liver,ethnic,Hispanic or Latino,0,3,3
434462,VSD - Ventricular septal defect,racial,Asian,0,3,3
374946,Recurrent erosion syndrome,ethnic,Hispanic or Latino,0,3,3
432447,Atypical glandular cells on cervical Papanicolaou smear,racial,Other Race,3,0,3
200837,Congenital anomaly of fixation of intestine,ethnic,Not Hispanic or Latino,3,0,3
321689,Apneic,racial,Other Race,2,1,3
439297,Nuclear senile cataract,racial,Other Race,1,2,3
135032,Dermatitis due to substances taken internally,racial,Unknown,2,1,3
376401,Traumatic cataract,ethnic,Hispanic or Latino,3,0,3
376229,Abnormal involuntary movement,racial,Black or African American ,1,2,3
76202,Non-traumatic rupture of Achilles tendon,ethnic,Hispanic or Latino,0,3,3
318445,Post cardiac operation functional disturbance,ethnic,Hispanic or Latino,1,2,3
141831,Branchial arch syndrome,racial,Asian,3,0,3
434893,Selective IgM immunodeficiency,ethnic,Not Hispanic or Latino,2,1,3
376707,Acute conjunctivitis,racial,American Indian or Alaska Native ,2,1,3
192954,Acute gastric ulcer without hemorrhage AND without perforation but with obstruction,racial,White,1,2,3
439554,Hypnotic or anxiolytic abuse,racial,Other Race,0,3,3
201675,Autosomal recessive polycystic kidney disease,racial,White,3,0,3
4023168,Home alone,ethnic,Hispanic or Latino,2,1,3
437671,Abnormal feces,racial,Asian,1,2,3
374915,Localisation-related epilepsy,racial,White,3,0,3
373982,Benign tumour of conjunctiva,ethnic,Not Hispanic or Latino,2,1,3
432454,Excessive thirst,racial,Black or African American ,1,2,3
444115,Disorder of bursa,ethnic,Not Hispanic or Latino,1,2,3
140173,Telogen effluvium,ethnic,Not Hispanic or Latino,2,1,3
81713,Carpal joint sprain,racial,White,2,1,3
433471,Retinal neovascularization,racial,Unknown,3,0,3
75911,Acquired hallux valgus,racial,Black or African American ,1,2,3
137967,"Muscle, ligament and fascia disorders",racial,Unknown,3,0,3
199076,Fallopian tube pregnancy,ethnic,Not Hispanic or Latino,1,2,3
4236391,Acute necrotizing otitis media,ethnic,Hispanic or Latino,0,3,3
4270866,Symptomatic dermographism,ethnic,Not Hispanic or Latino,2,1,3
195306,Gastroduodenitis,racial,Native Hawaiian or Other Pacific Islander ,2,1,3
373724,Neoplasm of brain,ethnic,Not Hispanic or Latino,1,2,3
81169,Superficial foreign body of finger without major open wound AND without infection,racial,White,2,1,3
141648,Contact dermatitis due to cosmetics,ethnic,Not Hispanic or Latino,2,1,3
321844,Initial apnea,ethnic,Not Hispanic or Latino,0,3,3
194878,Nodular lymphoma of extranodal AND/OR solid organ site,ethnic,Not Hispanic or Latino,0,3,3
437833,Hypokalaemia,racial,American Indian or Alaska Native ,3,0,3
141050,Disease of hard tissues of teeth,racial,Unknown,2,1,3
200761,Retroperitoneal abscess,ethnic,Hispanic or Latino,0,3,3
373775,Psychophysical visual disturbance,ethnic,Not Hispanic or Latino,1,2,3
77421,Open wound of hand except fingers without complication,racial,Black or African American ,1,2,3
201927,Cellulitis and abscess of leg,racial,American Indian,2,1,3
440083,Acute stress disorder,racial,Black or African American ,3,0,3
438329,Late effect of motor vehicle accident,racial,Unknown,3,0,3
439249,"Mixed bipolar affective disorder, mild",ethnic,Hispanic or Latino,0,3,3
133794,Chronic gingivitis,racial,Other Race,1,2,3
193517,Bile duct calculus with no mention of cholecystitis and with obstruction,ethnic,Not Hispanic or Latino,3,0,3
442325,Furuncle of foot,ethnic,Hispanic or Latino,1,2,3
381572,Abducens nerve palsy,ethnic,Not Hispanic or Latino,0,3,3
137626,Seborrhoeic eczema of scalp,racial,Other Race,2,1,3
77646,Disorder of bone and articular cartilage,ethnic,Not Hispanic or Latino,2,1,3
444283,Superficial foreign body of hand without major open wound AND without infection,racial,White,1,2,3
135204,Mycosis fungoides of extranodal AND/OR solid organ site,racial,White,3,0,3
140435,Arrested dental caries,ethnic,Hispanic or Latino,2,1,3
4310768,Fall on steps,ethnic,Not Hispanic or Latino,1,2,3
438261,Neonatal jaundice due to delayed conjugation associated with another disease,racial,White,1,2,3
28457,Hypertrophy of tonsils,racial,Asian,1,2,3
139899,Pemphigoid,racial,Asian,3,0,3
4064363,Intest helminthiasis screening,racial,Unknown,0,3,3
433134,Histoplasmosis,racial,Asian,3,0,3
77968,Hallux valgus AND bunion,racial,American Indian or Alaska Native ,2,1,3
438430,Squamous blepharitis,ethnic,Hispanic or Latino,2,1,3
4016352,Tuberculosis contact,racial,Asian,1,2,3
137813,Benign neoplasm of mouth region,racial,White,1,2,3
198246,Congenital hiatus hernia,racial,Unknown,2,1,3
377298,Chronic otitis externa,racial,Unknown,3,0,3
441407,Appetite loss - anorexia,racial,Black or African American ,2,1,3
75344,Intervertebral disc disorder,racial,Other Race,1,2,3
440631,Mycobacterial disease,racial,White,1,2,3
440925,Suicide,racial,Asian,3,0,3
372247,Candidal otomycosis,racial,Unknown,2,1,3
195072,Medullary sponge kidney,ethnic,Hispanic or Latino,3,0,3
30437,Gastroesophageal reflux disease with esophagitis,racial,Asian Indian,3,0,3
4235140,Operation for bone injury of phalanges of hand,racial,Unknown,2,1,3
4219847,Disease suspected,racial,White,3,0,3
197327,Female urinary-genital tract fistula,racial,Unknown,3,0,3
4110787,Other otitis externa,ethnic,Not Hispanic or Latino,0,3,3
132841,Malignant lymphoma of lymph nodes of multiple sites,racial,White,2,1,3
135778,Toxic multinodular goitre,racial,White,3,0,3
195083,Left lower quadrant pain,racial,Black or African American ,2,1,3
135777,Neoplasm of uncertain behaviour of skin,racial,Asian,2,1,3
196044,Primary malignant neoplasm of stomach,ethnic,Not Hispanic or Latino,2,1,3
438047,Contusion of orbital tissues,racial,White,1,2,3
200485,Decubitus ulcer of buttock,racial,Asian,0,3,3
436096,Chronic pain,racial,Filipino,0,3,3
195584,Acute peptic ulcer without hemorrhage AND without perforation but with obstruction,racial,Unknown,3,0,3
437753,Seen by surgical fitting - service,racial,Unknown,3,0,3
321119,Coarctation of aorta,racial,White,1,2,3
434301,Benign neoplasm of ribs and/or sternum and/or clavicle,racial,Unknown,3,0,3
318736,Migraine,racial,Native Hawaiian or Other Pacific Islander ,3,0,3
4079876,Familial combined hyperlipidemia,racial,Alaska Native,0,3,3
373054,Open wound of auricle of ear without complication,ethnic,Hispanic or Latino,1,2,3
434742,Congenital abnormality of skull and face bones,racial,Unknown,1,2,3
443447,Iatrogenic hypotension,racial,Asian,0,3,3
439666,Contracture of multiple joints,racial,Black or African American ,0,3,3
198185,Chronic renal failure syndrome,ethnic,Not Hispanic or Latino,1,2,3
4085075,At risk state,racial,White,1,2,3
4112819,Pneumonia due to other specified bacteria,ethnic,Hispanic or Latino,2,1,3
321052,Peripheral vascular disease,racial,Native Hawaiian or Other Pacific Islander ,1,2,3
435217,Paranoid schizophrenia in remission,ethnic,Hispanic or Latino,0,3,3
443454,Cerebral infarction,racial,Other Race,0,3,3
4124794,FH: - kidney disorder,ethnic,Hispanic or Latino,1,2,3
76207,Scoliosis due to radiation,ethnic,Hispanic or Latino,3,0,3
375479,Kaposi's sarcoma of soft tissues,racial,White,0,3,3
259070,PGN - Acute proliferative glomerulonephritis,ethnic,Hispanic or Latino,3,0,3
73183,Myotonic disorder,racial,White,3,0,3
137005,Tracheostomy complication,racial,White,3,0,3
318186,Achalasia of esophagus,racial,White,1,2,3
201338,Urethral fistula,ethnic,Hispanic or Latino,1,2,3
439128,Extreme immaturity,ethnic,Not Hispanic or Latino,3,0,3
376965,Hypertensive retinopathy,racial,Black or African American ,0,3,3
443428,Torus fracture of radius,racial,White,1,2,3
136774,Pityriasis rubra pilaris,racial,White,2,1,3
74250,Burn of foot,racial,White,2,1,3
192362,Nephrotic syndrome with membranoproliferative glomerulonephritis,racial,Unknown,0,3,3
375546,Combined nonsenile cataract,racial,Unknown,1,2,3
381033,Aphakia,ethnic,Hispanic or Latino,1,2,3
4025176,Respiratory system diseases NOS,racial,White,1,2,3
78237,Bicipital tenosynovitis,racial,American Indian or Alaska Native ,3,0,3
254980,Intrinsic asthma with asthma attack,ethnic,Not Hispanic or Latino,2,1,3
432312,Anatomical narrow angle glaucoma,racial,Asian,3,0,3
78593,Open wound of wrist without complication,ethnic,Not Hispanic or Latino,1,2,3
378752,Corneal opacity,ethnic,Not Hispanic or Latino,0,3,3
196431,Hypersensitivity angiitis,racial,White,1,2,3
4177243,Cancer of pharynx,ethnic,Hispanic or Latino,1,2,3
313800,Thrombotic microangiopathy,racial,White,3,0,3
374645,Phantom limb syndrome,racial,Unknown,1,2,3
201131,Pelvic mass,racial,American Indian or Alaska Native ,3,0,3
133444,Thyroiditis,ethnic,Not Hispanic or Latino,1,2,3
437464,"Injury undetermined whether accidentally or purposely inflicted, fall from residential premises",racial,White,2,1,3
4114610,Allergic arthritis NOS,racial,Unknown,3,0,3
441835,Chronic schizoaffective schizophrenia,racial,Asian,0,3,3
192964,Renal infection,racial,White,2,1,3
315286,Chronic ischemic heart disease,racial,Other Race,3,0,3
316437,Cerebral atherosclerosis,racial,American Indian or Alaska Native ,3,0,3
29056,Sialoadenitis,racial,Black or African American ,3,0,3
74809,Crushing injury of hand,ethnic,Hispanic or Latino,2,1,3
257011,Acute upper respiratory infection,racial,Asian Indian,0,3,3
138913,Second degree burn of two OR more fingers including thumb,ethnic,Hispanic or Latino,1,2,3
373999,Diabetic oculopathy associated with type I diabetes mellitus,racial,Asian,3,0,3
194703,Leucoplakia of vagina,racial,White,3,0,3
438688,Sarcoidosis,racial,Black or African American ,3,0,3
192353,Disorder of gallbladder,racial,Other Race,0,3,3
4014454,Single stillbirth,racial,White,3,0,3
435658,Atypical squamous cells on vaginal Papanicolaou smear cannot exclude high grade squamous intraepithelial lesion,racial,White,3,0,3
257905,Mucopurulent chronic bronchitis,ethnic,Not Hispanic or Latino,2,1,3
201129,Newborn swallowing maternal blood causing hematemesis or melena,ethnic,Hispanic or Latino,2,1,3
4062998,Infantile paralytic paralysis,racial,Unknown,3,0,3
4062641,Malaria screening,ethnic,Not Hispanic or Latino,2,1,3
442286,Abscess of digit,racial,Asian,2,1,3
132397,Pilonidal cyst with no abscess,ethnic,Not Hispanic or Latino,0,3,3
440388,[X]Developmental co - ordination disorder,ethnic,Not Hispanic or Latino,0,3,3
133685,Salmonellosis,ethnic,Hispanic or Latino,1,2,3
436972,Glaucoma associated with systemic syndromes,racial,Filipino,0,3,3
4102738,Screening for mental disorders,ethnic,Hispanic or Latino,1,2,3
195599,Post-hysterectomy vaginal vault prolapse,racial,White,3,0,3
433911,Contusion of eye AND ocular adnexa,racial,Unknown,1,2,3
441191,Poisoning by arthropod,ethnic,Hispanic or Latino,3,0,3
4003982,Other specified skin anomalies,ethnic,Not Hispanic or Latino,0,3,3
81247,Carcinoma in situ of urinary system,ethnic,Hispanic or Latino,3,0,3
434622,Deficiency anemias,racial,Other Race,3,0,3
201387,Doubling of uterus,racial,Unknown,3,0,3
372423,Reduction deformities of brain,racial,Filipino,3,0,3
435315,Torsion of testis,ethnic,Not Hispanic or Latino,0,3,3
137057,Paronychia,racial,Black or African American ,1,2,3
253321,Stridor,racial,Other Race,0,3,3
321502,Chagas' disease with heart involvement,ethnic,Hispanic or Latino,0,3,3
438791,Pulmonary congestion and hypostasis,racial,Unknown,3,0,3
139900,Urticaria,racial,Filipino,0,3,3
4261613,Educational problem,racial,Asian,2,1,3
4110022,Acute bronchitis and/or bronchiolitis,ethnic,Hispanic or Latino,1,2,3
196436,Internal haemorrhoid,racial,Other Race,3,0,3
138717,Thyrotoxicosis with diffuse goitre,racial,Asian,3,0,3
4181328,CA - Cancer of adrenal gland,ethnic,Hispanic or Latino,1,2,3
433450,Paranoid schizophrenia,racial,Black or African American ,2,1,3
437688,Abnormal findings on antenatal screening of mother,ethnic,Not Hispanic or Latino,3,0,3
436741,Vulvodynia,ethnic,Hispanic or Latino,3,0,3
4177966,Kaposi's sarcoma,ethnic,Hispanic or Latino,0,3,3
136279,Injury at T1-T6 level with spinal cord injury AND without bone injury,ethnic,Hispanic or Latino,3,0,3
436072,Bipolar disorder in partial remission,ethnic,Not Hispanic or Latino,3,0,3
195770,Subserous uterine fibroid,ethnic,Not Hispanic or Latino,3,0,3
443748,Congenital anomaly of the bladder,ethnic,Hispanic or Latino,2,1,3
439746,Primary malignant neoplasm of hypopharynx,ethnic,Hispanic or Latino,3,0,3
4014296,Twins - both live born,ethnic,Not Hispanic or Latino,2,1,3
435233,Disorders of fatty-acid metabolism,ethnic,Not Hispanic or Latino,3,0,3
435380,Closed fracture of radius AND ulna,ethnic,Hispanic or Latino,2,1,3
314131,Degeneration of cervical intervertebral disc,racial,Black or African American ,2,1,3
376966,Exudative age-related macular degeneration,racial,Asian,0,3,3
378157,Mechanical strabismus,racial,Unknown,3,0,3
77354,Primary localised osteoarthrosis of lower leg,racial,Filipino,3,0,3
321879,Dissecting aneurysm of coronary artery,ethnic,Hispanic or Latino,3,0,3
438722,Non megaloblastic anemia associated with nutritional deficiency,ethnic,Not Hispanic or Latino,1,2,3
374338,Nondiabetic proliferative retinopathy,racial,White,1,2,3
440508,Congenital disease,racial,Black or African American ,2,1,3
432508,"Mechanical complication of nervous system device, implant AND/OR graft",ethnic,Hispanic or Latino,0,3,3
79911,Effusion of joint of upper arm,racial,Other Race,1,2,3
436222,Altered mental status,racial,Other Race,2,1,3
442944,"Splinter of trunk, without major open wound or mention of infection",racial,White,2,1,3
133150,Malignant neoplasm of skin of lower limb and hip,ethnic,Hispanic or Latino,1,2,3
136497,Scar conditions and fibrosis of skin,ethnic,Not Hispanic or Latino,1,2,3
4166443,Family history: Arthritis,ethnic,Hispanic or Latino,1,2,3
77631,Secondary localized osteoarthrosis of shoulder region,ethnic,Hispanic or Latino,2,1,3
141372,Contact dermatitis due to solvents,racial,White,2,1,3
73153,Malignant neoplasm of lateral wall of urinary bladder,racial,Asian,0,3,3
433073,Superficial burn of back of hand,racial,White,3,0,3
433768,Glaucoma with increased episcleral venous pressure,ethnic,Hispanic or Latino,3,0,3
319825,Rheumatic heart disease,racial,White,3,0,3
439796,"Nondependent cocaine abuse, continuous",racial,White,0,3,3
4104862,Other forms of migraine,ethnic,Hispanic or Latino,3,0,3
372315,Anterior subcapsular polar cataract,ethnic,Hispanic or Latino,1,2,3
261053,Pneumonia with aspergillosis,racial,White,0,3,3
433533,Incomplete spontaneous abortion with no mention of complication,racial,Unknown,3,0,3
434908,Disorder of porphyrin and haem metabolism,ethnic,Hispanic or Latino,2,1,3
437092,Physiological development failure,racial,Filipino,0,3,3
4149560,Hand sprain unspecified,racial,Unknown,2,1,3
200171,Carbuncle of skin AND/OR subcutaneous tissue,racial,Unknown,2,1,3
136185,Abnormal granulation tissue,racial,Black or African American ,1,2,3
437013,"Primary dental caries, pit and fissure origin",racial,Unknown,0,3,3
434455,Acquired claw toes,racial,White,2,1,3
138813,Early or threatened labour,ethnic,Hispanic or Latino,3,0,3
77066,Derangement of medial meniscus,racial,Other Race,0,3,3
441962,Congenital bowing of tibia and/or fibula,ethnic,Hispanic or Latino,1,2,3
442295,Disorder of carbohydrate transport,racial,Unknown,2,1,3
133406,Roseola infantum due to human herpesvirus 6,ethnic,Hispanic or Latino,1,2,3
4094876,"Malignant neoplasm of lower lobe, bronchus or lung",ethnic,Hispanic or Latino,1,2,3
4201472,Varicella contact,racial,White,2,1,3
75365,Oliguria and anuria,racial,Unknown,3,0,3
139180,Open wound of multiple sites of face without complication,ethnic,Hispanic or Latino,1,2,3
138973,Chancroid,ethnic,Hispanic or Latino,2,1,3
195867,Noninflammatory vaginal disorders,racial,Black or African American ,3,0,3
137792,Kaposi's varicelliform eruption,racial,Unknown,1,2,3
4211231,Panic disorder without agoraphobia,racial,Asian,2,1,3
201346,Oedema of penis,racial,White,0,3,3
441192,Accidentally struck by or against objects or persons,racial,White,2,1,3
376709,Discharge of eye,racial,Asian,1,2,3
133298,Musculoskeletal disorder of the neck,racial,American Indian or Alaska Native ,1,2,3
137735,Second degree burn of forearm,racial,White,2,1,3
315296,Preinfarction syndrome,racial,Asian,0,3,3
78593,Open wound of wrist without complication,racial,Unknown,3,0,3
80578,Superficial injury of finger with infection,ethnic,Hispanic or Latino,2,1,3
194985,Postgastric surgery syndrome,ethnic,Not Hispanic or Latino,3,0,3
4009750,Open fracture of other tarsal and metatarsal bones,racial,Black or African American ,0,3,3
443708,Cervical Papanicolaou smear positive for malignant neoplasm,ethnic,Hispanic or Latino,3,0,3
441968,Acetonuria,racial,Unknown,2,1,3
4218420,Postinflammatory perforation of ear drum,racial,White,3,0,3
436700,Eye displaced forwards,ethnic,Not Hispanic or Latino,3,0,3
382014,Injury of facial nerve,ethnic,Hispanic or Latino,0,3,3
319054,Thrombophlebitis of upper extremities,ethnic,Hispanic or Latino,1,2,3
315276,Vitreous hemorrhage,ethnic,Not Hispanic or Latino,0,3,3
442598,Fracture of radius AND ulna,racial,White,2,1,3
4315363,"Accidents caused by knives, swords and daggers",ethnic,Not Hispanic or Latino,3,0,3
440279,Accident,racial,Other Race,2,1,3
442011,Mechanical complication due to cardiac pacemaker electrode,ethnic,Not Hispanic or Latino,1,2,3
432904,Blood in anterior chamber,racial,White,2,1,3
136774,Pityriasis rubra pilaris,ethnic,Hispanic or Latino,2,1,3
200757,Abscess of peritoneum,racial,White,2,1,3
140803,Idiopathic angio-oedema-urticaria,ethnic,Not Hispanic or Latino,3,0,3
192671,GI - Gastrointestinal haemorrhage,racial,American Indian or Alaska Native ,3,0,3
437449,Victim of child abuse,ethnic,Not Hispanic or Latino,2,1,3
434309,Sexual precocity,racial,Black or African American ,1,2,3
437222,Respiratory syncytial virus infection,ethnic,Not Hispanic or Latino,0,3,3
4162218,Vaginal enterocele,ethnic,Hispanic or Latino,3,0,3
315564,Aortic valve regurgitation,racial,White,0,3,3
439274,Acute exacerbation of subchronic latent schizophrenia,racial,White,0,3,3
73338,Sprain of lateral collateral ligament of knee,ethnic,Not Hispanic or Latino,0,3,3
4129482,Ovary observations,ethnic,Hispanic or Latino,3,0,3
443539,Motor vehicle injury,ethnic,Hispanic or Latino,1,2,3
376117,Cataract in degenerative disorder,racial,Other Race,0,3,3
318772,Disease of pericardium,racial,Black or African American ,2,1,3
195072,Medullary sponge kidney,racial,White,3,0,3
193242,Perforation of intestine,racial,White,3,0,3
40484522,Hemiplegia of dominant side as late effect of cerebrovascular disease,racial,Native Hawaiian or Other Pacific Islander ,0,3,3
440366,Delay in sexual development AND/OR puberty,racial,Unknown,1,2,3
4104555,Other and unspecified conjunctivitis,ethnic,Not Hispanic or Latino,3,0,3
4014454,Single stillbirth,ethnic,Hispanic or Latino,3,0,3
4015641,"Fracture of tibia and fibula, NOS",ethnic,Hispanic or Latino,3,0,3
192956,Cholecystitis,ethnic,Not Hispanic or Latino,3,0,3
194491,Tenderness of epigastrium,racial,Unknown,3,0,3
441604,Acute appendicitis without peritonitis,ethnic,Not Hispanic or Latino,0,3,3
195079,Functional urinary incontinence,racial,Other Race,3,0,3
75652,Congenital valgus deformity of foot,ethnic,Hispanic or Latino,0,3,3
444125,Satisfactory for evaluation but limited by absence of an endocervical/transformation zone component from a patient with a cervix,racial,White,3,0,3
432895,Cortical senile cataract,racial,Other Race,1,2,3
198363,Candidiasis of vagina,racial,American Indian or Alaska Native ,3,0,3
441848,Cranial nerve disorder,ethnic,Hispanic or Latino,2,1,3
75091,Closed fracture of carpal bone,racial,Black or African American ,0,3,3
4297375,Victim of abuse,racial,Unknown,3,0,3
439727,HIV - Human immunodeficiency virus infection,racial,American Indian,0,3,3
437544,Arterial retinal branch occlusion,ethnic,Hispanic or Latino,3,0,3
441276,Nondependent alcohol abuse in remission,racial,Black or African American ,0,3,3
435644,Metatarsal bone fracture,ethnic,Hispanic or Latino,2,1,3
4059157,Family circumstance NOS,racial,Other Race,0,3,3
316822,Finding of heart murmur,racial,American Indian or Alaska Native ,2,1,3
4141492,Other ill-defined heart disease,racial,American Indian or Alaska Native ,3,0,3
78621,Crushing injury of knee,ethnic,Hispanic or Latino,2,1,3
4057371,Diverticulosis NOS,ethnic,Hispanic or Latino,2,1,3
76506,Effusion of joint of lower leg,racial,Other Race,1,2,3
138876,Closed fracture of T1-T6 level with spinal cord injury,racial,Unknown,3,0,3
441333,Geographic tongue,racial,Unknown,2,1,3
199067,Inflammatory disease of female pelvic organs AND/OR tissues,racial,Unknown,3,0,3
443934,Prostatitis associated with another disease,racial,White,0,3,3
134618,Toxic diffuse goiter with thyrotoxic crisis,racial,White,3,0,3
261600,Pulmonary oedema - acute,racial,White,2,1,3
132408,Back problem,racial,Asian,2,1,3
438792,Crowding of teeth,ethnic,Hispanic or Latino,1,2,3
31602,Disease of the larynx,ethnic,Not Hispanic or Latino,3,0,3
139850,Acute frontal sinusitis,racial,Asian,3,0,3
381285,Peroneal muscular atrophy,ethnic,Hispanic or Latino,1,2,3
376387,Spasmodic torticollis,racial,White,2,1,3
194475,Singultus,ethnic,Not Hispanic or Latino,1,2,3
75670,Sprain pelvic ligament,racial,Black or African American ,3,0,3
256448,Chronic asthmatic bronchitis,racial,Other Race,2,1,3
432801,"Injury undetermined whether accidentally or purposely inflicted, fall from natural site",racial,Filipino,3,0,3
200831,Congenital anomaly of penis,racial,Unknown,0,3,3
443982,Traumatic amputation of thumb,ethnic,Hispanic or Latino,0,3,3
4185302,Chronic myocardial ischemia,racial,Black or African American ,1,2,3
436510,Acquired cavus foot deformity,racial,White,2,1,3
438725,Disorder of magnesium metabolism,racial,White,2,1,3
73021,Bilateral congenital dislocation of hip,racial,White,3,0,3
4141622,Asthma NOS,racial,Black or African American ,1,2,3
24075,Esophageal stricture and stenosis,ethnic,Not Hispanic or Latino,1,2,3
315273,MS - Mitral stenosis,racial,Unknown,2,1,3
439348,Pregnancy complications,racial,White,3,0,3
4064383,Rheumatoid arthritis screening,racial,Unknown,1,2,3
443447,Iatrogenic hypotension,racial,Unknown,1,2,3
196724,Disease of diaphragm,racial,White,3,0,3
4149353,"Attention deficit hyperactivity disorder, predominantly inattentive type",racial,American Indian or Alaska Native ,3,0,3
379832,Mixed conductive and sensorineural deafness,racial,Asian,2,1,3
196359,Primary malignant neoplasm of uterine cervix,racial,Asian,3,0,3
442901,"Motor vehicle traffic accident involving collision with another motor vehicle, stopped, occupant of tram injured",ethnic,Hispanic or Latino,1,2,3
27587,Disturbance of salivary secretion,ethnic,Not Hispanic or Latino,1,2,3
137083,Unilateral incomplete cleft palate,racial,White,0,3,3
74806,Open wound of finger with complication,ethnic,Hispanic or Latino,1,2,3
444445,Benign neoplasm of skin of leg,ethnic,Not Hispanic or Latino,2,1,3
374313,Neoplasm of uncertain behaviour of connective and other soft tissues,ethnic,Hispanic or Latino,1,2,3
375547,Anisometropia,racial,White,1,2,3
136760,Transient hypertension of pregnancy - not delivered,racial,Other Race,3,0,3
443582,Disorder of joint of hand,ethnic,Hispanic or Latino,2,1,3
137813,Benign neoplasm of mouth region,ethnic,Hispanic or Latino,1,2,3
376690,Cerebral edema,racial,White,3,0,3
75052,Enthesopathy of wrist AND/OR carpus,racial,Unknown,2,1,3
375794,Alcohol-induced sleep disorder,racial,White,0,3,3
435318,Complete spontaneous abortion with genital tract or pelvic infection,racial,White,3,0,3
321844,Initial apnea,racial,White,0,3,3
436670,MD - Metabolic disorders,racial,Asian,3,0,3
442441,Grand multiparity with antenatal problem,racial,Unknown,3,0,3
4119298,Late onset asthma,ethnic,Not Hispanic or Latino,1,2,3
441025,Stenosis of lacrimal canaliculi,ethnic,Hispanic or Latino,1,2,3
4192786,Potential infectious contact,racial,Unknown,3,0,3
442942,"Crush injury, toe(s)",racial,Unknown,2,1,3
433403,Viral meningitis,ethnic,Not Hispanic or Latino,1,2,3
432597,Schizoaffective schizophrenia,racial,Asian,0,3,3
198075,Venereal wart,racial,Black or African American ,2,1,3
194683,Obstructed umbilical hernia,racial,Unknown,3,0,3
378160,Otorrhea,ethnic,Not Hispanic or Latino,2,1,3
380097,Diabetic macular edema,ethnic,Not Hispanic or Latino,2,1,3
4077382,Familial lipoprotein lipase deficiency,ethnic,Hispanic or Latino,3,0,3
73090,Superficial bruising of foot,racial,Other Race,3,0,3
4316068,TP - Total pancreatectomy,racial,White,0,3,3
192858,Ovarian hyperfunction,racial,White,3,0,3
376938,NF - Neurofibromatosis,racial,American Indian or Alaska Native ,3,0,3
435120,Blister of toe with infection,racial,Unknown,2,1,3
437384,Raised laboratory findings,racial,White,3,0,3
4171075,Bite of animal,racial,Unknown,2,1,3
437791,Chickenpox with complication,racial,Unknown,2,1,3
140486,Ulcer of calf,racial,Unknown,2,1,3
4101602,Henoch-Schonlein purpura,ethnic,Not Hispanic or Latino,0,3,3
381290,Ocular hypertension,ethnic,Not Hispanic or Latino,2,1,3
4015842,Viral hepatitis carrier,ethnic,Hispanic or Latino,3,0,3
81336,Rectal prolapse,racial,Black or African American ,0,3,3
443604,Factitious disorder with predominantly psychological signs and symptoms,ethnic,Hispanic or Latino,3,0,3
4149455,Baby birth weight 2.0-2.5kg,ethnic,Hispanic or Latino,0,3,3
4056022,Chronic pyelonephritis NOS,racial,White,1,2,3
376113,Recent subtotal retinal detachment,racial,White,2,1,3
381732,Nerve injury,ethnic,Hispanic or Latino,2,1,3
4196206,beta^+^ Thalassemia,racial,White,3,0,3
443239,Precerebral arterial occlusion,ethnic,Hispanic or Latino,3,0,3
134442,Thibierge-Weissenbach syndrome,racial,Unknown,2,1,3
76482,MA - Missed abortion,racial,Black or African American ,3,0,3
138519,Spondylosis without myelopathy,racial,Black or African American ,3,0,3
4090255,Colloid bodies in retina,racial,White,2,1,3
77029,Epididymo-orchitis without abscess,ethnic,Not Hispanic or Latino,0,3,3
432626,Glaucoma associated with vascular disorder,racial,White,3,0,3
432302,Cocaine dependence in remission,racial,White,0,3,3
194091,Calculus in urethra,racial,White,0,3,3
444247,Venous thrombosis,racial,Black or African American ,1,2,3
315947,Thoracic back sprain,racial,Other Race,2,1,3
444069,Abrasion AND/OR friction burn of leg with infection,racial,Unknown,2,1,3
4073997,Stretching of prepuce,racial,White,0,3,3
377254,"Multi-infarct dementia, uncomplicated",racial,American Indian or Alaska Native ,3,0,3
374338,Nondiabetic proliferative retinopathy,racial,Unknown,0,3,3
73183,Myotonic disorder,ethnic,Not Hispanic or Latino,3,0,3
40482247,Organic sleep apnea,ethnic,Hispanic or Latino,1,2,3
432611,Explosive personality disorder,racial,Unknown,0,3,3
194686,Acquired renal cyst,racial,Black or African American ,2,1,3
4098600,Gouty nephropathy unspecified,ethnic,Hispanic or Latino,3,0,3
31120,Congenital anomaly of upper alimentary tract,ethnic,Hispanic or Latino,1,2,3
25486,Primary malignant neoplasm of islets of Langerhans,racial,White,0,3,3
433516,Duodenitis,racial,Unknown,2,1,3
439795,Minimal cognitive impairment,racial,Black or African American ,3,0,3
134057,Disease of cardiovascular system,racial,Asian,0,3,3
76472,Dysplasia of anus,racial,Asian,0,3,3
438887,Closed fracture shaft of femur,ethnic,Hispanic or Latino,1,2,3
441081,Maternal gonorrhoea during pregnancy - baby not yet delivered,racial,White,3,0,3
255891,Lupus erythematosus,racial,Other Race,3,0,3
195770,Subserous uterine fibroid,racial,Black or African American ,3,0,3
4305589,"Neoplasm, benign",ethnic,Not Hispanic or Latino,1,2,3
436583,[X]Falls,racial,Filipino,1,2,3
141253,Disease of thyroid gland,racial,Black or African American ,2,1,3
4056022,Chronic pyelonephritis NOS,ethnic,Hispanic or Latino,1,2,3
140654,Deep seated dermatophytosis,racial,Unknown,1,2,3
436837,Closed fracture of neck of radius,ethnic,Hispanic or Latino,3,0,3
198082,Overlapping malignant neoplasm of body of uterus,ethnic,Hispanic or Latino,3,0,3
80997,Myopathy due to endocrine disease EC,ethnic,Hispanic or Latino,3,0,3
198240,Congenital buried penis,racial,White,0,3,3
435443,[X]Fall involving wheelchair,racial,White,2,1,3
442626,Benign hypertensive heart AND renal disease,racial,White,3,0,3
436080,"Neoplasm of uncertain behaviour of lip, oral cavity and pharynx",ethnic,Hispanic or Latino,1,2,3
439013,Insomnia disorder related to another mental disorder,ethnic,Not Hispanic or Latino,2,1,3
435233,Disorders of fatty-acid metabolism,racial,Other Race,3,0,3
78529,Kyphoscoliosis and scoliosis,racial,Asian,2,1,3
4144783,Old healed fracture of bone,racial,White,3,0,3
4105187,Speech or language developmental disorder NOS,ethnic,Not Hispanic or Latino,1,2,3
4108533,Unspecified otalgia,racial,Black or African American ,3,0,3
81893,Chronic ulcerative colitis,racial,Black or African American ,3,0,3
441177,Second degree burn of upper limb,racial,White,2,1,3
435569,Disorder of jaw,racial,Unknown,2,1,3
135360,Fainting,racial,Filipino,3,0,3
201340,Gastritis,racial,Filipino,1,2,3
432526,Needs influenza immunisation,racial,Alaska Native,0,3,3
4058399,Placenta praevia without haemorrhage unspecified,ethnic,Hispanic or Latino,3,0,3
443392,Malignant neoplastic disease,ethnic,Hispanic or Latino,3,0,3
436510,Acquired cavus foot deformity,ethnic,Not Hispanic or Latino,2,1,3
260134,Croup,racial,Asian,1,2,3
141305,Unilateral sensorineural hearing loss with unrestricted hearing on the contralateral side,racial,Other Race,3,0,3
74434,Infection of the breast AND/OR nipple associated with childbirth,racial,White,3,0,3
433658,Adverse reaction to penicillins,racial,Unknown,2,1,3
381581,Chalazion,racial,Black or African American ,2,1,3
4077382,Familial lipoprotein lipase deficiency,ethnic,Not Hispanic or Latino,0,3,3
195583,Chronic gastric ulcer without hemorrhage AND without perforation but with obstruction,ethnic,Hispanic or Latino,3,0,3
374364,Disorder of middle ear,racial,White,1,2,3
192364,Nephrotic syndrome associated with another disorder,racial,White,1,2,3
4148404,Family history: Anemia,racial,White,2,1,3
444371,Abrasion AND/OR friction burn of finger without infection,racial,Unknown,3,0,3
439439,Injury of unknown intent by cutting instrument,ethnic,Hispanic or Latino,1,2,3
4112003,Hypotension NOS,ethnic,Hispanic or Latino,1,2,3
373962,Tabes dorsalis - neurosyphilis,ethnic,Hispanic or Latino,2,1,3
4097716,"Benign neoplasm of lip, oral cavity and pharynx NOS",ethnic,Hispanic or Latino,1,2,3
74322,Benign neoplasm of scrotum,ethnic,Not Hispanic or Latino,0,3,3
133510,Rapidly progressive periodontitis,ethnic,Not Hispanic or Latino,1,2,3
75046,Old bucket handle tear of medial meniscus,racial,White,0,3,3
25486,Primary malignant neoplasm of islets of Langerhans,ethnic,Hispanic or Latino,0,3,3
436700,Eye displaced forwards,racial,Unknown,2,1,3
198809,Acute cholecystitis,ethnic,Not Hispanic or Latino,2,1,3
437013,"Primary dental caries, pit and fissure origin",ethnic,Hispanic or Latino,0,3,3
376425,Chronic non-suppurative otitis media,ethnic,Not Hispanic or Latino,2,1,3
4166443,Family history: Arthritis,racial,White,1,2,3
437478,Bite of nonvenomous arthropod,racial,Other Race,0,3,3
194993,Intestinal malabsorption,racial,Black or African American ,3,0,3
200761,Retroperitoneal abscess,racial,White,0,3,3
432303,Cocaine abuse,ethnic,Not Hispanic or Latino,1,2,3
443934,Prostatitis associated with another disease,ethnic,Hispanic or Latino,0,3,3
260131,Bronchial disorder,ethnic,Not Hispanic or Latino,3,0,3
80492,Knee joint contracture,racial,White,3,0,3
201675,Autosomal recessive polycystic kidney disease,ethnic,Hispanic or Latino,3,0,3
4103471,Observation of body mass index,racial,Arab,3,0,3
434303,Benign neoplasm of rectum and anal canal,racial,White,0,3,3
4065355,Urticaria due to cold and heat,ethnic,Hispanic or Latino,3,0,3
434033,Chorioretinitis,ethnic,Hispanic or Latino,1,2,3
439005,Chronic alcoholism in remission,racial,Black or African American ,1,2,3
136779,Disease of forearm,racial,White,3,0,3
433505,Subclavian steal syndrome,ethnic,Hispanic or Latino,2,1,3
433633,Late effect of superficial injury,ethnic,Hispanic or Latino,3,0,3
28457,Hypertrophy of tonsils,racial,American Indian or Alaska Native ,2,1,3
4150307,Dental restoration observation,racial,Black or African American ,3,0,3
437703,Closed fracture of intracapsular section of femur,ethnic,Hispanic or Latino,3,0,3
439274,Acute exacerbation of subchronic latent schizophrenia,ethnic,Not Hispanic or Latino,0,3,3
201620,Calculus of kidney,racial,Black or African American ,2,1,3
141831,Branchial arch syndrome,ethnic,Not Hispanic or Latino,3,0,3
192671,GI - Gastrointestinal haemorrhage,racial,Black or African American ,1,2,3
440029,Viral disease,racial,Filipino,1,2,3
134898,Non-toxic single thyroid nodule,racial,Black or African American ,1,2,3
439391,Physical abuse of adult,racial,Unknown,3,0,3
441805,Primary malignant neoplasm of endocervix,racial,White,3,0,3
373425,Metastasis to nervous system,ethnic,Hispanic or Latino,3,0,3
194175,Left upper quadrant pain,racial,American Indian or Alaska Native ,2,1,3
194699,Liver disorder in pregnancy,racial,Unknown,3,0,3
4315363,"Accidents caused by knives, swords and daggers",racial,White,3,0,3
439940,Closed fracture of upper end of forearm,ethnic,Hispanic or Latino,1,2,3
443357,Ankle joint observation,ethnic,Hispanic or Latino,1,2,3
31057,Disorder of pharynx,racial,White,2,1,3
436675,Anorexia nervosa,ethnic,Not Hispanic or Latino,1,2,3
4103574,Chronic depression,racial,Black or African American ,1,2,3
4273095,Acute tracheitis without obstruction,racial,Unknown,0,3,3
193688,Clostridium difficile infection,racial,Black or African American ,2,1,3
441589,Endocarditis,racial,Asian,3,0,3
140173,Telogen effluvium,racial,Unknown,3,0,3
376686,Polyneuropathy associated with another disorder,racial,Asian,0,3,3
437689,Multiple closed fractures of cervical vertebrae,ethnic,Hispanic or Latino,0,3,3
437779,Streptococcal infectious disease,ethnic,Not Hispanic or Latino,0,3,3
377802,Late effects of poliomyelitis,racial,Other Race,0,3,3
4014231,Foot sprain NOS,racial,Unknown,2,1,3
435217,Paranoid schizophrenia in remission,racial,White,0,3,3
77074,Joint pain,racial,Native Hawaiian or Other Pacific Islander ,2,1,3
4051702,FH: Congenital anomaly,racial,White,3,0,3
4057371,Diverticulosis NOS,racial,White,2,1,3
74434,Infection of the breast AND/OR nipple associated with childbirth,ethnic,Hispanic or Latino,3,0,3
374645,Phantom limb syndrome,racial,Black or African American ,0,3,3
321822,Peripheral circulatory disorder associated with diabetes mellitus,racial,Unknown,2,1,3
437400,Closed fracture of shaft of ulna,racial,Unknown,1,2,3
317895,Hypertension due to renovascular disease,racial,White,2,1,3
81336,Rectal prolapse,racial,Unknown,3,0,3
436747,Legal abortion without complication,racial,White,3,0,3
76201,Non-traumatic rupture of biceps brachii tendon,racial,White,1,2,3
442936,"Motor vehicle traffic accident due to motor vehicle going out of control due to failure of mechanical part, without collision on the highway, passenger of motor vehicle injured",racial,White,3,0,3
200052,Primary malignant neoplasm of uterine adnexa,racial,White,3,0,3
373648,Superficial injury of eyelid AND/OR periocular area,racial,Unknown,1,2,3
4176878,Calculus of cystic duct with cholecystitis,ethnic,Hispanic or Latino,2,1,3
137005,Tracheostomy complication,ethnic,Not Hispanic or Latino,3,0,3
433599,Abnormal biochemistry finding,racial,American Indian or Alaska Native ,3,0,3
373425,Metastasis to nervous system,racial,White,3,0,3
434165,Abnormal cervical smear,racial,Black or African American ,3,0,3
77630,Disease of shoulder,racial,American Indian or Alaska Native ,3,0,3
200772,Gastroenteritis due to radiation,ethnic,Hispanic or Latino,2,1,3
316998,Left bundle branch block,racial,Asian,3,0,3
80141,Functional diarrhea,racial,Black or African American ,3,0,3
200452,Disease of female genital organ,racial,Asian,3,0,3
378253,HA - Headache,racial,Native Hawaiian or Other Pacific Islander ,3,0,3
198198,Vaginal polyp,racial,Unknown,3,0,3
138582,"Closed fracture scapula, acromion",racial,Unknown,3,0,3
4053045,Dog bite,racial,Other Race,3,0,3
314664,Long Q-T syndrome,racial,White,3,0,3
252365,MGN - Membranous glomerulonephritis,racial,Asian,0,3,3
433400,Emergency contraception,racial,Black or African American ,3,0,3
256439,Allergic rhinitis due to pollen,racial,Asian,2,1,3
376966,Exudative age-related macular degeneration,ethnic,Not Hispanic or Latino,0,3,3
73065,"Contusion, genital organs",ethnic,Hispanic or Latino,3,0,3
377575,Tinnitus,racial,Black or African American ,2,1,3
4147494,Nonspecific mesenteric adenitis,racial,Unknown,0,3,3
380669,Benign neoplasm of eyelid including canthus,racial,Unknown,2,1,3
141249,Benign tumour of thyroid gland,ethnic,Not Hispanic or Latino,3,0,3
432302,Cocaine dependence in remission,ethnic,Hispanic or Latino,0,3,3
321502,Chagas' disease with heart involvement,racial,Other Race,0,3,3
437525,Overweight,racial,Arab,3,0,3
374905,Non-organic sleep disorder,racial,Black or African American ,2,1,3
4232212,Hypoglycemic shock,ethnic,Hispanic or Latino,0,3,3
433621,Sprain of sternoclavicular joint AND/OR ligament,ethnic,Hispanic or Latino,2,1,3
201823,Benign tumour of penis,ethnic,Not Hispanic or Latino,0,3,3
432345,Hypertrophy of tongue papillae,racial,Unknown,2,1,3
439745,Primary malignant neoplasm of salivary gland duct,racial,White,3,0,3
380100,Glossopharyngeal neuralgia,ethnic,Hispanic or Latino,3,0,3
135699,Burn any degree involving 10-19 percent of body surface,ethnic,Not Hispanic or Latino,1,2,3
377271,Parsonage-Turner syndrome,ethnic,Hispanic or Latino,0,3,3
76201,Non-traumatic rupture of biceps brachii tendon,ethnic,Hispanic or Latino,1,2,3
435151,Physical child abuse,ethnic,Not Hispanic or Latino,1,2,3
133228,Dental caries,racial,Filipino,1,2,3
442626,Benign hypertensive heart AND renal disease,ethnic,Hispanic or Latino,3,0,3
138825,Actinic keratosis,racial,American Indian or Alaska Native ,2,1,3
194091,Calculus in urethra,ethnic,Hispanic or Latino,0,3,3
199754,Primary malignant neoplasm of pancreas,racial,Asian,2,1,3
372616,Werdnig-Hoffmann disease,ethnic,Not Hispanic or Latino,2,1,3
380093,Episodic cluster headache,ethnic,Hispanic or Latino,2,1,3
4332993,Childhood schizophrenia NOS,racial,White,0,3,3
438788,Hypertrophy of adenoids,ethnic,Not Hispanic or Latino,1,2,3
197654,Congenital cystic disease of liver,racial,White,0,3,3
196442,Chronic gastric ulcer with hemorrhage AND with perforation but without obstruction,ethnic,Hispanic or Latino,3,0,3
77234,Benign tumour of colon,racial,American Indian or Alaska Native ,3,0,3
4051568,Family history of mental disorder,ethnic,Not Hispanic or Latino,2,1,3
4108676,Other chronic ischaemic heart disease NOS,racial,White,0,3,3
134765,General body deterioration,racial,Asian,0,3,3
444069,Abrasion AND/OR friction burn of leg with infection,racial,White,1,2,3
432295,Pernicious anemia,ethnic,Not Hispanic or Latino,0,3,3
76472,Dysplasia of anus,ethnic,Not Hispanic or Latino,0,3,3
439658,Gestosis,ethnic,Not Hispanic or Latino,2,1,3
437589,Pulpitis,ethnic,Not Hispanic or Latino,1,2,3
134460,Plantar fascial fibromatosis,racial,Filipino,1,2,3
436263,Broken tooth without complication,racial,Other Race,2,1,3
436948,Benign neoplasm of choroid,ethnic,Hispanic or Latino,1,2,3
4192786,Potential infectious contact,racial,White,3,0,3
201823,Benign tumour of penis,racial,White,0,3,3
196734,Disease of prostate,racial,Other Race,0,3,3
133438,Chronic lymphoid leukaemia in remission,ethnic,Hispanic or Latino,0,3,3
81454,Injury of finger,racial,Black or African American ,0,3,3
4109545,Unspecified cataracta complicata,racial,White,1,2,3
138896,Open wound of forehead without complication,racial,Other Race,1,2,3
373212,Esophoria,racial,Unknown,2,1,3
140020,Viral exanthem,racial,Black or African American ,2,1,3
72418,Scoliosis deformity of spine,racial,Other Race,3,0,3
435782,Chronic schizophrenic,racial,Filipino,3,0,3
4092845,Candidiasis NOS,racial,White,1,2,3
375794,Alcohol-induced sleep disorder,ethnic,Not Hispanic or Latino,0,3,3
194871,Trichomonal vulvovaginitis,racial,Unknown,3,0,3
436659,Iron deficiency anaemia,racial,Native Hawaiian or Other Pacific Islander ,1,2,3
442287,Rest pain,racial,Unknown,2,1,3
439706,Psychosis with origin in childhood,racial,Black or African American ,0,3,3
23798,Acute laryngopharyngitis,ethnic,Not Hispanic or Latino,1,2,3
141475,Second degree burn of foot,ethnic,Hispanic or Latino,1,2,3
72710,Effusion of joint of forearm,ethnic,Not Hispanic or Latino,1,2,3
4064363,Intest helminthiasis screening,ethnic,Hispanic or Latino,0,3,3
75686,Open wound of hand except fingers with complication,racial,White,0,3,3
135618,Prurigo,racial,Asian,0,3,3
201618,Disease of intestine,racial,Unknown,2,1,3
376552,Cerebral laceration and contusion,ethnic,Not Hispanic or Latino,1,2,3
434547,Complication of surgical procedure,racial,White,2,1,3
74855,Genital herpes simplex,racial,Asian,2,1,3
432508,"Mechanical complication of nervous system device, implant AND/OR graft",racial,White,0,3,3
439249,"Mixed bipolar affective disorder, mild",racial,White,0,3,3
435604,"Viral disease in mother complicating pregnancy, childbirth AND/OR puerperium",racial,White,2,1,3
434663,Acute endocarditis,ethnic,Hispanic or Latino,1,2,3
81938,Climacteric arthritis of the shoulder region,ethnic,Hispanic or Latino,3,0,3
4316068,TP - Total pancreatectomy,ethnic,Hispanic or Latino,0,3,3
441385,Corrected transposition of great vessels,ethnic,Hispanic or Latino,2,1,3
434701,"Anemia in mother complicating pregnancy, childbirth AND/OR puerperium",ethnic,Not Hispanic or Latino,3,0,3
319054,Thrombophlebitis of upper extremities,racial,White,1,2,3
201914,Premenopausal menorrhagia,racial,Asian,3,0,3
318556,Nosebleed,racial,Filipino,1,2,3
441846,After-cataract not obscuring vision,ethnic,Hispanic or Latino,3,0,3
73089,Contusion of buttock,ethnic,Not Hispanic or Latino,2,1,3
314962,Raynaud disease,racial,Asian,3,0,3
444055,Thrombophlebitis of superficial veins of lower extremity,racial,Unknown,2,1,3
28385,Disorder of posterior pituitary,racial,Asian,3,0,3
4009750,Open fracture of other tarsal and metatarsal bones,ethnic,Not Hispanic or Latino,0,3,3
432601,Childhood and adolescent disturbance with elective mutism,ethnic,Not Hispanic or Latino,3,0,3
199075,Neurogenic bladder,racial,Black or African American ,0,3,3
4269719,Finding of growth of fungi,ethnic,Not Hispanic or Latino,1,2,3
138519,Spondylosis without myelopathy,racial,Native Hawaiian or Other Pacific Islander ,0,3,3
4228802,Mild recurrent major depression,racial,Black or African American ,1,2,3
74082,Acontractile detrusor,racial,Other Race,0,3,3
439656,A/N care: grand multip,racial,White,3,0,3
4064989,Lung function testing abnormal,racial,Unknown,1,2,3
443876,Obsessive compulsive personality disorder,racial,White,2,1,3
316211,Acquired spondylolisthesis,ethnic,Not Hispanic or Latino,1,2,3
199879,Fistula of the female genital organs,racial,White,3,0,3
439745,Primary malignant neoplasm of salivary gland duct,ethnic,Hispanic or Latino,3,0,3
378157,Mechanical strabismus,ethnic,Hispanic or Latino,3,0,3
433735,Alcohol dependence with acute alcoholic intoxication,ethnic,Not Hispanic or Latino,0,3,3
78593,Open wound of wrist without complication,racial,White,1,2,3
4236391,Acute necrotizing otitis media,racial,White,0,3,3
438447,Acute myocardial infarction of inferolateral wall,racial,Unknown,3,0,3
374924,Generalized convulsive epilepsy,racial,Filipino,0,3,3
316376,Eosinophilia,racial,Unknown,1,2,3
441264,Primary thrombocytopenia,racial,Other Race,2,1,3
138255,Abnormal cardiovascular function,racial,White,3,0,3
433736,Obesity,racial,Middle Eastern or North African,3,0,3
134681,Spasm of oesophagus,racial,White,2,1,3
198082,Overlapping malignant neoplasm of body of uterus,racial,Other Race,3,0,3
255454,"Tuberculosis of lung, confirmed by sputum microscopy with or without culture",ethnic,Hispanic or Latino,2,1,3
381857,Impairment level: one eye: total impairment: other eye: not specified,racial,Other Race,2,1,3
4152045,Screening for malignant neoplasm of respiratory tract,ethnic,Hispanic or Latino,3,0,3
435836,Disorder of nasopharynx,ethnic,Not Hispanic or Latino,2,1,3
199076,Fallopian tube pregnancy,racial,Unknown,3,0,3
141095,Acne,racial,Filipino,2,1,3
4115173,Atrial premature complex,racial,Black or African American ,2,1,3
135923,CP - Cleft palate,racial,Other Race,3,0,3
78472,Microscopic haematuria,racial,Native Hawaiian or Other Pacific Islander ,3,0,3
373747,Extrapyramidal disease,ethnic,Not Hispanic or Latino,2,1,3
434490,Shivering,ethnic,Not Hispanic or Latino,1,2,3
380055,Primary malignant neoplasm of brain,racial,Unknown,0,3,3
312664,Influenza with respiratory manifestation other than pneumonia,racial,Filipino,0,3,3
434916,"Amfetamine or psychostimulant dependence, continuous",racial,Unknown,3,0,3
260427,Common cold,racial,American Indian or Alaska Native ,3,0,3
198928,Mechanical complication due to intrauterine contraceptive device,racial,Unknown,3,0,3
435388,"Cortex contusion with open intracranial wound, with more than 24 hours loss of consciousness and return to pre-existing conscious level",ethnic,Hispanic or Latino,0,3,3
317893,Paroxysmal supraventricular tachycardia,racial,Other Race,0,3,3
381865,Sensorimotor disorder of eyelid,ethnic,Hispanic or Latino,2,1,3
192359,RF - Renal failure,racial,Other Race,2,1,3
376657,Lipoma of face,racial,Unknown,3,0,3
4059637,Work environment deleterious,ethnic,Not Hispanic or Latino,2,1,3
440846,"Blood coagulation disorder, categorized by value of screening test",racial,Asian,0,3,3
441829,Hyperosmolality and or hypernatremia,racial,Asian,3,0,3
30284,Motion sickness,ethnic,Not Hispanic or Latino,2,1,3
374338,Nondiabetic proliferative retinopathy,racial,Black or African American ,0,3,3
201449,Unilateral traumatic amputation of leg below knee without complication,racial,White,1,2,3
4278083,Viral tracheitis,racial,White,0,3,3
437478,Bite of nonvenomous arthropod,racial,Asian,1,2,3
79173,Closed dislocation of jaw,racial,White,2,1,3
79109,Climacteric arthritis,ethnic,Hispanic or Latino,3,0,3
439893,Excessive weight gain in pregnancy,ethnic,Hispanic or Latino,1,2,3
197676,Hepatomegaly,racial,Other Race,0,3,3
437064,Chondrocalcinosis,racial,White,2,1,3
26441,Bleeding ulcer of esophagus,racial,White,0,3,3
439893,Excessive weight gain in pregnancy,racial,White,1,2,3
4240902,Allergy to peanuts,racial,Other Race,0,3,3
441628,Menopausal and postmenopausal disorders,racial,Black or African American ,3,0,3
443563,Arteriosclerosis in coronary artery bypass graft,racial,Other Race,0,3,3
436799,Talipes cavus,racial,White,2,1,3
74725,Displacement of cervical intervertebral disc without myelopathy,racial,Black or African American ,3,0,3
4059014,Spontaneous bruising,racial,Black or African American ,0,3,3
432382,Complication of labor AND/OR delivery,ethnic,Hispanic or Latino,3,0,3
436089,"Nondependent cocaine abuse, episodic",ethnic,Hispanic or Latino,0,3,3
432884,Amfetamine or psychostimulant dependence in remission,ethnic,Hispanic or Latino,0,3,3
140027,Herpetic gingivostomatitis,racial,Other Race,3,0,3
199856,Varicose veins of lower extremity with inflammation,racial,Black or African American ,0,3,3
438460,Edentulous alveolar ridge atrophy,racial,White,3,0,3
74082,Acontractile detrusor,ethnic,Hispanic or Latino,0,3,3
4023168,Home alone,ethnic,Not Hispanic or Latino,2,1,3
255454,"Tuberculosis of lung, confirmed by sputum microscopy with or without culture",racial,White,2,1,3
194990,Inflammatory disorder of liver,racial,Black or African American ,1,2,3
440388,[X]Developmental co - ordination disorder,racial,Black or African American ,0,3,3
374907,Tics of organic origin,ethnic,Hispanic or Latino,1,2,3
432910,Disorder of lacrimal system,racial,Unknown,1,2,3
4115062,Other internal knee derangement NOS,racial,Unknown,0,3,3
436314,Accidental puncture AND/OR laceration during a procedure,ethnic,Not Hispanic or Latino,0,3,3
4288028,Mural pregnancy,ethnic,Hispanic or Latino,3,0,3
193983,Disorder of pancreatic internal secretion,ethnic,Hispanic or Latino,2,1,3
4179214,Family history of malignant neoplasm of gastrointestinal tract,racial,Black or African American ,1,2,3
192279,Diabetic nephropathy,racial,Alaska Native,3,0,3
198470,Unilateral inguinal hernia with obstruction but no gangrene,racial,Unknown,0,3,3
435080,Biliuria,racial,Unknown,2,1,3
138502,Vitiligo,racial,Other Race,1,2,3
4024361,Paralysis of glottis,racial,Other Race,3,0,3
196456,Cholecystolithiasis,racial,Asian Indian,0,3,3
380378,Epilepsy,racial,American Indian or Alaska Native ,2,1,3
443891,Cementum caries,ethnic,Not Hispanic or Latino,0,3,3
374915,Localisation-related epilepsy,ethnic,Not Hispanic or Latino,3,0,3
4015641,"Fracture of tibia and fibula, NOS",racial,White,3,0,3
376938,NF - Neurofibromatosis,ethnic,Not Hispanic or Latino,3,0,3
81713,Carpal joint sprain,ethnic,Hispanic or Latino,2,1,3
201079,Acute parametritis and pelvic cellulitis,ethnic,Not Hispanic or Latino,2,1,3
195500,Benign tumour of uterus,racial,White,2,1,3
442444,"Motor vehicle traffic accident involving pedestrian hit by motor vehicle, pedestrian injured",racial,Other Race,3,0,3
137977,Icteric,racial,Asian,1,2,3
4100382,Acute hysterical psychosis,ethnic,Hispanic or Latino,2,1,3
4061081,Other male genital organ diseases OS,racial,White,0,3,3
74472,Congenital deformity of foot,racial,Other Race,0,3,3
444361,Nonvenomous insect bite of toe without infection,racial,Unknown,1,2,3
440053,Infestation by insect,ethnic,Not Hispanic or Latino,3,0,3
137111,"Closed fracture scapula, coracoid",ethnic,Hispanic or Latino,0,3,3
379784,Senile dementia with depression,racial,Asian,2,1,3
432898,Severe mental handicap,racial,Black or African American ,0,3,3
432311,Angle-closure glaucoma - borderline,racial,White,2,1,3
440072,Hypogammaglobulinemia,racial,White,2,1,3
432626,Glaucoma associated with vascular disorder,racial,Unknown,1,2,3
141372,Contact dermatitis due to solvents,racial,Black or African American ,0,3,3
435569,Disorder of jaw,ethnic,Not Hispanic or Latino,3,0,3
435849,Parietoalveolar pneumopathy,racial,White,2,1,3
4165070,Unilateral breast implant,ethnic,Hispanic or Latino,3,0,3
138604,"Contusion of face, scalp and neck, excluding eye(s)",racial,Other Race,1,2,3
439554,Hypnotic or anxiolytic abuse,ethnic,Not Hispanic or Latino,0,3,3
26823,Oral phase dysphagia,racial,Other Race,3,0,3
4165070,Unilateral breast implant,racial,Unknown,3,0,3
442023,Poisoning of undetermined intent,racial,Unknown,2,1,3
138825,Actinic keratosis,racial,Other Race,1,2,3
4067435,"Joint disorder NOS, of unspecified site",racial,Unknown,1,2,3
321588,Heart disease,racial,Asian,0,3,3
4093344,Prostate observation,racial,American Indian or Alaska Native ,0,3,3
201461,Disorder affecting transplant,ethnic,Hispanic or Latino,2,1,3
434854,FP - Food poisoning,ethnic,Not Hispanic or Latino,1,2,3
432874,Lipidosis,ethnic,Not Hispanic or Latino,0,3,3
432875,Anemia due to chronic blood loss,ethnic,Not Hispanic or Latino,2,1,3
319843,Mitral valve disorder,racial,Other Race,2,1,3
438430,Squamous blepharitis,racial,Unknown,2,1,3
440668,Benign tumour of tongue,racial,White,1,2,3
138616,Superficial burn of hand,ethnic,Hispanic or Latino,1,2,3
439004,Restzustand,ethnic,Not Hispanic or Latino,0,3,3
437474,Postoperative infection,racial,Unknown,2,1,3
133685,Salmonellosis,racial,White,1,2,3
256723,Pneumonia and influenza,ethnic,Hispanic or Latino,2,1,3
321882,Generalised atherosclerosis,ethnic,Not Hispanic or Latino,1,2,3
441260,Drug withdrawal syndrome,racial,Unknown,2,1,3
78273,Closed fracture multiple ribs,racial,Other Race,0,3,3
376411,Central pterygium,racial,Unknown,2,1,3
437843,Childhood conduct disorder,racial,Unknown,1,2,3
434890,Repetitive stereotyped movement,ethnic,Hispanic or Latino,0,3,3
376690,Cerebral edema,ethnic,Not Hispanic or Latino,3,0,3
433196,Chorioretinal scar,ethnic,Hispanic or Latino,3,0,3
374357,Acquired stenosis of nasolacrimal duct,racial,Asian,0,3,3
4104016,Ts and As - Tonsillectomy and adenoidectomy,ethnic,Hispanic or Latino,1,2,3
195245,Reflex sympathetic dystrophy,racial,Unknown,0,3,3
141693,Elevated blood-pressure reading without diagnosis of hypertension,racial,American Indian,0,3,3
4161978,Patient on oxygen,racial,Black or African American ,0,3,3
435508,Adrenal cortical hypofunction,racial,American Indian,3,0,3
138667,Stoma observations,ethnic,Hispanic or Latino,2,1,3
200768,Inflammatory disease of vagina and/or vulva,ethnic,Not Hispanic or Latino,3,0,3
140486,Ulcer of calf,racial,Other Race,0,3,3
40481374,Allergic rhinitis due to food,ethnic,Not Hispanic or Latino,3,0,3
443350,Lower urinary tract symptoms,racial,Filipino,0,3,3
442752,Myalgia,racial,Asian Indian,3,0,3
79072,Inflammatory disorder of breast,racial,Other Race,3,0,3
80478,Engorgement of breasts associated with childbirth,racial,White,3,0,3
435782,Chronic schizophrenic,racial,American Indian or Alaska Native ,0,3,3
438130,Opioid abuse,ethnic,Not Hispanic or Latino,1,2,3
4281232,Type B viral hepatitis,ethnic,Not Hispanic or Latino,1,2,3
79098,Suppressed lactation,racial,Black or African American ,0,3,3
133637,Second degree burn of lower limb,racial,White,2,1,3
444253,Blister of scalp without infection,ethnic,Hispanic or Latino,2,1,3
192362,Nephrotic syndrome with membranoproliferative glomerulonephritis,ethnic,Hispanic or Latino,0,3,3
380403,External hordeolum,racial,Native Hawaiian or Other Pacific Islander ,2,1,3
197672,Urinary incontinence,racial,Filipino,2,1,3
437664,Does not vocalise,ethnic,Hispanic or Latino,1,2,3
433390,Immunosuppressant adverse reaction,racial,Unknown,3,0,3
439128,Extreme immaturity,racial,Asian,3,0,3
433930,Motor vehicle on road in collision with another motor vehicle,ethnic,Hispanic or Latino,2,1,3
193984,Adrenal hypofunction,racial,White,1,2,3
192606,Paraplegia,racial,Black or African American ,0,3,3
4008517,"Fracture of rib(s), sternum, larynx and trachea",ethnic,Hispanic or Latino,0,3,3
437664,Does not vocalise,racial,Unknown,1,2,3
441266,Thiamin deficiency,racial,White,2,1,3
434742,Congenital abnormality of skull and face bones,racial,Black or African American ,1,2,3
4046804,Disorder of fluency,racial,White,0,3,3
439961,Superficial injury without infection,ethnic,Not Hispanic or Latino,2,1,3
315586,Priapism,racial,White,0,2,2
194091,Calculus in urethra,ethnic,Not Hispanic or Latino,2,0,2
4115173,Atrial premature complex,ethnic,Not Hispanic or Latino,2,1,3
4208970,History of physical abuse,racial,Unknown,1,1,2
435644,Metatarsal bone fracture,racial,Unknown,1,2,3
441351,Early onset of delivery - delivered,racial,Black or African American ,1,2,3
437097,Congenital anomaly of cartilage,racial,Unknown,2,0,2
439971,Poisoning by anticoagulant,racial,Unknown,2,1,3
134741,Congenital anomaly of limb,ethnic,Not Hispanic or Latino,1,2,3
4013457,"Closed fracture of proximal humerus, unspecified part",ethnic,Not Hispanic or Latino,0,2,2
4115370,Arthralgia NOS,racial,Unknown,2,0,2
136495,Lichenification and lichen simplex chronicus,racial,Other Race,2,1,3
4064925,Hypertension screening,ethnic,Not Hispanic or Latino,2,1,3
318096,Secondary lymph node cancer,ethnic,Hispanic or Latino,0,2,2
4148121,Tonsil and/or adenoid hypertrophy,ethnic,Hispanic or Latino,1,1,2
434900,Drug-induced psychosis,ethnic,Not Hispanic or Latino,2,0,2
4177243,Cancer of pharynx,racial,Unknown,1,1,2
192815,Intestinal infection due to E. coli,racial,White,1,1,2
376094,Arteriosclerotic dementia with delirium,racial,White,2,0,2
132446,Congenital anomaly of skin,racial,Black or African American ,1,1,2
196515,Congenital chordee,ethnic,Hispanic or Latino,0,2,2
201727,Superficial injury of trunk without infection,ethnic,Hispanic or Latino,2,1,3
436667,Stammer,ethnic,Not Hispanic or Latino,0,2,2
438788,Hypertrophy of adenoids,racial,Black or African American ,0,2,2
440078,"Bipolar affective disorder, current episode manic",racial,Unknown,0,2,2
80478,Engorgement of breasts associated with childbirth,ethnic,Hispanic or Latino,2,0,2
433968,Candidiasis,racial,Asian,1,2,3
433917,Burns of multiple sites,ethnic,Hispanic or Latino,0,2,2
193445,Periodic disease,ethnic,Hispanic or Latino,0,2,2
257094,Congenital anomaly of lung,ethnic,Hispanic or Latino,1,1,2
4211657,Closed fracture of lower leg,ethnic,Hispanic or Latino,0,2,2
194686,Acquired renal cyst,racial,Asian,0,2,2
253235,Pneumonia in pertussis,ethnic,Hispanic or Latino,2,1,3
4141201,Beta lactam resistant bacterial infection,racial,Unknown,2,1,3
376394,Menstrual migraine,ethnic,Hispanic or Latino,2,0,2
439719,Disseminated mycobacteriosis,racial,Unknown,0,2,2
439763,Benign tumour of trachea,racial,White,0,2,2
193020,Incomplete emptying of bladder,ethnic,Not Hispanic or Latino,2,0,2
200169,Pruritus ani,racial,Black or African American ,1,1,2
4051564,FH: Metabolic disorder,racial,Unknown,1,1,2
4239069,Closed fracture of metacarpal bone,racial,White,0,2,2
442623,Abrasion AND/OR friction burn of scalp without infection,racial,Black or African American ,1,1,2
437390,Hypoxaemia,racial,Asian,0,2,2
443539,Motor vehicle injury,racial,Asian,0,2,2
22281,Sickle cell disease,ethnic,Hispanic or Latino,0,2,2
443585,Abrasion AND/OR friction burn of multiple sites,racial,Other Race,1,1,2
4197217,Arteriovenous anastomosis for renal dialysis,ethnic,Hispanic or Latino,1,2,3
437744,Heat exhaustion,racial,White,1,2,3
440668,Benign tumour of tongue,racial,Unknown,2,0,2
73720,Overlapping malignant neoplasm of urinary system,ethnic,Hispanic or Latino,2,0,2
432574,Diffuse malignant lymphoma - histiocytic,racial,Unknown,1,2,3
375251,Retinopathy of prematurity stage 2 - intraretinal ridge,ethnic,Hispanic or Latino,2,1,3
22340,Esophageal varices without bleeding,racial,Other Race,2,0,2
321414,Hemoglobinuria,racial,White,1,1,2
374034,Visual disturbance,racial,Native Hawaiian or Other Pacific Islander ,2,1,3
75686,Open wound of hand except fingers with complication,ethnic,Hispanic or Latino,0,2,2
4102166,Multiparous,racial,White,2,0,2
439394,Congenital anomaly of face,ethnic,Hispanic or Latino,2,1,3
4053378,FH: Blood disorder,racial,White,2,0,2
4088930,Confirmation of pregnancy,racial,Black or African American ,2,0,2
376683,Non proliferative diabetic retinopathy,racial,American Indian or Alaska Native ,2,0,2
4302979,Blepharorrhaphy,ethnic,Hispanic or Latino,2,0,2
141771,"Injury undetermined whether accidentally or purposely inflicted, by crashing of motor vehicle",ethnic,Hispanic or Latino,1,1,2
260139,Acute bronchitis,racial,Asian Indian,0,2,2
256451,Bronchitis,racial,Asian Indian,1,2,3
374049,Acute mucoid otitis media,racial,White,1,1,2
4093309,Secondary syphilis of skin and mucous membrane,ethnic,Hispanic or Latino,0,2,2
437477,[X]Fall involving playground equipment,racial,White,1,1,2
133713,Malignant melanoma of skin of face,ethnic,Hispanic or Latino,0,2,2
438959,Amoebiasis,racial,Unknown,2,1,3
432741,Abnormal immunology finding,racial,Black or African American ,1,2,3
4176890,Male sterility,racial,Unknown,0,2,2
440438,Anodontia,racial,Black or African American ,2,1,3
78834,Effusion of joint of hand,ethnic,Hispanic or Latino,1,1,2
438931,Foreign body accidentally entering eye and adnexa,racial,White,0,2,2
439857,Parainfluenza virus pneumonia,ethnic,Hispanic or Latino,1,2,3
77630,Disease of shoulder,racial,Black or African American ,1,1,2
81711,Glenoid labrum detachment,ethnic,Not Hispanic or Latino,1,2,3
436658,Vitamin deficiency,racial,Black or African American ,2,0,2
438250,Congenital talipes varus,ethnic,Hispanic or Latino,2,1,3
23988,Hemolytic anemia due to glutathione metabolism disorder,ethnic,Not Hispanic or Latino,1,2,3
137077,Chronic osteomyelitis of the ankle and/or foot,ethnic,Hispanic or Latino,1,2,3
438917,Superficial foreign body without major open wound AND without infection,ethnic,Not Hispanic or Latino,2,0,2
438223,Sunburn of second degree,racial,Unknown,1,2,3
442256,Disorder of bursae of shoulder region,racial,American Indian or Alaska Native ,1,1,2
4245252,Raised prostate specific antigen,racial,Native Hawaiian or Other Pacific Islander ,0,2,2
434272,Varicella infection,ethnic,Not Hispanic or Latino,1,2,3
72996,"Stiff joint NEC, of the lower leg",ethnic,Hispanic or Latino,2,1,3
442862,"Abrasion or friction burn of hand, without mention of infection",racial,Black or African American ,0,2,2
261053,Pneumonia with aspergillosis,ethnic,Hispanic or Latino,0,2,2
432878,Drug abuse using speed,racial,Unknown,1,2,3
134618,Toxic diffuse goiter with thyrotoxic crisis,ethnic,Not Hispanic or Latino,2,0,2
444437,Congenital abnormality of cervix,ethnic,Not Hispanic or Latino,2,0,2
196359,Primary malignant neoplasm of uterine cervix,racial,Black or African American ,2,0,2
436314,Accidental puncture AND/OR laceration during a procedure,racial,Unknown,1,1,2
4005823,Tobacco user,racial,Filipino,0,2,2
440735,Rheumatic fever without heart involvement,racial,White,0,2,2
4046893,Lifestyle,racial,Other Race,1,2,3
437995,Closed ill-defined fractures of upper limb,racial,Asian,0,2,2
138713,Disease of parathyroid glands,ethnic,Not Hispanic or Latino,1,2,3
319049,Acute respiratory failure,racial,Black or African American ,0,2,2
198995,Type 1 diabetes mellitus - poor control,racial,Asian Indian,0,2,2
74211,Superficial injury of finger without infection,racial,Unknown,2,0,2
4305841,Periodic limb movement disorder,ethnic,Not Hispanic or Latino,1,2,3
378726,Alcoholic dementia,ethnic,Not Hispanic or Latino,0,2,2
320128,Essential hypertension,racial,European,0,2,2
436078,Malnutrition of moderate degree (Gomez: 60% to less than 75% of standard weight),ethnic,Not Hispanic or Latino,2,0,2
440649,Primary malignant neoplasm of head of pancreas,ethnic,Hispanic or Latino,0,2,2
375826,Central hearing loss,racial,American Indian or Alaska Native ,2,0,2
4068748,Coarctation of aorta NOS,racial,White,2,0,2
442601,Sedative abuse,racial,White,1,1,2
81539,Mitochondrial disease,racial,Other Race,2,1,3
201958,Perinatal dermatological disorders,ethnic,Hispanic or Latino,2,0,2
316429,Ectopics,racial,Asian,2,1,3
437292,Coloboma of optic nerve,racial,White,2,1,3
314368,Mitral stenosis with insufficiency,racial,Unknown,2,0,2
4113027,Dietary intake observations,racial,Asian,1,2,3
437530,Disorders of lipoid metabolism,racial,American Indian or Alaska Native ,2,0,2
437217,Coccidioidomycosis,ethnic,Not Hispanic or Latino,0,2,2
195588,Cystitis,racial,Native Hawaiian or Other Pacific Islander ,2,0,2
436940,Insulin resistance syndrome,racial,Filipino,0,2,2
434842,Cause of overdose - accidental,racial,White,1,2,3
81454,Injury of finger,racial,Other Race,1,1,2
192901,HSP - Hereditary spastic paraplegia,ethnic,Hispanic or Latino,0,2,2
440112,Chloasma of eyelid,racial,Unknown,2,1,3
197145,Open wound of pelvic region without complication,racial,Unknown,2,0,2
200771,Peptic ulcer without hemorrhage AND without perforation but with obstruction,racial,Unknown,1,2,3
133857,Acquired deformity of limb,racial,Other Race,0,2,2
75668,Sprain of sacroiliac region,ethnic,Hispanic or Latino,2,0,2
199764,Benign ovarian tumour,racial,Other Race,2,0,2
28179,Polyp of vocal cord or larynx,racial,White,1,1,2
321037,Cholesterol embolisation syndrome,racial,White,2,0,2
76777,Arthropathy associated with infection,ethnic,Hispanic or Latino,2,1,3
81106,Acquired genu varum,ethnic,Not Hispanic or Latino,0,2,2
201916,Ureteric stone,racial,Other Race,2,0,2
441628,Menopausal and postmenopausal disorders,racial,American Indian or Alaska Native ,2,0,2
4111255,Unspecified labyrinthitis,racial,White,1,1,2
25572,Disease of salivary gland,ethnic,Not Hispanic or Latino,2,1,3
4149547,Fracture of vertebra without spinal cord lesion,ethnic,Hispanic or Latino,0,2,2
4238673,Arthrodesis of elbow,racial,White,1,2,3
434480,Syndrome of infant of diabetic mother,ethnic,Hispanic or Latino,2,0,2
133444,Thyroiditis,racial,Unknown,2,0,2
438332,Disease of possible viral origin,racial,Asian Indian,1,1,2
380095,Lesions of nerves plexuses and roots,ethnic,Hispanic or Latino,2,0,2
437899,Acute and subacute bacterial endocarditis,racial,Unknown,2,1,3
312998,Pain in thoracic spine,racial,Asian,2,1,3
432529,"Motor vehicle traffic accident involving pedestrian dragged by motor vehicle, driver of motor vehicle injured",ethnic,Hispanic or Latino,2,0,2
200051,Primary malignant neoplasm of ovary,ethnic,Not Hispanic or Latino,2,0,2
133593,Transverse deficiency of upper limb,racial,White,0,2,2
81672,Nonallopathic lesion of thoracic region,ethnic,Hispanic or Latino,2,0,2
374336,Infantile hemiplegia,racial,White,2,1,3
437113,Asthenia,racial,Asian,1,2,3
76744,Azoospermia,racial,White,0,2,2
439672,Viral hepatitis C with coma,racial,Asian,2,0,2
317971,Respiratory system congenital anomalies,ethnic,Hispanic or Latino,2,1,3
443949,Disease type AND/OR category unknown,racial,White,1,2,3
434063,Jaw to cranial base anomaly,ethnic,Not Hispanic or Latino,1,2,3
440029,Viral disease,racial,Native Hawaiian or Other Pacific Islander ,1,1,2
4109698,Acute conjunctivitis NOS,racial,Unknown,2,1,3
76002,Mechanical complication due to breast prosthesis,ethnic,Hispanic or Latino,2,0,2
4042836,Disease of head,racial,Unknown,2,0,2
440853,Closed fracture of surgical neck of humerus,racial,Asian,2,0,2
4012570,High risk sexual behavior,racial,Other Race,2,0,2
31884,Acquired diverticulum of esophagus,ethnic,Hispanic or Latino,2,0,2
375246,Mononeuritis of upper limb,ethnic,Not Hispanic or Latino,2,0,2
436976,Posterior subcapsular polar cataract,racial,Other Race,1,2,3
435368,Congenital pigeon chest,racial,Unknown,0,2,2
4097716,"Benign neoplasm of lip, oral cavity and pharynx NOS",racial,White,0,2,2
137497,Dermatophytosis of the body,racial,Filipino,2,1,3
373654,Second degree burn of face AND/OR head,ethnic,Hispanic or Latino,1,2,3
137945,Pressure ulcer stage 2,ethnic,Not Hispanic or Latino,2,1,3
192450,Not passing urine,racial,Other Race,0,2,2
4124268,Faecal smear,ethnic,Hispanic or Latino,1,1,2
134305,Acute lymphoid leukaemia,ethnic,Not Hispanic or Latino,2,0,2
257007,Allergic rhinitis,racial,Alaska Native,0,2,2
4052837,Open wound of breast,ethnic,Hispanic or Latino,2,0,2
440990,Chorea,racial,Asian,0,2,2
436839,Closed fracture of metacarpal bone,racial,Black or African American ,0,2,2
436070,Vitamin D deficiency,racial,American Indian or Alaska Native ,2,0,2
434901,Subchronic paranoid schizophrenia with acute exacerbation,ethnic,Hispanic or Latino,2,0,2
374168,Complex febrile seizure,racial,White,1,1,2
438105,Benign tumour of mediastinum,ethnic,Hispanic or Latino,2,1,3
436097,"Nondependent mixed drug abuse, continuous",ethnic,Not Hispanic or Latino,0,2,2
28974,Candidiasis of oesophagus,ethnic,Not Hispanic or Latino,1,2,3
4303710,Infection due to Entamoeba histolytica,ethnic,Hispanic or Latino,0,2,2
4331070,Family history of polyp of colon,racial,White,2,1,3
4113650,Noninflammatory cervical disorder,ethnic,Not Hispanic or Latino,2,0,2
81723,Contusion of hand,racial,Black or African American ,1,1,2
438116,Benign neoplasm of short bones of lower limb,racial,White,1,1,2
79939,Sprain of tarsometatarsal joint AND/OR ligament,racial,Unknown,2,1,3
255334,Collagen disease,ethnic,Not Hispanic or Latino,2,0,2
28109,Carcinoma in situ of esophagus,ethnic,Hispanic or Latino,1,2,3
312622,BVO - Branch retinal occlusion,racial,Asian,0,2,2
312334,Constrictive pericarditis,ethnic,Hispanic or Latino,0,2,2
435570,Pulp and periapical tissue disease,ethnic,Not Hispanic or Latino,2,1,3
441073,Complete legal abortion,ethnic,Hispanic or Latino,2,0,2
438477,Atrophy of testis,racial,Unknown,0,2,2
201894,Acute intestinal vascular insufficiency,ethnic,Not Hispanic or Latino,1,2,3
443257,Swellings and lumps,racial,Native Hawaiian or Other Pacific Islander ,0,2,2
436381,Gender identity disorder of childhood,ethnic,Not Hispanic or Latino,1,1,2
437584,Ataxia,racial,Asian,2,0,2
380702,Cerebral cysts,racial,Unknown,2,1,3
4302252,High risk pregnancy care,racial,American Indian or Alaska Native ,2,0,2
141095,Acne,racial,Asian Indian,1,2,3
436231,Abnormal findings diagnostic imaging of liver and biliary tract,racial,Unknown,2,0,2
135496,Acute leukemia in remission,ethnic,Hispanic or Latino,1,2,3
4091532,Bowel observation,racial,Asian,1,2,3
201265,Splenic disorder,racial,Unknown,1,1,2
441712,Open wound of ocular adnexa,racial,White,1,2,3
4070287,Preauricular sinus and fistula,racial,Unknown,1,2,3
438630,Exposure to radiation,racial,White,2,0,2
257010,Abscess of lung,racial,White,0,2,2
444283,Superficial foreign body of hand without major open wound AND without infection,racial,Unknown,2,0,2
433811,Hydronephrosis,racial,Black or African American ,2,1,3
196160,Fistula of intestine,ethnic,Hispanic or Latino,2,0,2
4108242,Atrial fibrillation and flutter NOS,racial,White,0,2,2
436398,Glaucoma associated with ocular disorder,racial,Asian,2,0,2
81723,Contusion of hand,racial,Asian,1,2,3
434323,Disorder of sulphur-bearing amino acid metabolism,ethnic,Not Hispanic or Latino,1,1,2
73866,Congenital anomaly of breast,racial,Unknown,2,0,2
194589,Primary malignant neoplasm of biliary tract,racial,Black or African American ,2,0,2
434153,Chromosomopathy,racial,Black or African American ,0,2,2
436336,Herpes zoster with nervous system complication,racial,Asian,1,2,3
437292,Coloboma of optic nerve,ethnic,Hispanic or Latino,2,1,3
4077577,Moderate recurrent major depression,racial,Black or African American ,0,2,2
377877,Convergent squint,racial,Black or African American ,1,2,3
375519,Alcohol withdrawal syndrome,racial,Unknown,0,2,2
76506,Effusion of joint of lower leg,racial,Black or African American ,1,2,3
141305,Unilateral sensorineural hearing loss with unrestricted hearing on the contralateral side,ethnic,Not Hispanic or Latino,2,1,3
134452,Miners' elbow,ethnic,Not Hispanic or Latino,1,2,3
432632,Noninfectious secondary iridocyclitis,racial,Unknown,2,1,3
136516,Congenital pes planus,racial,Black or African American ,2,1,3
4303710,Infection due to Entamoeba histolytica,racial,Unknown,0,2,2
135360,Fainting,racial,American Indian or Alaska Native ,2,1,3
433758,Childhood emotional disorder,racial,White,0,2,2
436265,Open wound of multiple sites of one lower limb AND thigh without complication,ethnic,Not Hispanic or Latino,1,2,3
141663,Osteomyelitis,racial,Other Race,2,0,2
193874,Bed wetting,racial,Other Race,1,1,2
440085,Schizoid personality disorder,ethnic,Not Hispanic or Latino,0,2,2
313867,Double outlet right ventricle,ethnic,Not Hispanic or Latino,2,0,2
432354,Chronic duodenal ulcer with perforation but without obstruction,ethnic,Hispanic or Latino,0,2,2
313791,Bundle branch block,racial,White,0,2,2
441177,Second degree burn of upper limb,ethnic,Not Hispanic or Latino,0,2,2
200837,Congenital anomaly of fixation of intestine,ethnic,Hispanic or Latino,2,1,3
435170,Effects of thirst,racial,White,2,0,2
443936,Microglossia,ethnic,Not Hispanic or Latino,2,0,2
316137,Phlebitis and/or thrombophlebitis of iliac vein,racial,Unknown,2,0,2
133303,Congenital anomaly of mouth,racial,White,0,2,2
440973,Benign neoplasm of long bones of lower limb,ethnic,Hispanic or Latino,0,2,2
30163,Cellulitis and abscess of neck,racial,Other Race,1,2,3
444253,Blister of scalp without infection,racial,White,1,2,3
201916,Ureteric stone,racial,Unknown,1,1,2
433197,PXF - Pseudoexfoliation of lens capsule,racial,Unknown,0,2,2
134736,Backache,racial,Filipino,1,2,3
4295261,Postmenopausal state,racial,Other Race,2,0,2
436001,Emotional abuse of adult,racial,White,2,0,2
132573,Benign neoplasm of floor of mouth,ethnic,Hispanic or Latino,1,2,3
27419,Open wound of neck without complication,racial,White,1,2,3
439439,Injury of unknown intent by cutting instrument,racial,White,0,2,2
440213,Consciousness and/or awareness finding,ethnic,Hispanic or Latino,1,1,2
437470,Adverse reaction to benzodiazepine-based tranquilliser,ethnic,Hispanic or Latino,2,0,2
437046,Complete abortion,racial,Black or African American ,2,0,2
435522,Hypervitaminosis D,racial,White,2,0,2
79126,Polysyndactyly,ethnic,Hispanic or Latino,0,2,2
434465,Nonallopathic lesion of rib cage,racial,Unknown,2,1,3
443887,Superficial foreign body of ankle without major open wound AND without infection,racial,Unknown,0,2,2
4066376,Pilonidal sinus with abscess,racial,Native Hawaiian or Other Pacific Islander ,2,0,2
441039,Phlebitis of lower limb vein,racial,Black or African American ,0,2,2
432236,Tuberculosis of peripheral lymph nodes,racial,Asian,2,0,2
443564,Malignant neoplasm of bone,racial,Unknown,0,2,2
23808,"Chronic peptic ulcer without hemorrhage, without perforation AND without obstruction",ethnic,Hispanic or Latino,1,1,2
372599,Severe mixed bipolar I disorder without psychotic features,racial,Unknown,2,0,2
373474,Seeing double,racial,Asian,2,1,3
135473,Dermatophytosis,racial,Filipino,2,1,3
438409,Attention deficit hyperactivity disorder,racial,Filipino,0,2,2
442530,Broken tooth injury with complication,racial,White,2,1,3
4340379,Hepatitis B carrier,racial,American Indian or Alaska Native ,2,0,2
4068748,Coarctation of aorta NOS,ethnic,Hispanic or Latino,2,0,2
195012,Metrorrhagia,racial,Black or African American ,2,0,2
78771,Labyrinthine dysfunction,racial,White,2,0,2
438855,Klinefelter's syndrome,racial,White,0,2,2
4087420,Other specified miliary tuberculosis,ethnic,Hispanic or Latino,2,0,2
435925,Very premature - less than 1000g or less than 28 weeks,racial,White,2,1,3
76725,Fissure in ano,racial,Black or African American ,1,2,3
436651,Hodgkin's disease of extranodal AND/OR solid organ site,racial,Other Race,0,2,2
441385,Corrected transposition of great vessels,racial,Unknown,2,0,2
317299,Disorder of vitreous body,ethnic,Hispanic or Latino,1,1,2
4071485,Foetus or neonate affected by caesarean section,racial,Unknown,2,0,2
377910,Deviated nasal septum,racial,Asian,0,2,2
23868,Congenital anomaly of esophagus,racial,White,1,1,2
319049,Acute respiratory failure,racial,Other Race,2,1,3
138388,Secondary hyperparathyroidism,racial,Unknown,2,0,2
4152813,Family disruption,racial,Other Race,0,2,2
4112003,Hypotension NOS,racial,White,1,2,3
438699,Primary malignant neoplasm of rectosigmoid junction,ethnic,Not Hispanic or Latino,0,2,2
73723,Benign tumour of epididymis,ethnic,Hispanic or Latino,0,2,2
442942,"Crush injury, toe(s)",racial,White,2,1,3
199064,Chronic vascular insufficiency of intestine,racial,White,2,0,2
434942,Postseptal orbital cellulitis,racial,Unknown,2,1,3
432803,[X]Fall on and from ladder,ethnic,Not Hispanic or Latino,0,2,2
376229,Abnormal involuntary movement,racial,American Indian or Alaska Native ,2,1,3
438855,Klinefelter's syndrome,racial,Black or African American ,0,2,2
433813,Bladder neck obstruction,ethnic,Hispanic or Latino,2,1,3
134248,Second degree burn of thumb,ethnic,Hispanic or Latino,1,2,3
80197,Poliomyelitis osteopathy of multiple sites,ethnic,Hispanic or Latino,0,2,2
437167,Accident caused by firearm missile,racial,White,0,2,2
196991,Chronic renal disease,racial,American Indian,2,0,2
194984,Hepatopathy,racial,Other Race,2,1,3
196325,Protozoal intestinal disease,racial,White,0,2,2
433195,Transient arterial retinal occlusion,racial,White,2,0,2
137951,Acquired keratoderma,racial,Black or African American ,0,2,2
141955,Pectus excavatum,racial,Unknown,1,2,3
138641,Foreign body in tracheobronchial tree,racial,Other Race,2,0,2
75580,Chronic ulcerative proctitis,ethnic,Not Hispanic or Latino,2,0,2
439918,Poliomyelitis osteopathy of the ankle and/or foot,racial,White,2,0,2
433758,Childhood emotional disorder,ethnic,Hispanic or Latino,0,2,2
198475,Gallstone ileus,racial,White,1,1,2
433514,Abnormal hard tissue formation in pulp,racial,Black or African American ,0,2,2
435207,"Nodular lymphoma of lymph nodes of head, face and neck",racial,Unknown,2,1,3
194092,Uterine prolapse without vaginal wall prolapse,racial,Other Race,2,0,2
438172,Atrial septal defect as current complication following acute myocardial infarction,racial,Unknown,2,0,2
444028,Open wound of alveolar process without complication,ethnic,Hispanic or Latino,1,1,2
199877,Mucous polyp of cervix,racial,Filipino,2,0,2
433454,Adjustment disorder with mixed emotional features,racial,Asian,2,0,2
75128,Injury of chest wall,racial,Unknown,1,1,2
200660,Reticulosarcoma of lymph nodes of inguinal region and lower limb,ethnic,Hispanic or Latino,2,0,2
436245,Atypical glandular cells on vaginal Papanicolaou smear,racial,Other Race,2,0,2
437557,Eczematous dermatitis of eyelid,racial,Unknown,1,1,2
75091,Closed fracture of carpal bone,racial,American Indian,2,0,2
437537,Shyness disorder of childhood,racial,Unknown,0,2,2
138592,Open wound of lip with complication,ethnic,Hispanic or Latino,2,1,3
4238673,Arthrodesis of elbow,ethnic,Hispanic or Latino,1,2,3
134736,Backache,racial,Asian Indian,0,2,2
372616,Werdnig-Hoffmann disease,racial,White,2,0,2
377001,Unruptured cerebral aneurysm,racial,Black or African American ,0,2,2
316137,Phlebitis and/or thrombophlebitis of iliac vein,ethnic,Hispanic or Latino,2,0,2
193155,Carcinoid tumour of large intestine,ethnic,Hispanic or Latino,2,0,2
316535,Closed fracture of dorsal vertebra without spinal cord injury,ethnic,Not Hispanic or Latino,2,1,3
440820,Contracture of wrist joint,ethnic,Hispanic or Latino,2,1,3
440916,Burn to wrist/hand - blister,ethnic,Not Hispanic or Latino,2,0,2
443747,Acute laryngotracheitis without obstruction,racial,White,0,2,2
198683,Viral hepatitis B without hepatic coma,racial,Black or African American ,2,0,2
80249,Sprain of acromioclavicular ligament,racial,Unknown,2,0,2
318448,"Incomplete atrioventricular block, second degree",racial,White,1,2,3
433740,Immunodeficiency disorder,racial,Other Race,2,0,2
374924,Generalized convulsive epilepsy,racial,American Indian or Alaska Native ,0,2,2
435644,Metatarsal bone fracture,racial,White,1,1,2
4331070,Family history of polyp of colon,racial,Other Race,0,2,2
441919,Twin pregnancy,ethnic,Hispanic or Latino,2,0,2
438931,Foreign body accidentally entering eye and adnexa,ethnic,Hispanic or Latino,0,2,2
443269,Elderly primiparous with labor,racial,White,2,0,2
194410,Male genital organ disorder associated with another disorder,racial,White,0,2,2
79833,Meniere's disease,racial,Native Hawaiian or Other Pacific Islander ,2,0,2
4112534,Chronic laryngitis and laryngotracheitis,racial,Unknown,0,2,2
432968,Anemia during pregnancy - baby delivered,racial,White,2,0,2
313011,Congenital abnormality of cardiac position,ethnic,Not Hispanic or Latino,0,2,2
4062495,Glaucoma screening,racial,American Indian or Alaska Native ,2,0,2
4284118,Fall on escalator,ethnic,Hispanic or Latino,1,1,2
194683,Obstructed umbilical hernia,ethnic,Not Hispanic or Latino,2,0,2
4139420,Foreign body in auditory canal,racial,Asian,2,1,3
78524,Acquired deformity of finger,ethnic,Not Hispanic or Latino,2,1,3
381573,Acute mastoiditis without complications,racial,White,2,0,2
31120,Congenital anomaly of upper alimentary tract,racial,White,1,2,3
4166080,Decompression of median nerve,ethnic,Not Hispanic or Latino,1,1,2
437833,Hypokalaemia,racial,Asian,2,0,2
75046,Old bucket handle tear of medial meniscus,racial,Unknown,0,2,2
4239069,Closed fracture of metacarpal bone,ethnic,Hispanic or Latino,0,2,2
438546,Congenital anomaly of anterior chamber of eye,ethnic,Hispanic or Latino,1,1,2
373175,Organic hallucinosis,ethnic,Hispanic or Latino,2,1,3
317248,Disorder of hematopoietic structure,racial,Asian,2,1,3
4090255,Colloid bodies in retina,racial,Unknown,2,0,2
200219,Abdominal pain,racial,American Indian,2,1,3
442011,Mechanical complication due to cardiac pacemaker electrode,racial,Asian,0,2,2
198483,Stricture or atresia of the vagina,ethnic,Hispanic or Latino,2,0,2
77317,Chronic ulcerative rectosigmoiditis,racial,White,2,0,2
374906,Cerebral lipidosis,ethnic,Hispanic or Latino,2,0,2
432870,Thrombocytopenia,racial,Black or African American ,0,2,2
380397,Keratoconjunctivitis,ethnic,Not Hispanic or Latino,2,0,2
438887,Closed fracture shaft of femur,racial,White,1,2,3
438630,Exposure to radiation,ethnic,Not Hispanic or Latino,2,0,2
435636,Juvenile osteochondritis of hip AND/OR pelvis,ethnic,Hispanic or Latino,0,2,2
132553,Herpangina,racial,Asian,2,1,3
199860,Hernia of abdominal cavity,racial,Asian,0,2,2
79127,Congenital spondylolisthesis,racial,Other Race,2,0,2
135360,Fainting,racial,Native Hawaiian or Other Pacific Islander ,2,0,2
4140207,Nephrosclerosis,racial,White,1,1,2
4008683,Anxiety neurosis,ethnic,Not Hispanic or Latino,2,0,2
253321,Stridor,racial,Asian,0,2,2
201355,Erosion and ectropion of the cervix,racial,White,2,1,3
81671,Unilateral congenital dislocation of hip,ethnic,Not Hispanic or Latino,2,0,2
194001,Abnormality of secretion of gastrin,racial,White,0,2,2
4145796,Family history: Musculoskeletal disease,ethnic,Not Hispanic or Latino,1,1,2
78232,Shoulder joint pain,racial,Filipino,2,0,2
435959,Subarachnoid hemorrhage following injury without open intracranial wound,racial,White,1,1,2
75337,Cellulitis and abscess of buttock,racial,Asian,1,1,2
4053378,FH: Blood disorder,ethnic,Not Hispanic or Latino,2,0,2
27419,Open wound of neck without complication,ethnic,Hispanic or Latino,1,2,3
4182210,Dementia,racial,Unknown,2,0,2
4215003,Myasthenic crisis,ethnic,Hispanic or Latino,2,0,2
4109691,Persistent alcohol abuse,racial,White,1,2,3
4058497,"Contusion, shoulder or upper arm",racial,Unknown,2,0,2
193809,Melena due to gastrointestinal hemorrhage,racial,American Indian or Alaska Native ,2,0,2
141216,MC - Molluscum contagiosum,racial,Other Race,1,1,2
380093,Episodic cluster headache,racial,White,2,1,3
196738,Male genital organ disease,racial,Black or African American ,0,2,2
4014231,Foot sprain NOS,racial,Asian,2,0,2
137792,Kaposi's varicelliform eruption,racial,Asian,2,0,2
443936,Microglossia,racial,White,2,0,2
197781,Shigella sonnei (group D),ethnic,Hispanic or Latino,1,2,3
79072,Inflammatory disorder of breast,racial,Asian,2,0,2
194175,Left upper quadrant pain,racial,Asian,2,0,2
442774,Intermittent claudication,racial,American Indian or Alaska Native ,0,2,2
439770,Ketoacidosis in type I diabetes mellitus,racial,Unknown,1,2,3
440358,Lipoma,racial,Native Hawaiian or Other Pacific Islander ,0,2,2
4005933,Urethral meatus underneath penis,racial,Asian,0,2,2
80070,Uric acid urolithiasis,racial,White,0,2,2
4177966,Kaposi's sarcoma,racial,White,0,2,2
194710,Placenta previa without hemorrhage,racial,Unknown,2,0,2
380403,External hordeolum,racial,Asian,2,1,3
441974,Closed fracture of forearm,racial,Asian,2,0,2
433985,Hypercarotinemia,racial,Black or African American ,1,2,3
433585,Klippel-Feil sequence,ethnic,Not Hispanic or Latino,1,2,3
78560,Congenital deformity and malformation of feet and toes,racial,Unknown,1,1,2
381304,Impulsive acoustic trauma,ethnic,Hispanic or Latino,1,2,3
23868,Congenital anomaly of esophagus,ethnic,Hispanic or Latino,1,1,2
433514,Abnormal hard tissue formation in pulp,ethnic,Not Hispanic or Latino,0,2,2
4185471,Disorder of pigmentation,racial,Asian,1,1,2
4098600,Gouty nephropathy unspecified,racial,White,2,0,2
432517,Posttraumatic wound infection,racial,Asian,1,2,3
73045,Hand sprain,racial,Other Race,2,1,3
442584,Carbuncle of buttock,racial,Black or African American ,0,2,2
433495,"Conductive hearing loss, bilateral",racial,Unknown,2,0,2
438138,Paralytic syndromes,racial,White,2,0,2
78529,Kyphoscoliosis and scoliosis,racial,Filipino,2,0,2
4058399,Placenta praevia without haemorrhage unspecified,racial,White,2,0,2
434203,Late effect of contusion,racial,Unknown,1,2,3
78518,Observation of shoulder joint,ethnic,Not Hispanic or Latino,2,1,3
77178,Contusion of multiple sites of upper limb,ethnic,Hispanic or Latino,2,1,3
195876,Hematometra,racial,White,0,2,2
380421,Tympanic membrane marginal perforation,racial,Unknown,0,2,2
199192,Abrasion AND/OR friction burn of trunk without infection,racial,Unknown,1,2,3
138346,Erysipelas,ethnic,Hispanic or Latino,2,0,2
380394,Idiopathic progressive polyneuropathy,racial,Unknown,0,2,2
201313,Hypertensive renal disease,racial,Other Race,2,0,2
432621,Purulent endophthalmitis,racial,White,1,1,2
257010,Abscess of lung,ethnic,Hispanic or Latino,1,2,3
73649,Contusion of finger,racial,Other Race,2,0,2
201045,Thrombosed external haemorrhoids,ethnic,Not Hispanic or Latino,2,1,3
4169009,FH: CVA,ethnic,Hispanic or Latino,2,1,3
440990,Chorea,ethnic,Not Hispanic or Latino,0,2,2
440938,Infection by Shigella,racial,White,2,0,2
40389850,"Neoplasm of uncertain behaviour of stomach, intestines and rectum",ethnic,Hispanic or Latino,0,2,2
72990,Localised osteoarthrosis uncertain if primary OR secondary,ethnic,Not Hispanic or Latino,1,1,2
195596,Chronic pancreatitis,racial,American Indian or Alaska Native ,2,0,2
440787,"Drug dependence in mother complicating pregnancy, childbirth AND/OR puerperium",ethnic,Hispanic or Latino,2,1,3
435792,Drug-induced sleep disorder,ethnic,Not Hispanic or Latino,2,0,2
377539,Syringomyelia and syringobulbia,racial,Unknown,2,0,2
436837,Closed fracture of neck of radius,racial,Unknown,2,0,2
4164222,Tendon contracture,ethnic,Not Hispanic or Latino,1,2,3
432436,Symbolic dysfunction,racial,White,1,1,2
316995,Coronary occlusion,ethnic,Not Hispanic or Latino,1,1,2
24660,Acute tonsillitis,racial,American Indian or Alaska Native ,1,1,2
4232212,Hypoglycemic shock,racial,White,0,2,2
435783,Schizophrenia,racial,Filipino,2,0,2
260034,Chronic pulmonary coccidioidomycosis,racial,Unknown,0,2,2
201129,Newborn swallowing maternal blood causing hematemesis or melena,racial,Unknown,1,1,2
74174,Urinary symptoms,racial,White,2,0,2
4104388,"Better eye: moderate visual impairment, Lesser eye: near total visual impairment",ethnic,Hispanic or Latino,0,2,2
374384,Cerebral ischemia,ethnic,Hispanic or Latino,0,2,2
440638,Lyme disease,racial,White,2,1,3
4096657,Toxic multinodular goitre NOS,ethnic,Hispanic or Latino,2,0,2
138388,Secondary hyperparathyroidism,racial,White,2,1,3
194700,"Diabetes mellitus in mother complicating pregnancy, childbirth AND/OR puerperium",racial,Asian,2,0,2
197320,ARF - Acute renal failure,racial,Native Hawaiian or Other Pacific Islander ,0,2,2
139057,Disease of oral soft tissues,racial,Other Race,1,1,2
133685,Salmonellosis,racial,Unknown,2,0,2
78621,Crushing injury of knee,racial,Unknown,2,0,2
435237,Reactive psychoses,racial,White,2,0,2
376971,Retinal tear,ethnic,Hispanic or Latino,1,1,2
441260,Drug withdrawal syndrome,racial,Other Race,1,2,3
436651,Hodgkin's disease of extranodal AND/OR solid organ site,racial,Unknown,2,1,3
253234,Upper respiratory inflammation due to fumes AND/OR vapors,racial,White,2,0,2
376104,Posttraumatic headache,ethnic,Not Hispanic or Latino,2,1,3
135611,Furuncle of hand,racial,White,2,0,2
140823,Acquired musculoskeletal deformity,ethnic,Hispanic or Latino,2,1,3
375806,Idiopathic peripheral neuropathy,racial,Native Hawaiian or Other Pacific Islander ,1,2,3
437082,Marie-Strumpell spondylitis,racial,Asian,2,0,2
441077,Stenosis of cervix,ethnic,Not Hispanic or Latino,2,0,2
72995,Joint contracture of hand,racial,Other Race,0,2,2
72737,Microcalcifications of the breast,racial,Other Race,2,0,2
438204,Edema or excessive weight gain in pregnancy without mention of hypertension,racial,White,2,0,2
437943,Pulp abscess of finger,ethnic,Not Hispanic or Latino,0,2,2
439707,Folie a deux,racial,Unknown,2,0,2
81983,Multiple dislocations,ethnic,Hispanic or Latino,2,1,3
4010838,Increased body growth,racial,White,1,2,3
4077382,Familial lipoprotein lipase deficiency,racial,Unknown,1,1,2
193326,Urge incontinence of urine,racial,Native Hawaiian or Other Pacific Islander ,2,0,2
4180783,Malignant tumour of lingual tonsil,ethnic,Hispanic or Latino,2,0,2
133414,Candidiasis of skin and nails,racial,Other Race,2,1,3
314666,Healed coronary,racial,Native Hawaiian or Other Pacific Islander ,2,1,3
4121123,Haemophagocytic lymphohistiocytosis,ethnic,Hispanic or Latino,2,0,2
441737,Bruising,racial,Native Hawaiian or Other Pacific Islander ,0,2,2
433752,Impulse control disorder,racial,Other Race,2,0,2
134118,Atrophic condition of skin,racial,Filipino,2,0,2
78834,Effusion of joint of hand,racial,White,2,1,3
377572,Noise effect on inner ear,ethnic,Hispanic or Latino,2,1,3
194395,Bleeding diverticulosis,ethnic,Not Hispanic or Latino,2,0,2
444384,Nonvenomous insect bite of leg with infection,racial,Unknown,1,2,3
435216,Disorder associated with type I diabetes mellitus,racial,Asian,0,2,2
4113102,Amputated at hip,ethnic,Hispanic or Latino,2,0,2
380055,Primary malignant neoplasm of brain,racial,Other Race,0,2,2
73574,Nonunion of fracture,ethnic,Hispanic or Latino,0,2,2
4090550,Evening colic,racial,Unknown,2,1,3
443260,Umbilical lump,racial,Other Race,2,0,2
439857,Parainfluenza virus pneumonia,racial,White,1,2,3
80495,Palindromic rheumatism of the pelvic region and thigh,racial,Black or African American ,2,0,2
434900,Drug-induced psychosis,racial,White,2,0,2
436176,Spontaneous abortion without complication,racial,Black or African American ,2,0,2
434926,Iridocyclitis,racial,Unknown,1,1,2
134386,Gingival recession,racial,Unknown,1,1,2
435696,Early trauma complications,racial,White,1,1,2
141508,Dermatophytosis of scalp or beard,racial,Other Race,1,2,3
136773,Rosacea,racial,Other Race,2,0,2
74114,Cellulitis and abscess of foot excluding toe,racial,Filipino,0,2,2
78200,Benign mammary dysplasia,racial,Black or African American ,2,0,2
320835,TOF - Tetralogy of Fallot,racial,Other Race,2,0,2
435661,Closed orbital blow-out fracture,ethnic,Hispanic or Latino,0,2,2
4296611,Chronic gastric ulcer without hemorrhage AND without perforation,ethnic,Hispanic or Latino,2,0,2
198062,"Infectious colitis, enteritis and gastroenteritis",racial,Other Race,2,0,2
432860,Benign tumor of epipharynx,racial,White,2,0,2
432695,Post-term pregnancy,racial,Unknown,2,0,2
439695,Hypertensive heart and renal disease with renal failure,ethnic,Not Hispanic or Latino,1,1,2
196473,Hypertrophy of uterus,racial,Black or African American ,2,0,2
4103723,Other refraction and accommodation disorders,ethnic,Not Hispanic or Latino,2,0,2
4064206,O/E - tuning fork testing,racial,White,2,1,3
376224,Spina bifida without hydrocephalus,racial,Other Race,2,0,2
4109544,"Total, mature senile cataract",racial,Unknown,2,0,2
77030,Disease of breast,racial,Native Hawaiian or Other Pacific Islander ,2,0,2
433716,Primary malignant neoplasm of testis,racial,White,0,2,2
435299,Failure of dental prosthesis,ethnic,Hispanic or Latino,2,0,2
194589,Primary malignant neoplasm of biliary tract,ethnic,Not Hispanic or Latino,2,0,2
372646,"Peripheral pterygium, stationary",racial,White,2,1,3
78234,Arthralgia of the hand,racial,Filipino,0,2,2
434626,Borderline personality disorder,ethnic,Hispanic or Latino,2,0,2
4100382,Acute hysterical psychosis,racial,Unknown,2,1,3
434752,Positive serological AND/OR viral culture findings for human immunodeficiency virus,racial,American Indian or Alaska Native ,1,1,2
132391,Furuncle of face,racial,Unknown,0,2,2
315361,Orthopnea,ethnic,Not Hispanic or Latino,2,0,2
441351,Early onset of delivery - delivered,ethnic,Not Hispanic or Latino,1,1,2
72487,Crush injury of foot,ethnic,Hispanic or Latino,2,0,2
435380,Closed fracture of radius AND ulna,racial,Unknown,2,1,3
437489,Herpes zoster with complication,racial,White,1,2,3
4008573,Advanced open-angle glaucoma,racial,Unknown,2,0,2
28714,Syndrome of diencephalo-hypophyseal origin,racial,American Indian or Alaska Native ,2,0,2
200524,Perinatal digestive system disorders,racial,White,0,2,2
314379,First degree atrioventricular block,racial,Black or African American ,1,2,3
312334,Constrictive pericarditis,racial,White,0,2,2
134736,Backache,racial,American Indian,2,0,2
434885,Benign neoplasm of skull and facial bones,racial,Unknown,1,1,2
135923,CP - Cleft palate,racial,Unknown,1,2,3
437374,Neonatal aspiration of meconium,ethnic,Hispanic or Latino,2,1,3
75373,Open fracture of head of radius,ethnic,Not Hispanic or Latino,2,0,2
194683,Obstructed umbilical hernia,racial,American Indian or Alaska Native ,2,0,2
378741,Brachial plexus lesion,racial,Other Race,0,2,2
137627,Prickly heat,racial,Other Race,2,1,3
372924,Cerebral arterial occlusion,racial,Unknown,2,0,2
198465,"Megacolon, not Hirschsprung's",ethnic,Hispanic or Latino,0,2,2
4091928,Chronic leukemia NOS,racial,White,2,0,2
4064375,Iron deficiency screening,racial,Asian Indian,1,1,2
440695,Encopresis,ethnic,Not Hispanic or Latino,0,2,2
200845,Urinary precipitancy,racial,Filipino,2,0,2
321587,Bilateral bundle branch block,racial,Unknown,1,1,2
442598,Fracture of radius AND ulna,racial,Unknown,2,0,2
195453,"Colitis, enteritis and gastroenteritis presumed infectious",racial,Black or African American ,2,0,2
380707,Distortion of visual image,ethnic,Hispanic or Latino,2,0,2
79938,Closed fracture of scapula,racial,Unknown,2,0,2
433071,Contusion of multiple sites,racial,Other Race,2,1,3
79873,Urolith,racial,Other Race,2,1,3
138913,Second degree burn of two OR more fingers including thumb,racial,White,0,2,2
435959,Subarachnoid hemorrhage following injury without open intracranial wound,ethnic,Hispanic or Latino,1,1,2
435081,Abnormal findings on diagnostic imaging of heart and coronary circulation,racial,Unknown,1,2,3
433736,Obesity,racial,Alaska Native,1,2,3
40480431,Speech and language developmental delay due to hearing loss,racial,Asian,0,2,2
40389850,"Neoplasm of uncertain behaviour of stomach, intestines and rectum",racial,White,0,2,2
440853,Closed fracture of surgical neck of humerus,ethnic,Not Hispanic or Latino,2,0,2
78243,Congenital spondylolysis of lumbosacral region,racial,Unknown,0,2,2
437390,Hypoxaemia,racial,Other Race,1,1,2
136262,Open wound of forehead with complication,racial,White,0,2,2
377539,Syringomyelia and syringobulbia,ethnic,Hispanic or Latino,2,0,2
374941,Retained foreign body of eyelid,ethnic,Hispanic or Latino,2,0,2
194001,Abnormality of secretion of gastrin,ethnic,Hispanic or Latino,0,2,2
441049,Enamel caries,ethnic,Hispanic or Latino,2,1,3
434891,Hypersomnia disorder related to a known organic factor,ethnic,Hispanic or Latino,2,0,2
432345,Hypertrophy of tongue papillae,racial,White,2,1,3
4065355,Urticaria due to cold and heat,ethnic,Not Hispanic or Latino,2,0,2
74451,Palindromic rheumatism of the forearm,racial,Black or African American ,0,2,2
437828,Disorder of calcium metabolism,ethnic,Not Hispanic or Latino,1,2,3
259153,Throat soreness,racial,American Indian,2,0,2
442427,Cervical post-laminectomy syndrome,ethnic,Hispanic or Latino,0,2,2
315523,Hemoglobin S-F disease,ethnic,Hispanic or Latino,2,1,3
4058497,"Contusion, shoulder or upper arm",ethnic,Hispanic or Latino,2,0,2
196515,Congenital chordee,racial,White,0,2,2
4145004,Osteoarthritis of spine NOS,ethnic,Hispanic or Latino,1,1,2
434203,Late effect of contusion,ethnic,Hispanic or Latino,1,2,3
136262,Open wound of forehead with complication,ethnic,Hispanic or Latino,0,2,2
80552,Closed fracture of the scaphoid,racial,Other Race,0,2,2
433934,Accident caused by needle,racial,Unknown,2,1,3
441969,Radiology result abnormal,racial,Asian,2,1,3
434893,Selective IgM immunodeficiency,racial,Other Race,2,0,2
435783,Schizophrenia,racial,American Indian,0,2,2
30234,Cervical sprain,racial,Filipino,0,2,2
138239,Observation of limb structure,racial,Other Race,1,2,3
201072,Benign prostatic hypertrophy without outflow obstruction,racial,Asian,0,2,2
136915,Primary malignant neoplasm of skin of lip,racial,Unknown,0,2,2
443111,Tenosynovitis of foot,racial,Unknown,1,1,2
24978,Chronic adenotonsillitis,ethnic,Not Hispanic or Latino,0,2,2
438527,"Juvenile osteochondrosis of lower extremity, excluding foot",racial,Black or African American ,2,1,3
4060985,BMI 30+ - obesity,racial,Middle Eastern or North African,2,0,2
314059,Right bundle branch block,racial,American Indian or Alaska Native ,2,0,2
132573,Benign neoplasm of floor of mouth,racial,White,1,2,3
441408,Vomiting,racial,American Indian,2,0,2
80880,Open wound of foot except toes with tendon involvement,racial,White,2,1,3
436398,Glaucoma associated with ocular disorder,ethnic,Not Hispanic or Latino,2,0,2
193252,Diverticulosis of small intestine,racial,Unknown,2,0,2
441897,Chronic duodenal ileus,ethnic,Hispanic or Latino,2,0,2
138813,Early or threatened labour,racial,White,2,0,2
199958,Open wound of hip AND thigh without complication,racial,Unknown,1,1,2
193814,Chronic parametritis and pelvic cellulitis,racial,Unknown,2,0,2
442325,Furuncle of foot,racial,White,0,2,2
444258,Abrasion AND/OR friction burn of neck with infection,ethnic,Hispanic or Latino,1,1,2
77987,Respiratory observations of chest,racial,Black or African American ,1,2,3
138387,Thyrotoxicosis,racial,Unknown,2,0,2
196328,Enteric paratyphosis,racial,Unknown,1,2,3
441191,Poisoning by arthropod,racial,White,2,0,2
135615,Pityriasis,racial,Black or African American ,1,1,2
196214,Congenital disorder of gallbladder and biliary tract,ethnic,Hispanic or Latino,2,0,2
73843,Synovial cyst of popliteal space,racial,Asian,2,0,2
23799,Pharynx or nasopharynx oedema,ethnic,Hispanic or Latino,2,0,2
372424,Congenital anolmaly of eye,ethnic,Not Hispanic or Latino,1,2,3
4324124,Peritoneal dialysis,racial,White,2,1,3
381664,Algoneurodystrophy,ethnic,Hispanic or Latino,2,1,3
4108242,Atrial fibrillation and flutter NOS,racial,Unknown,2,1,3
432738,Iceland disease,racial,Other Race,2,1,3
432458,Closed fracture of C1-C4 level with spinal cord injury,ethnic,Hispanic or Latino,0,2,2
437992,Abnormal results of kidney function studies,racial,Asian,2,1,3
380834,Coma,ethnic,Not Hispanic or Latino,0,2,2
4146239,Pruritus of genital organs,racial,Asian,2,0,2
194703,Leucoplakia of vagina,ethnic,Hispanic or Latino,2,0,2
72434,Congenital hydrocele,ethnic,Hispanic or Latino,0,2,2
196523,Diarrhea,racial,Native Hawaiian or Other Pacific Islander ,2,1,3
4108055,Other forms of retinal detachment,ethnic,Hispanic or Latino,1,1,2
136497,Scar conditions and fibrosis of skin,racial,Unknown,2,1,3
80197,Poliomyelitis osteopathy of multiple sites,racial,Other Race,0,2,2
4143350,Other deficiency anaemias,ethnic,Hispanic or Latino,2,1,3
436659,Iron deficiency anaemia,racial,Filipino,2,0,2
439176,Closed traumatic dislocation of metacarpophalangeal joint of finger,racial,White,2,0,2
194996,Postoperative urethral stricture,racial,Unknown,0,2,2
443115,Closed fracture finger proximal phalanx,racial,Black or African American ,1,1,2
434887,Disorders of bilirubin excretion,racial,Other Race,1,1,2
436672,Disorder of copper metabolism,ethnic,Hispanic or Latino,2,0,2
433471,Retinal neovascularization,racial,White,1,2,3
74104,Fetal condition affecting obstetrical care of mother,racial,Unknown,2,0,2
312938,Hypertensive encephalopathy,racial,White,0,2,2
435522,Hypervitaminosis D,ethnic,Hispanic or Latino,2,0,2
312622,BVO - Branch retinal occlusion,racial,Unknown,1,1,2
440558,Closed dislocation of interphalangeal joint of finger,racial,White,0,2,2
193874,Bed wetting,racial,Asian,2,1,3
193251,Umbilical hernia without obstruction AND without gangrene,racial,American Indian or Alaska Native ,0,2,2
198289,Nonvenomous insect bite of hip without infection,ethnic,Not Hispanic or Latino,2,0,2
196175,Congenital OR acquired abnormality of cervix affecting pregnancy,ethnic,Hispanic or Latino,2,0,2
435570,Pulp and periapical tissue disease,racial,Asian,2,1,3
79109,Climacteric arthritis,racial,Unknown,2,0,2
4103679,Percutaneous transluminal angioscopy,ethnic,Hispanic or Latino,1,2,3
438047,Contusion of orbital tissues,ethnic,Hispanic or Latino,0,2,2
441963,Prader-Willi syndrome,racial,Other Race,1,1,2
192276,Chronic gouty nephropathy,racial,White,2,1,3
75099,Coccyx sprain,racial,Unknown,2,0,2
194412,Dysplasia of vagina,ethnic,Hispanic or Latino,2,0,2
435151,Physical child abuse,racial,Black or African American ,1,2,3
380375,Organic personality disorder,ethnic,Hispanic or Latino,1,2,3
438391,Amino acid transport disorder,ethnic,Hispanic or Latino,2,1,3
4062495,Glaucoma screening,racial,Native Hawaiian or Other Pacific Islander ,1,1,2
80571,Open wound of foot with complication,racial,White,1,1,2
193522,Acute prostatitis,racial,American Indian or Alaska Native ,0,2,2
380834,Coma,racial,Other Race,2,0,2
441962,Congenital bowing of tibia and/or fibula,racial,White,1,1,2
4149455,Baby birth weight 2.0-2.5kg,racial,White,0,2,2
136915,Primary malignant neoplasm of skin of lip,ethnic,Hispanic or Latino,0,2,2
75365,Oliguria and anuria,ethnic,Not Hispanic or Latino,2,1,3
441897,Chronic duodenal ileus,racial,White,2,0,2
76790,Familial ligamentous laxity,racial,White,1,1,2
40491340,Closed fracture of tibia,racial,Other Race,0,2,2
439707,Folie a deux,ethnic,Hispanic or Latino,2,0,2
376267,Superficial injury of conjunctiva,racial,White,2,1,3
198062,"Infectious colitis, enteritis and gastroenteritis",racial,Asian,2,1,3
141816,Acute lymphoid leukaemia in remission,racial,White,1,2,3
443865,Non-infective colitis,racial,American Indian or Alaska Native ,2,1,3
135033,Hair and hair follicle diseases,racial,American Indian or Alaska Native ,1,2,3
138821,Seborrhea,racial,Black or African American ,2,1,3
192360,Cyst and pseudocyst of pancreas,ethnic,Not Hispanic or Latino,2,0,2
4218420,Postinflammatory perforation of ear drum,ethnic,Hispanic or Latino,2,0,2
259043,Emphysematous bleb of lung,ethnic,Not Hispanic or Latino,2,0,2
443587,Diastolic heart failure,racial,Other Race,2,0,2
314754,Wheezing,racial,Filipino,2,1,3
434901,Subchronic paranoid schizophrenia with acute exacerbation,racial,Unknown,2,0,2
4157605,Infection due to resistant organism,racial,White,0,2,2
133002,Acute osteomyelitis,racial,White,0,2,2
440674,Gout,racial,American Indian,0,2,2
4029763,Check artificial pacemaker for electrode impedance,ethnic,Hispanic or Latino,0,2,2
440426,Vertigo as late effect of stroke,racial,Black or African American ,2,0,2
434663,Acute endocarditis,racial,Unknown,1,1,2
4100249,Presenile dementia NOS,racial,White,2,0,2
435642,Disturbance in speech,ethnic,Not Hispanic or Latino,1,2,3
432545,Bacterial disease,racial,Black or African American ,2,0,2
436391,Primary cerebellar degeneration,ethnic,Not Hispanic or Latino,0,2,2
75670,Sprain pelvic ligament,ethnic,Hispanic or Latino,2,1,3
141372,Contact dermatitis due to solvents,ethnic,Hispanic or Latino,1,1,2
4129342,Nephrectomy of remaining or solitary kidney,racial,Unknown,2,0,2
314463,Congenital anomaly of aorta,ethnic,Hispanic or Latino,1,2,3
255891,Lupus erythematosus,racial,Unknown,2,0,2
436996,Thoracoabdominal aortic aneurysm,ethnic,Not Hispanic or Latino,0,2,2
444093,Patient status finding,racial,Other Race,2,1,3
200449,Hepatitis in viral diseases EC,ethnic,Hispanic or Latino,1,1,2
436278,Superficial bruising of thigh,racial,American Indian or Alaska Native ,1,1,2
376979,Diabetic cataract,racial,Native Hawaiian or Other Pacific Islander ,2,0,2
75652,Congenital valgus deformity of foot,racial,White,0,2,2
138604,"Contusion of face, scalp and neck, excluding eye(s)",racial,Black or African American ,1,1,2
441241,Reticulosarcoma of lymph nodes of axilla and upper limb,racial,White,2,0,2
443293,Obstetric breast abscess with postnatal complication,ethnic,Hispanic or Latino,2,0,2
26441,Bleeding ulcer of esophagus,ethnic,Not Hispanic or Latino,0,2,2
4092896,Stool contents abnormal,racial,Filipino,1,1,2
4290927,Impairment level: low vision of both eyes,racial,Black or African American ,0,2,2
141095,Acne,racial,American Indian,2,1,3
4239975,Myocardial disease,racial,White,0,2,2
132449,Transient limb paralysis,ethnic,Hispanic or Latino,1,1,2
77646,Disorder of bone and articular cartilage,racial,Unknown,1,2,3
81379,Lateral epicondylitis,racial,Black or African American ,2,0,2
200780,Disease of uterus,racial,Unknown,2,0,2
435318,Complete spontaneous abortion with genital tract or pelvic infection,ethnic,Hispanic or Latino,2,0,2
375393,Laceration of skin of eyelid AND periocular area,ethnic,Hispanic or Latino,0,2,2
134735,Chronic osteomyelitis,ethnic,Not Hispanic or Latino,2,0,2
200660,Reticulosarcoma of lymph nodes of inguinal region and lower limb,racial,White,2,0,2
193242,Perforation of intestine,racial,Unknown,2,0,2
134305,Acute lymphoid leukaemia,racial,American Indian or Alaska Native ,2,0,2
138117,Benign tumour of spinal cord,racial,Black or African American ,0,2,2
436100,Narcolepsy,ethnic,Not Hispanic or Latino,0,2,2
439696,Hypertensive heart and renal disease with (congestive) heart failure,ethnic,Not Hispanic or Latino,0,2,2
201956,Congenital anomaly of lower limb,racial,White,2,0,2
381384,Congenital absence of external ear,ethnic,Hispanic or Latino,1,2,3
4211657,Closed fracture of lower leg,racial,White,0,2,2
74698,Breech presentation,racial,Unknown,2,0,2
437501,Primary malignant neoplasm of labia majora,ethnic,Hispanic or Latino,2,0,2
4100529,Misuse of drugs NOS,racial,White,2,1,3
140065,Pure red cell aplasia,racial,Black or African American ,2,0,2
434490,Shivering,racial,Other Race,2,0,2
372409,Sciatica neuralgia,racial,Native Hawaiian or Other Pacific Islander ,0,2,2
74855,Genital herpes simplex,racial,American Indian or Alaska Native ,2,0,2
433030,False-positive serological test for syphilis,racial,Unknown,2,1,3
315947,Thoracic back sprain,racial,Asian,1,1,2
434462,VSD - Ventricular septal defect,racial,Black or African American ,2,0,2
442589,Superficial foreign body of wrist without major open wound AND without infection,ethnic,Hispanic or Latino,1,2,3
436546,Strain of subscapularis muscle,racial,Other Race,2,0,2
4149353,"Attention deficit hyperactivity disorder, predominantly inattentive type",racial,Asian,2,1,3
198334,Campylobacter diarrhoea,racial,White,1,2,3
439082,Menopausal syndrome,racial,Native Hawaiian or Other Pacific Islander ,2,0,2
381017,Ametropic amblyopia,racial,Asian,1,1,2
435642,Disturbance in speech,racial,Unknown,0,2,2
435696,Early trauma complications,ethnic,Hispanic or Latino,1,1,2
4126282,Chlamydial urethritis,racial,Unknown,1,2,3
440532,Heavy-for-dates infant regardless of gestation period,racial,White,2,0,2
135611,Furuncle of hand,ethnic,Hispanic or Latino,2,0,2
317895,Hypertension due to renovascular disease,racial,Black or African American ,2,0,2
432620,Disorder of choroid of eye,racial,Unknown,2,0,2
73301,Synovitis/tenosynovitis - wrist,racial,Asian,2,0,2
79908,Muscle strength reduced,racial,Black or African American ,1,1,2
73754,Restless legs,racial,American Indian or Alaska Native ,2,0,2
441963,Prader-Willi syndrome,ethnic,Not Hispanic or Latino,1,1,2
313761,Central retinal vein occlusion,ethnic,Not Hispanic or Latino,0,2,2
373982,Benign tumour of conjunctiva,racial,Asian,2,0,2
40485064,Latent syphilis,racial,Other Race,0,2,2
78888,Open fracture of ankle,ethnic,Hispanic or Latino,2,0,2
193020,Incomplete emptying of bladder,racial,Unknown,1,1,2
436289,Non-medicinal agent causing toxic effects,ethnic,Hispanic or Latino,1,2,3
439653,Partial epilepsy without mention of impairment of consciousness,racial,White,1,2,3
133685,Salmonellosis,ethnic,Not Hispanic or Latino,2,0,2
442073,Malunion and nonunion of fracture,ethnic,Hispanic or Latino,2,1,3
4093309,Secondary syphilis of skin and mucous membrane,racial,White,0,2,2
4193570,Abnormal results of hearing screening test,ethnic,Not Hispanic or Latino,2,1,3
432250,Infective disorder,racial,Other Race,1,1,2
4147497,Nervous system and sense organ diseases,racial,Asian,0,2,2
438878,Abnormal results of liver function studies,racial,Black or African American ,2,1,3
439228,Adverse reaction to sulphonamides,ethnic,Hispanic or Latino,1,2,3
4016358,Staphylococcus carrier,racial,White,1,1,2
134159,Precordial pain,racial,Asian,1,2,3
443597,Chronic kidney disease stage 3,racial,American Indian,1,1,2
75860,Costiveness,racial,Asian Indian,1,2,3
259852,Staphylococcal pneumonia,ethnic,Hispanic or Latino,0,2,2
75620,Traumatic arthropathy of the ankle and/or foot,ethnic,Hispanic or Latino,2,0,2
77631,Secondary localized osteoarthrosis of shoulder region,racial,Unknown,2,0,2
4101068,Observation of ear discharge,racial,Unknown,2,1,3
439918,Poliomyelitis osteopathy of the ankle and/or foot,racial,Unknown,0,2,2
201211,Herpetic vulvovaginitis,racial,Unknown,2,0,2
4102808,Transsexuality with homosexual history,racial,Black or African American ,0,2,2
194306,Carcinoid tumor of stomach,racial,White,0,2,2
432586,Mental disorder,racial,Other Race,1,2,3
439666,Contracture of multiple joints,racial,Asian,2,0,2
381281,Degenerative progressive high myopia,racial,Unknown,2,1,3
372624,Cataract with neovascularization,ethnic,Hispanic or Latino,2,0,2
381114,Microcephalus,racial,Unknown,1,1,2
192372,Placenta praevia without haemorrhage - not delivered,ethnic,Not Hispanic or Latino,2,0,2
444420,Calculus of bile duct with chronic cholecystitis,ethnic,Hispanic or Latino,2,0,2
194685,Chronic non-obstructive atrophic pyelonephritis,ethnic,Hispanic or Latino,1,2,3
436747,Legal abortion without complication,ethnic,Hispanic or Latino,2,0,2
196214,Congenital disorder of gallbladder and biliary tract,racial,White,2,0,2
443747,Acute laryngotracheitis without obstruction,ethnic,Hispanic or Latino,1,1,2
437614,Early onset of delivery,ethnic,Hispanic or Latino,2,0,2
439924,Endocrine AND/OR metabolic disorder specific to the fetus OR newborn,ethnic,Hispanic or Latino,0,2,2
137111,"Closed fracture scapula, coracoid",racial,Unknown,0,2,2
4008566,Atypical schizophrenia,ethnic,Not Hispanic or Latino,1,2,3
4066724,Pilonidal sinus/cyst NOS,ethnic,Hispanic or Latino,0,2,2
4062795,Twin pregnancy unspecified,racial,White,2,0,2
4091532,Bowel observation,racial,Other Race,1,1,2
200784,Placental condition affecting management of mother,ethnic,Hispanic or Latino,2,0,2
432354,Chronic duodenal ulcer with perforation but without obstruction,racial,Unknown,0,2,2
30515,Oesophagostenosis,ethnic,Not Hispanic or Latino,0,2,2
196236,Septicaemic shock,ethnic,Hispanic or Latino,1,1,2
441126,Monosomy and deletion from autosome,racial,Other Race,2,0,2
79873,Urolith,racial,Asian,0,2,2
432554,Human immunodeficiency virus II infection,racial,Black or African American ,1,2,3
439224,Drug allergy,racial,Asian,2,1,3
372328,Otitis media,racial,American Indian,2,0,2
75373,Open fracture of head of radius,racial,Unknown,2,0,2
441691,Atypical squamous cells of undetermined significance on vaginal Papanicolaou smear,racial,American Indian or Alaska Native ,2,0,2
138825,Actinic keratosis,racial,Black or African American ,2,0,2
437428,Crushing injury - disorder,ethnic,Hispanic or Latino,1,2,3
433668,Burn of two OR more fingers including thumb,ethnic,Hispanic or Latino,2,1,3
80509,Bone cyst,racial,Black or African American ,1,2,3
79118,Deformity of calcaneum,ethnic,Hispanic or Latino,0,2,2
435781,Vitamin K deficiency,racial,White,2,0,2
316432,Right bundle branch block AND left anterior fascicular block,racial,White,1,1,2
440454,Abortion without complication,ethnic,Hispanic or Latino,2,0,2
443401,Congenital connective tissue disorder,ethnic,Hispanic or Latino,2,1,3
437093,Congenital ptosis of upper eyelid,ethnic,Not Hispanic or Latino,0,2,2
376961,Disturbance of consciousness,racial,American Indian or Alaska Native ,2,1,3
81938,Climacteric arthritis of the shoulder region,racial,Unknown,2,0,2
372914,Optic atrophy,racial,Black or African American ,2,1,3
433315,Feeding difficulties in newborn,racial,Other Race,1,2,3
443909,"Decreased level, laboratory test",racial,Black or African American ,2,0,2
436204,Subcutaneous hematoma,racial,White,1,2,3
380100,Glossopharyngeal neuralgia,racial,White,2,0,2
24977,Mucocele of salivary gland,racial,Unknown,2,1,3
140602,"Mechanical complication of internal orthopedic device, implant and graft",racial,Unknown,2,0,2
195259,Entrapment of lateral cutaneous nerve of thigh,racial,Black or African American ,1,2,3
200052,Primary malignant neoplasm of uterine adnexa,ethnic,Not Hispanic or Latino,2,0,2
201603,Disease of teeth AND/OR supporting structures,racial,American Indian or Alaska Native ,2,1,3
79106,Arthralgia of the pelvic region and thigh,racial,Filipino,2,0,2
4101068,Observation of ear discharge,ethnic,Not Hispanic or Latino,1,1,2
380706,Regular astigmatism,racial,Unknown,2,0,2
132703,Lichen planus,ethnic,Not Hispanic or Latino,2,1,3
77670,Chest pain,racial,Asian Indian,2,1,3
377085,Congenital anomaly of brain,racial,Asian,0,2,2
316822,Finding of heart murmur,racial,Native Hawaiian or Other Pacific Islander ,1,1,2
259852,Staphylococcal pneumonia,racial,White,0,2,2
434712,Varicose veins of legs in pregnancy and the puerperium with antenatal complication,ethnic,Hispanic or Latino,0,2,2
378165,Nystagmus,ethnic,Not Hispanic or Latino,1,1,2
436812,Tongue tie,racial,Unknown,1,2,3
440383,Depressive disorder,racial,Asian Indian,1,1,2
79173,Closed dislocation of jaw,ethnic,Not Hispanic or Latino,2,1,3
316427,Aneurysm of coronary vessels,racial,White,1,2,3
4145796,Family history: Musculoskeletal disease,racial,White,2,0,2
436522,Irregular sleep-wake pattern,ethnic,Not Hispanic or Latino,1,2,3
434872,Infection by Trichomonas,ethnic,Not Hispanic or Latino,2,0,2
4324124,Peritoneal dialysis,ethnic,Hispanic or Latino,2,1,3
201322,Internal hemorrhoids without complication,racial,Asian,1,1,2
201618,Disease of intestine,racial,Other Race,2,1,3
195926,Slowing of urinary stream,racial,Unknown,0,2,2
439348,Pregnancy complications,ethnic,Hispanic or Latino,2,0,2
440012,Fall from chair or bed,ethnic,Not Hispanic or Latino,0,2,2
377294,Exotropia,racial,Black or African American ,1,1,2
4148121,Tonsil and/or adenoid hypertrophy,racial,White,1,1,2
438204,Edema or excessive weight gain in pregnancy without mention of hypertension,ethnic,Hispanic or Latino,2,0,2
134735,Chronic osteomyelitis,racial,Asian,2,0,2
77146,Open wound of finger with tendon involvement,ethnic,Hispanic or Latino,1,2,3
434413,Incomplete spontaneous abortion with complication,ethnic,Hispanic or Latino,2,0,2
437839,Pica,racial,Unknown,2,0,2
435753,Malignant lymphoma of intrathoracic lymph nodes,ethnic,Hispanic or Latino,0,2,2
438111,Hematologic neoplasm of uncertain behavior,racial,White,0,2,2
4154623,Fit denture,racial,White,2,1,3
434046,Unilateral mixed conductive and sensorineural hearing loss with unrestricted hearing on the contralateral side,racial,White,0,2,2
138117,Benign tumour of spinal cord,ethnic,Not Hispanic or Latino,0,2,2
4051119,FH: Osteoporosis,racial,Unknown,2,0,2
256717,Bronchospasm,racial,Black or African American ,1,2,3
256722,Bronchopneumonia,racial,Unknown,1,1,2
432236,Tuberculosis of peripheral lymph nodes,ethnic,Not Hispanic or Latino,2,0,2
4016359,Streptococcus carrier,ethnic,Not Hispanic or Latino,2,0,2
433917,Burns of multiple sites,racial,White,0,2,2
433681,Late effect of accident due to natural and environmental factors,ethnic,Hispanic or Latino,2,0,2
4108374,Other specified peripheral vascular disease NOS,ethnic,Hispanic or Latino,1,1,2
197610,Ovarian cyst,racial,American Indian or Alaska Native ,2,0,2
139737,Pediculosis corporis,racial,White,2,1,3
80874,Open wound of multiple sites of one upper limb without complication,ethnic,Not Hispanic or Latino,1,1,2
440529,Abnormal findings on diagnostic imaging of urinary organs,racial,Other Race,1,2,3
374941,Retained foreign body of eyelid,racial,White,2,0,2
134671,Dental abscess without a sinus,racial,Black or African American ,1,1,2
373786,Abnormal vision,racial,Asian,2,0,2
376946,Senile delirium,racial,White,2,0,2
433881,Additional general conditions of patient,racial,Unknown,2,0,2
432529,"Motor vehicle traffic accident involving pedestrian dragged by motor vehicle, driver of motor vehicle injured",racial,Other Race,2,0,2
4264281,Open fracture,racial,White,2,1,3
4087420,Other specified miliary tuberculosis,racial,White,2,0,2
4180783,Malignant tumour of lingual tonsil,racial,White,2,0,2
432512,Foreign object left in body during procedure,ethnic,Hispanic or Latino,1,2,3
318186,Achalasia of esophagus,ethnic,Not Hispanic or Latino,2,1,3
192679,Renal disease in pregnancy AND/OR puerperium without hypertension,ethnic,Hispanic or Latino,2,0,2
139895,"Thyroid dysfunction during pregnancy, childbirth and the puerperium",racial,White,2,1,3
4059635,Work maladjustment problem,ethnic,Hispanic or Latino,2,1,3
317002,Hypopiesis,racial,Black or African American ,0,2,2
40483286,Critical illness myopathy,ethnic,Hispanic or Latino,0,2,2
73336,Closed traumatic dislocation ankle joint,racial,Other Race,2,0,2
376555,Open wound of ear drum without complication,ethnic,Hispanic or Latino,1,2,3
4272867,General well-being finding,racial,Native Hawaiian or Other Pacific Islander ,1,2,3
138176,Acute gingivitis,racial,Asian,1,1,2
192954,Acute gastric ulcer without hemorrhage AND without perforation but with obstruction,ethnic,Hispanic or Latino,1,1,2
4215909,Artificial pacemaker rate check,racial,White,2,1,3
77642,Arthralgia of the forearm,racial,American Indian or Alaska Native ,2,1,3
4288676,Acute and chronic cholecystitis,racial,Other Race,2,0,2
137682,Skin sensation disturbance,racial,Native Hawaiian or Other Pacific Islander ,2,0,2
73723,Benign tumour of epididymis,racial,White,0,2,2
77352,Pyogenic arthritis of the lower leg,racial,Unknown,2,0,2
140065,Pure red cell aplasia,ethnic,Not Hispanic or Latino,2,0,2
4176890,Male sterility,ethnic,Not Hispanic or Latino,0,2,2
381001,Subjective visual disturbance,ethnic,Not Hispanic or Latino,0,2,2
138841,Disorder of sacrum,racial,Unknown,1,1,2
141955,Pectus excavatum,ethnic,Not Hispanic or Latino,0,2,2
433894,Open fracture of phalanx of toe,ethnic,Hispanic or Latino,2,0,2
4018734,Sprain of costal cartilage,racial,Other Race,1,2,3
4037738,Visual alteration,racial,White,2,1,3
74723,Arthropathy associated with a neurological disorder,racial,Black or African American ,2,0,2
26823,Oral phase dysphagia,racial,White,0,2,2
318247,Apnea in the newborn,racial,White,2,1,3
436398,Glaucoma associated with ocular disorder,racial,White,2,1,3
135027,"Carbuncle of leg, except foot",racial,Unknown,1,2,3
436373,DSD - Developmental speech disorder,racial,Filipino,1,2,3
432586,Mental disorder,racial,Unknown,2,1,3
372425,Congenital abnormality of ear,ethnic,Not Hispanic or Latino,2,1,3
4064061,Other skin and subcutaneous tissue disorders,ethnic,Hispanic or Latino,1,1,2
441398,Anomaly of sex chromosome,racial,White,2,0,2
437579,Paroxysmal ventricular tachycardia,ethnic,Not Hispanic or Latino,1,2,3
4139915,Acute pyelitis,ethnic,Not Hispanic or Latino,1,1,2
24966,OV - Oesophageal varices,racial,American Indian or Alaska Native ,2,0,2
444200,Neoplasm of nervous system,racial,Unknown,2,0,2
138463,Oral aphthae,racial,American Indian or Alaska Native ,2,0,2
133713,Malignant melanoma of skin of face,racial,White,0,2,2
443783,Chronic disease,racial,American Indian,2,0,2
443545,Nonvenomous insect bite,racial,American Indian or Alaska Native ,2,0,2
26060,Benign tumor of tonsil,racial,White,2,0,2
441025,Stenosis of lacrimal canaliculi,ethnic,Not Hispanic or Latino,1,2,3
432546,Herpes zoster dermatitis of eyelids,racial,White,1,1,2
435244,Developmental disorder,racial,Asian,2,0,2
24978,Chronic adenotonsillitis,racial,Black or African American ,0,2,2
443776,Brachial radiculitis,racial,Black or African American ,2,1,3
434277,Hemophilus influenzae infection,ethnic,Hispanic or Latino,2,1,3
433000,Patellar tendonitis,racial,Black or African American ,0,2,2
374906,Cerebral lipidosis,racial,White,2,0,2
444375,"Contact dermatitis due to plants, except food",racial,Unknown,2,1,3
198475,Gallstone ileus,racial,Unknown,2,1,3
435521,Psychophysiologic disorder,ethnic,Not Hispanic or Latino,1,1,2
435951,"Closed fracture of tibia and fibula, shaft",racial,Unknown,1,1,2
381504,Post-herpetic trigeminal neuralgia,racial,White,2,0,2
436665,Manic-depressive psychosis,racial,Native Hawaiian or Other Pacific Islander ,2,0,2
4144876,Contact dermatitis and other eczemas,racial,Unknown,1,2,3
321037,Cholesterol embolisation syndrome,ethnic,Hispanic or Latino,2,0,2
380117,Oedema of conjunctiva,racial,White,1,1,2
4060434,Unstable lie unspecified,racial,White,2,0,2
312349,Venous varices,racial,Filipino,2,1,3
436375,Sodium and water depletion,racial,White,2,1,3
133586,Bilateral incomplete cleft palate with cleft lip,ethnic,Hispanic or Latino,0,2,2
4055208,Chronic hepatitis unspecified,ethnic,Not Hispanic or Latino,0,2,2
81175,Contusion of chest,racial,American Indian or Alaska Native ,1,1,2
4202322,Amputated big toe,ethnic,Not Hispanic or Latino,1,1,2
380421,Tympanic membrane marginal perforation,ethnic,Hispanic or Latino,0,2,2
441132,Laboratory finding abnormal,racial,Unknown,1,1,2
441751,Adverse reaction to salicylate,ethnic,Hispanic or Latino,0,2,2
443603,Adverse reaction to antidiabetic drug,ethnic,Hispanic or Latino,2,1,3
257004,Acute exacerbation of chronic obstructive airways disease,racial,Filipino,0,2,2
434547,Complication of surgical procedure,ethnic,Not Hispanic or Latino,2,0,2
138278,Sprains and strains of joints and adjacent muscles,racial,Filipino,2,1,3
4196960,Varicocele,racial,Black or African American ,0,2,2
4333977,Acquired anophthalmos,ethnic,Hispanic or Latino,1,1,2
439176,Closed traumatic dislocation of metacarpophalangeal joint of finger,ethnic,Hispanic or Latino,2,0,2
434311,Disorder of the urea cycle metabolism,racial,Black or African American ,0,2,2
4282316,Recurrent major depression,racial,Unknown,2,0,2
4028827,Manual examination of breast,ethnic,Hispanic or Latino,2,0,2
201461,Disorder affecting transplant,racial,White,2,0,2
443367,Antihypertensive adverse reaction,ethnic,Hispanic or Latino,2,0,2
441579,Acute inferoposterior infarction,ethnic,Hispanic or Latino,0,2,2
4317150,Sudden cardiac death,ethnic,Hispanic or Latino,1,1,2
255919,Finding of head and neck region,racial,Other Race,2,1,3
374882,Benign connective tissue neoplasm,ethnic,Not Hispanic or Latino,2,0,2
4331899,Child in family care,racial,Other Race,2,0,2
261782,Herpetic ulceration of vulva,racial,Other Race,2,0,2
4051114,FH: Diabetes mellitus,racial,Native Hawaiian or Other Pacific Islander ,2,1,3
4186238,Louse infestation,racial,Other Race,2,1,3
443767,Diabetic oculopathy,racial,Filipino,2,0,2
312950,IgE-mediated allergic asthma,racial,Alaska Native,0,2,2
438067,Malaria,ethnic,Hispanic or Latino,2,0,2
75865,Disorder of the urinary system,ethnic,Hispanic or Latino,1,1,2
435543,Primary angle-closure glaucoma,racial,White,2,1,3
77081,Tibialis tendinitis,racial,Unknown,2,0,2
77403,Closed fracture of vertebral column without spinal cord injury,racial,Asian,1,1,2
194091,Calculus in urethra,racial,Asian,2,0,2
315085,Enlargement of lymph nodes,racial,Filipino,2,1,3
77670,Chest pain,racial,American Indian,0,2,2
81247,Carcinoma in situ of urinary system,racial,Other Race,2,0,2
443541,Recurrent inguinal hernia with gangrene,ethnic,Hispanic or Latino,0,2,2
442584,Carbuncle of buttock,racial,Unknown,2,0,2
75121,Burn of lower leg,racial,Other Race,2,0,2
201901,Abscess of liver,ethnic,Hispanic or Latino,1,2,3
138340,Septicaemia due to Staphylococcus aureus,ethnic,Not Hispanic or Latino,0,2,2
254761,Cough,racial,Asian Indian,1,2,3
434500,Closed fracture of neck of femur,racial,American Indian or Alaska Native ,2,0,2
437093,Congenital ptosis of upper eyelid,racial,Unknown,2,0,2
432545,Bacterial disease,racial,Asian,2,0,2
193528,Third degree uterine prolapse,racial,Unknown,2,0,2
439975,Injury at C1-C4 level with spinal cord injury AND without bone injury,racial,Unknown,2,0,2
134386,Gingival recession,ethnic,Hispanic or Latino,1,1,2
72487,Crush injury of foot,racial,White,2,0,2
4111875,Varicose veins of the leg NOS,racial,Unknown,2,0,2
73302,Curvature of spine,racial,Unknown,0,2,2
4165091,Lack of exercise,racial,American Indian or Alaska Native ,0,2,2
435810,After-cataract,ethnic,Not Hispanic or Latino,2,1,3
436366,Benign tumour of testis,ethnic,Not Hispanic or Latino,0,2,2
433934,Accident caused by needle,racial,White,2,0,2
376901,"Acute paralytic poliomyelitis, bulbar",ethnic,Hispanic or Latino,2,0,2
4152045,Screening for malignant neoplasm of respiratory tract,racial,White,2,0,2
4149547,Fracture of vertebra without spinal cord lesion,racial,White,0,2,2
381551,Drug-related polyneuropathy,racial,White,0,2,2
76744,Azoospermia,ethnic,Hispanic or Latino,0,2,2
133303,Congenital anomaly of mouth,ethnic,Hispanic or Latino,0,2,2
31821,Endocrinopathy,racial,Asian,2,0,2
196738,Male genital organ disease,racial,American Indian or Alaska Native ,0,2,2
439719,Disseminated mycobacteriosis,ethnic,Hispanic or Latino,0,2,2
80232,Closed fracture of calcaneus,racial,Asian,0,2,2
443783,Chronic disease,racial,Filipino,1,1,2
4112534,Chronic laryngitis and laryngotracheitis,ethnic,Hispanic or Latino,0,2,2
200765,Chronic cholecystitis,racial,Unknown,1,1,2
433403,Viral meningitis,racial,Black or African American ,1,2,3
434752,Positive serological AND/OR viral culture findings for human immunodeficiency virus,racial,Asian,0,2,2
196064,Carcinoma in situ of digestive organ,ethnic,Hispanic or Latino,0,2,2
433197,PXF - Pseudoexfoliation of lens capsule,ethnic,Hispanic or Latino,0,2,2
4116861,Neuromyopathy,ethnic,Not Hispanic or Latino,2,0,2
437787,Secondary syphilis,racial,Black or African American ,0,2,2
435171,Allergic state,racial,Native Hawaiian or Other Pacific Islander ,1,1,2
254669,Disease of vocal cords,racial,White,1,2,3
436672,Disorder of copper metabolism,racial,White,2,0,2
4107655,Observations relating to psychosocial functioning,racial,Asian,1,1,2
26711,Chronic pharyngitis,racial,Other Race,2,0,2
377550,Compression of brain,ethnic,Not Hispanic or Latino,2,0,2
436265,Open wound of multiple sites of one lower limb AND thigh without complication,racial,Unknown,1,2,3
78272,Sprain of wrist,racial,Filipino,0,2,2
373404,Ophthalmic herpes simplex,racial,Unknown,2,0,2
78842,Acquired postural lordosis,racial,White,2,0,2
195500,Benign tumour of uterus,ethnic,Hispanic or Latino,2,0,2
138387,Thyrotoxicosis,ethnic,Hispanic or Latino,2,0,2
440389,MR - Mental retardation,racial,Filipino,2,1,3
444445,Benign neoplasm of skin of leg,racial,Unknown,1,2,3
436251,Closed fracture of proximal end of ulna,ethnic,Hispanic or Latino,1,2,3
201343,Acute alcoholic liver disease,ethnic,Not Hispanic or Latino,2,1,3
26060,Benign tumor of tonsil,ethnic,Hispanic or Latino,2,0,2
200779,Intrauterine polyp,racial,Black or African American ,2,0,2
440840,Neonatal candidiasis,ethnic,Not Hispanic or Latino,2,0,2
133566,Necrotizing fasciitis,racial,Unknown,2,0,2
201061,Diaphragmatic hernia,racial,Other Race,1,2,3
440649,Primary malignant neoplasm of head of pancreas,racial,White,0,2,2
4094448,Pregnancy test negative,racial,Asian,2,0,2
376337,Disease of nervous system,racial,American Indian or Alaska Native ,1,2,3
258780,Chronic obstructive bronchitis,racial,American Indian or Alaska Native ,0,2,2
73754,Restless legs,racial,Other Race,2,0,2
4051702,FH: Congenital anomaly,ethnic,Not Hispanic or Latino,2,0,2
375545,Lens opacity,racial,American Indian or Alaska Native ,1,1,2
441190,Injury of unknown intent due to fall from height,racial,White,2,0,2
199866,Acute gastritis,racial,American Indian or Alaska Native ,2,0,2
435781,Vitamin K deficiency,ethnic,Hispanic or Latino,2,0,2
200768,Inflammatory disease of vagina and/or vulva,racial,Unknown,2,0,2
200843,Observation of frequency of urination,racial,Filipino,1,2,3
196821,Observation of urethral discharge,ethnic,Not Hispanic or Latino,0,2,2
321052,Peripheral vascular disease,racial,Filipino,0,2,2
4206460,Problem,racial,Other Race,2,1,3
4116452,Generalized osteoarthritis NOS,racial,Black or African American ,2,0,2
433846,Ankylosis of joint of lower leg,racial,Unknown,2,0,2
444246,Cirrhosis of liver not due to alcohol,racial,American Indian or Alaska Native ,2,0,2
443539,Motor vehicle injury,ethnic,Not Hispanic or Latino,0,2,2
439924,Endocrine AND/OR metabolic disorder specific to the fetus OR newborn,racial,White,0,2,2
321876,Disease of capillaries,racial,Unknown,2,0,2
440525,Prematurity of fetus,racial,American Indian or Alaska Native ,0,2,2
4302979,Blepharorrhaphy,racial,Unknown,2,0,2
444243,Neurotic disorder,racial,Other Race,2,1,3
79126,Polysyndactyly,racial,White,0,2,2
434207,"Insect bite, nonvenomous, of hand, without mention of infection",racial,Unknown,1,1,2
380111,Acute atopic conjunctivitis,racial,Asian,1,1,2
80504,Acquired genu valgum,racial,Other Race,2,1,3
433257,Mesangiocapillary glomerulonephritis,racial,Unknown,1,1,2
432868,Hemoglobinopathy,racial,Unknown,0,2,2
133028,Scalp injuries due to birth trauma,racial,White,0,2,2
200528,Ascites,racial,American Indian or Alaska Native ,2,0,2
192667,Atrophic gastritis,racial,Black or African American ,0,2,2
77025,Diverticulitis of colon,racial,American Indian or Alaska Native ,1,2,3
132446,Congenital anomaly of skin,racial,Other Race,1,2,3
80861,Closed fracture of ischium,ethnic,Hispanic or Latino,2,0,2
432587,Polyclonal hypergammaglobulinemia,racial,Unknown,0,2,2
435889,Decubitus ulcer of ankle,ethnic,Not Hispanic or Latino,0,2,2
373175,Organic hallucinosis,racial,White,2,1,3
437038,Blood in urine,racial,American Indian or Alaska Native ,2,0,2
313005,Congenital stenosis of pulmonary valve,racial,Unknown,2,0,2
136661,Nodular goiter,ethnic,Not Hispanic or Latino,2,1,3
81984,Sprain of shoulder and upper arm,racial,American Indian or Alaska Native ,2,0,2
4008517,"Fracture of rib(s), sternum, larynx and trachea",racial,Unknown,0,2,2
440697,Nonaggressive unsocial conduct disorder,racial,Unknown,0,2,2
440786,Threatened premature labor,racial,White,2,0,2
372887,Disease of brain,ethnic,Not Hispanic or Latino,1,1,2
439025,Dacryocystitis,racial,White,2,0,2
437902,Teeth development and eruption disorders,racial,Filipino,1,1,2
4331070,Family history of polyp of colon,ethnic,Not Hispanic or Latino,2,1,3
197781,Shigella sonnei (group D),racial,White,1,2,3
377566,Palsy of conjugate gaze,racial,White,2,0,2
197304,Ulcer of lower limb,racial,Black or African American ,1,1,2
434712,Varicose veins of legs in pregnancy and the puerperium with antenatal complication,racial,Unknown,0,2,2
434822,Complication of internal prosthetic device,racial,White,1,1,2
254387,Upper respiratory tract hypersensitivity reaction,racial,Other Race,2,1,3
381316,CVA - Cerebrovascular accident,racial,American Indian or Alaska Native ,2,0,2
381562,"Impairment level: better eye: moderate impairment: lesser eye: blind, not further specified",racial,White,1,1,2
436546,Strain of subscapularis muscle,ethnic,Not Hispanic or Latino,1,2,3
199059,Ventral hernia with obstruction but no gangrene,ethnic,Hispanic or Latino,2,0,2
77963,Achilles tendinitis,racial,Asian,1,2,3
4108374,Other specified peripheral vascular disease NOS,racial,White,1,1,2
433168,Iron deficiency anaemia secondary to inadequate dietary iron intake,racial,Unknown,1,1,2
4057348,"Contusion, knee and lower leg NOS",ethnic,Hispanic or Latino,0,2,2
381028,Acute suppurative otitis media - tympanic membrane ruptured,racial,Other Race,1,1,2
436033,Syphilis,racial,Other Race,0,2,2
440760,Inflammatory disorder of jaw,racial,White,2,1,3
443789,Victim of trauma,racial,White,1,1,2
441593,Arteriovenous fistula of pulmonary vessels,ethnic,Hispanic or Latino,2,0,2
435790,Spurious polycythaemia,racial,Other Race,2,1,3
80182,Dermatomyositis,racial,Unknown,1,2,3
437217,Coccidioidomycosis,racial,Black or African American ,0,2,2
4164222,Tendon contracture,racial,Black or African American ,0,2,2
438792,Crowding of teeth,racial,White,1,2,3
380375,Organic personality disorder,racial,White,1,2,3
40481374,Allergic rhinitis due to food,racial,Unknown,1,1,2
441077,Stenosis of cervix,racial,Unknown,2,0,2
438209,Pregnancy care of habitual aborter,racial,White,2,0,2
73290,Contracture of joint,racial,White,0,2,2
434902,Autistic disorder of childhood onset,racial,American Indian or Alaska Native ,0,2,2
434277,Hemophilus influenzae infection,racial,White,2,1,3
441481,Adult victim of abuse,racial,Unknown,2,1,3
436996,Thoracoabdominal aortic aneurysm,racial,White,0,2,2
260034,Chronic pulmonary coccidioidomycosis,ethnic,Hispanic or Latino,0,2,2
4028716,Idiopathic thrombocythemia,racial,Other Race,2,1,3
76191,Disease of upper arm,racial,Asian,2,1,3
436314,Accidental puncture AND/OR laceration during a procedure,racial,Black or African American ,0,2,2
432289,Drug-induced neutropenia,racial,Unknown,1,2,3
442632,Abrasion AND/OR friction burn of wrist with infection,ethnic,Hispanic or Latino,2,1,3
197318,Cholesterolosis of gallbladder,racial,Asian,2,1,3
436353,Primary malignant neoplasm of upper outer quadrant of female breast,ethnic,Hispanic or Latino,2,0,2
375292,Perforation of tympanic membrane,racial,American Indian or Alaska Native ,0,2,2
133593,Transverse deficiency of upper limb,ethnic,Hispanic or Latino,0,2,2
4115379,"Localised, primary osteoarthritis of the pelvic region and thigh",racial,Other Race,2,0,2
432600,Stress reaction causing mixed disturbance of emotion and conduct,ethnic,Hispanic or Latino,2,1,3
436829,Closed fracture of angle of jaw,ethnic,Hispanic or Latino,0,2,2
80495,Palindromic rheumatism of the pelvic region and thigh,racial,Asian,2,0,2
434046,Unilateral mixed conductive and sensorineural hearing loss with unrestricted hearing on the contralateral side,racial,Unknown,2,0,2
195876,Hematometra,ethnic,Not Hispanic or Latino,0,2,2
4015842,Viral hepatitis carrier,ethnic,Not Hispanic or Latino,0,2,2
4091320,Meningococcal infection NOS,racial,White,2,0,2
436253,Sprain of foot,racial,Other Race,0,2,2
196325,Protozoal intestinal disease,ethnic,Hispanic or Latino,0,2,2
194306,Carcinoid tumor of stomach,ethnic,Hispanic or Latino,0,2,2
441836,Depressed bipolar I disorder,racial,Black or African American ,2,0,2
4010838,Increased body growth,ethnic,Hispanic or Latino,1,2,3
4304916,Gastrointestinal tract finding,ethnic,Not Hispanic or Latino,0,2,2
436285,Superficial foreign body without major open wound but with infection,ethnic,Hispanic or Latino,2,1,3
200040,Acute gonococcal endometritis,ethnic,Hispanic or Latino,2,0,2
380117,Oedema of conjunctiva,ethnic,Hispanic or Latino,1,1,2
439037,Aneurysm of artery of neck,racial,Unknown,2,0,2
443392,Malignant neoplastic disease,racial,White,2,0,2
432719,Panniculitis,ethnic,Hispanic or Latino,1,1,2
434219,Anaphylactic shock due to adverse food reaction,ethnic,Not Hispanic or Latino,2,1,3
443524,Mixed incontinence,racial,Other Race,2,0,2
4148404,Family history: Anemia,ethnic,Hispanic or Latino,1,1,2
140949,Scabies,racial,Filipino,1,2,3
261774,"Respiratory tuberculosis, not confirmed bacteriologically or histologically",ethnic,Not Hispanic or Latino,0,2,2
373654,Second degree burn of face AND/OR head,racial,White,1,2,3
4102808,Transsexuality with homosexual history,ethnic,Not Hispanic or Latino,0,2,2
372892,Metabolic encephalopathy,racial,White,1,1,2
312622,BVO - Branch retinal occlusion,ethnic,Not Hispanic or Latino,0,2,2
439183,Concussion,racial,Other Race,0,2,2
4012491,Difficulty chewing,racial,Black or African American ,1,1,2
195501,Polycystic ovaries,racial,American Indian,2,0,2
74806,Open wound of finger with complication,racial,White,0,2,2
374358,Dermatochalasis,racial,White,0,2,2
78907,Superficial injury of foot without infection,racial,Unknown,1,2,3
439672,Viral hepatitis C with coma,ethnic,Not Hispanic or Latino,2,0,2
440438,Anodontia,racial,Asian,2,0,2
80269,Mechanical complication of internal joint prosthesis,racial,Other Race,2,0,2
432461,"Closed fracture clavicle, shaft",racial,Black or African American ,0,2,2
4270866,Symptomatic dermographism,racial,Other Race,1,2,3
436246,Low libido,racial,Other Race,1,1,2
4116861,Neuromyopathy,racial,Asian,2,0,2
195769,Submucous uterine leiomyoma,ethnic,Not Hispanic or Latino,2,0,2
31884,Acquired diverticulum of esophagus,racial,White,2,0,2
318549,Cardiac septal defects,racial,White,2,0,2
77365,Disuse osteoporosis,ethnic,Not Hispanic or Latino,2,0,2
438731,Fat pad,racial,Unknown,2,1,3
195007,Female stress incontinence,racial,Black or African American ,2,0,2
432458,Closed fracture of C1-C4 level with spinal cord injury,racial,Unknown,0,2,2
4112819,Pneumonia due to other specified bacteria,racial,White,2,0,2
380533,Neonatal seizures,racial,White,2,0,2
437787,Secondary syphilis,racial,White,0,2,2
4096783,Total prostatectomy,racial,White,0,2,2
321318,Angina,racial,American Indian or Alaska Native ,2,1,3
4110022,Acute bronchitis and/or bronchiolitis,racial,White,0,2,2
443610,Prolapse of uterine cervical stump,ethnic,Hispanic or Latino,2,0,2
433315,Feeding difficulties in newborn,racial,Unknown,1,1,2
438567,Adult failure to thrive syndrome,racial,Asian,1,1,2
438398,Leukocytosis,racial,Native Hawaiian or Other Pacific Islander ,0,2,2
198985,Primary malignant neoplasm of kidney,racial,Asian,0,2,2
4067435,"Joint disorder NOS, of unspecified site",racial,White,2,0,2
25780,Lorain - Levi dwarfism,ethnic,Not Hispanic or Latino,0,2,2
439656,A/N care: grand multip,ethnic,Hispanic or Latino,2,0,2
439294,"Malignant neoplasm of head, neck and face",ethnic,Hispanic or Latino,2,1,3
432729,Crying infant,racial,Unknown,0,2,2
439183,Concussion,racial,Black or African American ,1,2,3
438871,Drug withdrawal syndrome in newborn,racial,White,2,1,3
81902,Urinary tract infectious disease,racial,American Indian,2,0,2
433837,Obstetric nipple infection with postnatal complication,ethnic,Not Hispanic or Latino,2,0,2
76194,Osteoarthrosis involving multiple sites but not designated as generalized,racial,Asian,2,1,3
373784,Acute allergic serous otitis media,racial,Unknown,2,1,3
376419,Haematoma of pinna,ethnic,Hispanic or Latino,2,1,3
436253,Sprain of foot,racial,Black or African American ,1,1,2
439298,Bronchitis and pneumonitis due to chemical fumes,racial,White,1,2,3
201322,Internal hemorrhoids without complication,racial,Black or African American ,0,2,2
433456,Acute pain,racial,American Indian or Alaska Native ,2,0,2
4053378,FH: Blood disorder,ethnic,Hispanic or Latino,1,1,2
312938,Hypertensive encephalopathy,ethnic,Hispanic or Latino,0,2,2
73720,Overlapping malignant neoplasm of urinary system,racial,White,2,0,2
76227,Leg oedema,ethnic,Hispanic or Latino,2,0,2
193277,Deliveries by caesarean,ethnic,Not Hispanic or Latino,2,0,2
438692,Primary malignant neoplasm of lateral wall of nasopharynx,racial,Unknown,0,2,2
440321,Helicobacter-associated disease,racial,American Indian or Alaska Native ,2,0,2
434626,Borderline personality disorder,ethnic,Not Hispanic or Latino,1,1,2
4170137,Non-suppurative otitis media,racial,Asian,2,1,3
432801,"Injury undetermined whether accidentally or purposely inflicted, fall from natural site",racial,Other Race,2,0,2
195977,Contusion of trunk,racial,Other Race,2,0,2
433911,Contusion of eye AND ocular adnexa,racial,Black or African American ,1,1,2
372924,Cerebral arterial occlusion,ethnic,Hispanic or Latino,2,0,2
199860,Hernia of abdominal cavity,racial,Other Race,1,2,3
4100249,Presenile dementia NOS,ethnic,Hispanic or Latino,2,0,2
435543,Primary angle-closure glaucoma,ethnic,Not Hispanic or Latino,2,0,2
439763,Benign tumour of trachea,ethnic,Hispanic or Latino,0,2,2
4113102,Amputated at hip,racial,White,2,0,2
78771,Labyrinthine dysfunction,racial,Unknown,0,2,2
438692,Primary malignant neoplasm of lateral wall of nasopharynx,ethnic,Not Hispanic or Latino,0,2,2
434089,Antepartum hemorrhage,ethnic,Hispanic or Latino,2,0,2
77673,Sign or symptom of the urinary system,racial,Other Race,1,2,3
436954,Drug abuse,racial,Other Race,0,2,2
377286,VFD - Visual field defect,racial,Asian,0,2,2
437470,Adverse reaction to benzodiazepine-based tranquilliser,racial,Unknown,2,0,2
433196,Chorioretinal scar,racial,Unknown,2,0,2
136368,Non-toxic multinodular goiter,racial,American Indian or Alaska Native ,2,0,2
438398,Leukocytosis,racial,Other Race,2,1,3
4317150,Sudden cardiac death,racial,White,1,1,2
377575,Tinnitus,racial,Filipino,0,2,2
194158,Perinatal gastrointestinal hemorrhage,racial,Filipino,0,2,2
380707,Distortion of visual image,racial,Unknown,2,0,2
441241,Reticulosarcoma of lymph nodes of axilla and upper limb,ethnic,Hispanic or Latino,2,0,2
194092,Uterine prolapse without vaginal wall prolapse,racial,Asian,2,0,2
192502,Contusion of multiple sites of trunk,racial,White,2,1,3
433881,Additional general conditions of patient,racial,Asian,2,1,3
4103640,Amputated foot,racial,Black or African American ,0,2,2
136497,Scar conditions and fibrosis of skin,racial,Black or African American ,1,2,3
134671,Dental abscess without a sinus,racial,Asian,2,0,2
376971,Retinal tear,racial,White,1,1,2
4192676,Born by caesarean section,racial,White,1,2,3
438111,Hematologic neoplasm of uncertain behavior,ethnic,Hispanic or Latino,0,2,2
4090255,Colloid bodies in retina,racial,Other Race,2,0,2
440735,Rheumatic fever without heart involvement,ethnic,Hispanic or Latino,0,2,2
438701,UKP - Disseminated malignancy of unknown primary,racial,Asian,2,0,2
4077382,Familial lipoprotein lipase deficiency,racial,White,1,2,3
195058,Nonallopathic lesion of abdomen,racial,White,2,0,2
4064382,Skin disease screening,ethnic,Not Hispanic or Latino,2,1,3
4028253,Neoplasm of digestive system,racial,Unknown,2,0,2
432611,Explosive personality disorder,ethnic,Not Hispanic or Latino,0,2,2
72711,Shoulder stiff,ethnic,Hispanic or Latino,2,0,2
4013457,"Closed fracture of proximal humerus, unspecified part",racial,Alaska Native,0,2,2
376525,Audiogram abnormal,racial,Other Race,1,1,2
77146,Open wound of finger with tendon involvement,racial,White,1,2,3
196156,Urethral diverticulum,racial,Unknown,2,0,2
439394,Congenital anomaly of face,racial,White,2,1,3
439221,"Adverse effect, due to correct medicinal substance properly administered",racial,Other Race,1,1,2
4091928,Chronic leukemia NOS,ethnic,Not Hispanic or Latino,2,0,2
440828,Renal pelvis and ureter obstructive defects,racial,Unknown,0,2,2
81936,Monoarthritis,racial,Unknown,2,1,3
197925,Haemorrhage of rectum and anus,racial,Black or African American ,1,1,2
259055,Extrinsic asthma with asthma attack,racial,Native Hawaiian or Other Pacific Islander ,0,2,2
374336,Infantile hemiplegia,ethnic,Hispanic or Latino,2,1,3
80509,Bone cyst,racial,Unknown,2,1,3
436075,Adjustment disorder with anxious mood,racial,Filipino,2,1,3
318736,Migraine,racial,Asian Indian,2,1,3
195289,Goodpasture's syndrome,ethnic,Not Hispanic or Latino,2,0,2
24134,Nonspecific pain in the neck region,racial,Filipino,1,2,3
435131,Victim of neglect,racial,Unknown,2,0,2
444112,Integumentary system finding,racial,Other Race,1,2,3
195012,Metrorrhagia,racial,Native Hawaiian or Other Pacific Islander ,2,0,2
198465,"Megacolon, not Hirschsprung's",racial,White,0,2,2
440088,Academic underachievement disorder,racial,Other Race,0,2,2
81711,Glenoid labrum detachment,racial,White,1,2,3
433644,Shellfish allergy,racial,White,1,1,2
435753,Malignant lymphoma of intrathoracic lymph nodes,racial,White,0,2,2
26727,Vomiting blood,racial,Other Race,1,2,3
318852,Congenital malformation of vitreous body,racial,Other Race,2,0,2
198892,Internal injury of abdominal organs without open wound into cavity,ethnic,Hispanic or Latino,1,1,2
200848,Dribbling of urine,racial,Unknown,0,2,2
134404,Anal spasm,racial,Unknown,1,1,2
195847,Gastroparesis syndrome,racial,Asian,2,0,2
443752,Ventricular hemorrhage,racial,White,2,0,2
137351,Epidermoid cyst of skin,racial,Filipino,0,2,2
443949,Disease type AND/OR category unknown,ethnic,Not Hispanic or Latino,0,2,2
28179,Polyp of vocal cord or larynx,ethnic,Not Hispanic or Latino,2,0,2
138388,Secondary hyperparathyroidism,ethnic,Not Hispanic or Latino,2,0,2
4087442,Acute poliomyelitis NOS,racial,Unknown,1,1,2
77358,Observation of hand region,racial,White,1,1,2
137829,Erythroid aplasia,racial,Asian,2,0,2
195301,Acute dilatation of stomach,ethnic,Hispanic or Latino,1,1,2
198192,Renal and perinephric abscess,racial,White,2,0,2
4109699,Unspecified chronic conjunctivitis,ethnic,Hispanic or Latino,1,1,2
201121,Malformation of urachus,ethnic,Hispanic or Latino,0,2,2
443357,Ankle joint observation,racial,White,1,1,2
321119,Coarctation of aorta,ethnic,Not Hispanic or Latino,1,1,2
321822,Peripheral circulatory disorder associated with diabetes mellitus,racial,White,0,2,2
192815,Intestinal infection due to E. coli,ethnic,Hispanic or Latino,1,1,2
376229,Abnormal involuntary movement,racial,Filipino,1,1,2
442623,Abrasion AND/OR friction burn of scalp without infection,racial,Asian,1,1,2
4264281,Open fracture,racial,Unknown,2,0,2
4152047,Lipid screening,racial,American Indian or Alaska Native ,2,0,2
253954,PTB - Pulmonary tuberculosis,racial,Other Race,1,1,2
438120,Opioid dependence,racial,American Indian or Alaska Native ,0,2,2
437165,Motor vehicle traffic accident,racial,Asian,1,1,2
432729,Crying infant,racial,Other Race,1,1,2
435755,Primary malignant neoplasm of skin of eyelid,ethnic,Hispanic or Latino,2,0,2
444031,Chronic heart failure,racial,Unknown,2,0,2
76161,Impotence of organic origin,racial,Filipino,0,2,2
443864,Multi-infarct dementia with depression,racial,Asian,2,0,2
435758,Burkitt's tumor of extranodal AND/OR solid organ site,ethnic,Hispanic or Latino,1,1,2
4152045,Screening for malignant neoplasm of respiratory tract,ethnic,Not Hispanic or Latino,2,0,2
135688,Abrasion AND/OR friction burn of foot with infection,racial,Unknown,2,0,2
436078,Malnutrition of moderate degree (Gomez: 60% to less than 75% of standard weight),racial,Other Race,2,0,2
79916,Acquired hallux rigidus,ethnic,Hispanic or Latino,2,0,2
79916,Acquired hallux rigidus,racial,White,2,0,2
434894,Acute post-hemorrhagic anemia,racial,Unknown,2,0,2
435243,Alcohol dependence,racial,American Indian,0,2,2
437838,"Cannabis dependence, episodic",racial,White,1,1,2
440360,Pure hyperglyceridemia,racial,Asian Indian,1,1,2
194682,Bilateral inguinal hernia with obstruction but no gangrene,ethnic,Not Hispanic or Latino,0,2,2
134144,Cleft palate with cleft lip,racial,Unknown,0,2,2
78473,Solitary cyst of breast,racial,American Indian or Alaska Native ,2,0,2
192676,Cervical intraepithelial neoplasia grade 1,racial,Black or African American ,2,0,2
197724,Unilateral traumatic amputation of foot without complication,racial,Unknown,0,2,2
434316,von Willebrand disorder,racial,Asian,2,0,2
439666,Contracture of multiple joints,racial,Unknown,1,1,2
4210151,HIV counseling,racial,Native Hawaiian or Other Pacific Islander ,2,0,2
198263,Right upper quadrant pain,racial,Native Hawaiian or Other Pacific Islander ,1,1,2
255919,Finding of head and neck region,racial,Asian,1,1,2
193242,Perforation of intestine,racial,Other Race,0,2,2
442601,Sedative abuse,ethnic,Not Hispanic or Latino,1,1,2
376419,Haematoma of pinna,racial,White,1,1,2
377910,Deviated nasal septum,racial,Other Race,0,2,2
4064359,Cholera screening,racial,White,0,2,2
381857,Impairment level: one eye: total impairment: other eye: not specified,racial,American Indian or Alaska Native ,2,0,2
443943,Herpes zoster,ethnic,Not Hispanic or Latino,1,1,2
374034,Visual disturbance,racial,Filipino,2,0,2
4330220,Family history of malignant neoplasm of genital structure,ethnic,Hispanic or Latino,2,0,2
79127,Congenital spondylolisthesis,racial,Asian,2,0,2
197607,Polymenorrhagia,racial,Filipino,2,0,2
80494,Arthropathy associated with another disorder,ethnic,Hispanic or Latino,1,1,2
74740,Accessory digit,ethnic,Hispanic or Latino,0,2,2
194686,Acquired renal cyst,racial,American Indian or Alaska Native ,2,0,2
375291,Bullous myringitis,racial,Unknown,1,1,2
438725,Disorder of magnesium metabolism,racial,Asian,2,0,2
75954,Sprain of interphalangeal joint of finger,ethnic,Not Hispanic or Latino,1,1,2
198313,Burn erythema of abdominal wall,ethnic,Hispanic or Latino,1,1,2
436072,Bipolar disorder in partial remission,racial,American Indian or Alaska Native ,2,0,2
433976,Primary malignant neoplasm of temporal lobe,ethnic,Hispanic or Latino,2,0,2
375828,Patulous eustachian tube,ethnic,Hispanic or Latino,1,1,2
200444,Post-cholecystectomy syndrome,racial,Unknown,1,1,2
440916,Burn to wrist/hand - blister,racial,Unknown,1,1,2
197601,Spermatocele,ethnic,Not Hispanic or Latino,0,2,2
434614,Disorder of iron metabolism,ethnic,Hispanic or Latino,1,1,2
432310,Meningitis due to cryptococcus,racial,Unknown,0,2,2
198645,Third degree burn of lower limb,racial,White,0,2,2
438130,Opioid abuse,ethnic,Hispanic or Latino,1,1,2
74187,Sprain of coracohumeral ligament,ethnic,Hispanic or Latino,0,2,2
73575,Deformity of toe,ethnic,Not Hispanic or Latino,1,1,2
4113683,Spontaneous abortion unspecified,ethnic,Hispanic or Latino,2,0,2
376105,Krampfe salaam attacks,racial,Asian,1,1,2
374372,Otogenic otalgia,ethnic,Not Hispanic or Latino,2,0,2
435299,Failure of dental prosthesis,racial,Asian,0,2,2
198101,Lipoma of skin and subcutaneous tissue (excluding face),racial,American Indian or Alaska Native ,2,0,2
137057,Paronychia,racial,American Indian or Alaska Native ,1,1,2
195223,Renal carnitine transport defect,racial,White,1,1,2
78193,Epididymo-orchitis,racial,Other Race,0,2,2
4318718,Limitation of movement of temporomandibular joint,ethnic,Hispanic or Latino,2,0,2
380731,OE - Otitis externa,racial,Black or African American ,0,2,2
192577,Carcinoma in situ of female genital organ,racial,White,2,0,2
437902,Teeth development and eruption disorders,racial,Other Race,1,1,2
374645,Phantom limb syndrome,racial,White,1,1,2
135722,Chronic infection of amputation stump,ethnic,Not Hispanic or Latino,0,2,2
443629,Generalised abdominal tenderness,ethnic,Hispanic or Latino,0,2,2
438067,Malaria,ethnic,Not Hispanic or Latino,1,1,2
259153,Throat soreness,racial,Native Hawaiian or Other Pacific Islander ,1,1,2
192885,Tarsal tunnel syndrome,ethnic,Not Hispanic or Latino,2,0,2
259848,Chronic rhinitis,racial,American Indian or Alaska Native ,1,1,2
253790,Pneumonia due to Klebsiella pneumoniae,racial,White,0,2,2
4100367,Simple schizophrenia NOS,racial,Asian,2,0,2
437523,Dependent personality disorder,racial,White,0,2,2
442110,Benign neoplasm of nasal sinus,ethnic,Hispanic or Latino,1,1,2
435023,Mild hyperemesis-not delivered,racial,Black or African American ,2,0,2
435633,Juvenile osteochondrosis of upper extremity,ethnic,Hispanic or Latino,2,0,2
81936,Monoarthritis,ethnic,Not Hispanic or Latino,1,1,2
436289,Non-medicinal agent causing toxic effects,racial,White,0,2,2
441262,"Amfetamine or psychostimulant dependence, episodic",racial,Asian,0,2,2
373449,Drug-induced delirium,ethnic,Hispanic or Latino,2,0,2
376969,Orofacial dyskinesia,racial,Unknown,2,0,2
317299,Disorder of vitreous body,racial,Unknown,1,1,2
437741,Accidental burning caused by caustic and corrosive substance,racial,White,0,2,2
193136,Acute gonococcal cervicitis,ethnic,Hispanic or Latino,2,0,2
4064061,Other skin and subcutaneous tissue disorders,racial,White,1,1,2
321483,Respiratory complication,ethnic,Hispanic or Latino,1,1,2
435849,Parietoalveolar pneumopathy,racial,Unknown,0,2,2
4167069,Aneurysm clipping,ethnic,Not Hispanic or Latino,2,0,2
31317,Can't get food down,racial,American Indian or Alaska Native ,2,0,2
375545,Lens opacity,racial,American Indian,2,0,2
4028827,Manual examination of breast,racial,Unknown,2,0,2
437643,Gait abnormality,racial,Alaska Native,2,0,2
77421,Open wound of hand except fingers without complication,racial,Asian,0,2,2
192367,Dysplasia of cervix,racial,Other Race,2,0,2
436140,Vulval varices,racial,Unknown,2,0,2
444433,Open wound of toe with complication,racial,White,1,1,2
201061,Diaphragmatic hernia,racial,Asian,2,0,2
373182,Amyotrophic lateral sclerosis,racial,White,1,1,2
440953,Cysticercosis,racial,Unknown,2,0,2
435786,Disorder of sleep-wake cycle,racial,White,1,1,2
376709,Discharge of eye,racial,Black or African American ,1,1,2
440085,Schizoid personality disorder,ethnic,Hispanic or Latino,1,1,2
433244,Tooth loss,racial,White,1,1,2
197332,Incomplete uterovaginal prolapse,racial,Other Race,2,0,2
73923,"Contusion, upper arm",racial,Other Race,2,0,2
443367,Antihypertensive adverse reaction,racial,White,1,1,2
437226,Malignant neoplasm of nasopharyngeal wall,ethnic,Hispanic or Latino,0,2,2
443452,Bleeding of unknown origin,ethnic,Not Hispanic or Latino,2,0,2
4149382,Endocrine/metabolic screening,racial,Other Race,0,2,2
194981,Bilateral femoral hernia without obstruction AND without gangrene,racial,Unknown,2,0,2
434782,Closed fracture of tibia AND fibula,racial,Other Race,2,0,2
4026149,Other cholecystitis,racial,White,2,0,2
441647,Continuing pregnancy after intrauterine death of twin fetus,ethnic,Hispanic or Latino,2,0,2
133147,Primary malignant neoplasm of skin of trunk,racial,Asian,0,2,2
443237,"Manic disorder, single episode",racial,Filipino,0,2,2
4224000,Transposition of pterygium,ethnic,Hispanic or Latino,2,0,2
4167075,Fusion of knee,ethnic,Not Hispanic or Latino,2,0,2
27321,Persistent vomiting,racial,Other Race,1,1,2
73026,Abnormal respiratory sounds,racial,Other Race,0,2,2
258482,Abscess of Bartholin's gland,ethnic,Not Hispanic or Latino,2,0,2
432311,Angle-closure glaucoma - borderline,ethnic,Not Hispanic or Latino,0,2,2
432296,Coagulation factor deficiency syndrome,ethnic,Hispanic or Latino,1,1,2
4018734,Sprain of costal cartilage,racial,Asian,2,0,2
4092669,Other viral exanthemata,racial,White,0,2,2
78835,Palindromic rheumatism of the lower leg,racial,Native Hawaiian or Other Pacific Islander ,0,2,2
196347,Intestinal parasitism,ethnic,Not Hispanic or Latino,1,1,2
437013,"Primary dental caries, pit and fissure origin",racial,Black or African American ,0,2,2
442752,Myalgia,racial,Filipino,1,1,2
4093460,Leptospirosis NOS,ethnic,Hispanic or Latino,1,1,2
440068,Psychosexual dysfunction,racial,Unknown,0,2,2
133367,Second degree burn of wrist,racial,White,2,0,2
377870,Heterotropia,ethnic,Hispanic or Latino,2,0,2
434165,Abnormal cervical smear,racial,Other Race,2,0,2
4056171,Prostatic hyperplasia NOS,ethnic,Not Hispanic or Latino,0,2,2
438329,Late effect of motor vehicle accident,racial,Other Race,2,0,2
433556,Derangement of posterior horn of lateral meniscus,racial,Unknown,0,2,2
437896,Disorder of language,racial,Unknown,2,0,2
254320,Cystic fibrosis of the lung,racial,White,2,0,2
4112954,Unspecified spontaneous abortion without mention of complication,racial,Unknown,2,0,2
4237140,Abnormal sexual function,racial,Unknown,0,2,2
138718,Thyrotoxicosis from ectopic thyroid nodule with no crisis,ethnic,Not Hispanic or Latino,1,1,2
313459,Sleep apnea,racial,Native Hawaiian or Other Pacific Islander ,0,2,2
314968,Varices,racial,Black or African American ,0,2,2
73557,Allergic arthritis of the pelvic region and thigh,racial,White,2,0,2
193402,Bacterial enteritis,ethnic,Hispanic or Latino,1,1,2
141932,Senile hyperkeratosis,racial,American Indian or Alaska Native ,2,0,2
4169658,No help available,racial,White,1,1,2
434073,Loss of teeth - acquired,racial,Asian,0,2,2
433894,Open fracture of phalanx of toe,racial,White,2,0,2
80852,Closed fracture of four ribs,ethnic,Hispanic or Latino,1,1,2
134681,Spasm of oesophagus,ethnic,Not Hispanic or Latino,2,0,2
441846,After-cataract not obscuring vision,racial,White,2,0,2
381865,Sensorimotor disorder of eyelid,racial,Unknown,1,1,2
73872,Congenital deformity of knee joint,racial,White,1,1,2
4062801,Threatened abortion NOS,ethnic,Hispanic or Latino,2,0,2
134304,Benign tumour of parathyroid gland,ethnic,Not Hispanic or Latino,2,0,2
197924,Bile duct calculus with acute cholecystitis and obstruction,racial,White,1,1,2
435796,Dehydration,racial,Filipino,2,0,2
4230975,Acquired deformity of the abdomen,racial,Asian,2,0,2
197324,Disease of peritoneum,racial,White,1,1,2
373204,Conjunctival xerosis,racial,Unknown,1,1,2
439273,"Single manic episode, mild",ethnic,Not Hispanic or Latino,2,0,2
444435,Superficial injury of elbow without infection,ethnic,Hispanic or Latino,1,1,2
440964,Hodgkin's paragranuloma of extranodal AND/OR solid organ site,racial,White,0,2,2
378439,Fourth nerve palsy,racial,White,1,1,2
4133029,Primigravida,racial,Filipino,2,0,2
4030270,Proliferative polycythemia,racial,Asian,1,1,2
40480002,Aphasia as late effect of cerebrovascular disease,racial,Other Race,0,2,2
320682,Finding of white blood cell number,racial,Asian,0,2,2
4024013,Sensory nervous system finding,ethnic,Not Hispanic or Latino,1,1,2
372925,Cholesteatoma,racial,Unknown,0,2,2
138538,Longitudinal deficiency of limb,racial,White,2,0,2
433773,Chronic orbital inflammation,racial,White,0,2,2
195363,Congenital anomaly of kidney,racial,Asian,2,0,2
440785,Vomiting of pregnancy,racial,Unknown,2,0,2
435011,Vulvar vestibulitis,ethnic,Hispanic or Latino,2,0,2
373786,Abnormal vision,racial,Black or African American ,2,0,2
438170,Acute myocardial infarction of inferior wall,racial,Unknown,2,0,2
437902,Teeth development and eruption disorders,racial,Black or African American ,0,2,2
374639,Chronic headache disorder,ethnic,Not Hispanic or Latino,2,0,2
4108358,Transient cerebral ischaemia NOS,ethnic,Hispanic or Latino,2,0,2
444132,Knee injury,racial,American Indian or Alaska Native ,1,1,2
133794,Chronic gingivitis,racial,Black or African American ,1,1,2
73036,Closed fracture of olecranon process of ulna,ethnic,Not Hispanic or Latino,0,2,2
30978,Hereditary leptocytosis,racial,Black or African American ,2,0,2
141056,Acute ethmoidal sinusitis,racial,Asian,1,1,2
40480435,Spastic hemiplegia of nondominant side,racial,White,0,2,2
194913,Idiopathic peripheral autonomic neuropathy,racial,White,1,1,2
436089,"Nondependent cocaine abuse, episodic",racial,White,1,1,2
134074,Oral soft tissue cellulitis,racial,Asian,1,1,2
373769,Nuclear cataract,racial,White,1,1,2
4202322,Amputated big toe,racial,Other Race,0,2,2
140352,AML - Acute myeloid leukemia,ethnic,Hispanic or Latino,1,1,2
80241,Closed fracture navicular,ethnic,Not Hispanic or Latino,2,0,2
134780,Closed dislocation of metatarsal joint,ethnic,Hispanic or Latino,1,1,2
141004,Lesion of radial nerve,ethnic,Not Hispanic or Latino,2,0,2
137658,Congenital pigmentary anomaly of skin,ethnic,Not Hispanic or Latino,1,1,2
441793,Infection due to Class Cestoda and/or Class Trematoda and/or Phylum Nemata,ethnic,Not Hispanic or Latino,1,1,2
436826,Closed fracture of shaft of radius,racial,White,1,1,2
4204967,Laryngismus,racial,White,1,1,2
440710,IRMA - Intraretinal microvascular abnormality,racial,Unknown,1,1,2
138994,MDS - Myelodysplastic syndrome,ethnic,Not Hispanic or Latino,2,0,2
439702,Residual infantile autism,racial,Unknown,0,2,2
138604,"Contusion of face, scalp and neck, excluding eye(s)",racial,Native Hawaiian or Other Pacific Islander ,1,1,2
434170,Atypical squamous cells of undetermined significance on cervical Papanicolaou smear,racial,American Indian or Alaska Native ,2,0,2
137750,Second degree burn of forehead AND/OR cheek,racial,Black or African American ,0,2,2
81148,Open Monteggia's fracture,ethnic,Not Hispanic or Latino,2,0,2
379009,Retinopathy of prematurity stage 3 - ridge with extraretinal fibrovascular proliferation,ethnic,Hispanic or Latino,2,0,2
443789,Victim of trauma,ethnic,Hispanic or Latino,2,0,2
75911,Acquired hallux valgus,racial,Asian,2,0,2
312437,Dyspnea,racial,Native Hawaiian or Other Pacific Islander ,2,0,2
441835,Chronic schizoaffective schizophrenia,racial,Black or African American ,2,0,2
196442,Chronic gastric ulcer with hemorrhage AND with perforation but without obstruction,racial,Other Race,2,0,2
200450,Disease of urethra,racial,Other Race,1,1,2
40484952,Retinal function study abnormal,ethnic,Hispanic or Latino,1,1,2
198978,Acute gonorrhea of lower genitourinary tract,racial,Black or African American ,1,1,2
200391,Peripheral autonomic neuropathy disease EC,racial,American Indian or Alaska Native ,0,2,2
376691,Delimited old retinal detachment,racial,White,1,1,2
372328,Otitis media,racial,Asian Indian,1,1,2
138592,Open wound of lip with complication,racial,Unknown,1,1,2
374640,Exudative retinal detachment,ethnic,Hispanic or Latino,2,0,2
439081,Premenstrual tension syndrome,racial,Asian,2,0,2
433909,Foreign body on external eye,ethnic,Not Hispanic or Latino,1,1,2
77638,Displacement of intervertebral disc without myelopathy,racial,Black or African American ,2,0,2
436421,"Mixed conductive and sensorineural hearing loss, bilateral",racial,White,1,1,2
75103,Sprain of jaw,racial,Asian,2,0,2
138676,Gram negative septicemia,ethnic,Hispanic or Latino,1,1,2
4178898,Economic problem,ethnic,Hispanic or Latino,1,1,2
136368,Non-toxic multinodular goiter,racial,Other Race,0,2,2
196821,Observation of urethral discharge,racial,Unknown,0,2,2
4114451,"Localized, primary osteoarthritis of unspecified site",ethnic,Hispanic or Latino,2,0,2
438668,Accidents due to travel and motion,ethnic,Hispanic or Latino,1,1,2
441615,Trigonitis,ethnic,Hispanic or Latino,2,0,2
30284,Motion sickness,racial,Asian,1,1,2
433456,Acute pain,racial,Filipino,1,1,2
194682,Bilateral inguinal hernia with obstruction but no gangrene,racial,Unknown,0,2,2
194081,Acute cystitis,racial,Native Hawaiian or Other Pacific Islander ,2,0,2
4030270,Proliferative polycythemia,racial,Other Race,0,2,2
435120,Blister of toe with infection,ethnic,Not Hispanic or Latino,1,1,2
193519,Impaired renal function disorder,racial,Unknown,1,1,2
372605,Spinal muscular atrophy,ethnic,Hispanic or Latino,0,2,2
441334,Glossodynia,ethnic,Not Hispanic or Latino,0,2,2
434143,Anophthalmos,racial,White,1,1,2
4222896,Chronic duodenal ulcer without haemorrhage AND without perforation,racial,Unknown,2,0,2
192357,Paralytic ileus,ethnic,Not Hispanic or Latino,1,1,2
434547,Complication of surgical procedure,racial,Unknown,2,0,2
72459,Closed fracture of two ribs,racial,Unknown,2,0,2
201072,Benign prostatic hypertrophy without outflow obstruction,racial,Other Race,0,2,2
4061214,Ulceration of vulva NOS,racial,White,2,0,2
137627,Prickly heat,racial,Asian,1,1,2
134741,Congenital anomaly of limb,ethnic,Hispanic or Latino,1,1,2
433949,Human bite,ethnic,Hispanic or Latino,0,2,2
376411,Central pterygium,racial,White,1,1,2
438977,"Primary malignant neoplasm of ribs, sternum and clavicle",ethnic,Not Hispanic or Latino,2,0,2
78472,Microscopic haematuria,racial,Black or African American ,0,2,2
381732,Nerve injury,racial,Unknown,2,0,2
80232,Closed fracture of calcaneus,racial,Unknown,0,2,2
133810,Secondary hyperparathyroidism of renal origin,racial,Black or African American ,1,1,2
138682,Herpes zoster auricularis,racial,White,1,1,2
196436,Internal haemorrhoid,racial,American Indian or Alaska Native ,0,2,2
254980,Intrinsic asthma with asthma attack,racial,Other Race,1,1,2
73065,"Contusion, genital organs",racial,White,2,0,2
442752,Myalgia,racial,Native Hawaiian or Other Pacific Islander ,1,1,2
4204904,Education about sexually transmitted disease prevention,racial,Native Hawaiian or Other Pacific Islander ,2,0,2
432596,Immune defect,ethnic,Hispanic or Latino,0,2,2
133278,Disorder of hair,racial,Asian,2,0,2
374948,Acute nonsuppurative otitis media,racial,Black or African American ,1,1,2
4194160,Thyroid function tests abnormal,racial,American Indian or Alaska Native ,2,0,2
440063,"Benign neoplasm of pancreas, excluding islets of Langerhans",ethnic,Hispanic or Latino,0,2,2
4129482,Ovary observations,racial,White,2,0,2
4109880,Varicose veins of the leg with ulcer,racial,Filipino,2,0,2
435754,Ca ascending colon,ethnic,Hispanic or Latino,0,2,2
435150,Effects of heat AND/OR light,racial,Unknown,2,0,2
443580,Systolic heart failure,racial,Black or African American ,1,1,2
377290,Legal blindness USA,racial,Asian,1,1,2
380839,TS - Tuberous sclerosis,racial,Other Race,0,2,2
78497,Cellulitis and abscess of toe,racial,Black or African American ,1,1,2
434822,Complication of internal prosthetic device,racial,Unknown,1,1,2
432311,Angle-closure glaucoma - borderline,racial,Asian,0,2,2
195603,Vulval and/or perineal noninflammatory disorders,racial,Other Race,2,0,2
197913,Disorder of function of stomach,racial,Native Hawaiian or Other Pacific Islander ,1,1,2
440751,Peritonsillar abscess,racial,Asian,0,2,2
439655,Symptom: generalized,racial,Black or African American ,0,2,2
317305,Stricture of artery,ethnic,Not Hispanic or Latino,0,2,2
194151,Congenital anomaly of stomach,ethnic,Hispanic or Latino,0,2,2
200319,Herpetic infection of penis,racial,White,0,2,2
441929,Varicose veins of perineum and vulva in pregnancy and the puerperium with antenatal complication,ethnic,Hispanic or Latino,2,0,2
4194056,"Simple partial seizure, consciousness not impaired",racial,Unknown,0,2,2
438559,Abnormal vaginal Papanicolaou smear,racial,Unknown,2,0,2
313005,Congenital stenosis of pulmonary valve,ethnic,Not Hispanic or Latino,2,0,2
436299,Fall from one level to another,racial,Unknown,1,1,2
137065,Nonstageable pressure ulcer,racial,White,2,0,2
137652,Specific bursitis often of occupational origin,racial,White,0,2,2
373198,Unqualified visual loss of both eyes,racial,Black or African American ,1,1,2
380038,Viral conjunctivitis,racial,Asian,0,2,2
437699,Strain of infraspinatus muscle AND/OR tendon,racial,White,0,2,2
372324,Eustachian tube disorder,racial,American Indian,1,1,2
377560,Internal hordeolum,racial,Black or African American ,2,0,2
380944,Adenoviral pharyngoconjunctivitis,ethnic,Hispanic or Latino,1,1,2
25844,Ulcer of esophagus,ethnic,Not Hispanic or Latino,2,0,2
132740,Positive skin test reaction,racial,Filipino,1,1,2
140821,Spasm,racial,Native Hawaiian or Other Pacific Islander ,1,1,2
4098297,Unspecified latent schizophrenia,racial,White,2,0,2
137856,Atypical facial pain,racial,Unknown,1,1,2
436027,Coxsackie virus disease,ethnic,Not Hispanic or Latino,1,1,2
440612,Toxic effect of tobacco and nicotine,racial,Unknown,2,0,2
374371,Stenosis of precerebral artery,racial,Unknown,0,2,2
434750,Feeding difficulties and mismanagement,racial,Native Hawaiian or Other Pacific Islander ,1,1,2
4138253,Malabsorption syndrome,racial,Unknown,1,1,2
138455,Stomatitis,ethnic,Not Hispanic or Latino,1,1,2
372912,Visual discomfort,racial,Asian,0,2,2
197444,Vascular complication of medical care,racial,Unknown,2,0,2
444445,Benign neoplasm of skin of leg,racial,Other Race,1,1,2
74464,Idiopathic scoliosis AND/OR kyphoscoliosis,racial,Filipino,2,0,2
376405,Binocular vision disorder,ethnic,Hispanic or Latino,0,2,2
80242,Current tear of medial cartilage AND/OR meniscus of knee,racial,Other Race,1,1,2
318222,Acute adenitis,racial,Black or African American ,1,1,2
436375,Sodium and water depletion,ethnic,Not Hispanic or Latino,0,2,2
4333977,Acquired anophthalmos,racial,Black or African American ,0,2,2
441838,Personality disorder,racial,Black or African American ,2,0,2
134681,Spasm of oesophagus,ethnic,Hispanic or Latino,0,2,2
436700,Eye displaced forwards,racial,Other Race,2,0,2
136057,Benign neoplasm of skin of trunk,racial,Black or African American ,1,1,2
4230642,Acquired deformity of chest,racial,Filipino,2,0,2
435928,Abnormal decrease in weight,racial,Native Hawaiian or Other Pacific Islander ,1,1,2
436089,"Nondependent cocaine abuse, episodic",racial,Unknown,0,2,2
440464,Complication following molar AND/OR ectopic pregnancy,racial,Unknown,2,0,2
313780,Mobitz type 2 second degree atrioventricular block,racial,Unknown,1,1,2
193070,Blister of trunk with infection,ethnic,Not Hispanic or Latino,2,0,2
134312,Iatrogenic hypothyroidism,racial,Other Race,2,0,2
199855,Acute gastric ulcer with hemorrhage AND with perforation but without obstruction,ethnic,Hispanic or Latino,0,2,2
444438,Leucoplakia of tongue,racial,Other Race,0,2,2
137648,Osteomyelitis of hand,ethnic,Hispanic or Latino,1,1,2
438350,Pneumocystosis,racial,Black or African American ,0,2,2
4092562,Reduction deformity of arm,ethnic,Hispanic or Latino,2,0,2
315564,Aortic valve regurgitation,racial,Unknown,1,1,2
194696,Menorrhalgia,racial,Native Hawaiian or Other Pacific Islander ,2,0,2
139202,"Burn involving 20-29 percent of body surface, with 10-19 percent of body surface with full thickness burn",ethnic,Hispanic or Latino,2,0,2
379822,Cyst of eyelid,ethnic,Not Hispanic or Latino,0,2,2
134870,Pityriasis versicolor,racial,American Indian or Alaska Native ,2,0,2
4062637,TB - Tuberculosis screening,racial,Asian Indian,1,1,2
4192676,Born by caesarean section,ethnic,Hispanic or Latino,0,2,2
73153,Malignant neoplasm of lateral wall of urinary bladder,ethnic,Hispanic or Latino,0,2,2
380402,Central corneal ulcer,ethnic,Hispanic or Latino,2,0,2
440142,Disease of mediastinum,racial,White,2,0,2
194981,Bilateral femoral hernia without obstruction AND without gangrene,racial,White,0,2,2
372646,"Peripheral pterygium, stationary",ethnic,Not Hispanic or Latino,1,1,2
443776,Brachial radiculitis,racial,Other Race,1,1,2
4088930,Confirmation of pregnancy,racial,American Indian or Alaska Native ,2,0,2
73019,Breast engorgement in newborn,ethnic,Hispanic or Latino,0,2,2
192385,"Tumour of uterine body complicating antenatal care, baby not yet delivered",racial,White,2,0,2
437175,"Fall on same level from slipping, tripping or stumbling",racial,Other Race,2,0,2
4104016,Ts and As - Tonsillectomy and adenoidectomy,racial,White,1,1,2
374350,Granuloma of conjunctiva,racial,White,2,0,2
436091,BM - Bacterial meningitis,racial,White,2,0,2
139902,Allergic urticaria,racial,American Indian or Alaska Native ,1,1,2
80204,IUGR - Intrauterine growth retardation,racial,White,1,1,2
4323962,"Electrocardiogram, rhythm",ethnic,Hispanic or Latino,0,2,2
440787,"Drug dependence in mother complicating pregnancy, childbirth AND/OR puerperium",racial,Unknown,2,0,2
381866,Degenerative disorder of eyelid,ethnic,Hispanic or Latino,1,1,2
379012,Monoplegia of upper limb,racial,Black or African American ,2,0,2
4161978,Patient on oxygen,racial,Asian,1,1,2
132483,"Insect bite, nonvenomous, of hand, infected",ethnic,Hispanic or Latino,0,2,2
443750,Nonvenomous insect bite of finger without infection,ethnic,Hispanic or Latino,1,1,2
80946,Tinea manus,racial,Other Race,0,2,2
436136,Dissection of thoracic aorta,ethnic,Hispanic or Latino,0,2,2
4150157,Other anemias,racial,Unknown,0,2,2
75311,Fibrosclerosis of breast,ethnic,Hispanic or Latino,2,0,2
133444,Thyroiditis,racial,Asian,1,1,2
4332993,Childhood schizophrenia NOS,racial,Unknown,0,2,2
72786,Burn of finger,ethnic,Hispanic or Latino,1,1,2
197605,Inflammatory disorder of male genital organ,racial,Unknown,0,2,2
315922,Patent ductus arteriosus,racial,American Indian or Alaska Native ,0,2,2
437689,Multiple closed fractures of cervical vertebrae,racial,White,0,2,2
435951,"Closed fracture of tibia and fibula, shaft",racial,White,0,2,2
433742,Latent schizophrenia,ethnic,Hispanic or Latino,0,2,2
138384,Acquired hypothyroidism,racial,Other Race,2,0,2
436446,Cracked tooth syndrome,racial,Other Race,0,2,2
77373,Congenital deformity of hip joint,racial,Unknown,0,2,2
444258,Abrasion AND/OR friction burn of neck with infection,ethnic,Not Hispanic or Latino,1,1,2
434156,Congenital anemia,racial,White,0,2,2
319845,Pulmonary valve disease,racial,Other Race,1,1,2
4243973,Laparoscopic appendectomy,racial,Unknown,2,0,2
440977,Megaloblastic anemia due to folate deficiency,ethnic,Not Hispanic or Latino,1,1,2
73045,Hand sprain,racial,Asian,1,1,2
201674,Congenital anomaly of pancreas,ethnic,Hispanic or Latino,1,1,2
26378,Hyperpituitarism,racial,Asian,2,0,2
192683,Uterovaginal prolapse,ethnic,Not Hispanic or Latino,2,0,2
72986,Disease of lower leg,racial,Asian,0,2,2
436635,Primary malignant neoplasm of sigmoid colon,ethnic,Hispanic or Latino,0,2,2
4129665,Hearing aid care,ethnic,Hispanic or Latino,2,0,2
80294,Foreign body in genitourinary tract,ethnic,Hispanic or Latino,2,0,2
443767,Diabetic oculopathy,racial,American Indian,2,0,2
376124,Pinguecula,racial,Black or African American ,1,1,2
381854,Disorder of conjunctiva,racial,Other Race,2,0,2
315078,Palpitations,racial,Asian Indian,1,1,2
74138,Pathological fracture of vertebra,racial,Asian,2,0,2
4104157,Genital observation,racial,Unknown,0,2,2
198810,Vulval intraepithelial neoplasia grade 2,racial,White,2,0,2
439197,Nonvenomous insect bite of neck with infection,racial,White,1,1,2
441680,Fetus OR newborn affected by multiple pregnancy,ethnic,Hispanic or Latino,2,0,2
199066,Female digestive-genital tract fistula,ethnic,Not Hispanic or Latino,2,0,2
201613,Chronic nonalcoholic liver disease,racial,American Indian or Alaska Native ,2,0,2
4152813,Family disruption,racial,Asian,1,1,2
375258,Photokeratitis,ethnic,Hispanic or Latino,1,1,2
256810,Choanal atresia,ethnic,Hispanic or Latino,0,2,2
314369,Malignant hypertensive heart disease without congestive heart failure,ethnic,Not Hispanic or Latino,1,1,2
440856,Open fracture of shaft of femur,ethnic,Hispanic or Latino,0,2,2
437920,Spontaneous abortion complicated by genital-pelvic infection,ethnic,Hispanic or Latino,2,0,2
199079,Hypertrophy of clitoris,racial,White,2,0,2
435799,Adjustment disorder with disturbance of conduct,racial,White,0,2,2
80497,Disorder of cervical spine,racial,Black or African American ,1,1,2
74127,Elbow joint contracture,racial,Unknown,0,2,2
443864,Multi-infarct dementia with depression,ethnic,Not Hispanic or Latino,2,0,2
435940,"Closed fracture of humerus, shaft",ethnic,Not Hispanic or Latino,0,2,2
194878,Nodular lymphoma of extranodal AND/OR solid organ site,racial,White,1,1,2
381865,Sensorimotor disorder of eyelid,racial,White,1,1,2
26638,Primary malignant neoplasm of oesophagus,racial,Unknown,2,0,2
140641,Verruca vulgaris,racial,American Indian,1,1,2
78831,Disease of ankle,racial,Asian,2,0,2
74635,Lumbosacral root lesion,racial,Asian,1,1,2
258458,Bacterial pleurisy with effusion,ethnic,Hispanic or Latino,2,0,2
439790,Psychalgia,ethnic,Hispanic or Latino,1,1,2
4179963,Family history of malignant neoplasm of breast,racial,Other Race,2,0,2
438306,Poisoning by psychodysleptic,ethnic,Hispanic or Latino,0,2,2
319041,Orthostatic hypotension,racial,American Indian or Alaska Native ,0,2,2
73231,Arthralgia of temporomandibular joint,racial,Asian,2,0,2
441947,Posttraumatic state,ethnic,Hispanic or Latino,2,0,2
321109,Congenital anomaly of coronary artery,racial,White,0,2,2
372425,Congenital abnormality of ear,racial,Black or African American ,2,0,2
140214,Eruption of skin,racial,Asian Indian,1,1,2
138667,Stoma observations,racial,White,0,2,2
434904,Persistent hypersomnia,racial,Unknown,2,0,2
132491,Contusion of scapular region,racial,White,2,0,2
434630,Sleep rhythm problem,ethnic,Hispanic or Latino,0,2,2
374498,Concussion with prolonged loss of consciousness AND return to pre-existing conscious level,ethnic,Hispanic or Latino,2,0,2
4100515,Cocaine type drug dependence,racial,White,0,2,2
433454,Adjustment disorder with mixed emotional features,racial,Other Race,2,0,2
321661,Spinal stenosis of thoracic region,racial,White,1,1,2
375393,Laceration of skin of eyelid AND periocular area,racial,White,1,1,2
80819,Acquired hallux varus,ethnic,Hispanic or Latino,2,0,2
372599,Severe mixed bipolar I disorder without psychotic features,ethnic,Not Hispanic or Latino,2,0,2
132449,Transient limb paralysis,racial,White,1,1,2
138616,Superficial burn of hand,racial,Unknown,1,1,2
433633,Late effect of superficial injury,racial,Unknown,2,0,2
437614,Early onset of delivery,ethnic,Not Hispanic or Latino,2,0,2
40490434,Abnormal arterial blood gas,racial,Unknown,1,1,2
73574,Nonunion of fracture,racial,White,2,0,2
378679,Acute poliomyelitis,racial,Other Race,0,2,2
433992,"Bipolar affective disorder, currently manic, moderate",racial,Unknown,2,0,2
198964,Chronic type C viral hepatitis,racial,Native Hawaiian or Other Pacific Islander ,0,2,2
24134,Nonspecific pain in the neck region,racial,Native Hawaiian or Other Pacific Islander ,0,2,2
260759,Malocclusion of teeth,racial,White,1,1,2
437892,Lown-Ganong-Levine syndrome,ethnic,Hispanic or Latino,2,0,2
22281,Sickle cell disease,racial,White,1,1,2
439080,Dyspareunia,racial,Black or African American ,2,0,2
432588,Megaloblastic anemia due to vitamin B>12< deficiency,racial,American Indian or Alaska Native ,2,0,2
201927,Cellulitis and abscess of leg,racial,Black or African American ,2,0,2
378425,Eyelid inflammation,racial,Black or African American ,1,1,2
438648,Vitamin poisoning,ethnic,Hispanic or Latino,2,0,2
80573,Contusion of ankle,racial,Other Race,1,1,2
315286,Chronic ischemic heart disease,racial,Filipino,0,2,2
4084229,Primary gout,racial,Native Hawaiian or Other Pacific Islander ,0,2,2
442167,Neoplasm of uncertain behaviour of craniopharyngeal duct,ethnic,Not Hispanic or Latino,2,0,2
433400,Emergency contraception,racial,Other Race,2,0,2
261116,Acquired nasal deformity,ethnic,Not Hispanic or Latino,1,1,2
4120610,Carrier of hereditary factor VIII deficiency disease,ethnic,Hispanic or Latino,0,2,2
4051114,FH: Diabetes mellitus,racial,American Indian or Alaska Native ,1,1,2
381664,Algoneurodystrophy,racial,White,2,0,2
441628,Menopausal and postmenopausal disorders,racial,Asian,2,0,2
314658,Cardiomegaly,racial,American Indian,0,2,2
199891,RI - Rhesus isoimmunisation,ethnic,Hispanic or Latino,2,0,2
433410,Primary syphilis,ethnic,Hispanic or Latino,0,2,2
201621,Chronic cystitis,racial,Asian,1,1,2
4171434,Immunization refused,racial,Black or African American ,1,1,2
4281232,Type B viral hepatitis,racial,Asian,0,2,2
434063,Jaw to cranial base anomaly,racial,Asian,0,2,2
442589,Superficial foreign body of wrist without major open wound AND without infection,racial,White,0,2,2
320536,Abnormal EKG finding,racial,American Indian,1,1,2
200445,Chronic prostatitis,racial,Black or African American ,0,2,2
136834,Closed intertrochanteric fracture,ethnic,Not Hispanic or Latino,2,0,2
4059173,Fracture of ankle,racial,White,1,1,2
4103915,Optic neuritis NOS,racial,Unknown,2,0,2
378001,Concussion with no loss of consciousness,racial,White,2,0,2
375827,Acute non-suppurative otitis media - serous,racial,American Indian or Alaska Native ,2,0,2
374342,Headache associated with sexual activity,ethnic,Hispanic or Latino,2,0,2
318247,Apnea in the newborn,ethnic,Not Hispanic or Latino,1,1,2
4269584,Finding relating to religious movement or belief,racial,Unknown,2,0,2
443360,Eye mass,ethnic,Not Hispanic or Latino,2,0,2
4319150,Pulled elbow,ethnic,Not Hispanic or Latino,2,0,2
321319,Cardiomyopathy,racial,Filipino,0,2,2
436682,Moderate mental handicap,racial,Black or African American ,2,0,2
436080,"Neoplasm of uncertain behaviour of lip, oral cavity and pharynx",racial,White,1,1,2
437342,Abnormality of forces of labor,racial,Unknown,2,0,2
4084229,Primary gout,racial,Black or African American ,1,1,2
192687,Vulvovaginitis associated with another disease,ethnic,Not Hispanic or Latino,2,0,2
443865,Non-infective colitis,racial,Native Hawaiian or Other Pacific Islander ,1,1,2
313500,Acute rheumatic heart disease,ethnic,Hispanic or Latino,1,1,2
75356,Congenital deformity of sternocleidomastoid muscle,ethnic,Hispanic or Latino,1,1,2
434953,Orbital granuloma,ethnic,Hispanic or Latino,1,1,2
377678,EEG abnormality,ethnic,Hispanic or Latino,1,1,2
440063,"Benign neoplasm of pancreas, excluding islets of Langerhans",racial,White,0,2,2
381854,Disorder of conjunctiva,ethnic,Not Hispanic or Latino,1,1,2
436077,Developmental delay,racial,Filipino,1,1,2
196751,Haemorrhage from placenta previa,racial,White,2,0,2
435553,Watery eye,racial,Other Race,2,0,2
4147494,Nonspecific mesenteric adenitis,ethnic,Hispanic or Latino,1,1,2
434610,Hyperkalemia,racial,Asian Indian,0,2,2
81721,Open wound of hand except fingers with tendon involvement,ethnic,Hispanic or Latino,1,1,2
440250,Subarachnoid hemorrhage following injury without open intracranial wound AND with concussion,racial,White,1,1,2
253321,Stridor,racial,Black or African American ,2,0,2
254387,Upper respiratory tract hypersensitivity reaction,racial,Native Hawaiian or Other Pacific Islander ,0,2,2
436446,Cracked tooth syndrome,ethnic,Not Hispanic or Latino,1,1,2
4311591,Cramp in limb,racial,Black or African American ,1,1,2
192376,Rhesus isoimmunization with antenatal problem,racial,Unknown,2,0,2
440547,Closed fracture of shaft of metacarpal bone,ethnic,Not Hispanic or Latino,2,0,2
4268980,Finding of general development,racial,Unknown,2,0,2
444413,Pyrexial convulsion,racial,Asian,1,1,2
444413,Pyrexial convulsion,racial,Filipino,0,2,2
4047937,Neonatal urinary tract infection,ethnic,Not Hispanic or Latino,1,1,2
192385,"Tumour of uterine body complicating antenatal care, baby not yet delivered",ethnic,Not Hispanic or Latino,2,0,2
375256,Anterior subcapsular polar senile cataract,racial,Unknown,0,2,2
380097,Diabetic macular edema,racial,Black or African American ,1,1,2
4326838,Decubitus ulcer of upper back,ethnic,Not Hispanic or Latino,0,2,2
376552,Cerebral laceration and contusion,ethnic,Hispanic or Latino,2,0,2
137991,Sick-euthyroid syndrome,ethnic,Hispanic or Latino,1,1,2
138825,Actinic keratosis,racial,Filipino,0,2,2
4103679,Percutaneous transluminal angioscopy,racial,White,0,2,2
436350,Schistosoma hematobium infection,racial,White,2,0,2
432461,"Closed fracture clavicle, shaft",racial,Unknown,0,2,2
4060813,Cystitis NOS,ethnic,Hispanic or Latino,1,1,2
79165,Closed Monteggia fracture,ethnic,Hispanic or Latino,1,1,2
197506,Malignant tumor of abdomen,ethnic,Hispanic or Latino,1,1,2
196324,Food poisoning due to Clostridium perfringens,ethnic,Not Hispanic or Latino,0,2,2
4239975,Myocardial disease,racial,Unknown,0,2,2
440081,Barbiturate dependence,racial,Black or African American ,2,0,2
433257,Mesangiocapillary glomerulonephritis,ethnic,Not Hispanic or Latino,0,2,2
437878,Persistent mydriasis,racial,White,1,1,2
377545,Episodic tension-type headache,ethnic,Hispanic or Latino,2,0,2
4005823,Tobacco user,racial,Native Hawaiian or Other Pacific Islander ,0,2,2
4318111,Traumatic amputation of leg,racial,Unknown,0,2,2
141004,Lesion of radial nerve,racial,Asian,2,0,2
253790,Pneumonia due to Klebsiella pneumoniae,ethnic,Hispanic or Latino,0,2,2
436799,Talipes cavus,ethnic,Hispanic or Latino,1,1,2
133414,Candidiasis of skin and nails,racial,American Indian or Alaska Native ,2,0,2
137213,Fungal dermatosis,racial,Other Race,1,1,2
81426,Closed fracture of clavicle,racial,Black or African American ,1,1,2
24660,Acute tonsillitis,racial,Native Hawaiian or Other Pacific Islander ,1,1,2
198374,Nodular lymphoma of spleen,ethnic,Hispanic or Latino,0,2,2
376120,"Keratoconjunctivitis sicca, not specified as Sjogren's",racial,American Indian or Alaska Native ,2,0,2
438066,Chlamydial infection,racial,Asian,2,0,2
313007,MR - Congenital mitral regurgitation,racial,White,0,2,2
4230975,Acquired deformity of the abdomen,ethnic,Not Hispanic or Latino,2,0,2
376525,Audiogram abnormal,racial,Black or African American ,1,1,2
435119,Sequela of injury,racial,White,1,1,2
4080568,Problem behaviour,racial,Black or African American ,1,1,2
439273,"Single manic episode, mild",racial,Asian,2,0,2
80187,Medial epicondylitis,racial,Asian,2,0,2
23865,Congenital abnormality of pharynx,ethnic,Hispanic or Latino,2,0,2
439137,Neonatal jaundice due to delayed conjugation,ethnic,Hispanic or Latino,0,2,2
443239,Precerebral arterial occlusion,racial,Unknown,2,0,2
435443,[X]Fall involving wheelchair,racial,Black or African American ,2,0,2
74728,Synovitis and tenosynovitis,racial,Asian,1,1,2
141816,Acute lymphoid leukaemia in remission,racial,Unknown,2,0,2
378416,Retinal disorder,racial,Asian,1,1,2
380103,Retinal detachment with retinal defect,racial,Unknown,2,0,2
257775,Post-tuberculous bronchiectasis,ethnic,Not Hispanic or Latino,0,2,2
4168213,Chest pain on breathing,racial,Native Hawaiian or Other Pacific Islander ,0,2,2
197484,Diarrhea of presumed infectious origin,racial,Asian,0,2,2
137054,Skin striae,ethnic,Not Hispanic or Latino,0,2,2
40480943,Lateral cystocele,racial,Unknown,2,0,2
138346,Erysipelas,racial,White,1,1,2
74189,Sprain of cruciate ligament of knee,racial,Other Race,0,2,2
318556,Nosebleed,racial,Native Hawaiian or Other Pacific Islander ,1,1,2
4124693,Hypertrophic cardiomyopathy,racial,Asian,0,2,2
439666,Contracture of multiple joints,racial,Filipino,2,0,2
201519,Ca liver - primary,ethnic,Not Hispanic or Latino,1,1,2
133384,Burn any degree involving less than 10 percent of body surface,racial,White,1,1,2
4201274,Anastomosis of small intestine to rectal stump,ethnic,Hispanic or Latino,2,0,2
4181328,CA - Cancer of adrenal gland,racial,Unknown,0,2,2
375826,Central hearing loss,racial,Asian,1,1,2
4144118,Gastrointestinal haemorrhage unspecified,ethnic,Hispanic or Latino,1,1,2
4057348,"Contusion, knee and lower leg NOS",racial,White,0,2,2
440829,Fetus and newborn affected by noxious influences transmitted via placenta or breast milk,racial,White,2,0,2
381301,Chronic serous otitis media,racial,Black or African American ,2,0,2
4124794,FH: - kidney disorder,racial,White,0,2,2
443747,Acute laryngotracheitis without obstruction,ethnic,Not Hispanic or Latino,0,2,2
25518,AS - Sickle cell trait,racial,Unknown,1,1,2
432966,Hypertrophy of vulva,racial,Unknown,2,0,2
195312,Functional voiding disorder,racial,Black or African American ,2,0,2
374362,Keratoconus,ethnic,Hispanic or Latino,1,1,2
438750,Old total retinal detachment,racial,Unknown,1,1,2
4333977,Acquired anophthalmos,racial,White,1,1,2
444202,Abscess,racial,Native Hawaiian or Other Pacific Islander ,0,2,2
195862,Urethritis,racial,Black or African American ,0,2,2
438208,Atrophy of vulva,racial,Unknown,2,0,2
432452,Anemia of prematurity,ethnic,Not Hispanic or Latino,1,1,2
142016,Nonvenomous insect bite of finger with infection,ethnic,Hispanic or Latino,2,0,2
380415,Acute swimmer's ear,racial,Other Race,1,1,2
195906,Disorder of lumbar spine,racial,Other Race,2,0,2
441262,"Amfetamine or psychostimulant dependence, episodic",racial,White,2,0,2
197911,Hernia of anterior abdominal wall without obstruction AND without gangrene,racial,American Indian or Alaska Native ,2,0,2
72501,Superficial foreign body of foot without major open wound AND without infection,racial,Unknown,2,0,2
140526,Congenital anomaly of endocrine gland,racial,Unknown,2,0,2
80578,Superficial injury of finger with infection,racial,White,1,1,2
75091,Closed fracture of carpal bone,racial,Other Race,0,2,2
197050,Abnormality of organs AND/OR soft tissues of pelvis affecting pregnancy,ethnic,Hispanic or Latino,2,0,2
435521,Psychophysiologic disorder,racial,Unknown,1,1,2
437496,Acute peripheral vestibulopathy,racial,Unknown,2,0,2
77600,Encysted hydrocele,ethnic,Hispanic or Latino,0,2,2
197223,Enterobiasis,racial,Black or African American ,0,2,2
442290,Varicose veins of legs complicating pregnancy AND/OR puerperium,racial,White,2,0,2
374350,Granuloma of conjunctiva,ethnic,Hispanic or Latino,2,0,2
434920,Hypochondriasis,ethnic,Hispanic or Latino,2,0,2
438304,Rat bite,racial,Unknown,0,2,2
4218420,Postinflammatory perforation of ear drum,ethnic,Not Hispanic or Latino,2,0,2
440005,Complication of medical care,ethnic,Not Hispanic or Latino,1,1,2
437969,Acquired pes planus,racial,American Indian,0,2,2
436386,Severe depressed bipolar I disorder with psychotic features,racial,Unknown,0,2,2
381574,External auditory canal exostosis,ethnic,Hispanic or Latino,1,1,2
315273,MS - Mitral stenosis,ethnic,Not Hispanic or Latino,2,0,2
4326838,Decubitus ulcer of upper back,racial,Unknown,2,0,2
441969,Radiology result abnormal,racial,Other Race,0,2,2
4113782,Cerebral artery occlusion NOS,ethnic,Hispanic or Latino,2,0,2
139099,Ingrowing nail,racial,Native Hawaiian or Other Pacific Islander ,1,1,2
201894,Acute intestinal vascular insufficiency,racial,Black or African American ,1,1,2
443446,Reflex sympathetic dystrophy of lower extremity,ethnic,Not Hispanic or Latino,1,1,2
4124693,Hypertrophic cardiomyopathy,ethnic,Not Hispanic or Latino,0,2,2
197043,Cervical observation during pregnancy and labor,racial,White,2,0,2
432512,Foreign object left in body during procedure,racial,Black or African American ,2,0,2
22274,Neoplasm of uncertain behaviour of larynx,racial,White,0,2,2
4242221,Rumination disorder,racial,White,0,2,2
193983,Disorder of pancreatic internal secretion,racial,Unknown,2,0,2
443458,Closed fracture of facial bone,racial,White,2,0,2
433595,Interstitial edema,racial,American Indian,2,0,2
434494,Closed fracture of the proximal humerus,racial,Alaska Native,0,2,2
132344,Gingival and periodontal disease,racial,Other Race,2,0,2
439053,Exostosis of jaw,ethnic,Hispanic or Latino,1,1,2
438106,"Reticulosarcoma of lymph nodes of head, face and neck",racial,White,1,1,2
141124,Congenital cardiovascular disorder,racial,White,0,2,2
4067537,Other disc disorders of unspecified site,ethnic,Hispanic or Latino,0,2,2
314963,Giant cell arteritis,racial,Unknown,0,2,2
4065991,Cellulitis and abscess of finger and toe,ethnic,Hispanic or Latino,2,0,2
316126,Crystalline deposits in vitreous,ethnic,Hispanic or Latino,1,1,2
372912,Visual discomfort,racial,Filipino,2,0,2
78097,Metastatic tumour of bone,racial,Other Race,2,0,2
75354,Osteochondropathy,racial,Black or African American ,2,0,2
4171434,Immunization refused,racial,Asian Indian,1,1,2
252658,Intrinsic asthma without status asthmaticus,racial,Asian,2,0,2
137441,"Insect bite, nonvenomous, of foot and toe, infected",ethnic,Hispanic or Latino,2,0,2
76790,Familial ligamentous laxity,racial,Unknown,1,1,2
23653,Foreign body in esophagus,racial,White,0,2,2
4062555,"Unspecified hypertension complicating pregnancy, childbirth and the puerperium NOS",ethnic,Not Hispanic or Latino,1,1,2
441276,Nondependent alcohol abuse in remission,racial,Native Hawaiian or Other Pacific Islander ,0,2,2
4059173,Fracture of ankle,ethnic,Hispanic or Latino,1,1,2
4109260,Other eyelid disorders,racial,Unknown,1,1,2
436855,Second degree burn of back of hand,ethnic,Hispanic or Latino,1,1,2
78015,Open wound of chest wall without complication,ethnic,Hispanic or Latino,1,1,2
437374,Neonatal aspiration of meconium,racial,White,2,0,2
138501,Cholinergic urticaria,racial,White,1,1,2
135033,Hair and hair follicle diseases,racial,Filipino,1,1,2
134305,Acute lymphoid leukaemia,racial,Other Race,0,2,2
441974,Closed fracture of forearm,racial,Black or African American ,0,2,2
198187,"Acute peptic ulcer without hemorrhage, without perforation AND without obstruction",ethnic,Not Hispanic or Latino,1,1,2
4108389,Generalized tuberculosis,racial,White,0,2,2
75614,Acrodermatitis continua,racial,American Indian,0,2,2
137520,Chronic thyroiditis,racial,Other Race,2,0,2
140582,Superficial burn of foot,ethnic,Hispanic or Latino,1,1,2
4233827,Biopsy of lymphatic structure,racial,White,1,1,2
193262,Inflammatory disorder of penis,racial,Unknown,0,2,2
376713,Cerebral hemorrhage,racial,Asian,2,0,2
199079,Hypertrophy of clitoris,ethnic,Hispanic or Latino,2,0,2
258458,Bacterial pleurisy with effusion,racial,White,2,0,2
200171,Carbuncle of skin AND/OR subcutaneous tissue,racial,Black or African American ,0,2,2
439940,Closed fracture of upper end of forearm,racial,White,1,1,2
320115,Mitral incompetence and aortic stenosis,ethnic,Hispanic or Latino,1,1,2
432284,Single major depressive episode,racial,American Indian or Alaska Native ,1,1,2
78233,Old disruption of medial collateral ligament,ethnic,Hispanic or Latino,1,1,2
433905,Open wound of vulva without complication,ethnic,Hispanic or Latino,2,0,2
77638,Displacement of intervertebral disc without myelopathy,racial,Asian,2,0,2
438749,Posterior subcapsular polar senile cataract,racial,White,0,2,2
442068,Cellulitis and abscess of forearm,racial,Asian,0,2,2
432598,Subchronic schizophrenia with acute exacerbations,racial,White,2,0,2
4326838,Decubitus ulcer of upper back,racial,White,0,2,2
253235,Pneumonia in pertussis,racial,Unknown,2,0,2
436245,Atypical glandular cells on vaginal Papanicolaou smear,racial,American Indian,2,0,2
436108,Acute closed-angle glaucoma,racial,Unknown,1,1,2
321882,Generalised atherosclerosis,racial,Asian,1,1,2
201338,Urethral fistula,racial,White,0,2,2
133848,Non-traumatic slipped upper femoral epiphysis,racial,Black or African American ,0,2,2
4140207,Nephrosclerosis,racial,Unknown,2,0,2
201355,Erosion and ectropion of the cervix,racial,Unknown,2,0,2
439796,"Nondependent cocaine abuse, continuous",racial,Unknown,2,0,2
440787,"Drug dependence in mother complicating pregnancy, childbirth AND/OR puerperium",racial,Black or African American ,2,0,2
313980,"Hodgkin disease, lymphocytic depletion of lymph nodes of multiple sites",ethnic,Hispanic or Latino,2,0,2
432730,Dysphonia,racial,Black or African American ,1,1,2
76548,Closed dislocation of hip,ethnic,Not Hispanic or Latino,1,1,2
377546,Chronic post-traumatic headache,ethnic,Not Hispanic or Latino,1,1,2
192858,Ovarian hyperfunction,ethnic,Hispanic or Latino,2,0,2
372613,Flaccid hemiplegia,ethnic,Not Hispanic or Latino,0,2,2
432738,Iceland disease,racial,Filipino,0,2,2
442139,Primary bronchial cancer,racial,Asian,1,1,2
317305,Stricture of artery,racial,White,0,2,2
438350,Pneumocystosis,racial,Unknown,0,2,2
257008,Abscess of parapharyngeal space,ethnic,Hispanic or Latino,1,1,2
134619,Toxic nodular goiter,racial,White,2,0,2
381308,Abscess of eyelid,racial,Other Race,1,1,2
75346,Disorder of meniscus of knee,racial,Asian,0,2,2
433837,Obstetric nipple infection with postnatal complication,racial,Unknown,2,0,2
4100091,Child attention deficit disorder NOS,ethnic,Not Hispanic or Latino,1,1,2
133384,Burn any degree involving less than 10 percent of body surface,racial,Unknown,1,1,2
379020,Entropion,racial,Unknown,2,0,2
4195231,Acute gastric ulcer without hemorrhage AND without perforation,ethnic,Hispanic or Latino,1,1,2
313224,Anomalous atrioventricular excitation,racial,Black or African American ,1,1,2
4024361,Paralysis of glottis,racial,Unknown,2,0,2
440878,Open wound of jaw without complication,racial,White,1,1,2
22856,Polyglandular dysfunction,racial,White,2,0,2
80815,Mucous cyst of skin,racial,Black or African American ,1,1,2
4108358,Transient cerebral ischaemia NOS,racial,White,2,0,2
374648,Monocular intermittent esotropia,ethnic,Hispanic or Latino,2,0,2
141411,Scalp injury,ethnic,Not Hispanic or Latino,0,2,2
74187,Sprain of coracohumeral ligament,racial,Other Race,0,2,2
440250,Subarachnoid hemorrhage following injury without open intracranial wound AND with concussion,ethnic,Hispanic or Latino,1,1,2
377560,Internal hordeolum,racial,Asian,1,1,2
75128,Injury of chest wall,racial,Other Race,1,1,2
437892,Lown-Ganong-Levine syndrome,racial,White,2,0,2
375557,Cerebral embolism,ethnic,Not Hispanic or Latino,1,1,2
197810,Malignant neoplasm of uterine adnexa,ethnic,Hispanic or Latino,2,0,2
436812,Tongue tie,racial,Black or African American ,0,2,2
76611,Injury of shoulder region,racial,Asian,2,0,2
200775,Endometrial hyperplasia,ethnic,Not Hispanic or Latino,2,0,2
193525,Abdominal pregnancy,racial,Other Race,2,0,2
443708,Cervical Papanicolaou smear positive for malignant neoplasm,racial,White,2,0,2
75004,Frank hematuria,racial,Other Race,0,2,2
258180,Pneumonia due to Gram negative bacteria,ethnic,Hispanic or Latino,2,0,2
443862,Complication of internal anastomosis,racial,Unknown,2,0,2
77068,Secondary localised osteoarthrosis of lower leg,racial,Other Race,0,2,2
197810,Malignant neoplasm of uterine adnexa,racial,Unknown,2,0,2
437937,Grand multiparity unspecified,ethnic,Hispanic or Latino,2,0,2
376106,Disorder of the central nervous system,ethnic,Not Hispanic or Latino,1,1,2
199063,"Hernia, with obstruction",ethnic,Hispanic or Latino,2,0,2
441946,Calcific tendinitis of shoulder,racial,Asian,2,0,2
433675,Toxic effect of chemical,ethnic,Not Hispanic or Latino,1,1,2
140570,Open wound of back without complication,ethnic,Hispanic or Latino,1,1,2
437966,Calcium deposits in tendon,racial,Asian,2,0,2
437501,Primary malignant neoplasm of labia majora,racial,Unknown,2,0,2
139955,Open wound of palate without complication,racial,White,2,0,2
436067,Schizophrenia simplex,racial,Alaska Native,2,0,2
200671,Benign tumour of renal pelvis,ethnic,Not Hispanic or Latino,1,1,2
439147,Amnesia,racial,American Indian or Alaska Native ,1,1,2
440228,Closed fracture of lower end of humerus,racial,Other Race,2,0,2
444082,False labor without delivery,ethnic,Hispanic or Latino,2,0,2
4179332,Parent-child problem,racial,Unknown,2,0,2
440788,Hyperemesis gravidarum with metabolic disturbance - not delivered,ethnic,Not Hispanic or Latino,2,0,2
73904,Open wound of buttock without complication,racial,White,1,1,2
372315,Anterior subcapsular polar cataract,racial,White,1,1,2
133637,Second degree burn of lower limb,racial,Unknown,2,0,2
195851,"Gastric ulcer without hemorrhage, without perforation AND without obstruction",racial,Black or African American ,2,0,2
194100,Obstructed labour due to foetal malposition,ethnic,Not Hispanic or Latino,0,2,2
374907,Tics of organic origin,racial,Unknown,1,1,2
439166,Closed fracture of radius,racial,Other Race,2,0,2
4331899,Child in family care,racial,Black or African American ,1,1,2
372828,Zoster ophthalmicus,racial,Unknown,1,1,2
443519,Retinopathy of prematurity stage 4 - subtotal retinal detachment,ethnic,Hispanic or Latino,2,0,2
135615,Pityriasis,racial,Other Race,1,1,2
314754,Wheezing,racial,Native Hawaiian or Other Pacific Islander ,1,1,2
201337,Disorder of bladder and bladder neck,racial,Asian,1,1,2
4240902,Allergy to peanuts,racial,Asian,0,2,2
4064362,Mycotic infection screening,ethnic,Not Hispanic or Latino,0,2,2
4149299,Follow-up orthopaedic assessment,ethnic,Hispanic or Latino,2,0,2
261738,Multiple burns of head and neck,racial,White,0,2,2
432582,Neoplastic disease of uncertain behavior,racial,Other Race,0,2,2
199151,Must strain to pass urine,ethnic,Hispanic or Latino,1,1,2
433069,Open wound of external genital organs with complication,racial,Filipino,2,0,2
4291005,VH - Viral hepatitis,racial,White,1,1,2
436882,[X]Fall involving bed,ethnic,Not Hispanic or Latino,1,1,2
441834,"Bipolar affective disorder, currently manic, mild",ethnic,Not Hispanic or Latino,1,1,2
439981,Wound dehiscence,racial,Unknown,2,0,2
73017,Congenital anomaly of toe,racial,White,2,0,2
81403,Osteopetrosis,ethnic,Not Hispanic or Latino,2,0,2
258375,Malignant neoplasm of overlapping lesion of bronchus and lung,ethnic,Hispanic or Latino,0,2,2
314423,"Benign essential hypertension complicating pregnancy, childbirth and the puerperium - not delivered",racial,Unknown,2,0,2
75924,Osteodystrophy,ethnic,Not Hispanic or Latino,1,1,2
440374,Obsessive compulsive disorder,racial,Other Race,1,1,2
440161,Indication for care AND/OR intervention in labor AND/OR delivery,ethnic,Hispanic or Latino,2,0,2
433813,Bladder neck obstruction,racial,Unknown,2,0,2
135287,Non-neoplastic naevus,racial,Black or African American ,1,1,2
4145479,Other specified candidiasis NOS,ethnic,Hispanic or Latino,2,0,2
4263325,Actinic cheilitis,racial,Black or African American ,2,0,2
193493,Benign hypertensive renal disease,racial,Unknown,2,0,2
134312,Iatrogenic hypothyroidism,racial,White,1,1,2
78162,Peripheral vertigo,ethnic,Not Hispanic or Latino,1,1,2
372318,Chronic follicular conjunctivitis,ethnic,Hispanic or Latino,1,1,2
140821,Spasm,racial,American Indian,1,1,2
75337,Cellulitis and abscess of buttock,racial,Other Race,1,1,2
377870,Heterotropia,racial,Other Race,2,0,2
381859,Infective OE,racial,American Indian,2,0,2
320347,Nodular lymphoma of lymph nodes of multiple sites,racial,White,0,2,2
442270,Disease of duodenum,racial,Black or African American ,0,2,2
137077,Chronic osteomyelitis of the ankle and/or foot,racial,Unknown,0,2,2
200783,Previous cesarean section,racial,Unknown,2,0,2
80819,Acquired hallux varus,racial,White,2,0,2
320739,Dissecting aortic aneurysm,ethnic,Hispanic or Latino,1,1,2
28457,Hypertrophy of tonsils,racial,Native Hawaiian or Other Pacific Islander ,1,1,2
199877,Mucous polyp of cervix,racial,Native Hawaiian or Other Pacific Islander ,2,0,2
133510,Rapidly progressive periodontitis,racial,Asian,1,1,2
77403,Closed fracture of vertebral column without spinal cord injury,racial,Other Race,2,0,2
444071,Furuncle of forearm,racial,American Indian,2,0,2
196217,Congenital malformation of diaphragm,racial,Asian,0,2,2
4103915,Optic neuritis NOS,ethnic,Not Hispanic or Latino,2,0,2
433856,Fracture of neck of femur,ethnic,Hispanic or Latino,0,2,2
194964,Aneurysm of splenic artery,racial,Asian,0,2,2
438532,Swan-neck deformity of finger,ethnic,Hispanic or Latino,1,1,2
139841,Chronic frontal sinusitis,racial,Asian,2,0,2
77139,Open wound of finger without complication,racial,Black or African American ,1,1,2
441641,FTND - Full term normal delivery,ethnic,Not Hispanic or Latino,1,1,2
4122116,Tooth eruption disturbances,racial,White,1,1,2
441261,Episodic acute alcoholic intoxication in alcoholism,racial,Unknown,0,2,2
4200655,Urostomy present,racial,White,1,1,2
4140233,"X-ray of ribs, sternum and clavicle",ethnic,Hispanic or Latino,1,1,2
74396,TMJ - Temporomandibular joint disorder,racial,Other Race,1,1,2
444429,Herpes simplex infection,ethnic,Not Hispanic or Latino,2,0,2
444121,"Primary dental caries, proximal smooth surface origin",ethnic,Hispanic or Latino,2,0,2
440925,Suicide,racial,White,1,1,2
4087442,Acute poliomyelitis NOS,ethnic,Hispanic or Latino,1,1,2
440385,Obstructive hydrocephalus,racial,Native Hawaiian or Other Pacific Islander ,1,1,2
4104561,Ptosis of eyelid NOS,ethnic,Not Hispanic or Latino,1,1,2
440329,Herpes zoster without complication,racial,Filipino,0,2,2
77070,Allergic arthritis of the hand,ethnic,Hispanic or Latino,1,1,2
196307,Lumbosacral plexus injury,ethnic,Hispanic or Latino,2,0,2
138501,Cholinergic urticaria,ethnic,Hispanic or Latino,1,1,2
437496,Acute peripheral vestibulopathy,ethnic,Not Hispanic or Latino,0,2,2
4064381,Nephropathy screening,racial,Asian,2,0,2
79833,Meniere's disease,racial,Unknown,1,1,2
4287544,Manic bipolar I disorder,racial,American Indian or Alaska Native ,0,2,2
201603,Disease of teeth AND/OR supporting structures,racial,American Indian,0,2,2
198289,Nonvenomous insect bite of hip without infection,racial,Other Race,1,1,2
435917,Fetus OR newborn affected by incompetent cervix,ethnic,Hispanic or Latino,2,0,2
195058,Nonallopathic lesion of abdomen,ethnic,Hispanic or Latino,2,0,2
192502,Contusion of multiple sites of trunk,ethnic,Hispanic or Latino,1,1,2
316432,Right bundle branch block AND left anterior fascicular block,ethnic,Not Hispanic or Latino,0,2,2
198446,Embolism and thrombosis of the abdominal aorta,ethnic,Hispanic or Latino,2,0,2
141933,Alopecia areata,racial,Other Race,1,1,2
4030398,Amputation of arm through shoulder,racial,White,1,1,2
138346,Erysipelas,racial,Unknown,2,0,2
435233,Disorders of fatty-acid metabolism,racial,White,1,1,2
4208970,History of physical abuse,racial,Black or African American ,2,0,2
4096215,"Hyperlipidemia, group A",racial,American Indian,0,2,2
76491,Obstetric non-purulent mastitis with antenatal complication,ethnic,Hispanic or Latino,2,0,2
81988,Sprain of sternum,ethnic,Hispanic or Latino,2,0,2
433773,Chronic orbital inflammation,ethnic,Hispanic or Latino,0,2,2
139734,Early yaws skin lesion,racial,White,1,1,2
433514,Abnormal hard tissue formation in pulp,ethnic,Hispanic or Latino,1,1,2
381581,Chalazion,racial,Asian,1,1,2
4227745,Infertility test,ethnic,Hispanic or Latino,1,1,2
4092562,Reduction deformity of arm,racial,White,2,0,2
381308,Abscess of eyelid,racial,Black or African American ,1,1,2
74717,Galactorrhoea in pregnancy and the puerperium - delivered with postnatal complication,ethnic,Hispanic or Latino,2,0,2
4067537,Other disc disorders of unspecified site,ethnic,Not Hispanic or Latino,2,0,2
374267,Tuberculosis of central nervous system,racial,Unknown,2,0,2
443417,Villonodular synovitis of lower limb,racial,Black or African American ,2,0,2
436741,Vulvodynia,racial,White,2,0,2
4094126,Family problems,ethnic,Hispanic or Latino,1,1,2
443344,Barrett esophagus,racial,Other Race,2,0,2
444028,Open wound of alveolar process without complication,racial,White,1,1,2
194989,Bilateral recurrent inguinal hernia with obstruction but no gangrene,ethnic,Hispanic or Latino,0,2,2
4116761,Lateral meniscus derangement unspecified,racial,White,1,1,2
78228,Joint derangement,racial,Black or African American ,1,1,2
378001,Concussion with no loss of consciousness,ethnic,Hispanic or Latino,2,0,2
318772,Disease of pericardium,racial,Other Race,1,1,2
435656,Neonatal jaundice,racial,Black or African American ,1,1,2
441919,Twin pregnancy,racial,Other Race,2,0,2
4242221,Rumination disorder,ethnic,Hispanic or Latino,0,2,2
197043,Cervical observation during pregnancy and labor,ethnic,Hispanic or Latino,2,0,2
77178,Contusion of multiple sites of upper limb,racial,Unknown,1,1,2
443716,Blister of shoulder without infection,racial,White,1,1,2
78512,Joint contracture of the ankle and/or foot,ethnic,Not Hispanic or Latino,2,0,2
141411,Scalp injury,racial,Asian,0,2,2
200219,Abdominal pain,racial,Asian Indian,1,1,2
74777,Closed fracture of astragalus,racial,Unknown,2,0,2
376578,Otitic barotrauma,racial,White,1,1,2
4116861,Neuromyopathy,racial,Unknown,0,2,2
79091,Unstable lie,racial,Unknown,2,0,2
436298,Adverse reaction to food,racial,Filipino,2,0,2
192956,Cholecystitis,racial,Other Race,2,0,2
434628,Separation anxiety,racial,Unknown,2,0,2
4302543,Insertion of prosthesis or prosthetic device of femoral head,racial,White,2,0,2
74125,Inflammatory polyarthropathy,racial,Asian,1,1,2
4113782,Cerebral artery occlusion NOS,racial,Unknown,2,0,2
378413,Partial recent retinal detachment with multiple defects,ethnic,Hispanic or Latino,1,1,2
438332,Disease of possible viral origin,racial,American Indian,1,1,2
193308,Congenital anomaly of spleen,ethnic,Not Hispanic or Latino,1,1,2
443582,Disorder of joint of hand,racial,Unknown,2,0,2
4305080,Abnormal breathing,racial,Black or African American ,1,1,2
74464,Idiopathic scoliosis AND/OR kyphoscoliosis,racial,Native Hawaiian or Other Pacific Islander ,1,1,2
40481920,Periumbilical pain,racial,Asian,2,0,2
438879,Closed bimalleolar fracture,ethnic,Not Hispanic or Latino,2,0,2
437295,Abnormal pupillary function,ethnic,Hispanic or Latino,2,0,2
133150,Malignant neoplasm of skin of lower limb and hip,racial,Unknown,0,2,2
438977,"Primary malignant neoplasm of ribs, sternum and clavicle",racial,White,2,0,2
4302252,High risk pregnancy care,racial,Native Hawaiian or Other Pacific Islander ,2,0,2
140821,Spasm,racial,Filipino,1,1,2
78236,Muscle wasting disorder,racial,Other Race,1,1,2
24909,Hereditary spherocytosis,ethnic,Hispanic or Latino,2,0,2
432660,Dentofacial anomaly,ethnic,Hispanic or Latino,1,1,2
435138,Injury of femoral nerve,racial,White,1,1,2
434697,Maternal tobacco abuse,racial,White,2,0,2
376400,Combined form of senile cataract,racial,Filipino,2,0,2
136497,Scar conditions and fibrosis of skin,racial,Other Race,0,2,2
4333977,Acquired anophthalmos,ethnic,Not Hispanic or Latino,0,2,2
439717,Active cochleovestibular Meniere's disease,ethnic,Hispanic or Latino,0,2,2
76685,MG - Myasthenia gravis,racial,Other Race,0,2,2
432513,Animal bite wound,racial,Unknown,2,0,2
436285,Superficial foreign body without major open wound but with infection,racial,White,2,0,2
432551,Parvovirus infection,ethnic,Hispanic or Latino,0,2,2
438005,Closed fracture shaft of fibula,ethnic,Not Hispanic or Latino,0,2,2
4168213,Chest pain on breathing,racial,Filipino,2,0,2
435866,Retrograde ejaculation,racial,White,0,2,2
436145,Pneumonia due to respiratory syncytial virus,racial,White,2,0,2
436096,Chronic pain,racial,Native Hawaiian or Other Pacific Islander ,1,1,2
440642,CSD - Cat scratch disease,ethnic,Hispanic or Latino,1,1,2
373461,Leukocoria,racial,White,2,0,2
78799,Chronic ulcerative ileocolitis,ethnic,Hispanic or Latino,2,0,2
379820,No colour perception,ethnic,Not Hispanic or Latino,1,1,2
195209,Benign neoplasm of liver and/or biliary ducts,ethnic,Not Hispanic or Latino,2,0,2
437409,Intracranial injury,racial,Other Race,0,2,2
77592,Articular crepitus of temporomandibular joint,ethnic,Not Hispanic or Latino,1,1,2
196152,Peritonitis,racial,Unknown,2,0,2
4210151,HIV counseling,racial,Black or African American ,0,2,2
28461,Hypertrophy of salivary gland,racial,Unknown,0,2,2
256531,Head and neck swelling,racial,American Indian or Alaska Native ,1,1,2
81151,Sprain of ankle joint,racial,American Indian or Alaska Native ,2,0,2
439294,"Malignant neoplasm of head, neck and face",racial,Unknown,2,0,2
321414,Hemoglobinuria,racial,Unknown,1,1,2
74150,"Congenital subluxation of hip, bilateral",ethnic,Hispanic or Latino,1,1,2
77354,Primary localised osteoarthrosis of lower leg,racial,Native Hawaiian or Other Pacific Islander ,1,1,2
136496,Cellulitis and abscess of face,racial,American Indian or Alaska Native ,1,1,2
81175,Contusion of chest,racial,Other Race,1,1,2
197339,"Congenital abnormality of uterus, affecting pregnancy",ethnic,Hispanic or Latino,1,1,2
74127,Elbow joint contracture,ethnic,Hispanic or Latino,0,2,2
201254,Insulin dependent diabetes mellitus,racial,American Indian,1,1,2
134453,Inflammation of bursa,racial,American Indian or Alaska Native ,2,0,2
372651,Chronic mastoiditis,ethnic,Hispanic or Latino,2,0,2
437839,Pica,racial,Black or African American ,0,2,2
443577,Asymmetric sensorineural hearing loss,racial,Other Race,1,1,2
372828,Zoster ophthalmicus,racial,White,1,1,2
196365,Neoplasm of uncertain behaviour of adrenal gland,racial,White,2,0,2
438791,Pulmonary congestion and hypostasis,racial,White,1,1,2
439705,Active disintegrative psychoses,ethnic,Hispanic or Latino,0,2,2
76150,Ulcer of rectum,ethnic,Not Hispanic or Latino,1,1,2
201313,Hypertensive renal disease,racial,Asian,2,0,2
4073526,Bilateral inguinal hernia repair,ethnic,Hispanic or Latino,0,2,2
443541,Recurrent inguinal hernia with gangrene,racial,Unknown,0,2,2
74809,Crushing injury of hand,racial,Asian,0,2,2
196738,Male genital organ disease,racial,Asian Indian,0,2,2
440424,Aphasia,racial,Native Hawaiian or Other Pacific Islander ,0,2,2
438350,Pneumocystosis,ethnic,Not Hispanic or Latino,0,2,2
23988,Hemolytic anemia due to glutathione metabolism disorder,ethnic,Hispanic or Latino,1,1,2
443629,Generalised abdominal tenderness,racial,Unknown,0,2,2
200764,Bile duct calculus without mention of cholecystitis and no obstruction,ethnic,Not Hispanic or Latino,2,0,2
432645,Necrotising scleritis without inflammation,ethnic,Hispanic or Latino,0,2,2
201773,Enteritis,racial,Unknown,0,2,2
132491,Contusion of scapular region,ethnic,Hispanic or Latino,2,0,2
4069400,Acquired genu valgum and varum,ethnic,Hispanic or Latino,0,2,2
318852,Congenital malformation of vitreous body,ethnic,Hispanic or Latino,2,0,2
78890,Sprain of elbow and forearm,racial,Other Race,1,1,2
132393,Pressure ulcer stage 1,racial,Asian,0,2,2
440543,Fracture of tibia,ethnic,Not Hispanic or Latino,2,0,2
381281,Degenerative progressive high myopia,racial,White,0,2,2
133280,Alopecia,racial,Black or African American ,2,0,2
4103897,Unspecified ectropion,ethnic,Hispanic or Latino,2,0,2
4102738,Screening for mental disorders,racial,White,1,1,2
74809,Crushing injury of hand,ethnic,Not Hispanic or Latino,0,2,2
4016359,Streptococcus carrier,racial,Unknown,2,0,2
81148,Open Monteggia's fracture,racial,White,2,0,2
138582,"Closed fracture scapula, acromion",racial,White,0,2,2
200762,Autoimmune hepatitis,ethnic,Not Hispanic or Latino,2,0,2
198683,Viral hepatitis B without hepatic coma,racial,Other Race,2,0,2
200052,Primary malignant neoplasm of uterine adnexa,racial,Unknown,2,0,2
375671,Concussion with loss of consciousness,racial,Unknown,2,0,2
73019,Breast engorgement in newborn,racial,White,0,2,2
81988,Sprain of sternum,racial,White,2,0,2
438535,Congenital abnormality of iris and ciliary body,ethnic,Hispanic or Latino,1,1,2
435522,Hypervitaminosis D,ethnic,Not Hispanic or Latino,1,1,2
28974,Candidiasis of oesophagus,racial,Unknown,1,1,2
141917,Balanitis xerotica obliterans,racial,Asian,0,2,2
134718,Hirsutism,racial,Black or African American ,2,0,2
4052931,Abandoned child,racial,Unknown,1,1,2
372624,Cataract with neovascularization,racial,White,2,0,2
372409,Sciatica neuralgia,racial,American Indian,2,0,2
433985,Hypercarotinemia,racial,Other Race,1,1,2
4263748,Recurrent major depression in complete remission,ethnic,Not Hispanic or Latino,1,1,2
443982,Traumatic amputation of thumb,racial,White,0,2,2
437891,PPHT - Primary pulmonary hypertension,racial,Other Race,2,0,2
441276,Nondependent alcohol abuse in remission,racial,Other Race,0,2,2
375538,"Degeneration of macula due to cyst, hole or pseudohole",ethnic,Not Hispanic or Latino,2,0,2
4064925,Hypertension screening,racial,Other Race,1,1,2
201397,Prune belly syndrome,ethnic,Hispanic or Latino,0,2,2
254387,Upper respiratory tract hypersensitivity reaction,racial,American Indian or Alaska Native ,1,1,2
438447,Acute myocardial infarction of inferolateral wall,ethnic,Not Hispanic or Latino,0,2,2
256810,Choanal atresia,racial,White,0,2,2
439298,Bronchitis and pneumonitis due to chemical fumes,racial,Unknown,2,0,2
435928,Abnormal decrease in weight,racial,American Indian or Alaska Native ,1,1,2
201340,Gastritis,racial,Asian,2,0,2
77600,Encysted hydrocele,racial,White,0,2,2
438112,Neoplastic disease,ethnic,Not Hispanic or Latino,1,1,2
435774,Disorder of amino acid metabolism,ethnic,Hispanic or Latino,1,1,2
380407,Chronic infective otitis externa,racial,White,2,0,2
443617,Conduct disorder,racial,Other Race,1,1,2
132483,"Insect bite, nonvenomous, of hand, infected",racial,White,0,2,2
444413,Pyrexial convulsion,racial,Black or African American ,0,2,2
4179332,Parent-child problem,racial,Other Race,1,1,2
436136,Dissection of thoracic aorta,racial,White,0,2,2
437544,Arterial retinal branch occlusion,ethnic,Not Hispanic or Latino,2,0,2
438306,Poisoning by psychodysleptic,racial,White,0,2,2
437202,Giardiasis,racial,White,1,1,2
315586,Priapism,ethnic,Not Hispanic or Latino,0,2,2
378421,Alcoholic peripheral neuropathy,racial,American Indian or Alaska Native ,0,2,2
319038,Postmyocardial infarction syndrome,racial,Unknown,1,1,2
4204966,Regurgitant esophagitis,ethnic,Not Hispanic or Latino,0,2,2
192759,Sequelae of fracture of spine,racial,White,1,1,2
256722,Bronchopneumonia,ethnic,Not Hispanic or Latino,0,2,2
381575,Disorder of external ear,racial,Black or African American ,2,0,2
258785,Pneumococcal pneumonia,racial,Black or African American ,0,2,2
381839,Habit disorder,racial,Asian,0,2,2
378547,Congenital anomaly of retina,racial,White,2,0,2
198803,Nodular hyperplasia of prostate gland,racial,American Indian,0,2,2
73843,Synovial cyst of popliteal space,racial,American Indian or Alaska Native ,0,2,2
4323155,Limited consultation,racial,White,1,1,2
4064362,Mycotic infection screening,ethnic,Hispanic or Latino,2,0,2
4222896,Chronic duodenal ulcer without haemorrhage AND without perforation,ethnic,Hispanic or Latino,2,0,2
440748,Interstitial emphysema of lung,racial,Other Race,0,2,2
381301,Chronic serous otitis media,racial,Asian,1,1,2
192496,Unilateral traumatic amputation of leg below knee with complication,ethnic,Hispanic or Latino,0,2,2
375838,Objective tinnitus,racial,Unknown,0,2,2
193955,TB - Renal tuberculosis,ethnic,Hispanic or Latino,2,0,2
4144118,Gastrointestinal haemorrhage unspecified,racial,White,1,1,2
432968,Anemia during pregnancy - baby delivered,racial,Other Race,2,0,2
437222,Respiratory syncytial virus infection,racial,Other Race,1,1,2
4103897,Unspecified ectropion,racial,White,2,0,2
192279,Diabetic nephropathy,racial,American Indian,2,0,2
438438,Acute myocardial infarction of anterolateral wall,ethnic,Not Hispanic or Latino,0,2,2
134452,Miners' elbow,racial,Other Race,0,2,2
439672,Viral hepatitis C with coma,racial,White,0,2,2
201354,Infertility due to extratesticular cause,ethnic,Not Hispanic or Latino,0,2,2
432441,Finding of length of gestation,racial,Asian,1,1,2
432512,Foreign object left in body during procedure,ethnic,Not Hispanic or Latino,2,0,2
76002,Mechanical complication due to breast prosthesis,racial,White,2,0,2
137591,Chronic apical periodontitis,ethnic,Hispanic or Latino,1,1,2
80502,Osteoporosis,racial,Native Hawaiian or Other Pacific Islander ,2,0,2
439935,Abnormal posture,ethnic,Hispanic or Latino,1,1,2
373205,Hemorrhage of eyelid,ethnic,Hispanic or Latino,1,1,2
78799,Chronic ulcerative ileocolitis,racial,Unknown,2,0,2
432867,Hyperlipidemia,racial,European,0,2,2
81426,Closed fracture of clavicle,racial,Asian,2,0,2
4100515,Cocaine type drug dependence,ethnic,Hispanic or Latino,0,2,2
72459,Closed fracture of two ribs,ethnic,Hispanic or Latino,2,0,2
196438,Acquired arteriovenous fistula of liver,racial,Other Race,1,1,2
443401,Congenital connective tissue disorder,racial,Unknown,2,0,2
79173,Closed dislocation of jaw,racial,American Indian,2,0,2
433846,Ankylosis of joint of lower leg,racial,White,1,1,2
78804,Schimmelbusch's disease,racial,American Indian or Alaska Native ,2,0,2
436667,Stammer,racial,Asian,0,2,2
135208,Benign tumor of lip,racial,Unknown,2,0,2
373474,Seeing double,racial,Black or African American ,2,0,2
4194160,Thyroid function tests abnormal,racial,Black or African American ,1,1,2
137016,Retained dental root,ethnic,Hispanic or Latino,1,1,2
196151,Functional disorder of intestine,racial,White,2,0,2
140176,Erythema nodosum,racial,Unknown,0,2,2
132494,Partial thickness burn of toe,racial,White,2,0,2
434842,Cause of overdose - accidental,ethnic,Hispanic or Latino,1,1,2
72374,Unstable lie with antenatal problem,ethnic,Not Hispanic or Latino,2,0,2
81721,Open wound of hand except fingers with tendon involvement,racial,White,1,1,2
4168213,Chest pain on breathing,racial,American Indian or Alaska Native ,2,0,2
201958,Perinatal dermatological disorders,racial,White,1,1,2
79898,Cellulitis and abscess of finger,racial,Other Race,1,1,2
440224,Closed dislocation of cervical vertebra,ethnic,Hispanic or Latino,2,0,2
4114451,"Localized, primary osteoarthritis of unspecified site",racial,Unknown,2,0,2
432525,Thyroid agent adverse reaction,ethnic,Not Hispanic or Latino,1,1,2
4167069,Aneurysm clipping,racial,Asian,2,0,2
80249,Sprain of acromioclavicular ligament,racial,White,0,2,2
133295,Inflammatory spondylopathy,ethnic,Not Hispanic or Latino,2,0,2
198810,Vulval intraepithelial neoplasia grade 2,ethnic,Hispanic or Latino,2,0,2
439197,Nonvenomous insect bite of neck with infection,ethnic,Hispanic or Latino,1,1,2
318448,"Incomplete atrioventricular block, second degree",ethnic,Not Hispanic or Latino,0,2,2
74114,Cellulitis and abscess of foot excluding toe,racial,Black or African American ,0,2,2
313867,Double outlet right ventricle,racial,Other Race,2,0,2
4129665,Hearing aid care,racial,White,1,1,2
433208,Disorder of pulmonary circulation,ethnic,Hispanic or Latino,1,1,2
378165,Nystagmus,racial,Unknown,2,0,2
438535,Congenital abnormality of iris and ciliary body,racial,White,1,1,2
79116,Disorder of tendon of shoulder region,racial,Asian,0,2,2
432725,Congenital anomaly of integument,racial,Unknown,2,0,2
374640,Exudative retinal detachment,racial,Unknown,2,0,2
200447,Gastrointestinal complication,racial,White,2,0,2
4062488,Thyroid disorder screening,racial,Black or African American ,1,1,2
141666,Acute osteomyelitis of lower leg,ethnic,Not Hispanic or Latino,0,2,2
4069400,Acquired genu valgum and varum,racial,White,0,2,2
372424,Congenital anolmaly of eye,racial,Unknown,1,1,2
4219346,Meatoplasty of urethra,racial,Unknown,0,2,2
374035,Keratitis,racial,White,2,0,2
377527,Presenile dementia with depression,racial,Asian,2,0,2
133278,Disorder of hair,racial,Unknown,2,0,2
81251,Neoplasm of breast,racial,White,2,0,2
378135,Facial nerve disorder,ethnic,Not Hispanic or Latino,0,2,2
436251,Closed fracture of proximal end of ulna,racial,White,1,1,2
440700,Communicating hydrocephalus,racial,White,2,0,2
4064362,Mycotic infection screening,racial,Asian,0,2,2
73889,Sprain of distal tibiofibular ligament,racial,White,1,1,2
441049,Enamel caries,ethnic,Not Hispanic or Latino,2,0,2
441190,Injury of unknown intent due to fall from height,racial,Asian,1,1,2
439222,Corticosteroids adverse reaction,ethnic,Hispanic or Latino,2,0,2
201995,"Contusion, lower limb, multiple sites",ethnic,Hispanic or Latino,2,0,2
136354,Dermal metastasis,racial,White,0,2,2
4323962,"Electrocardiogram, rhythm",racial,White,0,2,2
434675,Complication of gastrostomy,racial,Black or African American ,1,1,2
132494,Partial thickness burn of toe,ethnic,Hispanic or Latino,2,0,2
378849,Microtia,racial,Unknown,1,1,2
443788,Peritoneal adhesions with obstruction,racial,White,1,1,2
192954,Acute gastric ulcer without hemorrhage AND without perforation but with obstruction,ethnic,Not Hispanic or Latino,0,2,2
440422,Noise-induced hearing loss,ethnic,Hispanic or Latino,1,1,2
197324,Disease of peritoneum,ethnic,Not Hispanic or Latino,1,1,2
79903,Effusion of joint,ethnic,Not Hispanic or Latino,2,0,2
197032,Hyperplasia of prostate,racial,Black or African American ,0,2,2
439656,A/N care: grand multip,racial,Unknown,2,0,2
77630,Disease of shoulder,racial,Asian Indian,0,2,2
441647,Continuing pregnancy after intrauterine death of twin fetus,racial,White,2,0,2
4334644,Decubitus ulcer of lower back,ethnic,Not Hispanic or Latino,1,1,2
374364,Disorder of middle ear,ethnic,Not Hispanic or Latino,1,1,2
4026149,Other cholecystitis,ethnic,Hispanic or Latino,2,0,2
138973,Chancroid,racial,White,1,1,2
201449,Unilateral traumatic amputation of leg below knee without complication,racial,Unknown,2,0,2
441712,Open wound of ocular adnexa,racial,Unknown,1,1,2
433083,Opiate and narcotic poisoning,racial,White,2,0,2
377091,Fits - convulsions,racial,American Indian or Alaska Native ,0,2,2
193739,Ovarian failure,racial,Unknown,2,0,2
134780,Closed dislocation of metatarsal joint,racial,White,2,0,2
4092879,Absent kidney,racial,American Indian,0,2,2
4052837,Open wound of breast,racial,Unknown,2,0,2
200445,Chronic prostatitis,racial,Other Race,0,2,2
74194,Back sprain,racial,Other Race,1,1,2
438155,Optic disc glaucomatous atrophy,racial,Filipino,0,2,2
375256,Anterior subcapsular polar senile cataract,ethnic,Not Hispanic or Latino,2,0,2
75010,Fibroadenosis of breast,racial,Black or African American ,2,0,2
196734,Disease of prostate,racial,Asian,0,2,2
134461,Tietze disease,racial,Native Hawaiian or Other Pacific Islander ,1,1,2
435875,"Complications of pregnancy, childbirth and the puerperium",racial,Black or African American ,1,1,2
440098,Rubeosis iridis,ethnic,Hispanic or Latino,1,1,2
4196362,Genetic counselling,racial,Asian,2,0,2
439836,Atheromatous embolus of upper limb,racial,Unknown,2,0,2
24134,Nonspecific pain in the neck region,racial,American Indian,0,2,2
437259,Disruptive behavior disorder,racial,White,2,0,2
134324,Lipodystrophy,racial,Unknown,0,2,2
4107375,Somatoform pain disorder,ethnic,Hispanic or Latino,2,0,2
133848,Non-traumatic slipped upper femoral epiphysis,ethnic,Not Hispanic or Latino,0,2,2
254761,Cough,racial,Alaska Native,2,0,2
73841,Multiple stiff joints,ethnic,Hispanic or Latino,0,2,2
437409,Intracranial injury,racial,Black or African American ,0,2,2
201626,Mid-cycle pain,ethnic,Not Hispanic or Latino,1,1,2
440787,"Drug dependence in mother complicating pregnancy, childbirth AND/OR puerperium",ethnic,Not Hispanic or Latino,2,0,2
4056171,Prostatic hyperplasia NOS,ethnic,Hispanic or Latino,0,2,2
375838,Objective tinnitus,ethnic,Not Hispanic or Latino,0,2,2
379782,Gilles de la Tourette's syndrome,racial,Other Race,0,2,2
201899,Unilateral recurrent inguinal hernia,racial,Asian,2,0,2
441207,Drug reaction,racial,Black or African American ,1,1,2
4201412,Speech therapy,racial,White,1,1,2
380533,Neonatal seizures,racial,Other Race,2,0,2
435171,Allergic state,racial,American Indian or Alaska Native ,2,0,2
132416,Chronic haematoma of pinna,ethnic,Hispanic or Latino,1,1,2
4100091,Child attention deficit disorder NOS,racial,Unknown,1,1,2
438407,BN - Bulimia nervosa,racial,Unknown,2,0,2
258375,Malignant neoplasm of overlapping lesion of bronchus and lung,racial,White,0,2,2
75946,Sprain of proximal tibiofibular ligament,racial,Unknown,2,0,2
4176890,Male sterility,racial,Black or African American ,0,2,2
40484028,Dental caries extending into dentine,ethnic,Not Hispanic or Latino,1,1,2
440519,Premature - weight 1000g-2499g or gestation of 28-37weeks,racial,Asian,0,2,2
4149299,Follow-up orthopaedic assessment,racial,White,2,0,2
432612,Mild mental handicap,racial,Other Race,0,2,2
22274,Neoplasm of uncertain behaviour of larynx,ethnic,Not Hispanic or Latino,0,2,2
135496,Acute leukemia in remission,ethnic,Not Hispanic or Latino,2,0,2
315085,Enlargement of lymph nodes,racial,Native Hawaiian or Other Pacific Islander ,2,0,2
30163,Cellulitis and abscess of neck,racial,Asian,2,0,2
134304,Benign tumour of parathyroid gland,racial,Black or African American ,2,0,2
435374,Closed fracture of distal end of ulna,racial,White,0,2,2
4152838,Paralysis of vocal cords or larynx,ethnic,Hispanic or Latino,2,0,2
80294,Foreign body in genitourinary tract,racial,Unknown,2,0,2
434610,Hyperkalemia,racial,Filipino,2,0,2
4046500,Acute peptic ulcer with hemorrhage,racial,Asian,0,2,2
79938,Closed fracture of scapula,racial,White,2,0,2
4272867,General well-being finding,racial,Filipino,1,1,2
141666,Acute osteomyelitis of lower leg,racial,Black or African American ,0,2,2
4112816,Other respiratory system diseases,racial,Black or African American ,1,1,2
75354,Osteochondropathy,racial,Filipino,2,0,2
434145,Embryonal nuclear cataract,ethnic,Hispanic or Latino,2,0,2
81937,Traumatic arthropathy of the hand,racial,Unknown,2,0,2
443732,Disorder associated with type II diabetes melliltus,racial,Other Race,0,2,2
23988,Hemolytic anemia due to glutathione metabolism disorder,racial,White,0,2,2
140480,Impetigo,racial,American Indian or Alaska Native ,2,0,2
141411,Scalp injury,racial,Unknown,2,0,2
201617,Prostatic cyst,racial,White,0,2,2
24660,Acute tonsillitis,racial,Filipino,2,0,2
443862,Complication of internal anastomosis,racial,White,2,0,2
80880,Open wound of foot except toes with tendon involvement,ethnic,Hispanic or Latino,2,0,2
200319,Herpetic infection of penis,ethnic,Hispanic or Latino,0,2,2
72469,Closed dislocation of shoulder region,racial,Other Race,0,2,2
261687,Hemoptysis,racial,Asian,1,1,2
443519,Retinopathy of prematurity stage 4 - subtotal retinal detachment,racial,White,2,0,2
140027,Herpetic gingivostomatitis,racial,American Indian or Alaska Native ,1,1,2
136834,Closed intertrochanteric fracture,racial,Asian,2,0,2
135892,Erythematous condition,racial,Other Race,1,1,2
139734,Early yaws skin lesion,ethnic,Hispanic or Latino,1,1,2
199876,Prolapse of female genital organs,racial,Other Race,2,0,2
4073526,Bilateral inguinal hernia repair,racial,White,0,2,2
257775,Post-tuberculous bronchiectasis,racial,White,0,2,2
4062653,Gout screening,ethnic,Hispanic or Latino,1,1,2
199881,Endometriosis of ovary,ethnic,Hispanic or Latino,2,0,2
31610,Disorder of oesophagus,ethnic,Not Hispanic or Latino,1,1,2
4179925,Basic learning problem,racial,Asian,0,2,2
439025,Dacryocystitis,racial,Unknown,1,1,2
4227745,Infertility test,racial,White,1,1,2
4016675,"Sprain, ankle joint, medial",racial,Black or African American ,0,2,2
435023,Mild hyperemesis-not delivered,racial,Other Race,2,0,2
4219346,Meatoplasty of urethra,ethnic,Hispanic or Latino,0,2,2
381278,Cluster headache,racial,Unknown,0,2,2
135722,Chronic infection of amputation stump,racial,White,0,2,2
81378,Chondromalacia of patella,racial,Other Race,1,1,2
435231,Nondependent cannabis abuse in remission,ethnic,Hispanic or Latino,1,1,2
4185471,Disorder of pigmentation,racial,Other Race,2,0,2
434613,Generalized anxiety disorder,racial,Asian Indian,2,0,2
435325,Umbilical cord complication,ethnic,Not Hispanic or Latino,1,1,2
436391,Primary cerebellar degeneration,racial,Unknown,2,0,2
80478,Engorgement of breasts associated with childbirth,ethnic,Not Hispanic or Latino,2,0,2
437544,Arterial retinal branch occlusion,racial,Asian,2,0,2
4250023,Severe major depression with psychotic features,racial,Asian,2,0,2
435233,Disorders of fatty-acid metabolism,ethnic,Hispanic or Latino,1,1,2
136779,Disease of forearm,ethnic,Not Hispanic or Latino,2,0,2
439836,Atheromatous embolus of upper limb,ethnic,Hispanic or Latino,2,0,2
78267,Closed anterior dislocation of humerus,ethnic,Hispanic or Latino,1,1,2
437828,Disorder of calcium metabolism,racial,Black or African American ,0,2,2
321107,AR - Congenital aortic regurgitation,racial,Unknown,0,2,2
439224,Drug allergy,racial,Black or African American ,1,1,2
435517,Acidosis,racial,Unknown,1,1,2
200483,Disease of pelvis,racial,Other Race,1,1,2
139202,"Burn involving 20-29 percent of body surface, with 10-19 percent of body surface with full thickness burn",racial,Unknown,2,0,2
437896,Disorder of language,ethnic,Not Hispanic or Latino,1,1,2
442444,"Motor vehicle traffic accident involving pedestrian hit by motor vehicle, pedestrian injured",ethnic,Not Hispanic or Latino,2,0,2
133655,Burn of forearm,ethnic,Hispanic or Latino,1,1,2
4326838,Decubitus ulcer of upper back,ethnic,Hispanic or Latino,2,0,2
196324,Food poisoning due to Clostridium perfringens,racial,White,0,2,2
435492,Nodular lymphoma of intrathoracic lymph nodes,racial,Black or African American ,0,2,2
74892,Articular gout,racial,Black or African American ,2,0,2
437257,Continuous acute alcoholic intoxication in alcoholism,racial,Unknown,0,2,2
138346,Erysipelas,ethnic,Not Hispanic or Latino,1,1,2
439346,"Motor vehicle traffic accident involving pedestrian run over by motor vehicle, occupant of tram injured",ethnic,Hispanic or Latino,1,1,2
4064905,Venereal disease screening,racial,Filipino,1,1,2
440071,Gout associated problems,racial,White,0,2,2
194989,Bilateral recurrent inguinal hernia with obstruction but no gangrene,racial,White,0,2,2
4092879,Absent kidney,racial,Other Race,1,1,2
4175331,Congenital haemolytic anaemia,racial,White,1,1,2
438878,Abnormal results of liver function studies,racial,Filipino,2,0,2
4318111,Traumatic amputation of leg,ethnic,Hispanic or Latino,0,2,2
313980,"Hodgkin disease, lymphocytic depletion of lymph nodes of multiple sites",racial,White,2,0,2
4069541,Other acquired ankle and foot deformity,ethnic,Hispanic or Latino,1,1,2
377560,Internal hordeolum,racial,Other Race,1,1,2
78282,Closed dislocation of coccyx,ethnic,Hispanic or Latino,2,0,2
257683,Postnasal drip,racial,Filipino,2,0,2
137750,Second degree burn of forehead AND/OR cheek,ethnic,Not Hispanic or Latino,0,2,2
141124,Congenital cardiovascular disorder,ethnic,Not Hispanic or Latino,0,2,2
258981,Kaposi's sarcoma of skin,racial,Unknown,0,2,2
75946,Sprain of proximal tibiofibular ligament,racial,White,2,0,2
201354,Infertility due to extratesticular cause,racial,White,0,2,2
439935,Abnormal posture,racial,White,1,1,2
435792,Drug-induced sleep disorder,racial,Unknown,2,0,2
4061214,Ulceration of vulva NOS,ethnic,Hispanic or Latino,2,0,2
377280,Corneal disorder,racial,Unknown,1,1,2
437699,Strain of infraspinatus muscle AND/OR tendon,ethnic,Hispanic or Latino,0,2,2
134144,Cleft palate with cleft lip,racial,Black or African American ,0,2,2
378439,Fourth nerve palsy,ethnic,Hispanic or Latino,1,1,2
142032,Partial thickness burn of lower leg,racial,White,2,0,2
201894,Acute intestinal vascular insufficiency,racial,White,0,2,2
373962,Tabes dorsalis - neurosyphilis,racial,Unknown,2,0,2
373648,Superficial injury of eyelid AND/OR periocular area,racial,White,1,1,2
376709,Discharge of eye,racial,Other Race,0,2,2
26441,Bleeding ulcer of esophagus,racial,Other Race,2,0,2
4090114,Toxoplasmosis chorioretinitis,ethnic,Hispanic or Latino,1,1,2
374954,Optic neuritis,racial,Unknown,1,1,2
433025,Complication of vaccination,ethnic,Hispanic or Latino,1,1,2
436519,Perinatal intraventricular hemorrhage,ethnic,Not Hispanic or Latino,1,1,2
260123,Acute inflammation of sinus,racial,Asian Indian,0,2,2
139180,Open wound of multiple sites of face without complication,racial,White,0,2,2
4060689,Polyhydramnios unspecified,ethnic,Hispanic or Latino,2,0,2
4113351,Unspecified spontaneous abortion with complication NOS,ethnic,Hispanic or Latino,2,0,2
73923,"Contusion, upper arm",ethnic,Not Hispanic or Latino,2,0,2
197332,Incomplete uterovaginal prolapse,ethnic,Not Hispanic or Latino,2,0,2
442290,Varicose veins of legs complicating pregnancy AND/OR puerperium,ethnic,Hispanic or Latino,2,0,2
194151,Congenital anomaly of stomach,racial,White,0,2,2
435754,Ca ascending colon,racial,White,0,2,2
316427,Aneurysm of coronary vessels,ethnic,Not Hispanic or Latino,0,2,2
376686,Polyneuropathy associated with another disorder,racial,Other Race,0,2,2
440457,Threatened abortion,racial,Black or African American ,2,0,2
377853,Chronic tension-type headache,racial,Other Race,2,0,2
442901,"Motor vehicle traffic accident involving collision with another motor vehicle, stopped, occupant of tram injured",racial,Unknown,0,2,2
4031190,Swallowed foreign body,racial,Unknown,2,0,2
377254,"Multi-infarct dementia, uncomplicated",racial,Native Hawaiian or Other Pacific Islander ,0,2,2
74468,Congenital anomaly of rib,ethnic,Not Hispanic or Latino,0,2,2
196165,Cervical intraepithelial neoplasia grade 2,racial,Asian,2,0,2
436381,Gender identity disorder of childhood,racial,Black or African American ,1,1,2
436681,Insomnia disorder related to known organic factor,racial,Other Race,0,2,2
194100,Obstructed labour due to foetal malposition,racial,White,0,2,2
433946,Fall on same level due to impact against another person,racial,Other Race,1,1,2
133569,Fasciitis,racial,Asian,1,1,2
4167075,Fusion of knee,racial,Unknown,0,2,2
434156,Congenital anemia,ethnic,Not Hispanic or Latino,1,1,2
444258,Abrasion AND/OR friction burn of neck with infection,racial,White,1,1,2
4102739,Screening for cardiovascular system disease,racial,Unknown,0,2,2
196217,Congenital malformation of diaphragm,racial,Other Race,0,2,2
196347,Intestinal parasitism,racial,Unknown,0,2,2
435510,Hypocalcemia,racial,Other Race,1,1,2
442116,Allergy to eggs,racial,Black or African American ,0,2,2
79106,Arthralgia of the pelvic region and thigh,racial,American Indian,2,0,2
139099,Ingrowing nail,racial,Filipino,1,1,2
201958,Perinatal dermatological disorders,ethnic,Not Hispanic or Latino,1,1,2
440068,Psychosexual dysfunction,ethnic,Not Hispanic or Latino,0,2,2
141932,Senile hyperkeratosis,racial,Black or African American ,1,1,2
435866,Retrograde ejaculation,ethnic,Hispanic or Latino,0,2,2
441691,Atypical squamous cells of undetermined significance on vaginal Papanicolaou smear,racial,Other Race,2,0,2
374267,Tuberculosis of central nervous system,ethnic,Hispanic or Latino,2,0,2
376125,Disorder of eyelid,racial,Filipino,0,2,2
440589,Toxic effect of caustic substance,racial,White,1,1,2
441545,Somatisation disorder,ethnic,Not Hispanic or Latino,1,1,2
435308,Acute exudative glomerulonephritis,ethnic,Hispanic or Latino,0,2,2
194412,Dysplasia of vagina,racial,White,2,0,2
80805,Primary localized osteoarthrosis of forearm,racial,Other Race,2,0,2
375806,Idiopathic peripheral neuropathy,racial,Asian Indian,0,2,2
378547,Congenital anomaly of retina,ethnic,Hispanic or Latino,2,0,2
443933,Nicotiana tabacum poisoning,racial,Black or African American ,2,0,2
29735,Candidiasis of mouth,racial,Filipino,1,1,2
74322,Benign neoplasm of scrotum,racial,Unknown,0,2,2
136580,Dehiscence of surgical wound,ethnic,Not Hispanic or Latino,2,0,2
4201274,Anastomosis of small intestine to rectal stump,racial,White,2,0,2
132834,White piedra,racial,Unknown,2,0,2
437257,Continuous acute alcoholic intoxication in alcoholism,racial,White,2,0,2
438827,Foreign body granuloma of subcutaneous tissue,racial,Unknown,2,0,2
4049623,"Moderate major depression, single episode",racial,American Indian or Alaska Native ,2,0,2
259070,PGN - Acute proliferative glomerulonephritis,racial,Unknown,2,0,2
321689,Apneic,racial,Black or African American ,1,1,2
81983,Multiple dislocations,racial,White,2,0,2
438223,Sunburn of second degree,racial,White,1,1,2
443556,Primary focal hyperhidrosis,ethnic,Not Hispanic or Latino,1,1,2
135893,Decubitus ulcer of heel,racial,Black or African American ,0,2,2
73866,Congenital anomaly of breast,ethnic,Not Hispanic or Latino,2,0,2
80568,Traumatic amputation of finger without mention of complication,ethnic,Not Hispanic or Latino,1,1,2
80242,Current tear of medial cartilage AND/OR meniscus of knee,racial,Black or African American ,2,0,2
40482030,Dysplasia of prostate,ethnic,Hispanic or Latino,0,2,2
441579,Acute inferoposterior infarction,racial,Unknown,0,2,2
439251,"Bipolar affective disorder, currently depressed, in full remission",racial,Black or African American ,2,0,2
4034214,Open wound of ear,racial,White,1,1,2
74472,Congenital deformity of foot,racial,Black or African American ,1,1,2
432611,Explosive personality disorder,racial,Black or African American ,0,2,2
440964,Hodgkin's paragranuloma of extranodal AND/OR solid organ site,ethnic,Hispanic or Latino,0,2,2
432250,Infective disorder,ethnic,Not Hispanic or Latino,1,1,2
435374,Closed fracture of distal end of ulna,racial,Unknown,1,1,2
138667,Stoma observations,ethnic,Not Hispanic or Latino,0,2,2
4053045,Dog bite,racial,Black or African American ,0,2,2
437947,Complication of obstetrical surgical wound,racial,Unknown,2,0,2
373472,Pigmentary retinal dystrophy,racial,White,1,1,2
192858,Ovarian hyperfunction,racial,Unknown,2,0,2
196796,Congenital biliary atresia,racial,Unknown,0,2,2
194802,Foreign body in vulva and vagina,ethnic,Not Hispanic or Latino,2,0,2
443295,Maternal care for diminished foetal movements,ethnic,Not Hispanic or Latino,2,0,2
73557,Allergic arthritis of the pelvic region and thigh,ethnic,Hispanic or Latino,2,0,2
201606,Crohn's disease,racial,Asian,0,2,2
197440,Nonvenomous insect bite of trunk without infection,ethnic,Not Hispanic or Latino,2,0,2
381866,Degenerative disorder of eyelid,racial,White,1,1,2
440535,Abnormal radiographic examination,racial,Asian,1,1,2
443869,Nonvenomous insect bite of wrist without infection,ethnic,Not Hispanic or Latino,0,2,2
440233,Strain of supraspinatus muscle AND/OR tendon,racial,Unknown,2,0,2
140357,Neoplasm of uncertain behaviour of endocrine gland,racial,Unknown,2,0,2
443539,Motor vehicle injury,racial,White,1,1,2
436249,Closed fracture of femoral condyle of femur,ethnic,Not Hispanic or Latino,1,1,2
437046,Complete abortion,racial,Asian,2,0,2
437165,Motor vehicle traffic accident,racial,Other Race,1,1,2
374914,Quadriplegia,racial,Unknown,0,2,2
376337,Disease of nervous system,racial,Other Race,1,1,2
4103894,Hordeolum and other deep inflammation of eyelid NOS,ethnic,Not Hispanic or Latino,1,1,2
380733,Otalgia,racial,American Indian or Alaska Native ,1,1,2
73017,Congenital anomaly of toe,racial,Unknown,2,0,2
432453,General clinical state finding,racial,Black or African American ,1,1,2
442926,"Motor vehicle traffic accident involving collision with another motor vehicle, parked, driver of motor vehicle injured",racial,Unknown,1,1,2
435492,Nodular lymphoma of intrathoracic lymph nodes,ethnic,Not Hispanic or Latino,0,2,2
199913,Acquired deformity of ankle AND/OR foot,racial,Other Race,2,0,2
76002,Mechanical complication due to breast prosthesis,racial,Unknown,2,0,2
78232,Shoulder joint pain,racial,American Indian,2,0,2
141248,Benign neoplasm of skin of lip,racial,Unknown,2,0,2
433856,Fracture of neck of femur,racial,White,0,2,2
440989,Intermittent explosive disorder,ethnic,Hispanic or Latino,1,1,2
373488,Pupil-sparing third nerve palsy,ethnic,Not Hispanic or Latino,0,2,2
73576,Acquired chest and rib deformity,racial,Unknown,1,1,2
75095,Closed fracture of ankle,racial,Other Race,1,1,2
380103,Retinal detachment with retinal defect,ethnic,Not Hispanic or Latino,1,1,2
72710,Effusion of joint of forearm,racial,Asian,1,1,2
432660,Dentofacial anomaly,racial,White,1,1,2
4092669,Other viral exanthemata,ethnic,Hispanic or Latino,0,2,2
437247,Anaemia of chronic disease,racial,Filipino,0,2,2
435381,Closed fracture of base of thumb,racial,White,1,1,2
4276723,Finding of child weight centiles,racial,Native Hawaiian or Other Pacific Islander ,1,1,2
432525,Thyroid agent adverse reaction,ethnic,Hispanic or Latino,2,0,2
140435,Arrested dental caries,racial,Unknown,1,1,2
433759,Developmental reading disorder,racial,White,1,1,2
435224,Leukopenia,racial,Other Race,1,1,2
134248,Second degree burn of thumb,racial,White,1,1,2
134404,Anal spasm,racial,White,1,1,2
192357,Paralytic ileus,racial,Unknown,2,0,2
437013,"Primary dental caries, pit and fissure origin",ethnic,Not Hispanic or Latino,0,2,2
259849,Pneumonia with infectious diseases EC,ethnic,Not Hispanic or Latino,1,1,2
72715,Exostosis,racial,Unknown,2,0,2
4098297,Unspecified latent schizophrenia,ethnic,Not Hispanic or Latino,1,1,2
24230,Laryngeal FB - foreign body,racial,White,0,2,2
137652,Specific bursitis often of occupational origin,ethnic,Not Hispanic or Latino,0,2,2
373870,Neonatal dacryocystitis and conjunctivitis,ethnic,Hispanic or Latino,0,2,2
193402,Bacterial enteritis,racial,Unknown,1,1,2
380407,Chronic infective otitis externa,racial,Unknown,1,1,2
376104,Posttraumatic headache,racial,Asian,1,1,2
76255,Sprain of iliofemoral ligament,racial,White,1,1,2
376965,Hypertensive retinopathy,racial,Other Race,2,0,2
200470,Varicose veins of vulva AND/OR perineum complicating pregnancy AND/OR puerperium,ethnic,Hispanic or Latino,2,0,2
4096657,Toxic multinodular goitre NOS,racial,White,2,0,2
193308,Congenital anomaly of spleen,racial,Unknown,1,1,2
22856,Polyglandular dysfunction,ethnic,Hispanic or Latino,2,0,2
434890,Repetitive stereotyped movement,ethnic,Not Hispanic or Latino,0,2,2
75555,Viral labyrinthitis,ethnic,Hispanic or Latino,1,1,2
198374,Nodular lymphoma of spleen,racial,White,0,2,2
437226,Malignant neoplasm of nasopharyngeal wall,racial,Unknown,0,2,2
195856,Cholangitis,racial,Unknown,1,1,2
200845,Urinary precipitancy,racial,Other Race,1,1,2
321483,Respiratory complication,racial,White,1,1,2
437589,Pulpitis,ethnic,Hispanic or Latino,2,0,2
200144,Unilateral simple femoral hernia,racial,White,1,1,2
432967,Anemia during pregnancy - baby not yet delivered,racial,Black or African American ,2,0,2
381017,Ametropic amblyopia,racial,Other Race,2,0,2
4291005,VH - Viral hepatitis,ethnic,Hispanic or Latino,1,1,2
196431,Hypersensitivity angiitis,ethnic,Not Hispanic or Latino,2,0,2
140486,Ulcer of calf,racial,Asian,0,2,2
201265,Splenic disorder,racial,Asian,0,2,2
439654,Partial epilepsy with impairment of consciousness,racial,Asian,0,2,2
194149,Hirschsprung disease,racial,Native Hawaiian or Other Pacific Islander ,0,2,2
375278,Acquired stenosis of external ear canal secondary to inflammation,racial,White,1,1,2
73075,Contusion of upper limb,ethnic,Not Hispanic or Latino,1,1,2
192577,Carcinoma in situ of female genital organ,ethnic,Hispanic or Latino,2,0,2
135350,Acute osteomyelitis of the ankle and/or foot,racial,Unknown,1,1,2
373463,Benign cough headache,racial,Unknown,1,1,2
436859,"Insect bite, nonvenomous, of shoulder and upper arm, infected",ethnic,Hispanic or Latino,1,1,2
443913,Congenital anomaly of trachea,racial,Asian,0,2,2
372247,Candidal otomycosis,ethnic,Not Hispanic or Latino,1,1,2
194093,Postcoital bleeding,racial,Asian,2,0,2
436522,Irregular sleep-wake pattern,racial,Black or African American ,0,2,2
315947,Thoracic back sprain,racial,Filipino,1,1,2
432695,Post-term pregnancy,ethnic,Not Hispanic or Latino,1,1,2
439794,CSA - Central sleep apnoea,ethnic,Hispanic or Latino,1,1,2
4233827,Biopsy of lymphatic structure,ethnic,Hispanic or Latino,1,1,2
193136,Acute gonococcal cervicitis,racial,White,2,0,2
435633,Juvenile osteochondrosis of upper extremity,racial,White,2,0,2
444256,Polyp of labia,racial,Unknown,2,0,2
441351,Early onset of delivery - delivered,racial,White,1,1,2
78233,Old disruption of medial collateral ligament,racial,White,1,1,2
78236,Muscle wasting disorder,racial,Asian,1,1,2
373478,Presbyopia,racial,Filipino,1,1,2
443580,Systolic heart failure,racial,Asian,1,1,2
433595,Interstitial edema,racial,Native Hawaiian or Other Pacific Islander ,0,2,2
193809,Melena due to gastrointestinal hemorrhage,racial,Native Hawaiian or Other Pacific Islander ,1,1,2
23808,"Chronic peptic ulcer without hemorrhage, without perforation AND without obstruction",racial,White,1,1,2
441896,Plicated tongue,racial,White,2,0,2
78237,Bicipital tenosynovitis,racial,Other Race,2,0,2
442012,"Mechanical complication of genitourinary device, implant AND/OR graft",racial,Unknown,0,2,2
194964,Aneurysm of splenic artery,racial,Other Race,2,0,2
4175226,Screening for malignant neoplasm of colon,racial,Alaska Native,0,2,2
77335,Known OR suspected fetal abnormality affecting management of mother,racial,White,1,1,2
200671,Benign tumour of renal pelvis,racial,White,2,0,2
443442,Finding of vaginal vault smear result,racial,Asian,2,0,2
314171,Low blood pressure reading,ethnic,Not Hispanic or Latino,1,1,2
373775,Psychophysical visual disturbance,racial,Unknown,2,0,2
440820,Contracture of wrist joint,racial,White,2,0,2
4171556,Ankle ulcer,racial,Black or African American ,0,2,2
80004,Hand injury,racial,Black or African American ,1,1,2
140842,Changes in skin texture,racial,Filipino,1,1,2
77734,Contusion of lower leg,racial,Black or African American ,2,0,2
436353,Primary malignant neoplasm of upper outer quadrant of female breast,racial,White,2,0,2
376382,Tension-type headache,racial,Filipino,2,0,2
4110787,Other otitis externa,racial,Asian,0,2,2
136354,Dermal metastasis,ethnic,Not Hispanic or Latino,0,2,2
432893,Myasthenic syndrome due to another disorder,racial,White,1,1,2
440878,Open wound of jaw without complication,racial,Unknown,2,0,2
4047947,Complete parathyroidectomy,racial,Unknown,2,0,2
443577,Asymmetric sensorineural hearing loss,ethnic,Not Hispanic or Latino,2,0,2
435412,Second degree burn of breast,ethnic,Hispanic or Latino,2,0,2
73026,Abnormal respiratory sounds,racial,Black or African American ,1,1,2
437523,Dependent personality disorder,ethnic,Not Hispanic or Latino,0,2,2
4109564,Unspecified corneal ulcer,ethnic,Hispanic or Latino,2,0,2
441334,Glossodynia,racial,Other Race,2,0,2
77968,Hallux valgus AND bunion,racial,Filipino,2,0,2
197444,Vascular complication of medical care,ethnic,Not Hispanic or Latino,0,2,2
436919,Primary malignant neoplasm of unspecified site,racial,Other Race,1,1,2
444202,Abscess,racial,American Indian,2,0,2
4150481,"Traumatic blister of shoulder and upper arm, infected",ethnic,Hispanic or Latino,2,0,2
442270,Disease of duodenum,ethnic,Not Hispanic or Latino,0,2,2
4326681,Family history of malignant neoplasm of ovary,ethnic,Not Hispanic or Latino,2,0,2
139850,Acute frontal sinusitis,racial,Asian Indian,2,0,2
77129,Closed fracture of pelvis,ethnic,Not Hispanic or Latino,2,0,2
381035,Vertigo of central origin,racial,White,1,1,2
4194056,"Simple partial seizure, consciousness not impaired",ethnic,Hispanic or Latino,0,2,2
437342,Abnormality of forces of labor,ethnic,Hispanic or Latino,2,0,2
200775,Endometrial hyperplasia,racial,Unknown,2,0,2
200051,Primary malignant neoplasm of ovary,racial,Unknown,2,0,2
4120610,Carrier of hereditary factor VIII deficiency disease,racial,White,0,2,2
197724,Unilateral traumatic amputation of foot without complication,racial,White,0,2,2
78909,"Contusion, shoulder and upper arm, multiple sites",ethnic,Not Hispanic or Latino,1,1,2
23865,Congenital abnormality of pharynx,racial,White,2,0,2
197684,Dysuria,racial,Asian Indian,2,0,2
138718,Thyrotoxicosis from ectopic thyroid nodule with no crisis,racial,White,1,1,2
439926,Malaise and fatigue,racial,Asian Indian,0,2,2
440084,Aphemesthaesia,racial,White,1,1,2
440647,Sexually transmitted infectious disease,racial,Black or African American ,0,2,2
4088930,Confirmation of pregnancy,racial,Native Hawaiian or Other Pacific Islander ,2,0,2
435987,Peanut-induced anaphylaxis,ethnic,Hispanic or Latino,0,2,2
201900,Neurogenic bowel,ethnic,Hispanic or Latino,0,2,2
437741,Accidental burning caused by caustic and corrosive substance,racial,Unknown,0,2,2
438761,Acute dacryocystitis,ethnic,Hispanic or Latino,1,1,2
199767,Neoplasm of uncertain behaviour of liver and/or biliary passages,racial,White,2,0,2
381384,Congenital absence of external ear,ethnic,Not Hispanic or Latino,2,0,2
321882,Generalised atherosclerosis,racial,Native Hawaiian or Other Pacific Islander ,0,2,2
376415,Hypermetropia,racial,Black or African American ,2,0,2
200837,Congenital anomaly of fixation of intestine,racial,Asian,2,0,2
4124268,Faecal smear,racial,White,1,1,2
435242,Cerebellar ataxia,ethnic,Not Hispanic or Latino,0,2,2
374498,Concussion with prolonged loss of consciousness AND return to pre-existing conscious level,racial,White,2,0,2
74582,Primary malignant neoplasm of rectum,ethnic,Not Hispanic or Latino,2,0,2
432626,Glaucoma associated with vascular disorder,ethnic,Not Hispanic or Latino,0,2,2
314968,Varices,ethnic,Not Hispanic or Latino,0,2,2
375290,Chronic suppurative otitis media - tubotympanic,ethnic,Hispanic or Latino,1,1,2
434281,Aspergillosis,ethnic,Not Hispanic or Latino,0,2,2
77340,Genitourinary tract infection in pregnancy,racial,Other Race,2,0,2
139955,Open wound of palate without complication,ethnic,Hispanic or Latino,2,0,2
4047947,Complete parathyroidectomy,ethnic,Hispanic or Latino,2,0,2
4025663,Obstructed inguinal hernia,ethnic,Hispanic or Latino,0,2,2
433976,Primary malignant neoplasm of temporal lobe,racial,White,2,0,2
79118,Deformity of calcaneum,ethnic,Not Hispanic or Latino,2,0,2
437259,Disruptive behavior disorder,ethnic,Not Hispanic or Latino,2,0,2
434309,Sexual precocity,racial,Asian,1,1,2
381839,Habit disorder,racial,Other Race,0,2,2
198470,Unilateral inguinal hernia with obstruction but no gangrene,racial,White,0,2,2
133857,Acquired deformity of limb,ethnic,Not Hispanic or Latino,1,1,2
4064359,Cholera screening,ethnic,Hispanic or Latino,0,2,2
201792,Nongonococcal urethritis,ethnic,Hispanic or Latino,1,1,2
318521,Displacement of thoracic intervertebral disc without myelopathy,racial,White,1,1,2
433218,Superficial thrombophlebitis of arm,ethnic,Hispanic or Latino,1,1,2
440856,Open fracture of shaft of femur,racial,White,0,2,2
72404,Joint stiffness,racial,Unknown,1,1,2
378743,Mild nonproliferative retinopathy,racial,Black or African American ,2,0,2
443801,Exercise-induced asthma,racial,Native Hawaiian or Other Pacific Islander ,1,1,2
439655,Symptom: generalized,ethnic,Not Hispanic or Latino,0,2,2
441947,Posttraumatic state,racial,White,2,0,2
133351,Open wound of cheek without complication,racial,White,1,1,2
375258,Photokeratitis,racial,White,1,1,2
381031,Alternating esotropia,ethnic,Hispanic or Latino,2,0,2
441081,Maternal gonorrhoea during pregnancy - baby not yet delivered,ethnic,Hispanic or Latino,2,0,2
4066260,Galactorrhea in pregnancy and the puerperium,racial,Unknown,2,0,2
436350,Schistosoma hematobium infection,ethnic,Hispanic or Latino,2,0,2
74740,Accessory digit,racial,White,0,2,2
321320,Myocardial degeneration,ethnic,Hispanic or Latino,2,0,2
439790,Psychalgia,racial,White,1,1,2
377888,CHL - Conductive hearing loss,racial,Other Race,0,2,2
443421,Gallbladder and bile duct calculi,ethnic,Hispanic or Latino,2,0,2
439717,Active cochleovestibular Meniere's disease,racial,White,0,2,2
442012,"Mechanical complication of genitourinary device, implant AND/OR graft",ethnic,Hispanic or Latino,0,2,2
4062801,Threatened abortion NOS,racial,Unknown,2,0,2
198446,Embolism and thrombosis of the abdominal aorta,racial,Unknown,2,0,2
4148407,Family history: Cardiovascular disease,racial,Black or African American ,1,1,2
314962,Raynaud disease,racial,Other Race,1,1,2
376131,Tympanic membrane conductive hearing loss,racial,White,1,1,2
134718,Hirsutism,racial,Other Race,2,0,2
373179,Senile degeneration of brain,racial,Unknown,0,2,2
72786,Burn of finger,racial,White,2,0,2
4171594,Family history of cancer,racial,Unknown,2,0,2
436140,Vulval varices,ethnic,Not Hispanic or Latino,1,1,2
434316,von Willebrand disorder,ethnic,Not Hispanic or Latino,2,0,2
136916,Primary malignant neoplasm of skin of external auditory canal,racial,White,1,1,2
78605,Superficial bruising of elbow,racial,Other Race,2,0,2
437382,Urine observation,racial,Asian Indian,2,0,2
440142,Disease of mediastinum,ethnic,Hispanic or Latino,2,0,2
442286,Abscess of digit,racial,Asian Indian,2,0,2
80204,IUGR - Intrauterine growth retardation,ethnic,Hispanic or Latino,1,1,2
441025,Stenosis of lacrimal canaliculi,racial,Other Race,0,2,2
4034214,Open wound of ear,racial,Unknown,1,1,2
434752,Positive serological AND/OR viral culture findings for human immunodeficiency virus,racial,American Indian,0,2,2
444038,Psychoactive substance-induced organic mood disorder,racial,White,1,1,2
4177115,Malignant tumour of testis,ethnic,Not Hispanic or Latino,0,2,2
4038835,HD - Hodgkin's disease,ethnic,Hispanic or Latino,1,1,2
444419,Quadriparesis,ethnic,Not Hispanic or Latino,0,2,2
4188027,Food allergy,racial,Asian,1,1,2
440012,Fall from chair or bed,racial,Asian,0,2,2
75580,Chronic ulcerative proctitis,racial,Unknown,0,2,2
437262,Common peroneal nerve lesion,ethnic,Hispanic or Latino,2,0,2
437104,"Abnormal smear, noted, recall delete",ethnic,Not Hispanic or Latino,2,0,2
379012,Monoplegia of upper limb,ethnic,Not Hispanic or Latino,2,0,2
438039,Injury caused by animal,racial,Asian,0,2,2
432626,Glaucoma associated with vascular disorder,racial,Asian,0,2,2
435262,Primary open angle glaucoma,racial,Asian,1,1,2
444455,Benign tumour of soft tissue of head,racial,White,0,2,2
140823,Acquired musculoskeletal deformity,racial,White,1,1,2
441918,"Emotional AND/OR mental disease in mother complicating pregnancy, childbirth AND/OR puerperium",racial,Black or African American ,2,0,2
194083,Vaginitis and vulvovaginitis,racial,American Indian,2,0,2
198363,Candidiasis of vagina,racial,Filipino,2,0,2
435138,Injury of femoral nerve,ethnic,Hispanic or Latino,1,1,2
40483107,Inflamed seborrheic keratosis,ethnic,Not Hispanic or Latino,2,0,2
380733,Otalgia,racial,American Indian,1,1,2
434480,Syndrome of infant of diabetic mother,racial,Other Race,2,0,2
141917,Balanitis xerotica obliterans,racial,Other Race,0,2,2
201613,Chronic nonalcoholic liver disease,racial,Black or African American ,2,0,2
376984,Conjunctival cyst,ethnic,Hispanic or Latino,1,1,2
140020,Viral exanthem,racial,Asian,1,1,2
373488,Pupil-sparing third nerve palsy,racial,Other Race,0,2,2
440694,"Nondependent mixed drug abuse, episodic",racial,Unknown,2,0,2
432551,Parvovirus infection,racial,White,0,2,2
75865,Disorder of the urinary system,racial,Unknown,1,1,2
78619,"Contusion, knee",racial,Asian,1,1,2
438172,Atrial septal defect as current complication following acute myocardial infarction,racial,White,2,0,2
435758,Burkitt's tumor of extranodal AND/OR solid organ site,racial,White,1,1,2
4302543,Insertion of prosthesis or prosthetic device of femoral head,ethnic,Hispanic or Latino,2,0,2
77358,Observation of hand region,racial,Unknown,1,1,2
376405,Binocular vision disorder,racial,White,0,2,2
436228,Fetal death due to termination of pregnancy,ethnic,Hispanic or Latino,2,0,2
200772,Gastroenteritis due to radiation,racial,White,1,1,2
432587,Polyclonal hypergammaglobulinemia,racial,White,2,0,2
27017,Defective dental restoration,racial,Unknown,1,1,2
4119298,Late onset asthma,racial,American Indian or Alaska Native ,0,2,2
433656,Abnormal patient reaction,racial,Unknown,1,1,2
435018,Twin pregnancy - delivered,ethnic,Hispanic or Latino,2,0,2
435397,Seq of effects foreign body entering through natural orifice,ethnic,Hispanic or Latino,2,0,2
440202,Multiple congenital malformations,racial,Black or African American ,0,2,2
437088,Fetus OR newborn affected by oligohydramnios,ethnic,Hispanic or Latino,2,0,2
4062557,False labor,ethnic,Hispanic or Latino,2,0,2
200769,"Chronic gastric ulcer without hemorrhage, without perforation AND without obstruction",racial,Unknown,2,0,2
194847,Mechanical complication due to urethral indwelling catheter,racial,Unknown,0,2,2
74464,Idiopathic scoliosis AND/OR kyphoscoliosis,racial,American Indian or Alaska Native ,1,1,2
439907,Spontaneous tendon rupture,racial,Other Race,2,0,2
76545,Closed traumatic dislocation of patella,ethnic,Not Hispanic or Latino,1,1,2
444401,Delusions,racial,White,1,1,2
77317,Chronic ulcerative rectosigmoiditis,ethnic,Not Hispanic or Latino,2,0,2
434019,"Nondependent cannabis abuse, continuous",ethnic,Not Hispanic or Latino,1,1,2
4112816,Other respiratory system diseases,racial,American Indian,2,0,2
260315,Tuberculosis of lung with cavitation,racial,White,2,0,2
436485,Hyperemesis gravidarum with metabolic disturbance,ethnic,Hispanic or Latino,2,0,2
141213,Scarlet fever,racial,Black or African American ,1,1,2
201078,Senile atrophic vaginitis,racial,Asian,2,0,2
440697,Nonaggressive unsocial conduct disorder,ethnic,Not Hispanic or Latino,1,1,2
434143,Anophthalmos,ethnic,Hispanic or Latino,1,1,2
442425,Lumbar post-laminectomy syndrome,racial,Other Race,0,2,2
72993,Primary localised osteoarthrosis,racial,Other Race,2,0,2
372605,Spinal muscular atrophy,racial,White,0,2,2
4008089,Dysentery,ethnic,Not Hispanic or Latino,2,0,2
194149,Hirschsprung disease,ethnic,Not Hispanic or Latino,0,2,2
440085,Schizoid personality disorder,racial,White,0,2,2
74855,Genital herpes simplex,racial,Filipino,1,1,2
80951,Candidiasis of urogenital site,racial,Asian,1,1,2
374384,Cerebral ischemia,ethnic,Not Hispanic or Latino,0,2,2
437186,Hypothermia - accidental,racial,White,1,1,2
4169658,No help available,ethnic,Hispanic or Latino,1,1,2
73872,Congenital deformity of knee joint,ethnic,Hispanic or Latino,1,1,2
4024567,Respiratory observation,racial,Asian,2,0,2
74188,Closed fracture of rib,racial,Other Race,1,1,2
77960,Joint observation,racial,Asian,2,0,2
432860,Benign tumor of epipharynx,ethnic,Hispanic or Latino,2,0,2
134453,Inflammation of bursa,racial,Asian,0,2,2
435299,Failure of dental prosthesis,ethnic,Not Hispanic or Latino,0,2,2
134619,Toxic nodular goiter,ethnic,Not Hispanic or Latino,2,0,2
434073,Loss of teeth - acquired,racial,Other Race,2,0,2
435644,Metatarsal bone fracture,ethnic,Not Hispanic or Latino,0,2,2
200485,Decubitus ulcer of buttock,racial,Other Race,0,2,2
198645,Third degree burn of lower limb,ethnic,Hispanic or Latino,0,2,2
441321,Chronic nasopharyngitis,racial,Unknown,2,0,2
313502,Benign hypertensive heart disease without congestive heart failure,racial,Asian,2,0,2
79072,Inflammatory disorder of breast,racial,American Indian or Alaska Native ,2,0,2
72404,Joint stiffness,ethnic,Not Hispanic or Latino,2,0,2
435381,Closed fracture of base of thumb,ethnic,Hispanic or Latino,0,2,2
73673,Disorder of prosthetic joint,racial,White,2,0,2
139188,Open wound of scalp without complication,racial,American Indian or Alaska Native ,0,2,2
432672,Fissure of nipple,racial,White,1,1,2
442530,Broken tooth injury with complication,ethnic,Not Hispanic or Latino,1,1,2
4103574,Chronic depression,racial,Other Race,2,0,2
433985,Hypercarotinemia,racial,Asian,0,2,2
440009,Complication of implant,racial,Asian,2,0,2
319843,Mitral valve disorder,racial,Native Hawaiian or Other Pacific Islander ,0,2,2
72374,Unstable lie with antenatal problem,racial,Asian,2,0,2
200524,Perinatal digestive system disorders,ethnic,Hispanic or Latino,0,2,2
440083,Acute stress disorder,racial,Other Race,2,0,2
443752,Ventricular hemorrhage,ethnic,Hispanic or Latino,2,0,2
433227,Abnormal sensation,racial,Unknown,1,1,2
436098,Nondependent cocaine abuse in remission,ethnic,Not Hispanic or Latino,1,1,2
434033,Chorioretinitis,racial,White,0,2,2
380818,Acquired deformity of head,racial,Unknown,0,2,2
438106,"Reticulosarcoma of lymph nodes of head, face and neck",ethnic,Hispanic or Latino,1,1,2
4340380,Hepatitis C carrier,racial,Black or African American ,1,1,2
254662,Pulmonary infarction,racial,Black or African American ,2,0,2
4062921,Asymptomatic bacteriuria in pregnancy unspecified,racial,White,2,0,2
201820,Diabetes mellitus,racial,Filipino,0,2,2
435755,Primary malignant neoplasm of skin of eyelid,racial,White,2,0,2
199879,Fistula of the female genital organs,ethnic,Hispanic or Latino,2,0,2
381839,Habit disorder,racial,Black or African American ,0,2,2
254320,Cystic fibrosis of the lung,ethnic,Hispanic or Latino,2,0,2
196733,Urethral syndrome,ethnic,Not Hispanic or Latino,2,0,2
193517,Bile duct calculus with no mention of cholecystitis and with obstruction,racial,Unknown,1,1,2
78516,Arthralgia of the upper arm,racial,Native Hawaiian or Other Pacific Islander ,1,1,2
443677,Open wound of knee and/or leg and/or ankle,racial,Other Race,1,1,2
444124,Class III malocclusion,ethnic,Hispanic or Latino,1,1,2
377286,VFD - Visual field defect,racial,Other Race,0,2,2
196468,Acute salpingo-oophoritis,racial,White,1,0,1
4194056,"Simple partial seizure, consciousness not impaired",racial,White,1,0,1
74747,Acquired genu recurvatum,ethnic,Not Hispanic or Latino,0,1,1
30437,Gastroesophageal reflux disease with esophagitis,racial,Filipino,1,0,1
132397,Pilonidal cyst with no abscess,racial,Asian,0,1,1
76737,Hydrocele,racial,White,0,1,1
432795,Traumatic AND/OR non-traumatic injury,racial,Black or African American ,1,0,1
375274,Monocular exotropia,racial,Unknown,1,0,1
4053383,Family history of glaucoma,racial,White,1,1,2
4147635,Unspecified otorrhea,ethnic,Hispanic or Latino,0,1,1
4330220,Family history of malignant neoplasm of genital structure,racial,Unknown,1,0,1
133298,Musculoskeletal disorder of the neck,racial,Black or African American ,1,1,2
195392,Laceration of liver,racial,White,1,0,1
441564,Optic disc oedema associated with retinal disorder,ethnic,Hispanic or Latino,1,0,1
4062653,Gout screening,racial,Unknown,1,1,2
4051564,FH: Metabolic disorder,racial,Other Race,1,0,1
4153751,Ear - 2nd degree burn,ethnic,Hispanic or Latino,1,0,1
439297,Nuclear senile cataract,racial,Black or African American ,1,0,1
4310768,Fall on steps,racial,American Indian or Alaska Native ,1,0,1
438422,Primary iridocyclitis,ethnic,Not Hispanic or Latino,0,1,1
4103906,Lacrimal system disorder NOS,racial,Unknown,1,0,1
4242720,Intracranial hematoma following injury,racial,Unknown,0,1,1
4194895,Screening for disorder,racial,Filipino,1,0,1
4110499,Allergic rhinitis NOS,racial,American Indian or Alaska Native ,0,1,1
441906,Prolapse of urethra,ethnic,Hispanic or Latino,1,0,1
4108055,Other forms of retinal detachment,racial,White,1,1,2
133141,Tinea pedis,racial,American Indian,0,1,1
436936,Benign neoplasm of cranial nerve,ethnic,Hispanic or Latino,1,0,1
4302543,Insertion of prosthesis or prosthetic device of femoral head,ethnic,Not Hispanic or Latino,0,1,1
4147164,Hematologic malignancy,racial,Other Race,1,0,1
200215,Abdominal rigidity,racial,White,1,1,2
442558,"Gestation period, 32 weeks",racial,Black or African American ,0,1,1
4059635,Work maladjustment problem,racial,White,1,0,1
138384,Acquired hypothyroidism,racial,American Indian or Alaska Native ,1,0,1
440589,Toxic effect of caustic substance,ethnic,Hispanic or Latino,1,0,1
4169641,Developmental handicap screening,ethnic,Not Hispanic or Latino,1,1,2
434413,Incomplete spontaneous abortion with complication,racial,White,1,0,1
26441,Bleeding ulcer of esophagus,racial,Unknown,0,1,1
444285,Acquired equinovarus deformity,ethnic,Not Hispanic or Latino,1,0,1
4268980,Finding of general development,ethnic,Not Hispanic or Latino,1,0,1
4024013,Sensory nervous system finding,racial,Asian,0,1,1
438329,Late effect of motor vehicle accident,racial,Black or African American ,1,1,2
437838,"Cannabis dependence, episodic",ethnic,Not Hispanic or Latino,1,0,1
4064906,Bacterial conjunctivitis screening,racial,White,0,1,1
441947,Posttraumatic state,racial,Black or African American ,0,1,1
141934,Degenerative skin disorder,ethnic,Hispanic or Latino,1,1,2
80471,Disorder of lactation,racial,White,1,0,1
438788,Hypertrophy of adenoids,racial,Unknown,1,1,2
380126,Rheumatic chorea with heart involvement,racial,White,0,1,1
4206460,Problem,racial,Filipino,1,0,1
437643,Gait abnormality,racial,Filipino,1,0,1
381864,Subjective tinnitus,ethnic,Not Hispanic or Latino,1,0,1
313006,Congenital stenosis of mitral valve,ethnic,Hispanic or Latino,0,1,1
377877,Convergent squint,racial,Asian Indian,1,0,1
433092,Burn of multiple sites of wrist AND/OR hand,ethnic,Hispanic or Latino,1,0,1
4194056,"Simple partial seizure, consciousness not impaired",ethnic,Not Hispanic or Latino,1,0,1
374950,Oedema of eyelid,racial,Asian,1,0,1
197050,Abnormality of organs AND/OR soft tissues of pelvis affecting pregnancy,racial,White,1,0,1
80805,Primary localized osteoarthrosis of forearm,racial,American Indian or Alaska Native ,1,0,1
196341,Dermatophytosis of the perianal area,racial,American Indian,0,1,1
137488,E. coli septicemia,racial,Unknown,1,0,1
4145492,Other peripheral vascular disease,racial,White,1,1,2
379820,No colour perception,racial,Black or African American ,0,1,1
201674,Congenital anomaly of pancreas,racial,White,1,1,2
372646,"Peripheral pterygium, stationary",racial,Unknown,0,1,1
438398,Leukocytosis,racial,Asian Indian,1,0,1
4111255,Unspecified labyrinthitis,ethnic,Not Hispanic or Latino,0,1,1
378253,HA - Headache,racial,American Indian,1,1,2
4104857,Automatism petit mal,racial,White,1,0,1
4070671,"Middle ear anomaly, excluding ossicles",racial,White,1,0,1
4311591,Cramp in limb,racial,Filipino,0,1,1
254062,Acute chest syndrome,ethnic,Hispanic or Latino,1,1,2
253549,Connective tissue disease,ethnic,Not Hispanic or Latino,1,0,1
433752,Impulse control disorder,racial,White,1,0,1
4104050,Other specified strabismus NOS,ethnic,Hispanic or Latino,0,1,1
4064929,Genitourinary disease screening,ethnic,Hispanic or Latino,0,1,1
28060,Strept throat,racial,Native Hawaiian or Other Pacific Islander ,1,1,2
4030872,Hyperemesis of pregnancy,ethnic,Hispanic or Latino,1,0,1
375539,Haemophthalmos without current injury,racial,Unknown,1,0,1
134460,Plantar fascial fibromatosis,racial,Native Hawaiian or Other Pacific Islander ,1,0,1
440081,Barbiturate dependence,racial,Asian,1,0,1
76304,Burn of upper arm,ethnic,Hispanic or Latino,1,0,1
375077,Sensory inattention,racial,White,1,0,1
436173,Hyperemesis gravidarum with metabolic disturbance - delivered,ethnic,Hispanic or Latino,1,0,1
77642,Arthralgia of the forearm,racial,American Indian,1,0,1
432302,Cocaine dependence in remission,racial,Black or African American ,0,1,1
433095,Fall on or from steps,racial,Asian,0,1,1
373503,Intermittent cerebral ischaemia,racial,Filipino,1,0,1
432589,Neutropenia associated with infectious disease,racial,White,0,1,1
441737,Bruising,racial,Asian Indian,1,1,2
438410,[X]Psychogenic dysuria,ethnic,Hispanic or Latino,1,0,1
200962,Primary malignant neoplasm of prostate,racial,Asian Indian,0,1,1
133280,Alopecia,racial,American Indian or Alaska Native ,1,0,1
380103,Retinal detachment with retinal defect,racial,Other Race,1,0,1
40482203,Karyotype evaluation abnormal,ethnic,Not Hispanic or Latino,1,0,1
439654,Partial epilepsy with impairment of consciousness,racial,Unknown,1,0,1
432730,Dysphonia,racial,Filipino,0,1,1
374653,Neurologic disorder of eye movements,racial,White,1,1,2
138340,Septicaemia due to Staphylococcus aureus,racial,Unknown,0,1,1
374886,Benign neoplasm of ear,racial,White,1,1,2
200671,Benign tumour of renal pelvis,ethnic,Hispanic or Latino,1,0,1
376387,Spasmodic torticollis,racial,Unknown,0,1,1
201347,Pelvic pain syndrome,racial,Other Race,1,0,1
27516,Neoplasm of uncertain behaviour of paraganglion,ethnic,Hispanic or Latino,1,0,1
434303,Benign neoplasm of rectum and anal canal,ethnic,Not Hispanic or Latino,0,1,1
141941,Cervical spondylosis without myelopathy,racial,Other Race,1,0,1
317585,Aortic aneurysm,racial,Asian,0,1,1
442116,Allergy to eggs,racial,Asian,0,1,1
135424,Foreign body in mouth,racial,White,1,1,2
374375,Impacted cerumen,racial,American Indian,1,1,2
435088,Senility,racial,Other Race,1,1,2
77178,Contusion of multiple sites of upper limb,racial,White,1,0,1
440207,Hypoplastic left heart syndrome,racial,Unknown,1,0,1
134757,Ectodermal dysplasia,racial,White,0,1,1
315558,Atherosclerosis of arteries of the extremities,racial,Filipino,0,1,1
4168396,Dilation of cervix uteri and curettage for termination of pregnancy,ethnic,Hispanic or Latino,1,0,1
438879,Closed bimalleolar fracture,racial,Black or African American ,1,0,1
78888,Open fracture of ankle,ethnic,Not Hispanic or Latino,1,0,1
4182210,Dementia,ethnic,Not Hispanic or Latino,1,0,1
4173811,Congenital quadriplegia,racial,Other Race,1,0,1
439901,Chondrocalcinosis due to pyrophosphate crystals,ethnic,Hispanic or Latino,1,0,1
380038,Viral conjunctivitis,racial,Other Race,1,1,2
197717,Open wound of anterior abdominal wall without complication,ethnic,Not Hispanic or Latino,0,1,1
433946,Fall on same level due to impact against another person,racial,Black or African American ,0,1,1
141651,Stevens-Johnson syndrome,racial,Unknown,1,0,1
438120,Opioid dependence,racial,Asian,1,0,1
318556,Nosebleed,racial,American Indian or Alaska Native ,0,1,1
437477,[X]Fall involving playground equipment,racial,Unknown,1,1,2
135424,Foreign body in mouth,ethnic,Hispanic or Latino,1,1,2
436799,Talipes cavus,ethnic,Not Hispanic or Latino,1,1,2
318775,Venous embolism,racial,Asian,1,0,1
442764,Anal pain,racial,Black or African American ,0,1,1
434376,Acute myocardial infarction of anterior wall,racial,White,1,0,1
26727,Vomiting blood,racial,Black or African American ,0,1,1
436231,Abnormal findings diagnostic imaging of liver and biliary tract,ethnic,Not Hispanic or Latino,1,0,1
440972,Medulloadrenal hyperfunction,ethnic,Not Hispanic or Latino,0,1,1
76777,Arthropathy associated with infection,racial,Unknown,1,0,1
201998,Unilateral traumatic amputation of leg at OR above knee without complication,racial,Asian,1,0,1
4297975,Manual rupture of ovarian cyst,ethnic,Hispanic or Latino,1,0,1
200974,Carcinoma in situ of stomach,racial,Unknown,1,0,1
437483,Homicide or assault by unarmed fight or brawl,ethnic,Hispanic or Latino,1,0,1
375529,Infantile cerebral palsy,racial,Other Race,0,1,1
316084,Lymphadenitis,racial,Asian,1,1,2
195901,Osteomyelitis of pelvic region,ethnic,Hispanic or Latino,0,1,1
76786,Derangement of knee,racial,Native Hawaiian or Other Pacific Islander ,0,1,1
192674,Allergic gastroenteritis and colitis,racial,White,1,0,1
442793,Diabetic complication,racial,American Indian,1,0,1
198846,Enthesopathy of hip region,racial,Other Race,1,0,1
436147,Glossitis,ethnic,Not Hispanic or Latino,1,0,1
433949,Human bite,racial,Unknown,0,1,1
438052,Accident due to excessive cold,racial,White,1,1,2
373870,Neonatal dacryocystitis and conjunctivitis,racial,White,0,1,1
199991,Complication of transplanted kidney,racial,Asian,1,0,1
4109276,Other lacrimal system disorder,ethnic,Hispanic or Latino,1,0,1
73291,Palindromic rheumatism of the ankle and/or foot,racial,Filipino,0,1,1
72737,Microcalcifications of the breast,racial,Filipino,1,0,1
73036,Closed fracture of olecranon process of ulna,racial,Other Race,0,1,1
444405,Open multiple fractures of lower limb with ribs AND sternum,racial,White,1,0,1
4305080,Abnormal breathing,racial,Other Race,1,1,2
4109559,"Better eye: severe visual impairment, Lesser eye: severe visual impairment",racial,White,1,0,1
4204966,Regurgitant esophagitis,racial,Unknown,1,1,2
381118,Congenital vascular anomaly of eye,ethnic,Hispanic or Latino,1,1,2
442942,"Crush injury, toe(s)",ethnic,Not Hispanic or Latino,1,0,1
435792,Drug-induced sleep disorder,racial,White,1,1,2
441488,Adverse reaction to substance,racial,White,0,1,1
4204989,Disturbance in sleep behavior,ethnic,Hispanic or Latino,1,1,2
438731,Fat pad,ethnic,Not Hispanic or Latino,1,0,1
80778,Genitourinary tract infection in pregnancy - delivered with postnatal complication,ethnic,Hispanic or Latino,1,0,1
74582,Primary malignant neoplasm of rectum,racial,Other Race,1,0,1
260754,Haemophilus influenzae pneumonia,ethnic,Hispanic or Latino,0,1,1
433107,Injury of unknown intent by explosive,racial,White,0,1,1
135858,Disorder of lip,racial,Black or African American ,0,1,1
253234,Upper respiratory inflammation due to fumes AND/OR vapors,racial,Unknown,0,1,1
135061,Congenital anomaly of musculoskeletal system,racial,Asian,1,0,1
313500,Acute rheumatic heart disease,racial,Other Race,1,0,1
320798,Parapsoriasis,ethnic,Hispanic or Latino,1,0,1
4294569,Cervico-facial actinomycosis,ethnic,Hispanic or Latino,1,0,1
314965,Embolism and thrombosis of an arm or leg artery,racial,Unknown,1,0,1
75091,Closed fracture of carpal bone,racial,Asian,1,0,1
438052,Accident due to excessive cold,ethnic,Hispanic or Latino,1,1,2
4005743,Female sterility,racial,American Indian or Alaska Native ,1,0,1
432800,Assault by cutting and stabbing instruments,racial,White,0,1,1
439237,Assault,ethnic,Not Hispanic or Latino,1,0,1
321876,Disease of capillaries,racial,White,0,1,1
440760,Inflammatory disorder of jaw,racial,Other Race,0,1,1
4110806,Other peripheral vertigo NOS,ethnic,Hispanic or Latino,1,0,1
133714,Malignant melanoma of skin of trunk,ethnic,Hispanic or Latino,1,0,1
441764,Inhalation or ingestion of foreign body with respiratory obstruction or suffocation,ethnic,Hispanic or Latino,1,0,1
4112534,Chronic laryngitis and laryngotracheitis,racial,Asian,0,1,1
74505,Closed subtrochanteric fracture,racial,Unknown,0,1,1
192438,Abdominal mass,racial,Asian,1,0,1
197593,Impaction of intestine,racial,White,1,1,2
312950,IgE-mediated allergic asthma,racial,Filipino,1,1,2
4058422,H/O: asbestos exposure,ethnic,Hispanic or Latino,1,0,1
432574,Diffuse malignant lymphoma - histiocytic,racial,White,0,1,1
22492,Pharyngeal FB - foreign body,racial,White,1,0,1
4129665,Hearing aid care,ethnic,Not Hispanic or Latino,1,1,2
137977,Icteric,racial,Black or African American ,0,1,1
4305589,"Neoplasm, benign",racial,Asian,0,1,1
436839,Closed fracture of metacarpal bone,racial,American Indian or Alaska Native ,0,1,1
27918,Eosinophilic esophagitis,racial,Black or African American ,0,1,1
374139,Buphthalmos,ethnic,Hispanic or Latino,1,1,2
4295261,Postmenopausal state,racial,Black or African American ,1,0,1
4110505,Chest infection - other bacterial pneumonia,racial,Unknown,1,0,1
438028,Poisoning by drug AND/OR medicinal substance,ethnic,Not Hispanic or Latino,1,1,2
201347,Pelvic pain syndrome,ethnic,Not Hispanic or Latino,1,0,1
443723,Finding of cellular component of blood,racial,Unknown,1,0,1
4141481,"Hand, foot and mouth disease",racial,Asian,0,1,1
201254,Insulin dependent diabetes mellitus,racial,Native Hawaiian or Other Pacific Islander ,1,0,1
78508,Arthralgia of the ankle and/or foot,racial,Filipino,1,0,1
377889,Hearing loss,racial,American Indian,1,0,1
4283892,Placement of stents in coronary artery,ethnic,Hispanic or Latino,1,0,1
133547,Pyoderma,racial,White,1,1,2
4329847,MI - Myocardial infarction,ethnic,Not Hispanic or Latino,0,1,1
435394,Intracranial hemorrhage following injury,ethnic,Not Hispanic or Latino,0,1,1
24075,Esophageal stricture and stenosis,racial,Unknown,1,1,2
435935,Body substance analysis finding,ethnic,Not Hispanic or Latino,1,1,2
433243,Anomaly of tooth position,ethnic,Hispanic or Latino,1,1,2
378726,Alcoholic dementia,racial,White,0,1,1
378756,Conjunctival hemorrhage,racial,Filipino,1,0,1
200447,Gastrointestinal complication,ethnic,Not Hispanic or Latino,1,0,1
198192,Renal and perinephric abscess,ethnic,Not Hispanic or Latino,1,0,1
197417,Injury of ureter with open wound into abdominal cavity,racial,Native Hawaiian or Other Pacific Islander ,1,0,1
440989,Intermittent explosive disorder,racial,White,1,0,1
135360,Fainting,racial,Alaska Native,1,0,1
201350,Placental abruption - not delivered,racial,White,0,1,1
259070,PGN - Acute proliferative glomerulonephritis,racial,White,1,0,1
141771,"Injury undetermined whether accidentally or purposely inflicted, by crashing of motor vehicle",racial,White,0,1,1
434327,Cannabis abuse,racial,Black or African American ,0,1,1
78474,Hypertrophy of breast,racial,Other Race,1,0,1
432876,Bipolar I disorder,racial,Asian,1,1,2
319054,Thrombophlebitis of upper extremities,racial,Asian,1,0,1
441834,"Bipolar affective disorder, currently manic, mild",racial,Black or African American ,1,0,1
4303805,Allergic reaction to bite and/or sting,racial,Unknown,1,1,2
139980,Burn erythema of forearm,racial,Asian,1,0,1
197723,Open wound of lateral abdominal wall without complication,racial,White,0,1,1
4148076,Chronic neurogenic ulcer of lower limb,ethnic,Not Hispanic or Latino,1,0,1
435011,Vulvar vestibulitis,racial,Unknown,1,0,1
434089,Antepartum hemorrhage,racial,White,1,0,1
4252594,Subconjunctival injection,ethnic,Not Hispanic or Latino,1,1,2
4273391,Suicidal thoughts,racial,Asian,0,1,1
439348,Pregnancy complications,ethnic,Not Hispanic or Latino,1,0,1
195769,Submucous uterine leiomyoma,racial,Unknown,1,0,1
373347,Subdural hemorrhage following injury without open intracranial wound AND with concussion,racial,White,0,1,1
138176,Acute gingivitis,racial,Other Race,1,1,2
194439,Obstetric perineal wound disruption,ethnic,Hispanic or Latino,1,0,1
4056770,Breast signs and symptoms,racial,White,1,0,1
372320,Impairment level: one eye: total impairment: other eye: near-normal vision,ethnic,Hispanic or Latino,0,1,1
442565,Gestational edema without hypertension,racial,American Indian or Alaska Native ,1,0,1
438390,Benign tumour of vulva,ethnic,Not Hispanic or Latino,1,0,1
380097,Diabetic macular edema,racial,Other Race,1,1,2
372765,Open wound of head without complication,racial,Black or African American ,0,1,1
4060813,Cystitis NOS,racial,White,1,1,2
201344,Vesico-intestinal fistula,ethnic,Not Hispanic or Latino,0,1,1
433243,Anomaly of tooth position,racial,White,1,1,2
380500,Hypertrophy of fat pad of knee,racial,Unknown,0,1,1
77963,Achilles tendinitis,racial,Other Race,1,0,1
193308,Congenital anomaly of spleen,racial,Black or African American ,0,1,1
441922,Transient hypertension of pregnancy,ethnic,Hispanic or Latino,1,0,1
437839,Pica,ethnic,Not Hispanic or Latino,1,1,2
4109276,Other lacrimal system disorder,racial,White,1,0,1
80862,"Closed fractures of phalanx or phalanges, multiple sites",ethnic,Hispanic or Latino,1,0,1
194755,Abdominal tenderness of left lower quadrant,racial,Unknown,1,1,2
438767,Posterior staphyloma,ethnic,Hispanic or Latino,0,1,1
444112,Integumentary system finding,racial,Native Hawaiian or Other Pacific Islander ,1,0,1
441697,Open fracture of radius,racial,White,1,1,2
434782,Closed fracture of tibia AND fibula,ethnic,Not Hispanic or Latino,1,1,2
434613,Generalized anxiety disorder,racial,Filipino,1,1,2
200671,Benign tumour of renal pelvis,racial,Black or African American ,0,1,1
76491,Obstetric non-purulent mastitis with antenatal complication,racial,Unknown,1,0,1
74816,Contusion of toe,racial,Black or African American ,1,1,2
4001802,"Other muscle, ligament and fascia disorder",ethnic,Hispanic or Latino,0,1,1
437273,Glaucoma capsulare,racial,Unknown,1,0,1
377861,Disorder of refraction AND/OR accommodation,racial,American Indian,0,1,1
4066820,Ingestion dermatitis due to food,racial,American Indian or Alaska Native ,1,0,1
436485,Hyperemesis gravidarum with metabolic disturbance,racial,White,1,0,1
4108975,Borderline glaucoma NOS,ethnic,Not Hispanic or Latino,1,0,1
438284,Sprain of chondrosternal joint,racial,Unknown,1,1,2
4290927,Impairment level: low vision of both eyes,racial,Asian,1,1,2
194699,Liver disorder in pregnancy,ethnic,Not Hispanic or Latino,1,0,1
442170,Blister of neck with infection,ethnic,Hispanic or Latino,1,0,1
4147494,Nonspecific mesenteric adenitis,racial,White,1,1,2
4154616,Family history: Mental retardation,ethnic,Hispanic or Latino,1,0,1
440453,Incomplete legal abortion with delayed or excessive haemorrhage,ethnic,Hispanic or Latino,1,0,1
438557,Abnormal glucose level,racial,Asian Indian,1,1,2
444274,Massive parenchymal disruption of spleen without open wound into abdominal cavity,racial,White,0,1,1
441680,Fetus OR newborn affected by multiple pregnancy,ethnic,Not Hispanic or Latino,1,0,1
433195,Transient arterial retinal occlusion,ethnic,Not Hispanic or Latino,1,0,1
78842,Acquired postural lordosis,ethnic,Not Hispanic or Latino,1,0,1
4086928,IUCD status,racial,Black or African American ,1,0,1
377678,EEG abnormality,racial,White,0,1,1
77310,Deep vein phlebitis and thrombophlebitis of the leg,racial,Other Race,1,1,2
135699,Burn any degree involving 10-19 percent of body surface,racial,Unknown,1,1,2
136025,Gp B streptococcal septicemia,ethnic,Not Hispanic or Latino,1,0,1
133613,Closed traumatic dislocation of tarsometatarsal joint,racial,White,1,0,1
201519,Ca liver - primary,racial,Unknown,0,1,1
195464,Epidemic pleurodynia,ethnic,Hispanic or Latino,0,1,1
312723,Congenital heart disease,racial,Native Hawaiian or Other Pacific Islander ,1,0,1
135057,Nonallopathic lesion of sacral region,ethnic,Hispanic or Latino,1,0,1
433600,"Problem, abnormal test",ethnic,Not Hispanic or Latino,1,1,2
375393,Laceration of skin of eyelid AND periocular area,racial,Unknown,0,1,1
441266,Thiamin deficiency,racial,Unknown,0,1,1
77358,Observation of hand region,ethnic,Not Hispanic or Latino,1,1,2
374912,Leukodystrophy,ethnic,Not Hispanic or Latino,1,0,1
81144,Sprain of medial collateral ligament of knee,racial,Other Race,1,0,1
4015843,Gonorrhea carrier,ethnic,Not Hispanic or Latino,0,1,1
134276,Cutaneous actinomycosis,racial,White,1,1,2
77642,Arthralgia of the forearm,racial,Filipino,0,1,1
200831,Congenital anomaly of penis,ethnic,Not Hispanic or Latino,0,1,1
4062491,Anemia screening,ethnic,Not Hispanic or Latino,1,1,2
75924,Osteodystrophy,racial,Black or African American ,1,0,1
4004778,Other and unspecified congenital anomalies,ethnic,Hispanic or Latino,0,1,1
139888,Threatened premature labor - not delivered,racial,Black or African American ,1,0,1
255566,Acute tracheitis with obstruction,ethnic,Hispanic or Latino,1,0,1
198198,Vaginal polyp,ethnic,Not Hispanic or Latino,1,0,1
194995,Disorder of ureter,racial,Asian,1,0,1
4176874,Infantile melanodontia,racial,Filipino,0,1,1
378442,Conductive hearing loss of combined sites,racial,Asian,0,1,1
441073,Complete legal abortion,racial,Unknown,1,0,1
436230,Blood chemistry abnormal,racial,American Indian,1,1,2
27587,Disturbance of salivary secretion,racial,Other Race,1,1,2
255891,Lupus erythematosus,racial,Asian,0,1,1
436278,Superficial bruising of thigh,racial,Filipino,1,0,1
24818,Neck injury,racial,Other Race,1,1,2
317971,Respiratory system congenital anomalies,racial,White,1,0,1
443571,Cervicovaginal cytology: High grade squamous intraepithelial lesion or carcinoma,racial,Asian,1,0,1
439658,Gestosis,racial,Unknown,1,0,1
443728,Mass of chest wall,racial,American Indian or Alaska Native ,0,1,1
376121,Recurrent pterygium,racial,Unknown,0,1,1
440426,Vertigo as late effect of stroke,racial,Asian,1,0,1
75066,Nonallopathic lesion of cervical region,ethnic,Hispanic or Latino,0,1,1
435604,"Viral disease in mother complicating pregnancy, childbirth AND/OR puerperium",racial,Unknown,1,0,1
377546,Chronic post-traumatic headache,racial,Filipino,0,1,1
4067459,Heterotopic liver transplant,ethnic,Hispanic or Latino,0,1,1
198194,Female genital organ symptoms,racial,Native Hawaiian or Other Pacific Islander ,1,0,1
373766,Retinopathy of prematurity,racial,Unknown,1,1,2
194133,Low back pain,racial,Asian Indian,0,1,1
76939,Neoplasm of uncertain behaviour of bone and articular cartilage,racial,White,1,0,1
437184,"Poisoning of undetermined intent by corrosive, acid or caustic alkali",racial,White,1,0,1
434344,Accommodative spasm,racial,Unknown,0,1,1
438040,"Adverse reaction to analgesics, antipyretics and antirheumatics",racial,White,1,1,2
4016353,Meningococcus contact,ethnic,Hispanic or Latino,1,0,1
434944,Scleritis,ethnic,Not Hispanic or Latino,1,1,2
436145,Pneumonia due to respiratory syncytial virus,ethnic,Not Hispanic or Latino,1,0,1
4108961,Other chorioretinitis and retinochoroiditis,racial,White,1,0,1
135975,Blister of finger without infection,ethnic,Not Hispanic or Latino,1,1,2
72708,Traumatic arthropathy of the shoulder region,racial,Unknown,1,0,1
436086,Manic bipolar I disorder in full remission,ethnic,Hispanic or Latino,1,0,1
4108087,Other and unspecified rheumatic heart disease,ethnic,Hispanic or Latino,1,0,1
312383,Postpartum cardiomyopathy,ethnic,Not Hispanic or Latino,1,1,2
199065,Stricture of ureter,ethnic,Hispanic or Latino,0,1,1
73574,Nonunion of fracture,ethnic,Not Hispanic or Latino,1,0,1
439147,Amnesia,racial,American Indian,1,0,1
194686,Acquired renal cyst,racial,Other Race,1,1,2
75670,Sprain pelvic ligament,racial,White,1,1,2
196158,Disease of penis,racial,Black or African American ,0,1,1
194696,Menorrhalgia,racial,American Indian or Alaska Native ,1,0,1
434615,Cystic fibrosis without meconium ileus,ethnic,Not Hispanic or Latino,0,1,1
23789,Pharynx or nasopharynx cyst,racial,White,1,0,1
81943,Rupture of flexor tendons of hand AND/OR wrist,racial,White,0,1,1
135027,"Carbuncle of leg, except foot",racial,Other Race,1,0,1
4102738,Screening for mental disorders,racial,Unknown,0,1,1
79069,Disease of rectum,racial,Other Race,0,1,1
376961,Disturbance of consciousness,racial,Native Hawaiian or Other Pacific Islander ,1,0,1
444291,Cochlear hearing loss,racial,Native Hawaiian or Other Pacific Islander ,0,1,1
380944,Adenoviral pharyngoconjunctivitis,racial,White,1,1,2
4152045,Screening for malignant neoplasm of respiratory tract,racial,Unknown,1,0,1
377277,Impairment level: total impairment of both eyes,ethnic,Not Hispanic or Latino,0,1,1
73026,Abnormal respiratory sounds,racial,Unknown,1,0,1
253788,Nasal polyp,racial,Other Race,1,1,2
197237,Benign tumour of prostate,racial,Asian,0,1,1
438871,Drug withdrawal syndrome in newborn,ethnic,Hispanic or Latino,1,0,1
201773,Enteritis,racial,White,1,0,1
373770,"Infantile, juvenile and presenile cataracts",racial,Unknown,1,0,1
80156,Asymptomatic bacteriuria in pregnancy,racial,Other Race,1,0,1
4288028,Mural pregnancy,racial,White,1,0,1
433149,Cerebellar Ca,racial,American Indian or Alaska Native ,0,1,1
195316,Atypical endometrial hyperplasia,racial,Unknown,1,0,1
374631,Motor neurone disease,racial,White,1,0,1
376102,Partial recent retinal detachment with single defect,ethnic,Not Hispanic or Latino,1,0,1
435658,Atypical squamous cells on vaginal Papanicolaou smear cannot exclude high grade squamous intraepithelial lesion,racial,Unknown,1,0,1
433163,Deficiency of macronutrients,racial,Asian,1,0,1
201075,Noninflammatory disorder of cervix,racial,Asian,1,0,1
195877,Observation of gravid uterus,racial,White,1,0,1
198190,Gastric ulcer with perforation AND obstruction,ethnic,Hispanic or Latino,1,0,1
193522,Acute prostatitis,racial,Asian,0,1,1
440846,"Blood coagulation disorder, categorized by value of screening test",racial,Other Race,1,0,1
378901,Open wound of nasal septum without complication,ethnic,Hispanic or Latino,1,1,2
79104,Loose body in joint,ethnic,Hispanic or Latino,1,1,2
201909,Female infertility,racial,Asian,1,0,1
193422,Primary malignant neoplasm of body of stomach,ethnic,Not Hispanic or Latino,0,1,1
26514,Laryngeal web,ethnic,Hispanic or Latino,1,0,1
439815,Choroidal degeneration,ethnic,Hispanic or Latino,1,1,2
4093146,Herpes simplex with other specified complication,ethnic,Not Hispanic or Latino,1,1,2
195603,Vulval and/or perineal noninflammatory disorders,racial,Black or African American ,1,0,1
443392,Malignant neoplastic disease,racial,Unknown,1,0,1
75351,Adolescent postural kyphosis,racial,White,1,0,1
443674,Traumatic amputation of toe(s) with complication,racial,White,1,1,2
437406,Closed traumatic dislocation of joint of wrist,racial,White,0,1,1
28403,Acromegaly and gigantism,racial,Other Race,0,1,1
201927,Cellulitis and abscess of leg,racial,Native Hawaiian or Other Pacific Islander ,0,1,1
441202,Generalized anaphylaxis,racial,Unknown,1,0,1
193144,Suprarenal metastasis,racial,White,1,1,2
432893,Myasthenic syndrome due to another disorder,ethnic,Not Hispanic or Latino,0,1,1
437920,Spontaneous abortion complicated by genital-pelvic infection,racial,White,1,0,1
140489,Acquired acanthosis nigricans,racial,American Indian or Alaska Native ,0,1,1
433905,Open wound of vulva without complication,racial,White,1,0,1
134780,Closed dislocation of metatarsal joint,ethnic,Not Hispanic or Latino,1,0,1
373205,Hemorrhage of eyelid,racial,Unknown,1,0,1
436073,Psychotic disorder,racial,American Indian or Alaska Native ,1,0,1
433621,Sprain of sternoclavicular joint AND/OR ligament,ethnic,Not Hispanic or Latino,1,0,1
192858,Ovarian hyperfunction,ethnic,Not Hispanic or Latino,1,0,1
436517,Fetus OR newborn affected by narcotic transmitted via placenta AND/OR breast milk,racial,White,0,1,1
80914,Second degree burn of two OR more fingers not including thumb,racial,White,0,1,1
443174,"Splinter of neck, without major open wound, infected",racial,White,1,0,1
438546,Congenital anomaly of anterior chamber of eye,racial,White,0,1,1
441929,Varicose veins of perineum and vulva in pregnancy and the puerperium with antenatal complication,racial,White,1,0,1
201388,Congenital uterine anomaly,racial,Unknown,1,0,1
443869,Nonvenomous insect bite of wrist without infection,racial,Unknown,1,1,2
4036945,Consciousness disturbance NOS,ethnic,Hispanic or Latino,0,1,1
377885,Disorder of eye movements,racial,Other Race,1,1,2
381416,Brain injury without open intracranial wound AND with prolonged loss of consciousness (more than 24 hours) without return to pre-existing conscious level,ethnic,Hispanic or Latino,0,1,1
135287,Non-neoplastic naevus,racial,American Indian or Alaska Native ,0,1,1
4062636,Bacterial disease screening,racial,Native Hawaiian or Other Pacific Islander ,1,0,1
381290,Ocular hypertension,racial,Asian,1,0,1
198551,"Embryonic cyst of cervix, vagina and external female genitalia",ethnic,Not Hispanic or Latino,1,0,1
434319,Premature orgasm - male,racial,Black or African American ,0,1,1
440607,Accident caused by explosive material,racial,White,0,1,1
433486,Acute orbital inflammation,ethnic,Hispanic or Latino,1,1,2
443111,Tenosynovitis of foot,racial,Other Race,1,0,1
132703,Lichen planus,racial,Unknown,1,1,2
193242,Perforation of intestine,ethnic,Not Hispanic or Latino,1,1,2
376712,Purulent otitis media,ethnic,Not Hispanic or Latino,1,0,1
4326601,Anorectal abscess,racial,American Indian or Alaska Native ,1,0,1
438039,Injury caused by animal,racial,Unknown,1,0,1
73090,Superficial bruising of foot,racial,Native Hawaiian or Other Pacific Islander ,1,0,1
200588,Injury of abdomen,racial,White,1,1,2
140976,Toxic uninodular goiter,racial,White,1,0,1
200524,Perinatal digestive system disorders,ethnic,Not Hispanic or Latino,0,1,1
372925,Cholesteatoma,racial,White,1,0,1
432933,Aneurysm of artery of lower extremity,ethnic,Hispanic or Latino,1,1,2
135615,Pityriasis,racial,Asian,1,0,1
75629,"Stiff joint NEC, of the forearm",racial,White,0,1,1
434917,"Nondependent antidepressant type drug abuse, episodic",ethnic,Hispanic or Latino,1,0,1
4081756,Radiotherapy follow-up,ethnic,Hispanic or Latino,1,0,1
318566,Flushing,racial,Unknown,1,1,2
75620,Traumatic arthropathy of the ankle and/or foot,racial,White,1,0,1
133551,Vesicular eczema of hands and/or feet,racial,Filipino,1,0,1
4100857,Pickwickian syndrome,racial,Native Hawaiian or Other Pacific Islander ,1,0,1
4105181,Socialised childhood truancy,racial,White,0,1,1
140062,Iodine hypothyroidism,ethnic,Hispanic or Latino,1,0,1
4109253,Pterygium NOS,ethnic,Not Hispanic or Latino,1,0,1
137488,E. coli septicemia,ethnic,Hispanic or Latino,1,0,1
444268,Inhibited male orgasm,ethnic,Not Hispanic or Latino,0,1,1
4178898,Economic problem,racial,White,1,1,2
4265479,Acute duodenal ulcer with perforation,ethnic,Hispanic or Latino,0,1,1
440547,Closed fracture of shaft of metacarpal bone,racial,Unknown,1,0,1
4104016,Ts and As - Tonsillectomy and adenoidectomy,ethnic,Not Hispanic or Latino,0,1,1
79167,Open fracture finger distal phalanx,ethnic,Hispanic or Latino,0,1,1
440642,CSD - Cat scratch disease,racial,Unknown,1,0,1
441139,Instantaneous death,ethnic,Hispanic or Latino,1,0,1
443263,Obstetric breast abscess,ethnic,Hispanic or Latino,1,0,1
72715,Exostosis,racial,Other Race,1,1,2
433805,Abnormal jaw closure,racial,White,1,1,2
434488,Finding of basal metabolic rate,ethnic,Hispanic or Latino,1,0,1
315832,Angina decubitus,racial,White,1,1,2
201779,Tuberculosis of adrenal glands,ethnic,Hispanic or Latino,1,1,2
312728,Congenital tricuspid atresia and stenosis,racial,White,1,0,1
4243827,Drug addiction counseling,racial,White,1,1,2
441678,"Gestation period, 33 weeks",racial,Asian,0,1,1
440067,"Moderate bipolar I disorder, single manic episode",racial,White,1,1,2
4231580,Acute gastric ulcer with haemorrhage,ethnic,Hispanic or Latino,0,1,1
432512,Foreign object left in body during procedure,racial,Unknown,0,1,1
435315,Torsion of testis,racial,Black or African American ,0,1,1
378544,Subdural and cerebral hemorrhage due to birth trauma,racial,Unknown,0,1,1
75406,Crush injury of finger,ethnic,Not Hispanic or Latino,0,1,1
435521,Psychophysiologic disorder,racial,Other Race,1,0,1
139900,Urticaria,racial,American Indian or Alaska Native ,1,0,1
432612,Mild mental handicap,racial,Black or African American ,0,1,1
4064383,Rheumatoid arthritis screening,racial,Other Race,1,0,1
4225928,Heteronymous hemianopsia,racial,White,0,1,1
436238,Elevated levels of transaminase and lactic acid dehydrogenase,racial,Native Hawaiian or Other Pacific Islander ,1,1,2
438555,Cyanosis,racial,Other Race,1,0,1
373638,Superficial injury of cornea,racial,Other Race,1,0,1
4146239,Pruritus of genital organs,racial,Black or African American ,1,0,1
372309,Mononeuritis,racial,Native Hawaiian or Other Pacific Islander ,0,1,1
439105,Traumatic arthropathy of the forearm,racial,White,1,0,1
81636,Excessive foetal growth affecting management of mother,ethnic,Hispanic or Latino,1,0,1
380096,Proliferative diabetic retinopathy,racial,Black or African American ,1,0,1
441697,Open fracture of radius,ethnic,Hispanic or Latino,1,1,2
437828,Disorder of calcium metabolism,racial,Asian,1,0,1
435950,Closed Colles' fracture,racial,Asian,1,0,1
313459,Sleep apnea,racial,Filipino,0,1,1
22492,Pharyngeal FB - foreign body,ethnic,Hispanic or Latino,1,0,1
440787,"Drug dependence in mother complicating pregnancy, childbirth AND/OR puerperium",racial,White,1,1,2
442926,"Motor vehicle traffic accident involving collision with another motor vehicle, parked, driver of motor vehicle injured",racial,Native Hawaiian or Other Pacific Islander ,1,1,2
434615,Cystic fibrosis without meconium ileus,racial,Unknown,1,0,1
78818,Large fetus causing disproportion with antenatal problem,ethnic,Hispanic or Latino,1,0,1
140172,Erythematosquamous dermatosis,ethnic,Not Hispanic or Latino,1,0,1
141508,Dermatophytosis of scalp or beard,racial,American Indian or Alaska Native ,0,1,1
197304,Ulcer of lower limb,racial,Asian,1,0,1
138913,Second degree burn of two OR more fingers including thumb,ethnic,Not Hispanic or Latino,0,1,1
441482,Administrative reason for encounter,racial,Filipino,1,0,1
435788,Disorder of phosphorus metabolism,ethnic,Not Hispanic or Latino,1,1,2
4054908,Closed injury of kidney,racial,Asian,0,1,1
4001516,Endocervical biopsy,ethnic,Hispanic or Latino,1,0,1
4163865,Acute peptic ulcer without hemorrhage AND without perforation,racial,White,1,1,2
135858,Disorder of lip,racial,Other Race,0,1,1
4056770,Breast signs and symptoms,ethnic,Hispanic or Latino,1,0,1
314131,Degeneration of cervical intervertebral disc,racial,Filipino,1,0,1
432452,Anemia of prematurity,racial,Black or African American ,0,1,1
432898,Severe mental handicap,racial,Unknown,0,1,1
433149,Cerebellar Ca,ethnic,Not Hispanic or Latino,0,1,1
254058,Acute bronchiolitis due to respiratory syncytial virus,racial,Other Race,0,1,1
194856,Viral hepatitis A with hepatic coma,ethnic,Hispanic or Latino,1,1,2
198646,Full thickness burn of multiple sites of leg,racial,White,0,1,1
133420,Primary malignant neoplasm of endocrine gland,ethnic,Hispanic or Latino,1,0,1
137054,Skin striae,racial,Other Race,0,1,1
132446,Congenital anomaly of skin,racial,Asian,1,0,1
140489,Acquired acanthosis nigricans,racial,Black or African American ,1,1,2
4053470,Amblyopia ex anopsia,ethnic,Hispanic or Latino,1,1,2
137057,Paronychia,racial,Asian,1,0,1
314426,Congenital cardiovascular disorder during pregnancy - baby not yet delivered,racial,White,1,0,1
441259,Non-thrombocytopenic purpura,racial,Other Race,0,1,1
439391,Physical abuse of adult,ethnic,Not Hispanic or Latino,1,0,1
437262,Common peroneal nerve lesion,ethnic,Not Hispanic or Latino,1,0,1
440989,Intermittent explosive disorder,racial,Unknown,1,1,2
4218420,Postinflammatory perforation of ear drum,racial,Unknown,1,0,1
135303,Cyst of oral soft tissue,racial,Unknown,1,1,2
441830,Disorder of fluid AND/OR electrolyte,racial,Other Race,1,1,2
441077,Stenosis of cervix,racial,Other Race,1,0,1
73336,Closed traumatic dislocation ankle joint,racial,White,0,1,1
435788,Disorder of phosphorus metabolism,racial,White,1,1,2
201907,Oedema of male genital organs,racial,Black or African American ,0,1,1
313543,Venous complication in pregnancy AND/OR the puerperium,ethnic,Hispanic or Latino,1,0,1
75121,Burn of lower leg,racial,White,1,0,1
434793,Subdural hemorrhage following injury without open intracranial wound,racial,White,1,0,1
73649,Contusion of finger,racial,Black or African American ,0,1,1
4105589,Biopsy of peritoneum,racial,Unknown,1,0,1
80876,Unilateral traumatic amputation at OR above elbow without complication,racial,White,1,0,1
139180,Open wound of multiple sites of face without complication,racial,Unknown,1,0,1
23789,Pharynx or nasopharynx cyst,ethnic,Hispanic or Latino,1,0,1
376555,Open wound of ear drum without complication,ethnic,Not Hispanic or Latino,0,1,1
199878,Light and infrequent menstruation,racial,Asian,1,0,1
440023,St. Louis encephalitis virus infection,ethnic,Hispanic or Latino,1,0,1
197378,Overflow incontinence of urine,ethnic,Not Hispanic or Latino,1,0,1
432795,Traumatic AND/OR non-traumatic injury,racial,American Indian or Alaska Native ,1,1,2
141666,Acute osteomyelitis of lower leg,racial,Unknown,1,0,1
381864,Subjective tinnitus,racial,Other Race,1,1,2
432677,Habitual aborter-not pregnant,racial,White,1,0,1
443458,Closed fracture of facial bone,racial,Unknown,1,0,1
74513,Open wound of foot without mention of complication,racial,Black or African American ,1,0,1
4112534,Chronic laryngitis and laryngotracheitis,ethnic,Not Hispanic or Latino,0,1,1
199063,"Hernia, with obstruction",racial,White,1,0,1
436078,Malnutrition of moderate degree (Gomez: 60% to less than 75% of standard weight),racial,White,1,0,1
76725,Fissure in ano,racial,Other Race,0,1,1
438930,Accidental poisoning by drugs affecting blood constituents,ethnic,Hispanic or Latino,1,0,1
80767,Breast irregular nodularity,racial,Native Hawaiian or Other Pacific Islander ,1,0,1
441283,Recurrent iridocyclitis,racial,White,0,1,1
4195473,Temporary tracheostomy,ethnic,Hispanic or Latino,0,1,1
135027,"Carbuncle of leg, except foot",racial,Native Hawaiian or Other Pacific Islander ,0,1,1
377286,VFD - Visual field defect,racial,Black or African American ,1,1,2
78193,Epididymo-orchitis,racial,Asian,0,1,1
4173498,FH: Heart disorder,racial,American Indian or Alaska Native ,1,0,1
376578,Otitic barotrauma,ethnic,Hispanic or Latino,1,1,2
444274,Massive parenchymal disruption of spleen without open wound into abdominal cavity,ethnic,Hispanic or Latino,0,1,1
135287,Non-neoplastic naevus,racial,Asian,1,1,2
257778,Pertussis,ethnic,Not Hispanic or Latino,1,1,2
75053,Fracture of bone,racial,Black or African American ,0,1,1
4061706,"Disorder of lactation NOS, unspecified",racial,White,1,0,1
444405,Open multiple fractures of lower limb with ribs AND sternum,ethnic,Hispanic or Latino,1,0,1
320299,Complication of transplanted heart,ethnic,Hispanic or Latino,0,1,1
376103,Retinopathy,racial,Black or African American ,1,0,1
141648,Contact dermatitis due to cosmetics,racial,Unknown,1,0,1
4148260,Calculus of kidney with calculus of ureter,racial,White,0,1,1
4050572,Implantation of automatic cardiac defibrillator,racial,American Indian or Alaska Native ,1,0,1
436375,Sodium and water depletion,racial,Asian,0,1,1
374034,Visual disturbance,racial,American Indian,0,1,1
438867,Generalized body aches,racial,Asian Indian,1,0,1
4145479,Other specified candidiasis NOS,racial,White,1,0,1
321462,Cardiac complications of care,racial,Unknown,0,1,1
442287,Rest pain,ethnic,Not Hispanic or Latino,1,0,1
139970,Second degree burn of thigh,ethnic,Hispanic or Latino,1,0,1
442794,Poisoning by wasp sting,racial,Black or African American ,1,1,2
441874,Cerebral thrombosis,racial,Black or African American ,0,1,1
140570,Open wound of back without complication,racial,White,1,1,2
27017,Defective dental restoration,ethnic,Not Hispanic or Latino,1,1,2
137371,Neonatal septicaemia,ethnic,Hispanic or Latino,1,0,1
4108905,Congenital malformation of the urinary system,racial,Other Race,0,1,1
141253,Disease of thyroid gland,racial,Native Hawaiian or Other Pacific Islander ,1,1,2
321822,Peripheral circulatory disorder associated with diabetes mellitus,ethnic,Not Hispanic or Latino,1,0,1
443372,Lipid-lowering drug adverse reaction,racial,White,1,0,1
195593,Congenital hydrocele of canal of Nuck,racial,White,0,1,1
433745,"Amphetamine abuse, episodic",racial,Unknown,1,0,1
444082,False labor without delivery,racial,White,1,0,1
136264,Open wound of floor of mouth without complication,racial,Unknown,1,0,1
375801,Demyelinating disease of central nervous system,racial,White,1,0,1
139180,Open wound of multiple sites of face without complication,ethnic,Not Hispanic or Latino,0,1,1
78162,Peripheral vertigo,racial,Other Race,1,0,1
132321,Ichthyosis of eyelid,ethnic,Hispanic or Latino,0,1,1
4334644,Decubitus ulcer of lower back,racial,Asian,0,1,1
4164222,Tendon contracture,racial,Unknown,0,1,1
196163,Cervicitis and endocervicitis,racial,Other Race,1,0,1
439696,Hypertensive heart and renal disease with (congestive) heart failure,racial,Black or African American ,0,1,1
140489,Acquired acanthosis nigricans,racial,Asian,0,1,1
436826,Closed fracture of shaft of radius,racial,Unknown,1,0,1
444413,Pyrexial convulsion,racial,American Indian or Alaska Native ,1,0,1
198571,Cardiogenic shock,racial,White,0,1,1
201626,Mid-cycle pain,racial,Unknown,1,0,1
438532,Swan-neck deformity of finger,racial,White,1,1,2
373494,Cholesterin granuloma of middle ear,ethnic,Hispanic or Latino,0,1,1
4061056,Endometriosis NOS,ethnic,Not Hispanic or Latino,1,0,1
376425,Chronic non-suppurative otitis media,racial,Asian,1,1,2
193522,Acute prostatitis,racial,Black or African American ,0,1,1
440392,Retinal vascular occlusion,ethnic,Not Hispanic or Latino,0,1,1
438304,Rat bite,racial,White,1,0,1
4110815,"Sensorineural hearing loss, bilateral",racial,Asian Indian,1,0,1
434494,Closed fracture of the proximal humerus,racial,Asian,1,0,1
379010,Macular retinal puckering,ethnic,Not Hispanic or Latino,0,1,1
372921,Retained foreign body of middle ear,ethnic,Hispanic or Latino,1,1,2
439060,Atrophy of tongue papillae,ethnic,Hispanic or Latino,0,1,1
4204989,Disturbance in sleep behavior,racial,Black or African American ,1,0,1
444239,Postprocedural state finding,racial,American Indian or Alaska Native ,1,0,1
443887,Superficial foreign body of ankle without major open wound AND without infection,racial,White,1,1,2
200450,Disease of urethra,racial,Asian,1,1,2
380395,Retinal dystrophy,ethnic,Hispanic or Latino,1,0,1
443350,Lower urinary tract symptoms,racial,Native Hawaiian or Other Pacific Islander ,0,1,1
193733,Neoplasm of uncertain behavior of retroperitoneum and peritoneum,ethnic,Hispanic or Latino,1,0,1
435394,Intracranial hemorrhage following injury,racial,White,0,1,1
438367,Primary malignant neoplasm of nasal cavity,ethnic,Hispanic or Latino,1,1,2
435315,Torsion of testis,racial,Unknown,0,1,1
201355,Erosion and ectropion of the cervix,ethnic,Not Hispanic or Latino,1,1,2
378523,Residual foreign body in soft tissue,racial,Other Race,1,1,2
196157,Induratio penis plastica,racial,Other Race,0,1,1
4116770,"Localized, secondary osteoarthritis NOS",ethnic,Hispanic or Latino,1,0,1
443462,Enteritis due to Candida,racial,Unknown,1,0,1
194871,Trichomonal vulvovaginitis,racial,Black or African American ,1,0,1
377910,Deviated nasal septum,racial,Black or African American ,0,1,1
435950,Closed Colles' fracture,racial,Black or African American ,0,1,1
443207,Single organ dysfunction,ethnic,Hispanic or Latino,0,1,1
198558,Nycturia,racial,American Indian or Alaska Native ,1,0,1
141934,Degenerative skin disorder,racial,Asian,0,1,1
441751,Adverse reaction to salicylate,racial,White,0,1,1
443877,Nonvenomous insect bite of shoulder without infection,racial,Unknown,1,0,1
444268,Inhibited male orgasm,racial,White,0,1,1
435018,Twin pregnancy - delivered,racial,Unknown,1,0,1
441260,Drug withdrawal syndrome,racial,American Indian or Alaska Native ,0,1,1
194286,"Malignant neoplasm of corpus uteri, excluding isthmus",racial,Asian,1,0,1
380403,External hordeolum,racial,Filipino,1,1,2
80813,Lumbosacral spondylosis without myelopathy,racial,Black or African American ,1,0,1
74132,Degeneration of lumbosacral intervertebral disc,racial,American Indian,1,0,1
73008,Enthesopathy,racial,American Indian or Alaska Native ,0,1,1
135766,Leukaemia in remission,ethnic,Hispanic or Latino,1,1,2
375800,Dystonia,racial,Other Race,1,0,1
4088372,Herpes zoster with other specified complication,ethnic,Hispanic or Latino,0,1,1
256440,Disorder of paranasal sinuses,racial,Filipino,0,1,1
75996,Sacral spinal cord injury without bone injury,racial,Unknown,0,1,1
4104016,Ts and As - Tonsillectomy and adenoidectomy,racial,Black or African American ,0,1,1
4276723,Finding of child weight centiles,racial,American Indian or Alaska Native ,0,1,1
4024848,Chronic peptic ulcer without mention of complication,racial,White,1,0,1
444124,Class III malocclusion,racial,White,0,1,1
4147639,Cellulitis and abscess of toe NOS,racial,Unknown,1,1,2
378849,Microtia,ethnic,Not Hispanic or Latino,1,1,2
434279,Congenital syphilis,ethnic,Hispanic or Latino,0,1,1
4054908,Closed injury of kidney,ethnic,Hispanic or Latino,1,1,2
4065991,Cellulitis and abscess of finger and toe,racial,Unknown,1,0,1
433171,Selective IgA immunodeficiency,racial,White,0,1,1
442018,Foreign body accidentally left during a procedure,ethnic,Not Hispanic or Latino,1,0,1
137443,Mechanical complication due to skin graft failure AND/OR rejection,ethnic,Hispanic or Latino,0,1,1
195584,Acute peptic ulcer without hemorrhage AND without perforation but with obstruction,racial,White,0,1,1
436587,"Toxic effect of gas, fumes AND/OR vapors",racial,American Indian or Alaska Native ,1,0,1
4148260,Calculus of kidney with calculus of ureter,ethnic,Hispanic or Latino,0,1,1
379009,Retinopathy of prematurity stage 3 - ridge with extraretinal fibrovascular proliferation,ethnic,Not Hispanic or Latino,0,1,1
76611,Injury of shoulder region,racial,American Indian or Alaska Native ,0,1,1
434942,Postseptal orbital cellulitis,racial,Asian,0,1,1
436043,Malignant overlapping lesion of tongue,ethnic,Hispanic or Latino,0,1,1
372912,Visual discomfort,racial,Black or African American ,0,1,1
437382,Urine observation,racial,American Indian,1,0,1
376112,Diabetic polyneuropathy,racial,American Indian,1,0,1
442747,Contact dermatitis due to food in contact with skin,ethnic,Not Hispanic or Latino,1,1,2
439940,Closed fracture of upper end of forearm,racial,Unknown,0,1,1
4145004,Osteoarthritis of spine NOS,racial,White,1,1,2
314457,Congenital stenosis of aortic valve,racial,White,1,0,1
4048727,Neoplasm screening,racial,Black or African American ,1,1,2
200775,Endometrial hyperplasia,racial,Asian,1,0,1
320115,Mitral incompetence and aortic stenosis,racial,Unknown,0,1,1
313236,Cough variant asthma,racial,Asian Indian,0,1,1
437394,Closed fracture of lower end of forearm,racial,American Indian or Alaska Native ,0,1,1
374024,Reaction to spinal or lumbar puncture,ethnic,Not Hispanic or Latino,1,0,1
433048,Closed dislocation of fifth cervical vertebra,ethnic,Hispanic or Latino,1,0,1
378424,Astigmatism,racial,Other Race,1,0,1
195845,"Acute gastric ulcer with hemorrhage, with perforation AND with obstruction",ethnic,Hispanic or Latino,1,0,1
199718,Enteritis due to rotavirus,ethnic,Hispanic or Latino,0,1,1
435726,Mechanical complication of device,racial,Unknown,1,1,2
440053,Infestation by insect,racial,Unknown,1,0,1
440457,Threatened abortion,racial,Other Race,1,0,1
4104581,Esotropia with accommodative compensation,ethnic,Hispanic or Latino,1,0,1
4109256,Other conjunctival disorders,ethnic,Hispanic or Latino,1,0,1
436477,Abnormal products of conception,racial,Asian,1,0,1
74998,Pycocele,ethnic,Not Hispanic or Latino,0,1,1
79962,Crushing injury of elbow,ethnic,Not Hispanic or Latino,0,1,1
373347,Subdural hemorrhage following injury without open intracranial wound AND with concussion,ethnic,Hispanic or Latino,0,1,1
4144103,Influenza NOS,ethnic,Not Hispanic or Latino,0,1,1
436522,Irregular sleep-wake pattern,racial,White,1,1,2
314381,Kawasaki syndrome,ethnic,Not Hispanic or Latino,0,1,1
442770,Disorder of ciliary body,racial,White,1,0,1
444287,Carbuncle of neck,ethnic,Not Hispanic or Latino,0,1,1
4070671,"Middle ear anomaly, excluding ossicles",ethnic,Not Hispanic or Latino,1,0,1
80187,Medial epicondylitis,racial,Other Race,0,1,1
316432,Right bundle branch block AND left anterior fascicular block,racial,Asian,0,1,1
195906,Disorder of lumbar spine,racial,Black or African American ,0,1,1
441447,Open wound of external genital organs without complication,ethnic,Hispanic or Latino,1,0,1
201957,Necrotizing enterocolitis in fetus OR newborn,ethnic,Hispanic or Latino,0,1,1
372894,central serous retinopathy,racial,Other Race,0,1,1
4064206,O/E - tuning fork testing,racial,Asian,1,0,1
23034,Neonatal hypoglycemia,ethnic,Hispanic or Latino,1,1,2
141934,Degenerative skin disorder,ethnic,Not Hispanic or Latino,0,1,1
193825,"Congenital abnormality of uterus complicating antenatal care, baby not yet delivered",racial,White,1,0,1
374649,Strabismic amblyopia,ethnic,Not Hispanic or Latino,1,1,2
255677,Open wound of nose without complication,ethnic,Not Hispanic or Latino,1,1,2
432352,Idiopathic fibrosing alveolitis,ethnic,Not Hispanic or Latino,1,0,1
443421,Gallbladder and bile duct calculi,racial,White,1,0,1
195594,Spontaneous abortion complicated by delayed AND/OR excessive hemorrhage,ethnic,Hispanic or Latino,1,0,1
432672,Fissure of nipple,ethnic,Hispanic or Latino,1,0,1
432512,Foreign object left in body during procedure,racial,White,1,1,2
320744,Complete atrioventricular block,racial,Asian,1,0,1
432923,SAH - Subarachnoid haemorrhage,racial,Black or African American ,0,1,1
4109253,Pterygium NOS,racial,American Indian or Alaska Native ,0,1,1
4113683,Spontaneous abortion unspecified,racial,White,1,0,1
22274,Neoplasm of uncertain behaviour of larynx,ethnic,Hispanic or Latino,1,0,1
4089984,Congenital syphilis NOS,ethnic,Hispanic or Latino,1,1,2
194995,Disorder of ureter,racial,Black or African American ,1,1,2
198313,Burn erythema of abdominal wall,racial,White,1,1,2
200391,Peripheral autonomic neuropathy disease EC,racial,Filipino,1,0,1
139970,Second degree burn of thigh,racial,Unknown,1,0,1
194997,Prostatitis,racial,American Indian or Alaska Native ,0,1,1
377830,Alcohol withdrawal delirium,ethnic,Not Hispanic or Latino,0,1,1
138539,Shprintzen-Goldberg syndrome,racial,Black or African American ,0,1,1
377889,Hearing loss,racial,Filipino,0,1,1
437359,Osteochondritis dissecans,racial,Unknown,1,0,1
440325,Rubella without complication,ethnic,Hispanic or Latino,1,0,1
436171,"Syphilis in mother complicating pregnancy, childbirth AND/OR puerperium",ethnic,Hispanic or Latino,1,0,1
194081,Acute cystitis,racial,American Indian or Alaska Native ,1,0,1
440647,Sexually transmitted infectious disease,racial,Asian,1,1,2
195301,Acute dilatation of stomach,racial,White,1,0,1
437090,Hemolytic disease of fetus OR newborn due to ABO immunization,racial,White,0,1,1
4112525,Acute bronchiolitis NOS,racial,Asian,0,1,1
440519,Premature - weight 1000g-2499g or gestation of 28-37weeks,racial,Black or African American ,0,1,1
443375,Vitamin products adverse reaction,racial,Unknown,1,0,1
443081,Drowning and non-fatal immersion,ethnic,Hispanic or Latino,1,1,2
140949,Scabies,racial,American Indian or Alaska Native ,1,1,2
4148404,Family history: Anemia,ethnic,Not Hispanic or Latino,1,0,1
376555,Open wound of ear drum without complication,racial,White,0,1,1
201620,Calculus of kidney,racial,American Indian,1,0,1
315947,Thoracic back sprain,racial,American Indian or Alaska Native ,1,0,1
4062488,Thyroid disorder screening,racial,Asian,1,0,1
439162,"Closed fracture ankle, medial malleolus",racial,Asian,1,1,2
4109249,Other corneal disorders,ethnic,Hispanic or Latino,1,0,1
4201745,Disease of digestive system,ethnic,Not Hispanic or Latino,1,1,2
74717,Galactorrhoea in pregnancy and the puerperium - delivered with postnatal complication,racial,White,1,0,1
432335,Subclavian artery aneurysm,ethnic,Hispanic or Latino,1,0,1
316437,Cerebral atherosclerosis,racial,Other Race,1,0,1
81454,Injury of finger,racial,Filipino,1,0,1
4153751,Ear - 2nd degree burn,racial,Unknown,1,0,1
192359,RF - Renal failure,racial,Asian,0,1,1
375828,Patulous eustachian tube,racial,White,0,1,1
441692,Finding of serum tumour marker level,ethnic,Not Hispanic or Latino,0,1,1
133420,Primary malignant neoplasm of endocrine gland,racial,White,1,0,1
437041,Mother not delivered,racial,American Indian or Alaska Native ,1,0,1
434008,White blood cell disorder,racial,Other Race,0,1,1
442038,Anaphylactic shock due to serum,racial,Unknown,1,0,1
4091532,Bowel observation,racial,Native Hawaiian or Other Pacific Islander ,1,0,1
376116,Central loss of vision,ethnic,Not Hispanic or Latino,1,0,1
258354,Pulmonary African histoplasmosis,racial,Unknown,0,1,1
441259,Non-thrombocytopenic purpura,racial,Filipino,0,1,1
74739,Osteopathy from poliomyelitis,racial,Other Race,1,0,1
375738,Neurosyphilis,racial,White,0,1,1
74250,Burn of foot,racial,Other Race,1,0,1
4080568,Problem behaviour,racial,Other Race,1,0,1
199991,Complication of transplanted kidney,racial,Other Race,1,1,2
437273,Glaucoma capsulare,ethnic,Hispanic or Latino,1,0,1
439706,Psychosis with origin in childhood,racial,Asian,0,1,1
435532,Episodic chronic alcoholism,racial,Unknown,0,1,1
439700,Inhibited sexual desire,racial,Asian Indian,0,1,1
255566,Acute tracheitis with obstruction,racial,White,1,0,1
432962,Leukoplakia of cervix,racial,White,1,0,1
194403,Obstructed diaphragmatic hernia,ethnic,Not Hispanic or Latino,1,0,1
440382,LD - Learning difficulties,racial,Other Race,0,1,1
133510,Rapidly progressive periodontitis,racial,Unknown,1,1,2
439314,Thrombophlebitis of the femoral vein,ethnic,Not Hispanic or Latino,1,1,2
377274,Nonsenile cataract,racial,Unknown,1,1,2
440971,Neoplasm of uncertain behaviour of testis,ethnic,Hispanic or Latino,0,1,1
376125,Disorder of eyelid,ethnic,Not Hispanic or Latino,1,0,1
196454,Colostomy and enterostomy malfunction,racial,Asian,1,0,1
442775,Degeneration of thoracic intervertebral disc,racial,Filipino,1,0,1
4294569,Cervico-facial actinomycosis,racial,Unknown,1,0,1
78524,Acquired deformity of finger,racial,Other Race,1,1,2
4089994,Serological relapse after treatment of latent early syphilis,racial,White,0,1,1
441545,Somatisation disorder,racial,Other Race,0,1,1
138225,Disease of sebaceous glands,racial,Other Race,0,1,1
440829,Fetus and newborn affected by noxious influences transmitted via placenta or breast milk,ethnic,Hispanic or Latino,1,0,1
433909,Foreign body on external eye,racial,American Indian or Alaska Native ,1,1,2
201627,Abnormal vaginal bleeding,racial,Asian,1,0,1
200974,Carcinoma in situ of stomach,ethnic,Hispanic or Latino,1,0,1
441874,Cerebral thrombosis,racial,Asian,0,1,1
4139681,Allergy to dairy product,racial,Other Race,1,1,2
375525,Athetoid cerebral palsy,racial,Native Hawaiian or Other Pacific Islander ,1,0,1
193323,Neonatal diabetes mellitus,racial,White,1,0,1
4104860,Infantile spasms NOS,racial,White,0,1,1
74747,Acquired genu recurvatum,racial,Black or African American ,0,1,1
4233605,Cervical spinal cord injury without spinal bone injury,racial,Unknown,1,0,1
4108664,Hypertensive heart disease NOS,racial,White,1,1,2
443897,Disruption of perineal wound in the puerperium,ethnic,Not Hispanic or Latino,1,0,1
201914,Premenopausal menorrhagia,racial,American Indian or Alaska Native ,1,0,1
192759,Sequelae of fracture of spine,ethnic,Not Hispanic or Latino,0,1,1
260427,Common cold,racial,Filipino,0,1,1
137989,Abnormal results of cardiovascular function studies,racial,Filipino,0,1,1
138239,Observation of limb structure,racial,Black or African American ,0,1,1
4101431,Disorder of calcium metabolism NOS,racial,White,1,1,2
380126,Rheumatic chorea with heart involvement,ethnic,Hispanic or Latino,0,1,1
440607,Accident caused by explosive material,ethnic,Hispanic or Latino,0,1,1
198646,Full thickness burn of multiple sites of leg,ethnic,Not Hispanic or Latino,0,1,1
138864,Congenital anomaly of nail,ethnic,Not Hispanic or Latino,0,1,1
4110806,Other peripheral vertigo NOS,racial,Unknown,1,0,1
314171,Low blood pressure reading,racial,Other Race,0,1,1
432411,Acquired equinus foot deformity,ethnic,Hispanic or Latino,0,1,1
439615,Fall from stationary vehicle,racial,American Indian or Alaska Native ,0,1,1
439656,A/N care: grand multip,racial,Black or African American ,1,0,1
375827,Acute non-suppurative otitis media - serous,racial,Filipino,1,0,1
78804,Schimmelbusch's disease,racial,Asian,1,0,1
4101609,Ebstein anomaly of right atrioventricular valve,racial,Unknown,1,0,1
4103416,Drug dependence NOS,racial,Black or African American ,1,0,1
313833,Puerperal cerebrovascular disorder with postnatal complication,racial,White,1,0,1
4107528,Lermoyez syndrome,ethnic,Not Hispanic or Latino,1,0,1
314171,Low blood pressure reading,racial,Unknown,1,1,2
437657,Simple syndactyly of toes,racial,White,1,1,2
440905,Toxic effect of venom,racial,Black or African American ,1,1,2
80295,Burn of toe,racial,Unknown,1,0,1
438542,Gestation less than 24 weeks,racial,White,1,1,2
72710,Effusion of joint of forearm,racial,White,0,1,1
378125,Presenile dementia,ethnic,Hispanic or Latino,1,0,1
193261,Vaginospasm,racial,Unknown,1,0,1
75344,Intervertebral disc disorder,racial,Asian,1,0,1
439615,Fall from stationary vehicle,ethnic,Not Hispanic or Latino,0,1,1
4001138,Other soft tissue disorders,ethnic,Hispanic or Latino,1,0,1
4310682,Multiple open wounds with complication,racial,Black or African American ,0,1,1
377271,Parsonage-Turner syndrome,racial,White,0,1,1
200031,Viral hepatitis B with hepatic coma,ethnic,Hispanic or Latino,0,1,1
441171,Second degree burn of chest wall,ethnic,Hispanic or Latino,0,1,1
73065,"Contusion, genital organs",racial,Unknown,1,0,1
195392,Laceration of liver,ethnic,Hispanic or Latino,1,0,1
4145796,Family history: Musculoskeletal disease,racial,Other Race,0,1,1
433227,Abnormal sensation,ethnic,Not Hispanic or Latino,1,1,2
201826,Type 2 diabetes mellitus,racial,European,0,1,1
376102,Partial recent retinal detachment with single defect,racial,White,1,0,1
375281,Acute suppurative otitis media - tympanic membrane intact,racial,Native Hawaiian or Other Pacific Islander ,0,1,1
443716,Blister of shoulder without infection,ethnic,Hispanic or Latino,1,1,2
4113027,Dietary intake observations,racial,Native Hawaiian or Other Pacific Islander ,1,1,2
439901,Chondrocalcinosis due to pyrophosphate crystals,racial,Unknown,1,0,1
4273560,Premature labor,ethnic,Hispanic or Latino,1,0,1
439776,Pervasive developmental disorder,racial,White,0,1,1
201927,Cellulitis and abscess of leg,racial,Filipino,0,1,1
4066724,Pilonidal sinus/cyst NOS,racial,White,0,1,1
4140233,"X-ray of ribs, sternum and clavicle",racial,Other Race,1,0,1
135765,"Sezary's disease of lymph nodes of head, face AND/OR neck",racial,White,1,0,1
376411,Central pterygium,racial,Other Race,0,1,1
442601,Sedative abuse,ethnic,Hispanic or Latino,1,1,2
375290,Chronic suppurative otitis media - tubotympanic,racial,White,1,0,1
196338,Chronic gonococcal cystitis,racial,White,1,0,1
193807,Anorectal fistula,racial,Other Race,1,0,1
441481,Adult victim of abuse,ethnic,Not Hispanic or Latino,1,0,1
444093,Patient status finding,racial,Asian,1,1,2
4113027,Dietary intake observations,racial,American Indian,1,0,1
194412,Dysplasia of vagina,ethnic,Not Hispanic or Latino,1,0,1
372634,Nonphysiologic vision loss,racial,Native Hawaiian or Other Pacific Islander ,1,0,1
435613,Cellulitis,racial,American Indian,1,0,1
78011,Sprain of metacarpophalangeal joint,racial,Unknown,0,1,1
380701,SDLT - Senile dementia of the Lewy body type,racial,White,0,1,1
197950,Cellulitis and abscess of trunk,racial,American Indian or Alaska Native ,1,0,1
4165091,Lack of exercise,racial,Asian,0,1,1
438580,Closed fracture of C5-C7 level with spinal cord injury,racial,White,1,0,1
138463,Oral aphthae,racial,Black or African American ,1,1,2
433451,Aggressive unsocial conduct disorder,ethnic,Hispanic or Latino,1,1,2
4194396,Haemoglobinopathy screening test,ethnic,Hispanic or Latino,1,1,2
435935,Body substance analysis finding,racial,White,1,1,2
200145,Peritonitis in infectious diseases EC,ethnic,Hispanic or Latino,0,1,1
201627,Abnormal vaginal bleeding,racial,Filipino,1,0,1
140821,Spasm,racial,European,0,1,1
439248,"Mixed bipolar affective disorder, moderate",racial,White,0,1,1
437541,Glaucoma,racial,American Indian or Alaska Native ,1,0,1
380706,Regular astigmatism,racial,White,1,0,1
433942,Accident whilst engaged in household activity,racial,Asian,0,1,1
4151249,Malignant tumour of respiratory AND/OR intrathoracic organ,ethnic,Hispanic or Latino,0,1,1
442985,Male,racial,Other Race,0,1,1
133861,CL - Cleft lip,ethnic,Hispanic or Latino,1,0,1
441545,Somatisation disorder,racial,White,1,1,2
434689,Incomplete abortion,ethnic,Not Hispanic or Latino,1,0,1
197672,Urinary incontinence,racial,Native Hawaiian or Other Pacific Islander ,1,0,1
443535,Infection due to enterococcus,ethnic,Hispanic or Latino,1,1,2
434854,FP - Food poisoning,racial,Other Race,1,0,1
4295261,Postmenopausal state,racial,American Indian or Alaska Native ,1,0,1
30753,Esophagitis,racial,Filipino,1,0,1
136779,Disease of forearm,racial,Asian,1,0,1
4245252,Raised prostate specific antigen,racial,Filipino,0,1,1
377877,Convergent squint,racial,Other Race,1,1,2
74817,Crushing injury of buttock,racial,White,1,0,1
4145022,Traumatic arthritis NOS,racial,Unknown,1,0,1
74136,Muscle calcification and ossification,racial,White,0,1,1
381304,Impulsive acoustic trauma,racial,Unknown,1,1,2
436086,Manic bipolar I disorder in full remission,racial,White,0,1,1
442983,Nasal mucosa observation,racial,White,0,1,1
437841,Somatoform autonomic dysfunction - respiratory tract,ethnic,Hispanic or Latino,1,0,1
442310,Acute heart failure,ethnic,Not Hispanic or Latino,0,1,1
434657,Weakness of face muscles,racial,Black or African American ,1,1,2
198402,Neoplasm of uncertain behaviour of kidney,ethnic,Hispanic or Latino,0,1,1
440454,Abortion without complication,ethnic,Not Hispanic or Latino,1,0,1
434073,Loss of teeth - acquired,racial,Black or African American ,1,0,1
132835,Pediculosis capitis,racial,Black or African American ,1,0,1
132835,Pediculosis capitis,racial,Other Race,1,0,1
439871,Haemospermia,racial,Other Race,0,1,1
197803,"Malignant neoplasm, overlapping lesion of stomach",racial,White,0,1,1
141050,Disease of hard tissues of teeth,ethnic,Not Hispanic or Latino,0,1,1
4154616,Family history: Mental retardation,racial,Unknown,1,0,1
4151244,Fracture NOS,ethnic,Hispanic or Latino,0,1,1
4094126,Family problems,racial,White,1,1,2
77335,Known OR suspected fetal abnormality affecting management of mother,ethnic,Not Hispanic or Latino,0,1,1
136184,Pruritic disorder,racial,Filipino,1,1,2
194788,Open wound of anterior abdominal wall with complication,racial,White,1,0,1
437394,Closed fracture of lower end of forearm,racial,Other Race,0,1,1
4117739,Joint derangement NOS,racial,Unknown,1,0,1
434328,"Nondependent cannabis abuse, episodic",ethnic,Not Hispanic or Latino,0,1,1
316126,Crystalline deposits in vitreous,racial,Black or African American ,0,1,1
437993,Closed fracture of cervical spine,racial,Black or African American ,0,1,1
75629,"Stiff joint NEC, of the forearm",ethnic,Not Hispanic or Latino,0,1,1
4012258,Humoral immune defect,ethnic,Hispanic or Latino,1,0,1
78647,Peroneal nerve injury,ethnic,Hispanic or Latino,0,1,1
4093344,Prostate observation,racial,American Indian,0,1,1
436339,Bacterial infection due to Klebsiella pneumoniae,ethnic,Hispanic or Latino,1,0,1
4064927,Respiratory disease screening,racial,White,1,1,2
321042,Cardiac arrest,racial,Asian,0,1,1
75555,Viral labyrinthitis,racial,Unknown,1,1,2
4270866,Symptomatic dermographism,racial,Unknown,1,1,2
196436,Internal haemorrhoid,racial,Asian,1,1,2
74472,Congenital deformity of foot,racial,Native Hawaiian or Other Pacific Islander ,0,1,1
196338,Chronic gonococcal cystitis,ethnic,Hispanic or Latino,1,0,1
201473,Foreign body in intestine and colon,racial,White,0,1,1
381865,Sensorimotor disorder of eyelid,ethnic,Not Hispanic or Latino,0,1,1
441428,Closed fracture of lateral malleolus,racial,Other Race,1,0,1
377126,Concussion with brief loss of consciousness,racial,White,0,1,1
138384,Acquired hypothyroidism,racial,American Indian,1,0,1
199885,Acute female pelvic peritonitis,ethnic,Hispanic or Latino,1,0,1
440213,Consciousness and/or awareness finding,racial,White,1,1,2
4177966,Kaposi's sarcoma,racial,Asian,0,1,1
438398,Leukocytosis,racial,Filipino,0,1,1
439037,Aneurysm of artery of neck,ethnic,Not Hispanic or Latino,1,0,1
321109,Congenital anomaly of coronary artery,racial,Unknown,1,1,2
137974,Abnormal fetal heart beat noted before labor in liveborn infant,ethnic,Hispanic or Latino,1,0,1
432750,Closed dislocation of metatarsophalangeal joint,ethnic,Hispanic or Latino,1,0,1
75128,Injury of chest wall,racial,Asian,1,0,1
442985,Male,racial,White,1,0,1
80522,Congenital deformity of clavicle,racial,White,1,1,2
257008,Abscess of parapharyngeal space,racial,White,0,1,1
378163,Sounds seem unnaturally loud,racial,White,0,1,1
374347,Blepharoconjunctivitis,ethnic,Not Hispanic or Latino,1,1,2
435917,Fetus OR newborn affected by incompetent cervix,racial,White,1,0,1
434488,Finding of basal metabolic rate,racial,White,1,0,1
440161,Indication for care AND/OR intervention in labor AND/OR delivery,racial,White,1,0,1
78834,Effusion of joint of hand,racial,Unknown,1,1,2
433750,"Single major depressive episode, in full remission",racial,Black or African American ,1,0,1
81064,Pseudopolyposis of colon,racial,White,1,1,2
315558,Atherosclerosis of arteries of the extremities,racial,Black or African American ,1,0,1
441846,After-cataract not obscuring vision,racial,Unknown,1,0,1
77373,Congenital deformity of hip joint,racial,Other Race,1,0,1
199764,Benign ovarian tumour,racial,Unknown,1,0,1
77340,Genitourinary tract infection in pregnancy,racial,Native Hawaiian or Other Pacific Islander ,1,0,1
4010070,Closed fracture of lumbar spine with spinal cord lesion,racial,Unknown,1,0,1
379778,Multi-infarct dementia,racial,Asian,1,0,1
200528,Ascites,racial,Other Race,0,1,1
378161,Disorder of ear,racial,Other Race,1,1,2
4283892,Placement of stents in coronary artery,racial,Unknown,1,0,1
4302252,High risk pregnancy care,racial,Middle Eastern or North African,1,0,1
4058089,Mild hyperemesis gravidarum NOS,ethnic,Hispanic or Latino,1,0,1
132408,Back problem,racial,American Indian or Alaska Native ,1,1,2
27017,Defective dental restoration,racial,Asian,1,1,2
135745,Exanthema subitum,racial,Unknown,1,0,1
75899,Dislocation of shoulder region,racial,White,1,0,1
377868,Corneal pannus,racial,Unknown,0,1,1
40479606,Septic embolus of lung,racial,White,1,0,1
439105,Traumatic arthropathy of the forearm,ethnic,Hispanic or Latino,1,0,1
135765,"Sezary's disease of lymph nodes of head, face AND/OR neck",ethnic,Hispanic or Latino,1,0,1
75620,Traumatic arthropathy of the ankle and/or foot,racial,Unknown,1,0,1
436164,Corpus luteum cyst,ethnic,Hispanic or Latino,1,0,1
433218,Superficial thrombophlebitis of arm,racial,White,1,0,1
4145627,Biliary calculus,racial,Black or African American ,0,1,1
4056620,Other urethritis,racial,White,1,1,2
193312,Congenital anomaly of ureter,ethnic,Hispanic or Latino,1,1,2
437935,"Hemorrhage in early pregnancy, antepartum",racial,Unknown,1,0,1
442827,Fetus with central nervous system malformation with antenatal problem,racial,White,1,0,1
141232,MM - Malignant melanoma of skin,racial,Asian,1,1,2
4240103,Operation for bone injury on phalanges of foot,ethnic,Hispanic or Latino,1,1,2
257143,Open wound of multiple sites of nose without complication,ethnic,Hispanic or Latino,1,1,2
4093344,Prostate observation,racial,Native Hawaiian or Other Pacific Islander ,0,1,1
440158,"Venereal disease in mother complicating pregnancy, childbirth AND/OR puerperium",racial,White,1,0,1
24978,Chronic adenotonsillitis,racial,White,1,1,2
4064206,O/E - tuning fork testing,racial,Unknown,1,1,2
437092,Physiological development failure,racial,American Indian or Alaska Native ,0,1,1
441482,Administrative reason for encounter,racial,Asian Indian,0,1,1
4028641,Pregnancy and drug dependence,racial,Native Hawaiian or Other Pacific Islander ,1,0,1
433599,Abnormal biochemistry finding,racial,Black or African American ,0,1,1
138538,Longitudinal deficiency of limb,ethnic,Not Hispanic or Latino,1,1,2
80482,Suppurative arthritis,racial,Unknown,1,0,1
379778,Multi-infarct dementia,ethnic,Not Hispanic or Latino,1,0,1
75996,Sacral spinal cord injury without bone injury,ethnic,Hispanic or Latino,0,1,1
437390,Hypoxaemia,racial,American Indian or Alaska Native ,1,0,1
137275,Disorder of muscle,ethnic,Not Hispanic or Latino,1,1,2
440279,Accident,racial,Asian,1,1,2
4117862,Chronic rheumatic mitral valve,racial,White,1,0,1
433107,Injury of unknown intent by explosive,ethnic,Hispanic or Latino,0,1,1
437093,Congenital ptosis of upper eyelid,racial,Black or African American ,0,1,1
440085,Schizoid personality disorder,racial,Unknown,1,0,1
432352,Idiopathic fibrosing alveolitis,racial,White,1,0,1
77072,Joint effusion of ankle AND/OR foot,racial,Asian,0,1,1
78517,Arthralgia of multiple joints,racial,Native Hawaiian or Other Pacific Islander ,1,0,1
195007,Female stress incontinence,racial,Asian Indian,1,0,1
441788,Human papilloma virus infection,racial,Other Race,1,0,1
434541,Effects of heat,racial,Unknown,1,0,1
440921,Traumatic injury,racial,American Indian or Alaska Native ,1,1,2
381832,Presenile dementia with delirium,racial,Unknown,1,1,2
4145022,Traumatic arthritis NOS,ethnic,Not Hispanic or Latino,1,0,1
433548,Cracked nipple associated with childbirth,ethnic,Hispanic or Latino,1,0,1
4143968,Hypertensive renal disease NOS,ethnic,Hispanic or Latino,0,1,1
376382,Tension-type headache,racial,Native Hawaiian or Other Pacific Islander ,1,1,2
134618,Toxic diffuse goiter with thyrotoxic crisis,racial,Unknown,1,0,1
374049,Acute mucoid otitis media,ethnic,Not Hispanic or Latino,0,1,1
375393,Laceration of skin of eyelid AND periocular area,ethnic,Not Hispanic or Latino,1,1,2
198199,Pyelonephritis,racial,Asian,1,0,1
373432,Benign tumour of nervous system,ethnic,Hispanic or Latino,0,1,1
438725,Disorder of magnesium metabolism,racial,Unknown,1,0,1
375819,TM - Tympanic membrane disorder,racial,Unknown,1,1,2
438422,Primary iridocyclitis,racial,Unknown,0,1,1
4096666,Diabetes mellitus with hyperosmolar coma,racial,White,0,1,1
435810,After-cataract,racial,Asian,1,1,2
438178,Postmastectomy lymphedema syndrome,racial,Unknown,1,0,1
78025,Superficial injury of hand with infection,ethnic,Hispanic or Latino,0,1,1
372849,Overlapping malignant neoplasm of brain and other parts of the central nervous system,ethnic,Hispanic or Latino,1,0,1
433741,Hereditary pure erythrocytosis,racial,White,1,1,2
201899,Unilateral recurrent inguinal hernia,racial,Black or African American ,0,1,1
312940,Acute-on-chronic respiratory failure,racial,White,1,0,1
436334,Infection by Trypanosoma cruzi,ethnic,Hispanic or Latino,1,0,1
78581,Sprain of sacroiliac ligament,ethnic,Hispanic or Latino,1,0,1
132489,Partial thickness burn of finger,racial,White,1,1,2
372892,Metabolic encephalopathy,racial,Unknown,1,1,2
315922,Patent ductus arteriosus,racial,Unknown,0,1,1
77702,Multiple closed fractures of pelvis with disruption of pelvic circle,ethnic,Hispanic or Latino,1,0,1
133414,Candidiasis of skin and nails,racial,Black or African American ,1,1,2
440158,"Venereal disease in mother complicating pregnancy, childbirth AND/OR puerperium",ethnic,Hispanic or Latino,1,0,1
435244,Developmental disorder,racial,Black or African American ,0,1,1
196159,Old laceration of pelvic floor muscle,ethnic,Hispanic or Latino,1,0,1
4263370,R.I.N.D. syndrome,racial,Filipino,1,0,1
4006788,Percutaneous transluminal coronary balloon angioplasty,ethnic,Not Hispanic or Latino,0,1,1
434638,Macular focal chorioretinitis,ethnic,Hispanic or Latino,1,0,1
435516,Lipoprotein deficiency disorder,racial,Filipino,1,1,2
4092896,Stool contents abnormal,racial,American Indian or Alaska Native ,1,0,1
78593,Open wound of wrist without complication,racial,Asian,0,1,1
312336,Arterial aneurysm,racial,Asian,0,1,1
435790,Spurious polycythaemia,racial,Asian,0,1,1
376125,Disorder of eyelid,racial,Other Race,1,0,1
432739,Red blood cell disorder,racial,Asian,0,1,1
193317,Generalized abdominal rigidity,ethnic,Hispanic or Latino,1,0,1
433208,Disorder of pulmonary circulation,racial,White,0,1,1
320128,Essential hypertension,racial,Alaska Native,1,0,1
4109415,Secondary infected iridocyclitis,ethnic,Not Hispanic or Latino,1,0,1
194995,Disorder of ureter,racial,Other Race,0,1,1
195064,Perinatal jaundice due to hepatocellular damage,ethnic,Hispanic or Latino,0,1,1
437221,Chlamydia trachomatis infection,racial,Native Hawaiian or Other Pacific Islander ,1,0,1
376555,Open wound of ear drum without complication,racial,Other Race,0,1,1
132853,Lymphatic leukaemia,racial,White,0,1,1
4148076,Chronic neurogenic ulcer of lower limb,racial,Asian,1,0,1
312383,Postpartum cardiomyopathy,racial,White,1,1,2
199958,Open wound of hip AND thigh without complication,ethnic,Not Hispanic or Latino,1,0,1
133613,Closed traumatic dislocation of tarsometatarsal joint,ethnic,Hispanic or Latino,1,0,1
4167406,Eye disorder screening,racial,Asian Indian,1,0,1
201619,Diverticulum of stomach,racial,Unknown,0,1,1
374338,Nondiabetic proliferative retinopathy,ethnic,Not Hispanic or Latino,0,1,1
197006,Residual hemorrhoidal skin tags,ethnic,Not Hispanic or Latino,1,0,1
444112,Integumentary system finding,racial,Black or African American ,0,1,1
313878,Respiratory symptoms,racial,Asian Indian,0,1,1
4108087,Other and unspecified rheumatic heart disease,racial,White,1,0,1
4108389,Generalized tuberculosis,ethnic,Hispanic or Latino,0,1,1
436956,Evans syndrome,racial,Unknown,1,0,1
138790,Chronic periodontitis,racial,Unknown,0,1,1
4093165,Other specified viral hepatitis with hepatic coma NOS,ethnic,Not Hispanic or Latino,1,0,1
80184,Arthropathy due to parasitic infection,racial,Unknown,1,0,1
375791,Uncomplicated senile dementia,racial,Black or African American ,1,0,1
438205,Maternal syphilis during pregnancy - baby not yet delivered,racial,Unknown,1,0,1
192357,Paralytic ileus,racial,Asian,1,1,2
434872,Infection by Trichomonas,racial,Black or African American ,1,0,1
4141201,Beta lactam resistant bacterial infection,racial,White,1,0,1
4198960,Amputated above elbow,racial,White,1,0,1
138906,Superficial injury of face without infection,racial,Unknown,1,1,2
375825,Referred otalgia,racial,Unknown,1,1,2
440202,Multiple congenital malformations,racial,Unknown,0,1,1
443891,Cementum caries,racial,Unknown,1,0,1
375249,Traction detachment of retina,ethnic,Not Hispanic or Latino,1,0,1
74511,Open wound of knee and/or leg and/or ankle with complication,racial,White,1,0,1
380719,Impairment level: one eye: moderate impairment: other eye: normal vision,racial,White,1,1,2
4144395,Enlarged angioscotoma,ethnic,Hispanic or Latino,0,1,1
141508,Dermatophytosis of scalp or beard,racial,Asian,1,0,1
135762,Acute myeloid leukaemia in remission,racial,Other Race,0,1,1
440023,St. Louis encephalitis virus infection,racial,White,1,0,1
197339,"Congenital abnormality of uterus, affecting pregnancy",racial,White,1,1,2
434164,Glycosuria,racial,American Indian or Alaska Native ,1,0,1
434901,Subchronic paranoid schizophrenia with acute exacerbation,ethnic,Not Hispanic or Latino,1,0,1
77653,Traumatic myositis ossificans,racial,Black or African American ,0,1,1
198528,Acquired unequal leg length,racial,Asian,1,0,1
379020,Entropion,ethnic,Not Hispanic or Latino,1,0,1
4109564,Unspecified corneal ulcer,racial,White,1,0,1
257683,Postnasal drip,racial,Native Hawaiian or Other Pacific Islander ,1,1,2
438668,Accidents due to travel and motion,racial,White,1,1,2
4003982,Other specified skin anomalies,ethnic,Hispanic or Latino,1,0,1
4193570,Abnormal results of hearing screening test,racial,Black or African American ,1,0,1
201065,Acute and subacute liver necrosis,ethnic,Hispanic or Latino,1,0,1
441615,Trigonitis,racial,White,1,0,1
196523,Diarrhea,racial,American Indian,1,0,1
196151,Functional disorder of intestine,ethnic,Not Hispanic or Latino,0,1,1
442794,Poisoning by wasp sting,racial,Other Race,1,1,2
438478,Hemorrhage in early pregnancy,ethnic,Hispanic or Latino,1,0,1
444243,Neurotic disorder,racial,Black or African American ,1,0,1
4287844,alpha Thalassemia,ethnic,Hispanic or Latino,1,0,1
200528,Ascites,racial,Asian,1,1,2
436081,Immunosecretory disorder,racial,White,1,0,1
30968,Diabetes insipidus,racial,Other Race,0,1,1
79104,Loose body in joint,racial,White,1,1,2
79091,Unstable lie,racial,Asian,1,0,1
373461,Leukocoria,ethnic,Hispanic or Latino,1,0,1
74470,Congenital anomaly of upper limb,ethnic,Not Hispanic or Latino,0,1,1
72245,Chlamydial infection of lower genitourinary tract,ethnic,Not Hispanic or Latino,1,1,2
200970,CIS - Carcinoma in situ of prostate,racial,Asian,0,1,1
253482,Cortical blindness,ethnic,Not Hispanic or Latino,1,1,2
81936,Monoarthritis,racial,Asian,1,0,1
433745,"Amphetamine abuse, episodic",ethnic,Hispanic or Latino,1,0,1
441460,Late effect of sprain AND/OR strain without tendon injury,racial,Asian,0,1,1
443729,Peripheral circulatory disorder associated with type II diabetes mellitus,racial,Native Hawaiian or Other Pacific Islander ,0,1,1
137735,Second degree burn of forearm,racial,Unknown,1,0,1
437579,Paroxysmal ventricular tachycardia,racial,Filipino,0,1,1
135688,Abrasion AND/OR friction burn of foot with infection,ethnic,Not Hispanic or Latino,0,1,1
381832,Presenile dementia with delirium,ethnic,Hispanic or Latino,1,1,2
432302,Cocaine dependence in remission,ethnic,Not Hispanic or Latino,0,1,1
373999,Diabetic oculopathy associated with type I diabetes mellitus,racial,Black or African American ,1,0,1
4066724,Pilonidal sinus/cyst NOS,racial,Unknown,0,1,1
196433,Aneurysm of iliac artery,racial,White,0,1,1
314666,Healed coronary,racial,Filipino,0,1,1
376387,Spasmodic torticollis,ethnic,Not Hispanic or Latino,1,0,1
40480943,Lateral cystocele,ethnic,Not Hispanic or Latino,1,0,1
433903,"Abrasion AND/OR friction burn of multiple sites, infected",racial,White,1,0,1
141831,Branchial arch syndrome,racial,Unknown,0,1,1
4010070,Closed fracture of lumbar spine with spinal cord lesion,ethnic,Hispanic or Latino,1,0,1
375264,Impairment level: one eye: near-total impairment: other eye: normal vision,ethnic,Hispanic or Latino,0,1,1
79167,Open fracture finger distal phalanx,racial,Unknown,0,1,1
135057,Nonallopathic lesion of sacral region,racial,White,1,0,1
439219,Poisoning due to venomous spider,racial,Unknown,1,0,1
4053383,Family history of glaucoma,ethnic,Hispanic or Latino,1,1,2
74188,Closed fracture of rib,racial,Asian,1,1,2
75897,Polyarthropathy,racial,Black or African American ,1,1,2
373432,Benign tumour of nervous system,racial,Unknown,0,1,1
442170,Blister of neck with infection,racial,White,1,1,2
440085,Schizoid personality disorder,racial,Black or African American ,0,1,1
443460,Pathological fracture of femur,ethnic,Hispanic or Latino,1,0,1
435237,Reactive psychoses,ethnic,Hispanic or Latino,1,0,1
136184,Pruritic disorder,racial,American Indian or Alaska Native ,1,0,1
435651,Atypical squamous cells on cervical Papanicolaou smear cannot exclude high grade squamous intraepithelial lesion,racial,Black or African American ,1,0,1
201418,"Flatulence, eructation and gas pain",racial,American Indian,1,0,1
200164,Urine-induced contact dermatitis,racial,Filipino,1,1,2
4053470,Amblyopia ex anopsia,racial,White,1,1,2
376394,Menstrual migraine,racial,Unknown,1,0,1
436681,Insomnia disorder related to known organic factor,racial,Black or African American ,0,1,1
442714,"Splinter of finger, without major open wound, infected",racial,White,1,0,1
4290000,Mumps,racial,Unknown,1,0,1
440750,Thrombophlebitis of deep veins of upper extremities,racial,White,1,0,1
432742,Closed skull fracture without intracranial injury,racial,American Indian or Alaska Native ,0,1,1
258354,Pulmonary African histoplasmosis,ethnic,Hispanic or Latino,0,1,1
375246,Mononeuritis of upper limb,racial,American Indian,1,0,1
376117,Cataract in degenerative disorder,racial,Black or African American ,1,0,1
442040,Accidental poisoning by lead paints,ethnic,Hispanic or Latino,1,1,2
439372,"Motor vehicle traffic accident involving collision, on highway, between motor vehicle and fallen stone, traffic sign, tree or utility pole, pedestrian injured",racial,White,1,0,1
256723,Pneumonia and influenza,racial,Unknown,1,0,1
434926,Iridocyclitis,racial,Asian,1,1,2
436145,Pneumonia due to respiratory syncytial virus,ethnic,Hispanic or Latino,1,0,1
4288676,Acute and chronic cholecystitis,racial,Black or African American ,1,0,1
442749,Inhibited female orgasm,ethnic,Hispanic or Latino,1,0,1
438047,Contusion of orbital tissues,ethnic,Not Hispanic or Latino,1,0,1
442600,Manic bipolar I disorder in partial remission,racial,White,1,0,1
261393,Congenital polycystic lung,racial,White,1,0,1
439297,Nuclear senile cataract,racial,Asian,0,1,1
200338,Nodular lymphoma of intra-abdominal lymph nodes,ethnic,Hispanic or Latino,1,0,1
193520,Urinary bladder stone,racial,Other Race,1,0,1
381732,Nerve injury,racial,White,1,1,2
78524,Acquired deformity of finger,racial,Unknown,1,0,1
192359,RF - Renal failure,racial,Black or African American ,0,1,1
72714,Chronic polyarticular juvenile rheumatoid arthritis,racial,Unknown,1,0,1
4162218,Vaginal enterocele,racial,Unknown,1,0,1
4103735,"Better eye: near total visual impairment, Lesser eye: near total visual impairment",racial,Unknown,0,1,1
4147164,Hematologic malignancy,ethnic,Not Hispanic or Latino,1,0,1
4104857,Automatism petit mal,ethnic,Hispanic or Latino,1,0,1
4270866,Symptomatic dermographism,racial,Asian,1,0,1
259055,Extrinsic asthma with asthma attack,racial,American Indian or Alaska Native ,0,1,1
436541,Closed fracture of ulna,racial,Unknown,0,1,1
377279,"Profound impairment, one eye",racial,Asian,0,1,1
377678,EEG abnormality,ethnic,Not Hispanic or Latino,1,1,2
434638,Macular focal chorioretinitis,racial,Unknown,1,0,1
436246,Low libido,racial,Asian,0,1,1
4145627,Biliary calculus,ethnic,Not Hispanic or Latino,0,1,1
437222,Respiratory syncytial virus infection,racial,Black or African American ,0,1,1
4093165,Other specified viral hepatitis with hepatic coma NOS,racial,Asian,1,0,1
4273560,Premature labor,racial,White,1,0,1
379778,Multi-infarct dementia,racial,Unknown,0,1,1
77960,Joint observation,racial,Other Race,1,0,1
436173,Hyperemesis gravidarum with metabolic disturbance - delivered,racial,White,1,0,1
436588,Traumatic wound dehiscence,ethnic,Not Hispanic or Latino,1,0,1
141050,Disease of hard tissues of teeth,racial,White,0,1,1
133298,Musculoskeletal disorder of the neck,racial,Asian,1,1,2
433401,Coccidiosis,racial,White,1,1,2
200215,Abdominal rigidity,ethnic,Hispanic or Latino,1,1,2
444038,Psychoactive substance-induced organic mood disorder,ethnic,Hispanic or Latino,1,1,2
4141481,"Hand, foot and mouth disease",racial,Black or African American ,0,1,1
140602,"Mechanical complication of internal orthopedic device, implant and graft",racial,White,0,1,1
374631,Motor neurone disease,ethnic,Hispanic or Latino,1,0,1
440751,Peritonsillar abscess,racial,Unknown,1,0,1
201388,Congenital uterine anomaly,ethnic,Hispanic or Latino,1,0,1
72374,Unstable lie with antenatal problem,racial,Unknown,1,0,1
441155,Closed trimalleolar fracture,racial,White,1,0,1
432267,"Hodgkin's disease, lymphocytic depletion of extranodal AND/OR solid organ site",ethnic,Not Hispanic or Latino,0,1,1
432589,Neutropenia associated with infectious disease,ethnic,Hispanic or Latino,0,1,1
4070415,Fetus or neonate affected by chorioamnionitis,ethnic,Hispanic or Latino,1,0,1
443709,Atypical squamous cells of undetermined significance on anal Papanicolaou smear,ethnic,Not Hispanic or Latino,1,0,1
134398,Periodontal disease,racial,American Indian or Alaska Native ,1,0,1
4169009,FH: CVA,racial,Unknown,1,0,1
30968,Diabetes insipidus,racial,Unknown,1,0,1
433083,Opiate and narcotic poisoning,ethnic,Hispanic or Latino,1,0,1
261326,Viral pneumonia,racial,Black or African American ,1,1,2
440021,Herpes simplex without complication,racial,American Indian or Alaska Native ,1,1,2
4091320,Meningococcal infection NOS,racial,Unknown,1,0,1
442597,Meteorism,racial,Black or African American ,0,1,1
194831,Gastric foreign body,racial,White,0,1,1
378901,Open wound of nasal septum without complication,racial,White,1,1,2
433000,Patellar tendonitis,racial,Other Race,0,1,1
79962,Crushing injury of elbow,racial,White,0,1,1
381301,Chronic serous otitis media,racial,American Indian or Alaska Native ,1,0,1
436421,"Mixed conductive and sensorineural hearing loss, bilateral",racial,Unknown,1,1,2
313209,Left bundle branch hemiblock,racial,Black or African American ,1,1,2
379963,Open wound of external ear without complication,ethnic,Hispanic or Latino,1,1,2
74114,Cellulitis and abscess of foot excluding toe,racial,Native Hawaiian or Other Pacific Islander ,0,1,1
438391,Amino acid transport disorder,racial,White,1,1,2
376106,Disorder of the central nervous system,racial,Other Race,0,1,1
4243827,Drug addiction counseling,ethnic,Hispanic or Latino,1,0,1
436956,Evans syndrome,ethnic,Hispanic or Latino,1,0,1
443174,"Splinter of neck, without major open wound, infected",ethnic,Hispanic or Latino,1,0,1
73290,Contracture of joint,racial,Unknown,1,0,1
376699,Cicatricial ectropion,racial,Unknown,1,0,1
374886,Benign neoplasm of ear,ethnic,Not Hispanic or Latino,1,1,2
140214,Eruption of skin,racial,American Indian,1,1,2
378442,Conductive hearing loss of combined sites,ethnic,Not Hispanic or Latino,0,1,1
439669,Gonorrhoea of anus,ethnic,Not Hispanic or Latino,0,1,1
380941,Herpetic meningoencephalitis,racial,Native Hawaiian or Other Pacific Islander ,0,1,1
135333,Pressure sore,racial,Asian,0,1,1
4093468,Dermatomycosis NOS,ethnic,Hispanic or Latino,1,1,2
77673,Sign or symptom of the urinary system,racial,Asian,0,1,1
4103906,Lacrimal system disorder NOS,ethnic,Hispanic or Latino,1,0,1
28179,Polyp of vocal cord or larynx,racial,Black or African American ,1,0,1
76836,Sprain of knee and leg,racial,Filipino,1,0,1
443732,Disorder associated with type II diabetes melliltus,racial,Native Hawaiian or Other Pacific Islander ,0,1,1
440396,Glaucoma associated with ocular trauma,ethnic,Hispanic or Latino,1,1,2
4093146,Herpes simplex with other specified complication,racial,Black or African American ,1,1,2
441561,Low tension glaucoma,ethnic,Hispanic or Latino,1,1,2
30133,Acute laryngitis,racial,American Indian or Alaska Native ,1,0,1
442018,Foreign body accidentally left during a procedure,racial,Black or African American ,1,0,1
4304916,Gastrointestinal tract finding,racial,Unknown,1,0,1
436640,Primary malignant neoplasm of long bone of lower limb,ethnic,Hispanic or Latino,0,1,1
434901,Subchronic paranoid schizophrenia with acute exacerbation,racial,Black or African American ,1,0,1
376793,Congenital anomaly of ear with impairment of hearing,ethnic,Not Hispanic or Latino,1,1,2
200616,Complication of transplanted liver,ethnic,Hispanic or Latino,1,0,1
436254,Closed fractures of multiple bones of lower limb,ethnic,Not Hispanic or Latino,1,1,2
139841,Chronic frontal sinusitis,racial,American Indian or Alaska Native ,1,0,1
197018,Chronic gastric ulcer with hemorrhage but without obstruction,racial,Other Race,1,0,1
439139,Infections specific to perinatal period,ethnic,Hispanic or Latino,0,1,1
28060,Strept throat,racial,American Indian,1,0,1
442530,Broken tooth injury with complication,racial,Other Race,0,1,1
193517,Bile duct calculus with no mention of cholecystitis and with obstruction,racial,White,0,1,1
444382,Thoracic radiculitis,racial,American Indian,1,0,1
438156,Epiphora due to insufficient drainage,racial,White,0,1,1
80802,Secondary localized osteoarthrosis,racial,White,1,1,2
135350,Acute osteomyelitis of the ankle and/or foot,ethnic,Not Hispanic or Latino,1,1,2
195588,Cystitis,racial,American Indian or Alaska Native ,1,0,1
79917,Acquired deformity of toe,ethnic,Not Hispanic or Latino,1,1,2
136916,Primary malignant neoplasm of skin of external auditory canal,ethnic,Hispanic or Latino,1,1,2
80883,Nonvenomous insect bite of elbow with infection,racial,Unknown,0,1,1
4310768,Fall on steps,racial,Other Race,1,0,1
4145492,Other peripheral vascular disease,ethnic,Hispanic or Latino,1,1,2
136575,Nonvenomous insect bite with infection,racial,Other Race,0,1,1
194574,Chronic type B viral hepatitis,racial,Alaska Native,0,1,1
435543,Primary angle-closure glaucoma,racial,Asian,1,0,1
195590,Urethral stricture,racial,Asian,0,1,1
4195231,Acute gastric ulcer without hemorrhage AND without perforation,racial,Unknown,1,0,1
81097,Felty's syndrome,ethnic,Hispanic or Latino,1,0,1
81670,Congenital anomaly of spine,racial,Black or African American ,0,1,1
138826,Acne varioliformis,racial,Asian,1,1,2
200051,Primary malignant neoplasm of ovary,racial,Black or African American ,1,0,1
439245,"Mixed bipolar affective disorder, in full remission",racial,White,1,0,1
73558,Allergic arthritis of the lower leg,ethnic,Hispanic or Latino,1,0,1
4318408,Subdural haematoma,racial,Other Race,0,1,1
4201387,Tracheostomy in situ,racial,Other Race,1,0,1
72413,Non-traumatic rupture of muscle,ethnic,Hispanic or Latino,1,0,1
30515,Oesophagostenosis,racial,Unknown,0,1,1
434953,Orbital granuloma,racial,Unknown,1,0,1
135923,CP - Cleft palate,racial,Black or African American ,0,1,1
433163,Deficiency of macronutrients,racial,Black or African American ,1,1,2
4080568,Problem behaviour,racial,Filipino,1,0,1
433167,Lipoma of intrathoracic organs,ethnic,Hispanic or Latino,0,1,1
256146,Pneumoconiosis due to silicates,racial,Unknown,0,1,1
435101,Open fracture of foot,ethnic,Hispanic or Latino,1,1,2
316994,Malignant hypertensive heart disease with congestive cardiac failure,racial,Other Race,0,1,1
201350,Placental abruption - not delivered,ethnic,Hispanic or Latino,1,0,1
4107375,Somatoform pain disorder,racial,White,1,0,1
376119,Perforated corneal ulcer,ethnic,Hispanic or Latino,1,0,1
375249,Traction detachment of retina,racial,Unknown,0,1,1
436517,Fetus OR newborn affected by narcotic transmitted via placenta AND/OR breast milk,ethnic,Hispanic or Latino,0,1,1
438701,UKP - Disseminated malignancy of unknown primary,racial,Black or African American ,1,0,1
441692,Finding of serum tumour marker level,racial,White,1,0,1
75905,Pathological dislocation of upper arm,ethnic,Hispanic or Latino,0,1,1
320074,Lymphocytosis,ethnic,Not Hispanic or Latino,0,1,1
441202,Generalized anaphylaxis,racial,Other Race,1,1,2
437979,Macroglossia,ethnic,Hispanic or Latino,1,1,2
380111,Acute atopic conjunctivitis,racial,Other Race,1,1,2
73847,Observation of elbow joint,ethnic,Not Hispanic or Latino,0,1,1
440971,Neoplasm of uncertain behaviour of testis,racial,White,0,1,1
133835,Dermatitis,racial,Native Hawaiian or Other Pacific Islander ,1,0,1
434169,Abnormal findings on diagnostic imaging of breast,racial,Filipino,1,0,1
4024567,Respiratory observation,racial,Unknown,0,1,1
375519,Alcohol withdrawal syndrome,racial,Black or African American ,0,1,1
193518,Intestinal obstruction,racial,Asian,0,1,1
443772,Superficial injury of scalp with infection,ethnic,Hispanic or Latino,1,0,1
4053378,FH: Blood disorder,racial,Other Race,0,1,1
79904,Secondary localised osteoarthrosis of hand,ethnic,Hispanic or Latino,0,1,1
199855,Acute gastric ulcer with hemorrhage AND with perforation but without obstruction,racial,Unknown,0,1,1
439669,Gonorrhoea of anus,racial,Black or African American ,0,1,1
434502,Closed fracture of phalanx of toe,racial,Black or African American ,1,0,1
439246,"Mixed bipolar affective disorder, severe, with psychosis",ethnic,Not Hispanic or Latino,0,1,1
79804,Myotonic dystrophy,racial,Black or African American ,1,0,1
31821,Endocrinopathy,racial,Black or African American ,0,1,1
133414,Candidiasis of skin and nails,racial,Asian,0,1,1
441482,Administrative reason for encounter,racial,American Indian,1,0,1
199877,Mucous polyp of cervix,racial,Black or African American ,1,0,1
198197,Male infertility,racial,Black or African American ,0,1,1
434697,Maternal tobacco abuse,ethnic,Hispanic or Latino,1,0,1
195593,Congenital hydrocele of canal of Nuck,ethnic,Hispanic or Latino,0,1,1
4005439,Other lung anomaly NOS,ethnic,Hispanic or Latino,0,1,1
194993,Intestinal malabsorption,racial,Other Race,1,1,2
200670,Benign tumour of male genital organs,racial,White,0,1,1
4143292,Varicose veins of legs in the puerperium,racial,White,1,0,1
193733,Neoplasm of uncertain behavior of retroperitoneum and peritoneum,racial,White,1,0,1
77961,Disseminated idiopathic skeletal hyperostosis,ethnic,Hispanic or Latino,1,0,1
81454,Injury of finger,racial,American Indian or Alaska Native ,0,1,1
436859,"Insect bite, nonvenomous, of shoulder and upper arm, infected",racial,White,0,1,1
4297375,Victim of abuse,racial,White,1,0,1
4178537,Family history: nervous system disorder,ethnic,Hispanic or Latino,1,1,2
4222138,Allergic contact dermatitis of eyelid,ethnic,Not Hispanic or Latino,1,0,1
4112514,Unilateral total vocal cord paralysis,racial,Black or African American ,0,1,1
432456,Finding of alcohol intake,racial,Unknown,0,1,1
255302,Spontaneous pneumothorax,ethnic,Not Hispanic or Latino,0,1,1
135030,Discoloration of skin,racial,Other Race,1,0,1
137856,Atypical facial pain,ethnic,Not Hispanic or Latino,1,0,1
4109559,"Better eye: severe visual impairment, Lesser eye: severe visual impairment",ethnic,Hispanic or Latino,1,0,1
194133,Low back pain,racial,Alaska Native,1,0,1
139841,Chronic frontal sinusitis,racial,Black or African American ,1,0,1
432878,Drug abuse using speed,racial,American Indian or Alaska Native ,1,1,2
444391,Pain around eye,racial,Black or African American ,0,1,1
201527,Neoplasm of uncertain behaviour of prostate,ethnic,Not Hispanic or Latino,0,1,1
432725,Congenital anomaly of integument,racial,Asian,1,0,1
75708,Foreign body in anus and rectum,ethnic,Hispanic or Latino,0,1,1
444435,Superficial injury of elbow without infection,racial,White,0,1,1
377556,Sudden visual loss,racial,Asian,1,0,1
4204989,Disturbance in sleep behavior,ethnic,Not Hispanic or Latino,1,0,1
436098,Nondependent cocaine abuse in remission,racial,Black or African American ,1,1,2
4025176,Respiratory system diseases NOS,racial,Unknown,0,1,1
444071,Furuncle of forearm,racial,Other Race,1,0,1
437589,Pulpitis,racial,Unknown,1,1,2
4284118,Fall on escalator,racial,White,1,0,1
4273391,Suicidal thoughts,racial,Other Race,1,0,1
259048,Pneumonia in systemic mycosis,racial,White,0,1,1
27137,Open wound of mouth with complication,ethnic,Hispanic or Latino,1,0,1
434628,Separation anxiety,racial,Other Race,1,0,1
254068,Upper respiratory disease,racial,Asian,0,1,1
441896,Plicated tongue,racial,Unknown,1,0,1
377279,"Profound impairment, one eye",racial,Other Race,1,1,2
4148076,Chronic neurogenic ulcer of lower limb,racial,Unknown,1,0,1
442619,Fracture of humerus,racial,White,1,1,2
133468,Disease of extremity,ethnic,Not Hispanic or Latino,0,1,1
443378,Anabolic steroids adverse reaction,racial,White,0,1,1
372324,Eustachian tube disorder,racial,Asian,1,0,1
72459,Closed fracture of two ribs,racial,White,1,0,1
141933,Alopecia areata,racial,American Indian or Alaska Native ,0,1,1
193144,Suprarenal metastasis,ethnic,Hispanic or Latino,1,1,2
79889,Unstable lie - delivered,racial,White,1,0,1
4144395,Enlarged angioscotoma,racial,White,1,1,2
437935,"Hemorrhage in early pregnancy, antepartum",ethnic,Hispanic or Latino,1,0,1
193136,Acute gonococcal cervicitis,ethnic,Not Hispanic or Latino,1,0,1
435543,Primary angle-closure glaucoma,racial,Other Race,1,0,1
435063,Fetus OR newborn affected by ectopic pregnancy,ethnic,Hispanic or Latino,1,0,1
436176,Spontaneous abortion without complication,racial,Asian,1,0,1
433933,Plants - toxic effect,racial,White,1,1,2
374362,Keratoconus,racial,White,1,1,2
4022073,Dependance on wheel chair,racial,Asian,0,1,1
437689,Multiple closed fractures of cervical vertebrae,racial,Unknown,0,1,1
195289,Goodpasture's syndrome,ethnic,Hispanic or Latino,0,1,1
441680,Fetus OR newborn affected by multiple pregnancy,racial,Other Race,1,0,1
195482,Primary malignant neoplasm of intestinal tract,racial,White,1,0,1
376699,Cicatricial ectropion,ethnic,Hispanic or Latino,1,0,1
376394,Menstrual migraine,racial,White,1,0,1
439372,"Motor vehicle traffic accident involving collision, on highway, between motor vehicle and fallen stone, traffic sign, tree or utility pole, pedestrian injured",ethnic,Not Hispanic or Latino,1,0,1
439264,Acute suppurative otitis media,ethnic,Not Hispanic or Latino,1,0,1
4146248,Rheumatoid arthritis and other inflammatory polyarthropathies,ethnic,Not Hispanic or Latino,1,0,1
4140734,Amniocentesis for possible chromosomal abnormality,racial,Unknown,1,0,1
433768,Glaucoma with increased episcleral venous pressure,racial,Unknown,1,0,1
432803,[X]Fall on and from ladder,racial,Asian,0,1,1
439262,"Single manic episode, severe, with psychosis",racial,White,1,0,1
4154623,Fit denture,racial,Native Hawaiian or Other Pacific Islander ,1,0,1
442073,Malunion and nonunion of fracture,racial,Unknown,1,0,1
4055758,Temporomandibular joint disorder NOS,ethnic,Not Hispanic or Latino,1,1,2
73855,Arrest of bone development AND/OR growth,ethnic,Hispanic or Latino,0,1,1
4143968,Hypertensive renal disease NOS,racial,White,0,1,1
437334,Cervical incompetence with antenatal problem,ethnic,Not Hispanic or Latino,1,1,2
40422016,Suicide and selfinflicted injury by jumping or lying before moving object,racial,White,1,0,1
4108961,Other chorioretinitis and retinochoroiditis,ethnic,Hispanic or Latino,1,0,1
76791,Acquired deformity of hip,racial,Black or African American ,1,0,1
319927,Heart sounds abnormal,racial,Asian,0,1,1
434119,Hidradenitis,racial,Black or African American ,0,1,1
195926,Slowing of urinary stream,ethnic,Not Hispanic or Latino,0,1,1
319041,Orthostatic hypotension,racial,Other Race,1,0,1
40484028,Dental caries extending into dentine,racial,Black or African American ,1,1,2
193063,Blister of trunk without infection,ethnic,Hispanic or Latino,1,0,1
433930,Motor vehicle on road in collision with another motor vehicle,racial,Other Race,1,1,2
74817,Crushing injury of buttock,ethnic,Hispanic or Latino,1,0,1
377574,Presbycusis,racial,Other Race,1,1,2
193519,Impaired renal function disorder,racial,Other Race,1,0,1
437899,Acute and subacute bacterial endocarditis,ethnic,Not Hispanic or Latino,1,0,1
199837,Deep vein thrombosis of portal vein,ethnic,Hispanic or Latino,0,1,1
137977,Icteric,racial,American Indian or Alaska Native ,1,0,1
433903,"Abrasion AND/OR friction burn of multiple sites, infected",ethnic,Not Hispanic or Latino,1,0,1
80492,Knee joint contracture,racial,Unknown,1,0,1
4051770,"Contusion, ankle and foot, excluding toe(s)",ethnic,Hispanic or Latino,0,1,1
435649,Complication of hemodialysis,racial,Native Hawaiian or Other Pacific Islander ,0,1,1
379019,Inflammation of conjunctiva,racial,Native Hawaiian or Other Pacific Islander ,1,0,1
437536,Somatoform autonomic dysfunction - gastrointestinal tract,racial,Unknown,1,0,1
380395,Retinal dystrophy,racial,Unknown,0,1,1
442256,Disorder of bursae of shoulder region,racial,Filipino,1,0,1
195877,Observation of gravid uterus,ethnic,Hispanic or Latino,1,0,1
261687,Hemoptysis,racial,Black or African American ,1,1,2
443524,Mixed incontinence,racial,Native Hawaiian or Other Pacific Islander ,1,0,1
377551,Blind hypertensive eye,ethnic,Hispanic or Latino,1,0,1
313791,Bundle branch block,ethnic,Not Hispanic or Latino,0,1,1
375671,Concussion with loss of consciousness,ethnic,Not Hispanic or Latino,1,0,1
4159157,Disorder of tooth development,racial,White,1,0,1
377545,Episodic tension-type headache,racial,White,1,1,2
137350,Radiation dermatitis,ethnic,Hispanic or Latino,1,1,2
261880,Atelectasis,racial,Other Race,0,1,1
441564,Optic disc oedema associated with retinal disorder,racial,Unknown,1,0,1
80876,Unilateral traumatic amputation at OR above elbow without complication,ethnic,Not Hispanic or Latino,1,0,1
435119,Sequela of injury,ethnic,Not Hispanic or Latino,0,1,1
4093468,Dermatomycosis NOS,racial,White,1,1,2
133737,Acute thyroiditis,ethnic,Not Hispanic or Latino,1,0,1
196456,Cholecystolithiasis,racial,Native Hawaiian or Other Pacific Islander ,1,1,2
192684,"Renal hypertension complicating pregnancy, childbirth and the puerperium - not delivered",ethnic,Not Hispanic or Latino,0,1,1
132391,Furuncle of face,ethnic,Not Hispanic or Latino,0,1,1
200765,Chronic cholecystitis,ethnic,Not Hispanic or Latino,1,0,1
436254,Closed fractures of multiple bones of lower limb,racial,Unknown,1,0,1
375800,Dystonia,ethnic,Not Hispanic or Latino,0,1,1
442983,Nasal mucosa observation,ethnic,Hispanic or Latino,0,1,1
316994,Malignant hypertensive heart disease with congestive cardiac failure,ethnic,Not Hispanic or Latino,1,1,2
40421730,"Adverse reaction to mixed bacterial vaccines, excluding combinations with a pertussis component",ethnic,Hispanic or Latino,0,1,1
443603,Adverse reaction to antidiabetic drug,racial,White,1,1,2
4143292,Varicose veins of legs in the puerperium,ethnic,Hispanic or Latino,1,0,1
440696,Cyclothymia,ethnic,Hispanic or Latino,1,1,2
132704,Lichen nitidus,ethnic,Hispanic or Latino,1,1,2
372605,Spinal muscular atrophy,racial,Other Race,0,1,1
381028,Acute suppurative otitis media - tympanic membrane ruptured,racial,Asian,1,1,2
436936,Benign neoplasm of cranial nerve,racial,White,1,0,1
80852,Closed fracture of four ribs,racial,White,1,1,2
433759,Developmental reading disorder,ethnic,Not Hispanic or Latino,0,1,1
196162,Uterine inflammatory disease,ethnic,Hispanic or Latino,1,0,1
439406,Allergy to animal,racial,Black or African American ,1,0,1
442038,Anaphylactic shock due to serum,ethnic,Hispanic or Latino,1,0,1
193016,Cystic disease of kidney,racial,Black or African American ,1,1,2
380415,Acute swimmer's ear,racial,Native Hawaiian or Other Pacific Islander ,1,0,1
440703,Trigeminal nerve disorder,racial,Unknown,1,0,1
4005439,Other lung anomaly NOS,racial,White,0,1,1
196468,Acute salpingo-oophoritis,ethnic,Hispanic or Latino,1,0,1
442926,"Motor vehicle traffic accident involving collision with another motor vehicle, parked, driver of motor vehicle injured",ethnic,Not Hispanic or Latino,1,1,2
141094,Lichen,ethnic,Not Hispanic or Latino,1,1,2
437470,Adverse reaction to benzodiazepine-based tranquilliser,racial,White,0,1,1
442752,Myalgia,racial,American Indian or Alaska Native ,1,0,1
195064,Perinatal jaundice due to hepatocellular damage,racial,White,0,1,1
4116770,"Localized, secondary osteoarthritis NOS",racial,Unknown,1,0,1
81539,Mitochondrial disease,ethnic,Not Hispanic or Latino,0,1,1
432267,"Hodgkin's disease, lymphocytic depletion of extranodal AND/OR solid organ site",racial,White,0,1,1
439233,Poisoning by antidiabetic agent,ethnic,Hispanic or Latino,1,1,2
200687,Renal disorder associated with type I diabetes mellitus,racial,Filipino,1,0,1
373770,"Infantile, juvenile and presenile cataracts",ethnic,Hispanic or Latino,1,0,1
4232618,Gelastic seizure,racial,White,1,0,1
374653,Neurologic disorder of eye movements,ethnic,Hispanic or Latino,1,1,2
434339,Adolescent - emotional problem,racial,Black or African American ,1,1,2
436233,Delayed milestone,racial,Other Race,0,1,1
140435,Arrested dental caries,racial,White,1,0,1
374347,Blepharoconjunctivitis,racial,Asian,0,1,1
77987,Respiratory observations of chest,racial,Other Race,1,1,2
197239,Haemangioma of intra-abdominal structure,racial,Asian,1,0,1
137785,Verruca plantaris,racial,Black or African American ,0,1,1
319845,Pulmonary valve disease,racial,Black or African American ,1,0,1
381033,Aphakia,racial,Other Race,0,1,1
132583,Postablative hypothyroidism,racial,Unknown,1,0,1
257094,Congenital anomaly of lung,racial,White,0,1,1
375822,Neonatal obstruction of nasolacrimal duct,racial,Black or African American ,1,1,2
440029,Viral disease,racial,Alaska Native,0,1,1
80778,Genitourinary tract infection in pregnancy - delivered with postnatal complication,racial,White,1,0,1
439264,Acute suppurative otitis media,ethnic,Hispanic or Latino,1,1,2
4319325,Acquired deformity of trunk,racial,Asian,1,1,2
4200655,Urostomy present,ethnic,Not Hispanic or Latino,0,1,1
81097,Felty's syndrome,racial,White,1,0,1
4109415,Secondary infected iridocyclitis,racial,Black or African American ,1,0,1
440035,European cryptococcosis,ethnic,Not Hispanic or Latino,0,1,1
375538,"Degeneration of macula due to cyst, hole or pseudohole",racial,Other Race,1,0,1
201612,ALD - Alcoholic liver disease,ethnic,Not Hispanic or Latino,1,1,2
441132,Laboratory finding abnormal,racial,White,1,1,2
443417,Villonodular synovitis of lower limb,racial,White,1,1,2
442597,Meteorism,racial,Asian,0,1,1
201727,Superficial injury of trunk without infection,racial,White,1,0,1
443454,Cerebral infarction,racial,Filipino,1,0,1
4067459,Heterotopic liver transplant,racial,White,0,1,1
4054908,Closed injury of kidney,ethnic,Not Hispanic or Latino,0,1,1
437787,Secondary syphilis,ethnic,Hispanic or Latino,0,1,1
132416,Chronic haematoma of pinna,racial,White,1,1,2
4109699,Unspecified chronic conjunctivitis,racial,White,0,1,1
373216,Disorder of mastoid,ethnic,Hispanic or Latino,1,1,2
4051110,FH: leukaemia,racial,Other Race,1,1,2
74451,Palindromic rheumatism of the forearm,racial,Other Race,1,1,2
31609,Abscess of salivary gland,ethnic,Hispanic or Latino,1,0,1
435849,Parietoalveolar pneumopathy,ethnic,Not Hispanic or Latino,1,0,1
40481091,Partial edentulism,racial,White,1,1,2
442262,Blister of toe without infection,racial,Other Race,0,1,1
440865,Closed fracture of epiphysis of femur,racial,Unknown,1,0,1
138965,Myelitis,racial,White,1,1,2
436677,"Brief situational non-psychotic disorder, NOS",racial,Asian,1,0,1
432750,Closed dislocation of metatarsophalangeal joint,racial,Unknown,1,0,1
139188,Open wound of scalp without complication,racial,Other Race,0,1,1
4112514,Unilateral total vocal cord paralysis,ethnic,Not Hispanic or Latino,0,1,1
372921,Retained foreign body of middle ear,racial,White,1,1,2
4317122,Adverse reaction to drugs primarily affecting the gastrointestinal system NOS,ethnic,Hispanic or Latino,1,0,1
4012590,Fracture of one or more phalanges of foot NOS,ethnic,Hispanic or Latino,1,0,1
437428,Crushing injury - disorder,racial,Unknown,0,1,1
200349,Malignant lymphoma of intra-abdominal lymph nodes,racial,White,1,0,1
444211,Disease of thigh,racial,Asian,1,0,1
435227,Nutritional deficiency,racial,Native Hawaiian or Other Pacific Islander ,0,1,1
255302,Spontaneous pneumothorax,racial,Asian,0,1,1
443178,"Insect bite, nonvenomous, of face",ethnic,Not Hispanic or Latino,1,0,1
73560,Calcaneal spur,racial,Native Hawaiian or Other Pacific Islander ,1,1,2
24818,Neck injury,racial,Native Hawaiian or Other Pacific Islander ,0,1,1
377287,Phlyctenular keratoconjunctivitis,racial,White,1,1,2
80568,Traumatic amputation of finger without mention of complication,racial,Asian,1,0,1
75053,Fracture of bone,racial,Alaska Native,0,1,1
78228,Joint derangement,racial,Other Race,0,1,1
4028716,Idiopathic thrombocythemia,racial,Black or African American ,0,1,1
379820,No colour perception,racial,Unknown,0,1,1
380395,Retinal dystrophy,ethnic,Not Hispanic or Latino,0,1,1
261889,Simple chronic bronchitis,racial,American Indian,0,1,1
4215568,Sensory disturbance in limb,racial,Unknown,0,1,1
4206460,Problem,racial,Native Hawaiian or Other Pacific Islander ,1,1,2
76737,Hydrocele,ethnic,Hispanic or Latino,0,1,1
81088,Failed lactation,ethnic,Not Hispanic or Latino,0,1,1
435372,Underweight,racial,Filipino,0,1,1
75899,Dislocation of shoulder region,ethnic,Hispanic or Latino,1,0,1
4111411,Aortic valve disorders NOS,racial,White,0,1,1
138538,Longitudinal deficiency of limb,ethnic,Hispanic or Latino,1,0,1
139210,Superficial burn of back,ethnic,Hispanic or Latino,1,0,1
316447,Chronic hypotension,ethnic,Not Hispanic or Latino,0,1,1
438873,Closed fracture of base of skull with intracranial hemorrhage,racial,Black or African American ,0,1,1
192731,Digestive symptom,racial,Asian,1,0,1
4278672,Fracture of forearm,racial,White,1,1,2
135027,"Carbuncle of leg, except foot",ethnic,Not Hispanic or Latino,1,1,2
257143,Open wound of multiple sites of nose without complication,racial,White,1,1,2
4305841,Periodic limb movement disorder,racial,Unknown,1,0,1
137989,Abnormal results of cardiovascular function studies,ethnic,Not Hispanic or Latino,1,0,1
4156802,"Blister of finger, infected",ethnic,Hispanic or Latino,1,1,2
436876,Toxic effect of lead compound,racial,Unknown,1,0,1
435186,Disease due to Rhinovirus,ethnic,Hispanic or Latino,1,1,2
201473,Foreign body in intestine and colon,ethnic,Hispanic or Latino,0,1,1
375824,Abnormal auditory perception,racial,Black or African American ,1,1,2
141831,Branchial arch syndrome,racial,Black or African American ,0,1,1
80004,Hand injury,racial,Asian,0,1,1
4305303,Sleep deprivation,racial,Black or African American ,0,1,1
312733,"Abnormal foetal heart beat, not clear if noted before OR after onset of labour in liveborn infant",ethnic,Hispanic or Latino,1,0,1
196236,Septicaemic shock,racial,White,1,1,2
137666,Congenital ear lobe absence,racial,White,1,1,2
4064927,Respiratory disease screening,ethnic,Hispanic or Latino,1,1,2
197039,Male genital organ vascular diseases,racial,Unknown,0,1,1
4301700,Acute mastoiditis,racial,White,1,0,1
443409,On examination - left lower abdominal mass,racial,Asian,1,1,2
200169,Pruritus ani,racial,Asian,1,0,1
4051110,FH: leukaemia,ethnic,Hispanic or Latino,1,1,2
321689,Apneic,racial,Asian,1,1,2
373139,Syphilitic parkinsonism,racial,Unknown,0,1,1
440069,Drug dependence,racial,Asian,0,1,1
4105589,Biopsy of peritoneum,ethnic,Hispanic or Latino,1,0,1
439840,Inflammation of lymphatics,ethnic,Hispanic or Latino,1,0,1
4296611,Chronic gastric ulcer without hemorrhage AND without perforation,racial,White,1,0,1
440066,Disorder of purine and pyrimidine metabolism,ethnic,Hispanic or Latino,1,1,2
437251,Benign neoplasm of pituitary gland and craniopharyngeal duct,racial,Other Race,1,0,1
4094865,Ca intrahepatic bile ducts,ethnic,Not Hispanic or Latino,1,0,1
372888,Sciatic nerve lesion,racial,Unknown,1,1,2
437316,Fissural cyst of jaw,ethnic,Hispanic or Latino,1,0,1
433600,"Problem, abnormal test",racial,Unknown,1,0,1
4144103,Influenza NOS,racial,Unknown,1,1,2
4296611,Chronic gastric ulcer without hemorrhage AND without perforation,racial,Unknown,1,0,1
4166080,Decompression of median nerve,racial,Black or African American ,0,1,1
193518,Intestinal obstruction,racial,Black or African American ,1,0,1
74250,Burn of foot,ethnic,Not Hispanic or Latino,1,1,2
77156,Superficial foreign body of toe without major open wound but with infection,racial,Unknown,1,0,1
4056620,Other urethritis,ethnic,Not Hispanic or Latino,1,1,2
320299,Complication of transplanted heart,ethnic,Not Hispanic or Latino,0,1,1
434033,Chorioretinitis,racial,Unknown,1,0,1
132408,Back problem,racial,Filipino,1,0,1
78234,Arthralgia of the hand,racial,Asian Indian,1,0,1
433746,"Combined drug dependence, excluding opioid, continuous",ethnic,Hispanic or Latino,1,0,1
432600,Stress reaction causing mixed disturbance of emotion and conduct,racial,White,1,0,1
438873,Closed fracture of base of skull with intracranial hemorrhage,ethnic,Not Hispanic or Latino,0,1,1
256571,FB - Nasal foreign body,racial,Asian,1,0,1
4018734,Sprain of costal cartilage,racial,American Indian or Alaska Native ,1,0,1
72402,Traumatic arthropathy of the lower leg,ethnic,Hispanic or Latino,1,1,2
200146,Pancreatic steatorrhea,ethnic,Hispanic or Latino,1,0,1
439928,Gangrenous disorder,racial,Black or African American ,0,1,1
437973,Congenital chorioretinal degeneration,ethnic,Hispanic or Latino,0,1,1
138994,MDS - Myelodysplastic syndrome,racial,Unknown,0,1,1
4340379,Hepatitis B carrier,racial,Other Race,1,0,1
432303,Cocaine abuse,racial,Black or African American ,0,1,1
313833,Puerperal cerebrovascular disorder with postnatal complication,ethnic,Hispanic or Latino,1,0,1
141673,Aseptic necrosis of head of humerus,ethnic,Hispanic or Latino,1,1,2
4117739,Joint derangement NOS,ethnic,Hispanic or Latino,1,0,1
4242720,Intracranial hematoma following injury,ethnic,Hispanic or Latino,0,1,1
377277,Impairment level: total impairment of both eyes,racial,Other Race,0,1,1
201627,Abnormal vaginal bleeding,racial,American Indian or Alaska Native ,1,0,1
77819,Benign tumour of pleura,racial,White,1,0,1
443115,Closed fracture finger proximal phalanx,racial,Other Race,1,1,2
193252,Diverticulosis of small intestine,racial,White,1,1,2
437394,Closed fracture of lower end of forearm,racial,Filipino,1,0,1
441081,Maternal gonorrhoea during pregnancy - baby not yet delivered,ethnic,Not Hispanic or Latino,1,0,1
313223,Wegener granulomatosis,ethnic,Not Hispanic or Latino,1,1,2
435786,Disorder of sleep-wake cycle,ethnic,Hispanic or Latino,1,1,2
373475,Impairment level: one eye: moderate impairment: other eye: not specified,racial,Asian,1,0,1
437745,Victim of infant/child neglect,ethnic,Hispanic or Latino,1,0,1
4051114,FH: Diabetes mellitus,racial,Filipino,1,1,2
375671,Concussion with loss of consciousness,racial,White,1,1,2
200773,Stenosis of rectum and anus,racial,White,0,1,1
443709,Atypical squamous cells of undetermined significance on anal Papanicolaou smear,racial,White,1,1,2
4103735,"Better eye: near total visual impairment, Lesser eye: near total visual impairment",ethnic,Not Hispanic or Latino,0,1,1
196751,Haemorrhage from placenta previa,racial,Unknown,1,0,1
441407,Appetite loss - anorexia,racial,Filipino,1,0,1
4310768,Fall on steps,racial,Black or African American ,0,1,1
314426,Congenital cardiovascular disorder during pregnancy - baby not yet delivered,ethnic,Hispanic or Latino,1,0,1
4024000,Urinary system finding,racial,Black or African American ,0,1,1
443943,Herpes zoster,racial,Asian,0,1,1
435018,Twin pregnancy - delivered,racial,White,1,0,1
380095,Lesions of nerves plexuses and roots,racial,Unknown,1,0,1
443593,Ulcer of thigh,racial,White,0,1,1
194526,Injury of trunk,racial,Black or African American ,1,0,1
376267,Superficial injury of conjunctiva,ethnic,Not Hispanic or Latino,1,0,1
442286,Abscess of digit,racial,American Indian or Alaska Native ,0,1,1
197609,"Cervical, vaginal and vulval inflammatory diseases",racial,Unknown,1,0,1
380719,Impairment level: one eye: moderate impairment: other eye: normal vision,ethnic,Hispanic or Latino,1,1,2
196625,Viral hepatitis A without hepatic coma,ethnic,Not Hispanic or Latino,1,1,2
193250,Gastric hemorrhage,racial,Unknown,1,1,2
440330,Rochalimaea infection,racial,White,1,0,1
76835,Closed dislocation of elbow,racial,Unknown,0,1,1
81685,Fracture of clavicle due to birth trauma,ethnic,Not Hispanic or Latino,1,0,1
434279,Congenital syphilis,racial,White,0,1,1
435648,Testicular retraction,ethnic,Not Hispanic or Latino,0,1,1
4150614,Communication disorder,racial,Unknown,1,0,1
200169,Pruritus ani,racial,Other Race,0,1,1
436164,Corpus luteum cyst,racial,Unknown,1,0,1
438262,Chyluria,ethnic,Hispanic or Latino,1,0,1
30753,Esophagitis,racial,Asian,1,0,1
381308,Abscess of eyelid,racial,Native Hawaiian or Other Pacific Islander ,1,0,1
199065,Stricture of ureter,racial,White,0,1,1
434674,Atrophy of edentulous mandibular alveolar ridge,ethnic,Hispanic or Latino,1,0,1
376337,Disease of nervous system,racial,Unknown,1,1,2
26514,Laryngeal web,racial,Unknown,1,0,1
4162218,Vaginal enterocele,racial,Other Race,1,0,1
436804,Fetus OR newborn affected by premature rupture of membranes,ethnic,Hispanic or Latino,1,0,1
140842,Changes in skin texture,racial,American Indian or Alaska Native ,1,0,1
440750,Thrombophlebitis of deep veins of upper extremities,ethnic,Hispanic or Latino,1,0,1
379812,Exposure keratitis,ethnic,Hispanic or Latino,1,0,1
133570,Acute osteomyelitis of the pelvic region and/or thigh,ethnic,Hispanic or Latino,0,1,1
443421,Gallbladder and bile duct calculi,racial,Unknown,1,0,1
436741,Vulvodynia,racial,Other Race,1,0,1
140582,Superficial burn of foot,racial,White,0,1,1
81454,Injury of finger,racial,Asian,1,1,2
319927,Heart sounds abnormal,racial,Unknown,1,1,2
261393,Congenital polycystic lung,ethnic,Hispanic or Latino,1,0,1
76797,Congenital deformity of genital organ,ethnic,Not Hispanic or Latino,0,1,1
433025,Complication of vaccination,racial,White,0,1,1
4163865,Acute peptic ulcer without hemorrhage AND without perforation,ethnic,Hispanic or Latino,1,1,2
440380,"Combined drug dependence, excluding opioid, episodic",ethnic,Hispanic or Latino,1,0,1
4095302,Malignant tumour of cranial nerve,ethnic,Not Hispanic or Latino,0,1,1
4049623,"Moderate major depression, single episode",racial,Asian,1,0,1
138484,Thyroid dysfunction in the puerperium - baby delivered during previous episode of care,ethnic,Hispanic or Latino,1,0,1
437221,Chlamydia trachomatis infection,racial,Unknown,1,0,1
4100857,Pickwickian syndrome,racial,Alaska Native,0,1,1
440697,Nonaggressive unsocial conduct disorder,racial,Other Race,1,0,1
439346,"Motor vehicle traffic accident involving pedestrian run over by motor vehicle, occupant of tram injured",racial,Other Race,0,1,1
4117862,Chronic rheumatic mitral valve,racial,Native Hawaiian or Other Pacific Islander ,1,0,1
4097561,Burkitt lymphoma of lymph nodes of axilla and upper limb,racial,White,0,1,1
438733,Profound mental handicap,racial,Black or African American ,1,0,1
195588,Cystitis,racial,Other Race,1,1,2
256723,Pneumonia and influenza,racial,Asian,1,1,2
439037,Aneurysm of artery of neck,racial,Black or African American ,1,0,1
440972,Medulloadrenal hyperfunction,racial,White,0,1,1
373449,Drug-induced delirium,racial,White,1,1,2
200670,Benign tumour of male genital organs,ethnic,Hispanic or Latino,0,1,1
373182,Amyotrophic lateral sclerosis,ethnic,Not Hispanic or Latino,1,0,1
200765,Chronic cholecystitis,racial,American Indian or Alaska Native ,1,0,1
77354,Primary localised osteoarthrosis of lower leg,racial,Asian Indian,1,0,1
441401,Talipes valgus,racial,White,1,0,1
201121,Malformation of urachus,racial,White,0,1,1
133803,Periapical abscess with sinus tract,ethnic,Not Hispanic or Latino,1,0,1
432661,Stomatitis,racial,Other Race,0,1,1
137627,Prickly heat,racial,Black or African American ,1,0,1
4064918,Diabetes mellitus screening,racial,Alaska Native,1,0,1
436677,"Brief situational non-psychotic disorder, NOS",racial,Other Race,0,1,1
443350,Lower urinary tract symptoms,racial,Asian Indian,0,1,1
433257,Mesangiocapillary glomerulonephritis,racial,Asian,0,1,1
373769,Nuclear cataract,ethnic,Not Hispanic or Latino,1,0,1
4173657,Congenital malformation of the respiratory system,ethnic,Hispanic or Latino,1,1,2
79173,Closed dislocation of jaw,racial,Unknown,1,0,1
77702,Multiple closed fractures of pelvis with disruption of pelvic circle,racial,White,1,0,1
434012,Developmental dyslexia,ethnic,Hispanic or Latino,1,1,2
4160859,Methicillin resistant staphylococcus aureus carrier,racial,Black or African American ,1,1,2
435789,Megaloblastic anemia,ethnic,Not Hispanic or Latino,1,0,1
75044,"Stiff joint NEC, of the hand",racial,Other Race,0,1,1
444246,Cirrhosis of liver not due to alcohol,racial,Black or African American ,1,0,1
436855,Second degree burn of back of hand,racial,White,0,1,1
4109256,Other conjunctival disorders,racial,White,1,0,1
140489,Acquired acanthosis nigricans,racial,American Indian,1,0,1
80494,Arthropathy associated with another disorder,racial,White,1,1,2
198201,Chronic salpingo-oophoritis,racial,Asian,1,0,1
80295,Burn of toe,ethnic,Hispanic or Latino,1,0,1
195012,Metrorrhagia,racial,Asian,1,0,1
434630,Sleep rhythm problem,racial,Unknown,0,1,1
200616,Complication of transplanted liver,racial,White,1,0,1
194996,Postoperative urethral stricture,racial,White,1,0,1
4064905,Venereal disease screening,racial,American Indian,1,0,1
433514,Abnormal hard tissue formation in pulp,racial,Unknown,0,1,1
136025,Gp B streptococcal septicemia,racial,Unknown,1,0,1
4173811,Congenital quadriplegia,racial,Asian,0,1,1
435626,Tibial collateral ligament bursitis,racial,White,1,0,1
196625,Viral hepatitis A without hepatic coma,racial,Other Race,1,0,1
441202,Generalized anaphylaxis,racial,Black or African American ,0,1,1
193250,Gastric hemorrhage,ethnic,Not Hispanic or Latino,0,1,1
78633,Stokers' cramp,ethnic,Hispanic or Latino,1,1,2
193253,Nephritis,racial,Asian Indian,1,1,2
443360,Eye mass,racial,Black or African American ,1,0,1
440207,Hypoplastic left heart syndrome,ethnic,Not Hispanic or Latino,1,0,1
79740,Overlapping malignant neoplasm of colon,racial,White,1,0,1
321119,Coarctation of aorta,racial,Asian,1,0,1
4014296,Twins - both live born,racial,Unknown,1,0,1
432411,Acquired equinus foot deformity,racial,Unknown,0,1,1
140027,Herpetic gingivostomatitis,racial,Black or African American ,1,1,2
137792,Kaposi's varicelliform eruption,racial,Black or African American ,0,1,1
76498,Arthropathy associated with bacterial disease,ethnic,Hispanic or Latino,1,1,2
4282684,Impairment level: low vision of one eye,racial,Asian,1,0,1
80802,Secondary localized osteoarthrosis,ethnic,Hispanic or Latino,1,1,2
4297975,Manual rupture of ovarian cyst,racial,White,1,0,1
438156,Epiphora due to insufficient drainage,ethnic,Hispanic or Latino,0,1,1
434917,"Nondependent antidepressant type drug abuse, episodic",racial,Unknown,1,0,1
4102166,Multiparous,racial,Unknown,1,0,1
24974,Stenosis of larynx,ethnic,Hispanic or Latino,0,1,1
40479606,Septic embolus of lung,ethnic,Hispanic or Latino,1,0,1
141933,Alopecia areata,racial,Asian,1,1,2
440066,Disorder of purine and pyrimidine metabolism,racial,White,1,1,2
315078,Palpitations,racial,Filipino,1,0,1
433885,Closed supracondylar fracture of humerus,racial,Unknown,1,0,1
132724,Congenital anomaly of hair,ethnic,Hispanic or Latino,1,0,1
194418,Urethral caruncle,ethnic,Hispanic or Latino,1,0,1
433401,Coccidiosis,ethnic,Hispanic or Latino,1,1,2
4222138,Allergic contact dermatitis of eyelid,racial,Asian,1,0,1
72434,Congenital hydrocele,racial,Unknown,0,1,1
443462,Enteritis due to Candida,ethnic,Hispanic or Latino,1,0,1
4053600,Open wound of elbow,racial,White,0,1,1
317585,Aortic aneurysm,racial,Other Race,1,0,1
135852,Teething syndrome,racial,Black or African American ,0,1,1
433292,Inflammatory spondylopathy associated with another disease,ethnic,Hispanic or Latino,1,0,1
441947,Posttraumatic state,ethnic,Not Hispanic or Latino,0,1,1
438808,Mammary duct ectasia,ethnic,Hispanic or Latino,1,0,1
4141201,Beta lactam resistant bacterial infection,ethnic,Not Hispanic or Latino,1,0,1
136871,Burn any degree involving 20-29 percent of body surface,racial,White,1,0,1
193136,Acute gonococcal cervicitis,racial,Asian,1,0,1
375277,Non-infectious pinna disorders,racial,White,1,0,1
77070,Allergic arthritis of the hand,racial,Unknown,1,1,2
314423,"Benign essential hypertension complicating pregnancy, childbirth and the puerperium - not delivered",racial,Asian,1,0,1
30753,Esophagitis,racial,Black or African American ,0,1,1
375077,Sensory inattention,ethnic,Hispanic or Latino,1,0,1
439141,Abnormal increase in weight,racial,Native Hawaiian or Other Pacific Islander ,0,1,1
201619,Diverticulum of stomach,ethnic,Hispanic or Latino,0,1,1
441507,"Early latent syphilis, positive serology, negative cerebrospinal fluid, less than 2 years after infection",ethnic,Not Hispanic or Latino,0,1,1
437899,Acute and subacute bacterial endocarditis,racial,Asian,1,0,1
437088,Fetus OR newborn affected by oligohydramnios,racial,White,1,0,1
440380,"Combined drug dependence, excluding opioid, episodic",racial,White,1,0,1
375530,Migraine with prolonged aura,ethnic,Hispanic or Latino,1,0,1
76887,Disorders of urogenital prostheses or implants,racial,Asian,1,0,1
4181332,Malignant tumour of posterior third of tongue,racial,White,0,1,1
440828,Renal pelvis and ureter obstructive defects,racial,White,0,1,1
138826,Acne varioliformis,ethnic,Not Hispanic or Latino,1,1,2
440847,Neonatal jaundice associated with preterm delivery,racial,White,1,1,2
200773,Stenosis of rectum and anus,ethnic,Hispanic or Latino,0,1,1
432586,Mental disorder,racial,Asian,1,1,2
74505,Closed subtrochanteric fracture,racial,White,1,0,1
438699,Primary malignant neoplasm of rectosigmoid junction,racial,Unknown,0,1,1
437406,Closed traumatic dislocation of joint of wrist,ethnic,Hispanic or Latino,0,1,1
435648,Testicular retraction,racial,Other Race,0,1,1
439907,Spontaneous tendon rupture,racial,Unknown,1,1,2
444375,"Contact dermatitis due to plants, except food",racial,Filipino,0,1,1
200349,Malignant lymphoma of intra-abdominal lymph nodes,ethnic,Not Hispanic or Latino,1,0,1
40484010,Unilateral conductive hearing loss,ethnic,Not Hispanic or Latino,1,0,1
439654,Partial epilepsy with impairment of consciousness,racial,Other Race,1,0,1
442862,"Abrasion or friction burn of hand, without mention of infection",racial,Other Race,0,1,1
316457,Mallory-Weiss syndrome,ethnic,Hispanic or Latino,0,1,1
197506,Malignant tumor of abdomen,racial,Other Race,1,0,1
441334,Glossodynia,racial,Asian,0,1,1
437995,Closed ill-defined fractures of upper limb,racial,Black or African American ,0,1,1
254980,Intrinsic asthma with asthma attack,racial,Filipino,0,1,1
4057923,Burn involving less than 10% of body surface NOS,ethnic,Hispanic or Latino,1,0,1
381857,Impairment level: one eye: total impairment: other eye: not specified,racial,Black or African American ,1,1,2
200164,Urine-induced contact dermatitis,racial,American Indian or Alaska Native ,1,1,2
436588,Traumatic wound dehiscence,racial,White,1,0,1
441246,Hemangioma of intracranial structure,racial,Black or African American ,1,0,1
135930,Musculoskeletal system observation,racial,Black or African American ,1,0,1
4016960,Concussion NOS,ethnic,Hispanic or Latino,1,0,1
4177966,Kaposi's sarcoma,ethnic,Not Hispanic or Latino,0,1,1
441680,Fetus OR newborn affected by multiple pregnancy,racial,Asian,1,0,1
4104555,Other and unspecified conjunctivitis,racial,Unknown,1,0,1
72712,Synovial cyst,ethnic,Not Hispanic or Latino,0,1,1
138525,Pain in limb,racial,Asian Indian,1,0,1
320536,Abnormal EKG finding,racial,Filipino,1,0,1
441321,Chronic nasopharyngitis,ethnic,Not Hispanic or Latino,1,1,2
31317,Can't get food down,racial,Native Hawaiian or Other Pacific Islander ,1,1,2
73065,"Contusion, genital organs",ethnic,Not Hispanic or Latino,0,1,1
200174,Disease of skin AND/OR subcutaneous tissue,racial,Alaska Native,0,1,1
440432,Accretion on teeth,racial,White,0,1,1
80471,Disorder of lactation,ethnic,Hispanic or Latino,1,0,1
313219,Phlebitis and thrombophlebitis,racial,Black or African American ,1,1,2
436785,Spinal stenosis in cervical region,racial,Other Race,1,1,2
439166,Closed fracture of radius,racial,Asian,0,1,1
4185302,Chronic myocardial ischemia,racial,Asian,0,1,1
435928,Abnormal decrease in weight,racial,Filipino,1,1,2
194403,Obstructed diaphragmatic hernia,racial,Black or African American ,1,0,1
375264,Impairment level: one eye: near-total impairment: other eye: normal vision,racial,White,0,1,1
438477,Atrophy of testis,ethnic,Not Hispanic or Latino,0,1,1
435887,Antepartum deep phlebothrombosis,racial,White,1,1,2
201779,Tuberculosis of adrenal glands,racial,White,1,1,2
435651,Atypical squamous cells on cervical Papanicolaou smear cannot exclude high grade squamous intraepithelial lesion,racial,Other Race,1,0,1
81175,Contusion of chest,racial,Black or African American ,1,1,2
4305303,Sleep deprivation,racial,Asian,1,0,1
374221,Injury of brachial plexus,racial,Black or African American ,0,1,1
256896,Tuberculosis of bronchus,ethnic,Hispanic or Latino,1,0,1
381304,Impulsive acoustic trauma,racial,White,0,1,1
442619,Fracture of humerus,ethnic,Hispanic or Latino,1,1,2
316857,Brachial blood vessel injury,ethnic,Hispanic or Latino,0,1,1
28109,Carcinoma in situ of esophagus,racial,White,1,1,2
80883,Nonvenomous insect bite of elbow with infection,racial,White,1,1,2
4175028,Irritant gastritis,ethnic,Not Hispanic or Latino,1,0,1
443585,Abrasion AND/OR friction burn of multiple sites,racial,Asian,1,1,2
4230642,Acquired deformity of chest,racial,Asian,1,0,1
444453,Benign tumour of soft tissue of leg,racial,Unknown,1,1,2
4103641,Amputated at ankle,racial,Unknown,0,1,1
440755,"Acute duodenal ulcer without hemorrhage, without perforation AND without obstruction",racial,White,0,1,1
435226,"Bipolar affective disorder, current episode mixed",racial,Other Race,1,0,1
439262,"Single manic episode, severe, with psychosis",ethnic,Not Hispanic or Latino,1,0,1
4110499,Allergic rhinitis NOS,racial,Asian,1,1,2
380733,Otalgia,racial,Native Hawaiian or Other Pacific Islander ,1,1,2
79889,Unstable lie - delivered,ethnic,Hispanic or Latino,1,0,1
78237,Bicipital tenosynovitis,racial,Asian,1,0,1
440548,Closed fracture of lower end of femur,racial,Unknown,1,1,2
197417,Injury of ureter with open wound into abdominal cavity,ethnic,Not Hispanic or Latino,1,0,1
75066,Nonallopathic lesion of cervical region,racial,Unknown,0,1,1
437896,Disorder of language,racial,Black or African American ,1,0,1
198571,Cardiogenic shock,ethnic,Hispanic or Latino,0,1,1
196158,Disease of penis,racial,Asian,0,1,1
75385,"Closed fracture distal humerus, lateral epicondyle",racial,Unknown,1,0,1
254443,Sicca syndrome,racial,Filipino,1,0,1
132736,Bacteremia,racial,Native Hawaiian or Other Pacific Islander ,0,1,1
437120,Closed dislocation of foot,racial,White,0,1,1
320299,Complication of transplanted heart,racial,White,0,1,1
436682,Moderate mental handicap,racial,Filipino,0,1,1
81942,Enthesopathy of ankle AND/OR tarsus,racial,Filipino,1,0,1
4144149,Cared for by family,racial,Unknown,0,1,1
195867,Noninflammatory vaginal disorders,racial,American Indian or Alaska Native ,1,0,1
139210,Superficial burn of back,racial,Unknown,1,0,1
78581,Sprain of sacroiliac ligament,racial,White,1,0,1
4016358,Staphylococcus carrier,ethnic,Not Hispanic or Latino,0,1,1
440039,Specific viral infections,racial,Unknown,1,0,1
435839,Lymphatic oedema,racial,Black or African American ,1,1,2
435839,Lymphatic oedema,racial,Other Race,1,0,1
440035,European cryptococcosis,racial,Black or African American ,0,1,1
374375,Impacted cerumen,racial,Asian Indian,0,1,1
433881,Additional general conditions of patient,racial,Alaska Native,1,0,1
132575,Myeloid sarcoma in remission,racial,White,0,1,1
193493,Benign hypertensive renal disease,racial,Black or African American ,0,1,1
319844,Acute ischemic heart disease,racial,White,1,1,2
77965,Nodular tendinous disease of finger,racial,American Indian or Alaska Native ,1,1,2
4194895,Screening for disorder,racial,American Indian or Alaska Native ,1,0,1
195861,Small kidney,racial,Unknown,1,0,1
437489,Herpes zoster with complication,ethnic,Not Hispanic or Latino,0,1,1
4052804,FH: Allergy,ethnic,Hispanic or Latino,1,0,1
137379,Musculoskeletal symptom,racial,Native Hawaiian or Other Pacific Islander ,0,1,1
4252915,Hydrorhachis,ethnic,Hispanic or Latino,1,0,1
133726,Carcinoma in situ of skin of face,ethnic,Not Hispanic or Latino,1,1,2
441207,Drug reaction,racial,Asian Indian,1,0,1
196464,Rapidly progressive glomerulonephritis,ethnic,Hispanic or Latino,1,1,2
193020,Incomplete emptying of bladder,racial,Asian,1,0,1
73008,Enthesopathy,racial,Native Hawaiian or Other Pacific Islander ,1,1,2
438725,Disorder of magnesium metabolism,racial,Black or African American ,0,1,1
433030,False-positive serological test for syphilis,ethnic,Not Hispanic or Latino,0,1,1
439922,"Gestation period, 24 weeks",ethnic,Hispanic or Latino,1,0,1
438531,Chondromalacia,racial,Unknown,1,1,2
4088372,Herpes zoster with other specified complication,racial,Unknown,0,1,1
198860,Congenital anomaly of lower alimentary tract,ethnic,Not Hispanic or Latino,1,0,1
261738,Multiple burns of head and neck,ethnic,Not Hispanic or Latino,0,1,1
438129,"Severe manic bipolar I disorder with psychotic features, mood-congruent",ethnic,Hispanic or Latino,0,1,1
200338,Nodular lymphoma of intra-abdominal lymph nodes,racial,Unknown,1,0,1
194992,Coeliac disease,racial,Unknown,1,1,2
378413,Partial recent retinal detachment with multiple defects,racial,White,1,0,1
437478,Bite of nonvenomous arthropod,racial,American Indian or Alaska Native ,1,0,1
442119,Adhesions of temporomandibular joint,ethnic,Not Hispanic or Latino,1,0,1
376901,"Acute paralytic poliomyelitis, bulbar",racial,White,1,0,1
432296,Coagulation factor deficiency syndrome,racial,Unknown,0,1,1
374024,Reaction to spinal or lumbar puncture,racial,White,1,0,1
196431,Hypersensitivity angiitis,racial,Filipino,1,0,1
443237,"Manic disorder, single episode",racial,American Indian or Alaska Native ,1,0,1
441848,Cranial nerve disorder,racial,White,1,1,2
433768,Glaucoma with increased episcleral venous pressure,racial,White,1,0,1
433644,Shellfish allergy,ethnic,Not Hispanic or Latino,0,1,1
316135,AVB - Atrioventricular block,racial,Black or African American ,1,0,1
435381,Closed fracture of base of thumb,ethnic,Not Hispanic or Latino,1,1,2
433759,Developmental reading disorder,ethnic,Hispanic or Latino,1,0,1
80523,Congenital fusion of spine,ethnic,Not Hispanic or Latino,1,0,1
195223,Renal carnitine transport defect,ethnic,Hispanic or Latino,1,0,1
74136,Muscle calcification and ossification,ethnic,Hispanic or Latino,0,1,1
139036,Systolic dysfunction,ethnic,Not Hispanic or Latino,1,0,1
4273095,Acute tracheitis without obstruction,racial,Asian,1,0,1
133013,Congenital spinal cord anomaly,racial,Other Race,0,1,1
433987,Benign tumour of orbit,racial,White,1,0,1
433410,Primary syphilis,racial,White,0,1,1
440431,Pneumonia due to Mycoplasma pneumoniae,racial,Black or African American ,1,0,1
379006,Cerebral degeneration in childhood,racial,Unknown,0,1,1
441655,Disorder of sweat gland,ethnic,Not Hispanic or Latino,1,1,2
439871,Haemospermia,racial,Unknown,0,1,1
4268980,Finding of general development,racial,Other Race,1,0,1
4012590,Fracture of one or more phalanges of foot NOS,racial,White,1,0,1
381308,Abscess of eyelid,racial,Asian,0,1,1
4030872,Hyperemesis of pregnancy,racial,Unknown,1,0,1
437046,Complete abortion,racial,Other Race,1,0,1
81064,Pseudopolyposis of colon,racial,Unknown,1,0,1
4014230,Ankle sprain NOS,racial,Asian,1,0,1
4145823,Inadequate housing,ethnic,Hispanic or Latino,0,1,1
437394,Closed fracture of lower end of forearm,racial,Asian,1,0,1
133088,Late amputation stump complication,racial,Unknown,1,1,2
4284118,Fall on escalator,racial,Unknown,0,1,1
4016352,Tuberculosis contact,racial,Black or African American ,1,1,2
4147635,Unspecified otorrhea,racial,Unknown,0,1,1
80571,Open wound of foot with complication,racial,Other Race,0,1,1
441283,Recurrent iridocyclitis,ethnic,Hispanic or Latino,0,1,1
133570,Acute osteomyelitis of the pelvic region and/or thigh,racial,Other Race,0,1,1
438767,Posterior staphyloma,racial,Unknown,0,1,1
436480,Dystrophy of vulva,ethnic,Hispanic or Latino,1,0,1
432287,Immunodeficiency with IgM hypergammaglobulinaemia,ethnic,Not Hispanic or Latino,1,1,2
4139420,Foreign body in auditory canal,racial,Filipino,0,1,1
377868,Corneal pannus,ethnic,Hispanic or Latino,0,1,1
439264,Acute suppurative otitis media,racial,White,1,0,1
381562,"Impairment level: better eye: moderate impairment: lesser eye: blind, not further specified",racial,Other Race,1,0,1
136779,Disease of forearm,racial,Unknown,1,0,1
436043,Malignant overlapping lesion of tongue,racial,White,0,1,1
27674,N&V - Nausea and vomiting,racial,American Indian,1,0,1
440309,Adverse reaction to diphtheria vaccine,ethnic,Hispanic or Latino,1,1,2
198683,Viral hepatitis B without hepatic coma,racial,Unknown,1,1,2
375251,Retinopathy of prematurity stage 2 - intraretinal ridge,racial,White,1,0,1
435510,Hypocalcemia,racial,Black or African American ,0,1,1
81064,Pseudopolyposis of colon,racial,Other Race,0,1,1
140490,Anhidrosis,racial,Asian,0,1,1
137443,Mechanical complication due to skin graft failure AND/OR rejection,racial,White,0,1,1
78233,Old disruption of medial collateral ligament,ethnic,Not Hispanic or Latino,1,0,1
442766,Malignant hypertensive renal disease,ethnic,Hispanic or Latino,1,0,1
4101199,Hearing problem,racial,Filipino,0,1,1
443239,Precerebral arterial occlusion,racial,White,1,0,1
373202,Corneal ulcer,racial,White,1,0,1
256142,Dental arch relationship anomaly,ethnic,Hispanic or Latino,1,1,2
76503,Joint contracture of shoulder,racial,White,1,0,1
136368,Non-toxic multinodular goiter,racial,Black or African American ,1,0,1
372849,Overlapping malignant neoplasm of brain and other parts of the central nervous system,racial,Unknown,1,0,1
4057923,Burn involving less than 10% of body surface NOS,racial,White,1,0,1
434793,Subdural hemorrhage following injury without open intracranial wound,ethnic,Hispanic or Latino,1,0,1
136916,Primary malignant neoplasm of skin of external auditory canal,ethnic,Not Hispanic or Latino,1,0,1
443767,Diabetic oculopathy,racial,Native Hawaiian or Other Pacific Islander ,1,0,1
377559,Vernal conjunctivitis,ethnic,Not Hispanic or Latino,1,1,2
138455,Stomatitis,racial,Asian,1,1,2
438648,Vitamin poisoning,racial,White,1,0,1
433612,Closed fracture of upper end of fibula,racial,White,1,0,1
438407,BN - Bulimia nervosa,racial,Native Hawaiian or Other Pacific Islander ,1,0,1
4016353,Meningococcus contact,racial,White,1,0,1
4139420,Foreign body in auditory canal,racial,Other Race,1,0,1
26942,Hemoglobin SS disease with crisis,racial,White,0,1,1
381416,Brain injury without open intracranial wound AND with prolonged loss of consciousness (more than 24 hours) without return to pre-existing conscious level,racial,White,0,1,1
437394,Closed fracture of lower end of forearm,racial,Black or African American ,0,1,1
72465,Closed fracture of one or more phalanges of hand,racial,Other Race,1,1,2
192673,Vascular insufficiency of intestine,ethnic,Not Hispanic or Latino,1,0,1
4145821,Symptom of head and neck region,racial,White,1,1,2
4036945,Consciousness disturbance NOS,racial,Unknown,0,1,1
31967,Nausea,racial,American Indian or Alaska Native ,1,0,1
436222,Altered mental status,racial,Native Hawaiian or Other Pacific Islander ,1,1,2
436166,Mild hyperemesis gravidarum,racial,Asian,1,0,1
441192,Accidentally struck by or against objects or persons,racial,Other Race,0,1,1
192731,Digestive symptom,racial,Black or African American ,0,1,1
440330,Rochalimaea infection,ethnic,Hispanic or Latino,1,0,1
195603,Vulval and/or perineal noninflammatory disorders,racial,American Indian,1,0,1
4112366,Nasal polyp NOS,racial,White,1,0,1
201909,Female infertility,racial,Middle Eastern or North African,1,0,1
432962,Leukoplakia of cervix,ethnic,Hispanic or Latino,1,0,1
136282,"Burn erythema of single finger, not thumb",ethnic,Hispanic or Latino,1,1,2
4059611,Other disorders of bladder,racial,White,1,1,2
313007,MR - Congenital mitral regurgitation,ethnic,Hispanic or Latino,0,1,1
432878,Drug abuse using speed,racial,Asian,0,1,1
76227,Leg oedema,racial,White,1,0,1
372634,Nonphysiologic vision loss,racial,American Indian or Alaska Native ,1,0,1
140357,Neoplasm of uncertain behaviour of endocrine gland,racial,White,1,0,1
30683,Hemoglobin SS disease without crisis,racial,Black or African American ,1,1,2
197913,Disorder of function of stomach,racial,Asian Indian,0,1,1
74725,Displacement of cervical intervertebral disc without myelopathy,racial,Filipino,1,0,1
80184,Arthropathy due to parasitic infection,ethnic,Not Hispanic or Latino,1,0,1
4112366,Nasal polyp NOS,ethnic,Not Hispanic or Latino,1,0,1
434030,Glaucoma with lens disorder,racial,White,0,1,1
4064906,Bacterial conjunctivitis screening,ethnic,Hispanic or Latino,0,1,1
4160859,Methicillin resistant staphylococcus aureus carrier,racial,Other Race,1,0,1
4272867,General well-being finding,racial,American Indian or Alaska Native ,1,1,2
197033,Endometriosis of pelvic peritoneum,ethnic,Not Hispanic or Latino,1,0,1
437470,Adverse reaction to benzodiazepine-based tranquilliser,ethnic,Not Hispanic or Latino,0,1,1
312437,Dyspnea,racial,Asian Indian,0,1,1
75668,Sprain of sacroiliac region,racial,White,1,0,1
373784,Acute allergic serous otitis media,racial,Other Race,1,0,1
4093460,Leptospirosis NOS,racial,Unknown,1,1,2
4188027,Food allergy,racial,Filipino,0,1,1
201531,"Diabetes mellitus, juvenile type, with hyperosmolar coma",ethnic,Not Hispanic or Latino,0,1,1
432612,Mild mental handicap,racial,Asian,1,1,2
4101431,Disorder of calcium metabolism NOS,ethnic,Hispanic or Latino,1,1,2
4088777,Vagina observation,racial,Asian,1,0,1
4025663,Obstructed inguinal hernia,racial,Unknown,0,1,1
72786,Burn of finger,ethnic,Not Hispanic or Latino,1,0,1
432306,Gender identity disorder of adolescence,racial,Black or African American ,1,0,1
193240,Acute generalized peritonitis,ethnic,Hispanic or Latino,1,0,1
200449,Hepatitis in viral diseases EC,racial,Unknown,1,0,1
132706,Nail disease,racial,Asian,1,0,1
376120,"Keratoconjunctivitis sicca, not specified as Sjogren's",racial,Asian,1,0,1
138539,Shprintzen-Goldberg syndrome,ethnic,Not Hispanic or Latino,0,1,1
372613,Flaccid hemiplegia,racial,Asian,0,1,1
435516,Lipoprotein deficiency disorder,racial,American Indian or Alaska Native ,1,0,1
380111,Acute atopic conjunctivitis,racial,Black or African American ,1,0,1
4109249,Other corneal disorders,racial,White,1,0,1
4239721,Seafood allergy,racial,Other Race,1,1,2
444253,Blister of scalp without infection,racial,Unknown,1,0,1
373189,Encephalomyelitis,ethnic,Not Hispanic or Latino,1,1,2
77066,Derangement of medial meniscus,racial,Asian,0,1,1
4224000,Transposition of pterygium,racial,Unknown,1,0,1
441269,Autoimmune hemolytic anemia,racial,Alaska Native,1,0,1
192259,Ascariasis,ethnic,Hispanic or Latino,1,1,2
4062998,Infantile paralytic paralysis,racial,White,1,0,1
440098,Rubeosis iridis,racial,Unknown,1,1,2
196163,Cervicitis and endocervicitis,racial,Native Hawaiian or Other Pacific Islander ,1,0,1
435262,Primary open angle glaucoma,racial,Native Hawaiian or Other Pacific Islander ,1,0,1
193863,Congenital abnormality of lower limb AND/OR pelvic girdle,racial,White,0,1,1
442770,Disorder of ciliary body,ethnic,Hispanic or Latino,1,0,1
78025,Superficial injury of hand with infection,racial,Unknown,0,1,1
438392,Disorder of hyperalimentation,racial,White,0,1,1
199991,Complication of transplanted kidney,ethnic,Not Hispanic or Latino,1,0,1
433167,Lipoma of intrathoracic organs,racial,White,0,1,1
433246,"Chronic duodenal ulcer without hemorrhage, without perforation AND without obstruction",ethnic,Hispanic or Latino,1,0,1
434094,Spontaneous abortion with complication,racial,Unknown,1,0,1
24818,Neck injury,racial,American Indian,1,0,1
4141622,Asthma NOS,racial,Filipino,0,1,1
439262,"Single manic episode, severe, with psychosis",racial,Unknown,0,1,1
74211,Superficial injury of finger without infection,ethnic,Not Hispanic or Latino,1,0,1
4112525,Acute bronchiolitis NOS,racial,Black or African American ,1,0,1
4117862,Chronic rheumatic mitral valve,ethnic,Not Hispanic or Latino,1,0,1
315276,Vitreous hemorrhage,racial,Other Race,1,0,1
26662,Testicular hypofunction,racial,American Indian or Alaska Native ,0,1,1
199881,Endometriosis of ovary,racial,White,1,0,1
440129,Hypertrophy of nasal turbinates,racial,Black or African American ,1,1,2
436587,"Toxic effect of gas, fumes AND/OR vapors",ethnic,Not Hispanic or Latino,1,0,1
432746,"Open fracture of radius and ulna, shaft",ethnic,Hispanic or Latino,0,1,1
80522,Congenital deformity of clavicle,ethnic,Hispanic or Latino,1,1,2
4104581,Esotropia with accommodative compensation,racial,White,1,0,1
437184,"Poisoning of undetermined intent by corrosive, acid or caustic alkali",ethnic,Hispanic or Latino,1,0,1
199718,Enteritis due to rotavirus,racial,White,0,1,1
4181328,CA - Cancer of adrenal gland,racial,White,1,0,1
40482247,Organic sleep apnea,ethnic,Not Hispanic or Latino,1,1,2
193323,Neonatal diabetes mellitus,ethnic,Hispanic or Latino,1,0,1
28974,Candidiasis of oesophagus,racial,Black or African American ,0,1,1
433862,Congenital anomaly of tongue,racial,White,1,0,1
374655,Mastoiditis,ethnic,Not Hispanic or Latino,1,1,2
378414,Separation of retinal layers,racial,Asian,1,1,2
434689,Incomplete abortion,racial,Black or African American ,1,0,1
434502,Closed fracture of phalanx of toe,racial,American Indian or Alaska Native ,0,1,1
313989,Chronic lymphadenitis,racial,Unknown,0,1,1
376691,Delimited old retinal detachment,ethnic,Not Hispanic or Latino,0,1,1
133861,CL - Cleft lip,racial,White,1,0,1
4097561,Burkitt lymphoma of lymph nodes of axilla and upper limb,ethnic,Hispanic or Latino,0,1,1
4152813,Family disruption,racial,Black or African American ,1,0,1
432803,[X]Fall on and from ladder,racial,Black or African American ,0,1,1
440230,Closed fracture of anatomical neck of humerus,racial,White,1,1,2
141323,Acute maxillary sinusitis,racial,Other Race,1,1,2
4285417,Incision of pituitary gland,racial,White,1,1,2
435774,Disorder of amino acid metabolism,racial,White,0,1,1
198263,Right upper quadrant pain,racial,American Indian,1,0,1
75897,Polyarthropathy,racial,American Indian or Alaska Native ,1,0,1
137016,Retained dental root,racial,Unknown,1,0,1
76161,Impotence of organic origin,racial,Native Hawaiian or Other Pacific Islander ,0,1,1
193825,"Congenital abnormality of uterus complicating antenatal care, baby not yet delivered",ethnic,Hispanic or Latino,1,0,1
4303805,Allergic reaction to bite and/or sting,racial,Asian,1,0,1
4060318,Chest pain NOS,racial,Unknown,0,1,1
194265,Cryptosporidiasis,ethnic,Hispanic or Latino,0,1,1
4186238,Louse infestation,racial,American Indian or Alaska Native ,1,0,1
138713,Disease of parathyroid glands,racial,Unknown,1,0,1
81713,Carpal joint sprain,ethnic,Not Hispanic or Latino,0,1,1
4310085,Accidental poisoning by other drugs acting on central and autonomic nervous system,ethnic,Hispanic or Latino,0,1,1
439937,C-reactive protein abnormal,racial,Filipino,1,0,1
437038,Blood in urine,racial,Native Hawaiian or Other Pacific Islander ,1,0,1
313221,Rheumatic aortic stenosis,racial,White,1,0,1
434462,VSD - Ventricular septal defect,racial,Other Race,1,1,2
439002,Eating disorder,racial,Other Race,0,1,1
435023,Mild hyperemesis-not delivered,racial,Asian,1,0,1
439840,Inflammation of lymphatics,racial,White,1,0,1
318775,Venous embolism,racial,Black or African American ,1,0,1
375278,Acquired stenosis of external ear canal secondary to inflammation,ethnic,Not Hispanic or Latino,0,1,1
434541,Effects of heat,ethnic,Hispanic or Latino,1,0,1
76255,Sprain of iliofemoral ligament,ethnic,Hispanic or Latino,1,0,1
433881,Additional general conditions of patient,racial,Black or African American ,1,0,1
200784,Placental condition affecting management of mother,racial,White,1,0,1
193530,Follicular cyst of ovary,racial,Asian,1,0,1
4148412,Family history: Genitourinary disease,ethnic,Hispanic or Latino,1,0,1
77819,Benign tumour of pleura,ethnic,Hispanic or Latino,1,0,1
442901,"Motor vehicle traffic accident involving collision with another motor vehicle, stopped, occupant of tram injured",racial,White,1,0,1
77373,Congenital deformity of hip joint,racial,Black or African American ,0,1,1
196724,Disease of diaphragm,racial,Unknown,0,1,1
432800,Assault by cutting and stabbing instruments,ethnic,Hispanic or Latino,0,1,1
75010,Fibroadenosis of breast,racial,Asian,1,0,1
201901,Abscess of liver,racial,Unknown,0,1,1
435875,"Complications of pregnancy, childbirth and the puerperium",racial,Asian,1,0,1
439776,Pervasive developmental disorder,ethnic,Hispanic or Latino,0,1,1
72748,Strain of rotator cuff of shoulder,racial,American Indian or Alaska Native ,1,0,1
4196362,Genetic counselling,racial,Black or African American ,1,0,1
443603,Adverse reaction to antidiabetic drug,racial,Unknown,1,0,1
441171,Second degree burn of chest wall,racial,White,0,1,1
313780,Mobitz type 2 second degree atrioventricular block,ethnic,Not Hispanic or Latino,0,1,1
438580,Closed fracture of C5-C7 level with spinal cord injury,ethnic,Hispanic or Latino,1,0,1
193070,Blister of trunk with infection,racial,Unknown,1,0,1
4194396,Haemoglobinopathy screening test,racial,White,1,1,2
139882,Endometriosis in scar of skin,racial,Unknown,1,0,1
4149560,Hand sprain unspecified,ethnic,Not Hispanic or Latino,1,0,1
74582,Primary malignant neoplasm of rectum,racial,Unknown,1,0,1
201075,Noninflammatory disorder of cervix,ethnic,Not Hispanic or Latino,1,0,1
376102,Partial recent retinal detachment with single defect,racial,Unknown,0,1,1
81424,Closed dislocation of knee,ethnic,Hispanic or Latino,1,1,2
4061073,Male infertility NOS,ethnic,Hispanic or Latino,0,1,1
77734,Contusion of lower leg,racial,Native Hawaiian or Other Pacific Islander ,0,1,1
438410,[X]Psychogenic dysuria,racial,White,1,0,1
443257,Swellings and lumps,racial,American Indian or Alaska Native ,0,1,1
440638,Lyme disease,ethnic,Not Hispanic or Latino,1,0,1
199891,RI - Rhesus isoimmunisation,racial,White,1,0,1
134736,Backache,racial,Alaska Native,1,0,1
378741,Brachial plexus lesion,racial,Unknown,1,1,2
201129,Newborn swallowing maternal blood causing hematemesis or melena,ethnic,Not Hispanic or Latino,0,1,1
317109,Respiratory arrest,ethnic,Hispanic or Latino,1,0,1
260759,Malocclusion of teeth,racial,Unknown,1,0,1
444434,Schizophreniform disorder,ethnic,Not Hispanic or Latino,1,0,1
443587,Diastolic heart failure,racial,Filipino,0,1,1
4269719,Finding of growth of fungi,racial,Black or African American ,0,1,1
23164,Disease of anterior pituitary,racial,White,1,0,1
132659,Acute apical periodontitis,racial,Native Hawaiian or Other Pacific Islander ,1,1,2
197596,Toxic gastroenteritis,ethnic,Hispanic or Latino,0,1,1
372627,Transient visual loss,ethnic,Hispanic or Latino,1,0,1
81169,Superficial foreign body of finger without major open wound AND without infection,ethnic,Not Hispanic or Latino,1,0,1
28461,Hypertrophy of salivary gland,ethnic,Not Hispanic or Latino,0,1,1
4143350,Other deficiency anaemias,racial,Unknown,1,1,2
375552,Pterygium,racial,American Indian or Alaska Native ,1,0,1
135852,Teething syndrome,racial,Filipino,0,1,1
4143966,Essential hypertension NOS,racial,White,1,0,1
132853,Lymphatic leukaemia,ethnic,Hispanic or Latino,0,1,1
437233,Plasmacytic myeloma,racial,Other Race,0,1,1
379778,Multi-infarct dementia,ethnic,Hispanic or Latino,0,1,1
375738,Neurosyphilis,ethnic,Hispanic or Latino,0,1,1
4024848,Chronic peptic ulcer without mention of complication,ethnic,Hispanic or Latino,1,0,1
73373,Burn erythema of upper limb,ethnic,Not Hispanic or Latino,1,1,2
4232618,Gelastic seizure,ethnic,Hispanic or Latino,1,0,1
378424,Astigmatism,racial,Asian,1,1,2
140172,Erythematosquamous dermatosis,racial,White,1,0,1
4323155,Limited consultation,ethnic,Hispanic or Latino,1,1,2
318459,Respiratory insufficiency,ethnic,Not Hispanic or Latino,0,1,1
375274,Monocular exotropia,ethnic,Hispanic or Latino,1,0,1
377280,Corneal disorder,ethnic,Not Hispanic or Latino,1,0,1
4105181,Socialised childhood truancy,ethnic,Hispanic or Latino,0,1,1
433760,Dysreflexia,racial,Black or African American ,0,1,1
4243827,Drug addiction counseling,ethnic,Not Hispanic or Latino,1,1,2
134324,Lipodystrophy,racial,Black or African American ,0,1,1
313006,Congenital stenosis of mitral valve,racial,White,0,1,1
437428,Crushing injury - disorder,racial,White,1,1,2
438871,Drug withdrawal syndrome in newborn,ethnic,Not Hispanic or Latino,1,1,2
433015,Congenital anomaly of aortic arch,racial,Black or African American ,1,0,1
258453,Acute upper respiratory infection of multiple sites,racial,Other Race,1,0,1
435101,Open fracture of foot,racial,White,1,1,2
437557,Eczematous dermatitis of eyelid,racial,Black or African American ,1,0,1
4302543,Insertion of prosthesis or prosthetic device of femoral head,racial,Black or African American ,0,1,1
316447,Chronic hypotension,racial,Asian,0,1,1
139888,Threatened premature labor - not delivered,racial,Other Race,1,0,1
31609,Abscess of salivary gland,racial,White,1,0,1
377802,Late effects of poliomyelitis,racial,Asian,0,1,1
376555,Open wound of ear drum without complication,racial,Unknown,1,1,2
4159157,Disorder of tooth development,ethnic,Hispanic or Latino,1,0,1
73301,Synovitis/tenosynovitis - wrist,racial,Other Race,1,0,1
437202,Giardiasis,ethnic,Not Hispanic or Latino,0,1,1
196151,Functional disorder of intestine,racial,Black or African American ,0,1,1
436635,Primary malignant neoplasm of sigmoid colon,racial,White,0,1,1
320073,Neutrophil count below reference range,racial,Black or African American ,1,0,1
194087,Hepatitis due to infection,ethnic,Hispanic or Latino,0,1,1
436392,Carotid sinus syncope,racial,White,1,0,1
314457,Congenital stenosis of aortic valve,ethnic,Hispanic or Latino,1,0,1
316857,Brachial blood vessel injury,racial,White,0,1,1
380120,Strabismus in neuromuscular disorder,racial,Unknown,1,1,2
196431,Hypersensitivity angiitis,racial,Unknown,1,0,1
4307254,Closed fracture,racial,Filipino,1,0,1
4175331,Congenital haemolytic anaemia,ethnic,Hispanic or Latino,1,0,1
441512,Infection by Onchocerca volvulus,ethnic,Hispanic or Latino,1,0,1
77234,Benign tumour of colon,racial,Filipino,1,0,1
442558,"Gestation period, 32 weeks",racial,Asian,0,1,1
444112,Integumentary system finding,racial,American Indian or Alaska Native ,1,1,2
441868,Optic disc oedema,ethnic,Not Hispanic or Latino,1,0,1
439141,Abnormal increase in weight,racial,American Indian,1,0,1
443674,Traumatic amputation of toe(s) with complication,racial,Unknown,0,1,1
316822,Finding of heart murmur,racial,Asian Indian,0,1,1
199837,Deep vein thrombosis of portal vein,racial,White,0,1,1
134757,Ectodermal dysplasia,ethnic,Hispanic or Latino,0,1,1
256571,FB - Nasal foreign body,racial,Black or African American ,0,1,1
316139,HF - Heart failure,racial,American Indian,1,0,1
444445,Benign neoplasm of skin of leg,racial,Filipino,1,0,1
81379,Lateral epicondylitis,racial,American Indian,1,0,1
314054,Aortic valve disease,racial,American Indian,0,1,1
30683,Hemoglobin SS disease without crisis,ethnic,Not Hispanic or Latino,1,1,2
73840,Primary localised osteoarthrosis of shoulder region,racial,American Indian or Alaska Native ,1,0,1
378757,Hypotrichosis of eyelid,ethnic,Hispanic or Latino,1,1,2
196236,Septicaemic shock,racial,Unknown,1,1,2
197807,Primary malignant neoplasm of soft tissues of abdomen,racial,White,1,0,1
4103574,Chronic depression,racial,American Indian,1,0,1
378427,Tear film insufficiency,racial,Filipino,1,0,1
433633,Late effect of superficial injury,racial,White,1,0,1
440432,Accretion on teeth,ethnic,Hispanic or Latino,1,1,2
135032,Dermatitis due to substances taken internally,ethnic,Not Hispanic or Latino,1,1,2
441039,Phlebitis of lower limb vein,racial,Other Race,1,0,1
4036945,Consciousness disturbance NOS,ethnic,Not Hispanic or Latino,1,0,1
441225,Primary malignant neoplasm of ampulla of Vater,racial,White,0,1,1
380818,Acquired deformity of head,ethnic,Not Hispanic or Latino,1,0,1
201399,Congenital anomaly of adrenal gland,ethnic,Hispanic or Latino,0,1,1
141651,Stevens-Johnson syndrome,ethnic,Not Hispanic or Latino,1,0,1
378419,AD - Alzheimer's disease,racial,Filipino,1,0,1
432456,Finding of alcohol intake,ethnic,Hispanic or Latino,0,1,1
433862,Congenital anomaly of tongue,ethnic,Not Hispanic or Latino,1,1,2
192259,Ascariasis,racial,White,0,1,1
4269584,Finding relating to religious movement or belief,ethnic,Not Hispanic or Latino,1,0,1
437116,Closed fracture of distal end of radius,racial,Asian,0,1,1
380669,Benign neoplasm of eyelid including canthus,ethnic,Not Hispanic or Latino,1,1,2
4299535,Pregnancy confirmed,racial,Filipino,1,0,1
439060,Atrophy of tongue papillae,racial,White,0,1,1
75343,Contracture of hip joint,ethnic,Hispanic or Latino,1,0,1
320206,Congenital atresia of pulmonary valve,ethnic,Not Hispanic or Latino,0,1,1
443585,Abrasion AND/OR friction burn of multiple sites,racial,American Indian or Alaska Native ,1,0,1
435649,Complication of hemodialysis,ethnic,Not Hispanic or Latino,0,1,1
4110505,Chest infection - other bacterial pneumonia,ethnic,Hispanic or Latino,1,0,1
200527,Splenomegaly,racial,Other Race,1,0,1
40422016,Suicide and selfinflicted injury by jumping or lying before moving object,ethnic,Hispanic or Latino,1,0,1
75043,Hemarthrosis of knee,racial,White,0,1,1
4109260,Other eyelid disorders,racial,White,1,1,2
434298,Metastasis to upper limb lymph node,ethnic,Not Hispanic or Latino,1,0,1
437247,Anaemia of chronic disease,racial,American Indian,1,0,1
379032,Acute mastoiditis with complications,ethnic,Not Hispanic or Latino,0,1,1
438555,Cyanosis,racial,Unknown,1,0,1
199066,Female digestive-genital tract fistula,racial,Unknown,1,0,1
76545,Closed traumatic dislocation of patella,racial,Unknown,1,0,1
193312,Congenital anomaly of ureter,racial,White,1,1,2
440600,Assault by bite of human being,ethnic,Hispanic or Latino,1,1,2
375525,Athetoid cerebral palsy,ethnic,Not Hispanic or Latino,1,0,1
434207,"Insect bite, nonvenomous, of hand, without mention of infection",racial,Other Race,1,1,2
433092,Burn of multiple sites of wrist AND/OR hand,racial,White,1,0,1
377126,Concussion with brief loss of consciousness,ethnic,Hispanic or Latino,0,1,1
439183,Concussion,racial,Native Hawaiian or Other Pacific Islander ,0,1,1
252942,Asthmatic pulmonary eosinophilia,ethnic,Not Hispanic or Latino,0,1,1
444375,"Contact dermatitis due to plants, except food",racial,Other Race,1,1,2
321052,Peripheral vascular disease,racial,American Indian or Alaska Native ,1,0,1
22274,Neoplasm of uncertain behaviour of larynx,racial,Unknown,1,0,1
440979,Acquired hemolytic anemia,racial,Asian,1,0,1
435119,Sequela of injury,ethnic,Hispanic or Latino,1,1,2
377535,Sleep walking disorder,racial,Unknown,0,1,1
72618,Disorder of muscle,racial,Black or African American ,0,1,1
443610,Prolapse of uterine cervical stump,racial,White,1,0,1
75351,Adolescent postural kyphosis,ethnic,Not Hispanic or Latino,1,0,1
373404,Ophthalmic herpes simplex,racial,White,1,1,2
135030,Discoloration of skin,racial,Asian,1,0,1
442827,Fetus with central nervous system malformation with antenatal problem,ethnic,Hispanic or Latino,1,0,1
442444,"Motor vehicle traffic accident involving pedestrian hit by motor vehicle, pedestrian injured",racial,Asian,1,0,1
316998,Left bundle branch block,racial,Asian Indian,0,1,1
132466,Lumbar sprain,racial,American Indian,1,1,2
377283,Conjunctival injection,ethnic,Hispanic or Latino,1,1,2
81088,Failed lactation,racial,White,0,1,1
4089984,Congenital syphilis NOS,racial,White,1,1,2
138994,MDS - Myelodysplastic syndrome,racial,Asian,1,0,1
140490,Anhidrosis,ethnic,Not Hispanic or Latino,0,1,1
432451,Abnormal results of function studies of central nervous system,racial,White,1,0,1
437986,FTT - Failure to thrive,racial,Asian Indian,0,1,1
435521,Psychophysiologic disorder,racial,Black or African American ,1,1,2
194491,Tenderness of epigastrium,ethnic,Not Hispanic or Latino,1,1,2
4084229,Primary gout,racial,Filipino,1,1,2
373775,Psychophysical visual disturbance,racial,Other Race,1,0,1
439154,Abnormal findings on diagnostic imaging of skull and head,racial,Black or African American ,0,1,1
380395,Retinal dystrophy,racial,White,1,0,1
76002,Mechanical complication due to breast prosthesis,ethnic,Not Hispanic or Latino,1,0,1
40481920,Periumbilical pain,racial,American Indian or Alaska Native ,1,0,1
4024567,Respiratory observation,racial,American Indian or Alaska Native ,1,0,1
435799,Adjustment disorder with disturbance of conduct,ethnic,Hispanic or Latino,0,1,1
4196935,Unilateral repair of inguinal hernia with prosthesis or graft,racial,White,0,1,1
436086,Manic bipolar I disorder in full remission,ethnic,Not Hispanic or Latino,0,1,1
433933,Plants - toxic effect,ethnic,Hispanic or Latino,1,1,2
77653,Traumatic myositis ossificans,ethnic,Not Hispanic or Latino,0,1,1
437222,Respiratory syncytial virus infection,racial,Unknown,0,1,1
432310,Meningitis due to cryptococcus,ethnic,Not Hispanic or Latino,0,1,1
4169641,Developmental handicap screening,racial,Black or African American ,1,1,2
4171115,Low birth weight infant,racial,American Indian or Alaska Native ,0,1,1
256716,Asthma with status asthmaticus,racial,Asian,1,0,1
141475,Second degree burn of foot,ethnic,Not Hispanic or Latino,1,1,2
73904,Open wound of buttock without complication,racial,Unknown,1,1,2
4060985,BMI 30+ - obesity,racial,Alaska Native,1,0,1
4053045,Dog bite,racial,Asian,1,0,1
380415,Acute swimmer's ear,racial,Asian Indian,1,0,1
4147414,Varicose veins of legs in pregnancy,racial,Unknown,1,0,1
257581,Exacerbation of asthma,racial,Asian Indian,0,1,1
4148076,Chronic neurogenic ulcer of lower limb,ethnic,Hispanic or Latino,1,0,1
434657,Weakness of face muscles,ethnic,Not Hispanic or Latino,1,1,2
133655,Burn of forearm,ethnic,Not Hispanic or Latino,1,0,1
319054,Thrombophlebitis of upper extremities,ethnic,Not Hispanic or Latino,1,0,1
4104860,Infantile spasms NOS,ethnic,Hispanic or Latino,0,1,1
443913,Congenital anomaly of trachea,racial,Black or African American ,0,1,1
4071485,Foetus or neonate affected by caesarean section,ethnic,Not Hispanic or Latino,1,0,1
78097,Metastatic tumour of bone,racial,Black or African American ,1,0,1
197500,Primary malignant neoplasm of colon,racial,American Indian or Alaska Native ,1,0,1
78473,Solitary cyst of breast,racial,Black or African American ,1,0,1
75043,Hemarthrosis of knee,ethnic,Hispanic or Latino,0,1,1
201341,Incisional hernia with obstruction but no gangrene,racial,Unknown,1,0,1
434502,Closed fracture of phalanx of toe,racial,Asian,1,0,1
194831,Gastric foreign body,ethnic,Hispanic or Latino,0,1,1
4062637,TB - Tuberculosis screening,racial,Alaska Native,1,0,1
134398,Periodontal disease,racial,Black or African American ,0,1,1
376657,Lipoma of face,ethnic,Not Hispanic or Latino,1,1,2
434145,Embryonal nuclear cataract,racial,Unknown,1,0,1
444437,Congenital abnormality of cervix,racial,Unknown,1,0,1
436640,Primary malignant neoplasm of long bone of lower limb,racial,White,0,1,1
24818,Neck injury,racial,Black or African American ,0,1,1
432739,Red blood cell disorder,racial,Black or African American ,0,1,1
196341,Dermatophytosis of the perianal area,racial,Filipino,0,1,1
442766,Malignant hypertensive renal disease,racial,Unknown,1,0,1
441192,Accidentally struck by or against objects or persons,ethnic,Not Hispanic or Latino,1,0,1
192385,"Tumour of uterine body complicating antenatal care, baby not yet delivered",ethnic,Hispanic or Latino,1,0,1
433288,Derangement of anterior horn of lateral meniscus,racial,Unknown,1,0,1
379020,Entropion,racial,Asian,1,0,1
142026,Disorder of cardiovascular prostheses and implants,ethnic,Not Hispanic or Latino,1,0,1
315830,Variant angina,racial,Other Race,0,1,1
4164792,Hemophilus influenzae laryngitis,ethnic,Not Hispanic or Latino,1,1,2
201347,Pelvic pain syndrome,racial,Unknown,1,0,1
200483,Disease of pelvis,racial,Asian,0,1,1
432968,Anemia during pregnancy - baby delivered,racial,Unknown,1,0,1
193807,Anorectal fistula,racial,Asian,0,1,1
443545,Nonvenomous insect bite,racial,Native Hawaiian or Other Pacific Islander ,1,1,2
439987,"Accident caused by hot liquid and vapor, including steam",ethnic,Hispanic or Latino,1,1,2
440543,Fracture of tibia,racial,White,1,1,2
79091,Unstable lie,ethnic,Not Hispanic or Latino,1,0,1
40353121,"Accidental cut, puncture, perforation or haemorrhage during medical care",racial,White,1,1,2
373962,Tabes dorsalis - neurosyphilis,racial,White,1,1,2
438390,Benign tumour of vulva,racial,Asian,1,0,1
255302,Spontaneous pneumothorax,ethnic,Hispanic or Latino,0,1,1
4113650,Noninflammatory cervical disorder,racial,Unknown,1,0,1
381592,Chronic mucoid otitis media,racial,Asian,1,0,1
142016,Nonvenomous insect bite of finger with infection,racial,White,1,0,1
75905,Pathological dislocation of upper arm,racial,White,0,1,1
4061073,Male infertility NOS,racial,White,0,1,1
313543,Venous complication in pregnancy AND/OR the puerperium,racial,Unknown,1,0,1
4301700,Acute mastoiditis,ethnic,Hispanic or Latino,1,0,1
4195473,Temporary tracheostomy,racial,Unknown,0,1,1
437969,Acquired pes planus,racial,Other Race,1,1,2
377085,Congenital anomaly of brain,racial,Unknown,0,1,1
4017388,Closed dislocation lumbar spine,ethnic,Not Hispanic or Latino,1,0,1
436666,Psychosexual disorder,ethnic,Not Hispanic or Latino,0,1,1
199726,Granuloma inguinale,ethnic,Hispanic or Latino,1,0,1
373054,Open wound of auricle of ear without complication,racial,White,1,1,2
376961,Disturbance of consciousness,racial,Black or African American ,1,1,2
4240103,Operation for bone injury on phalanges of foot,racial,Unknown,1,1,2
444084,Extrinsic allergic alveolitis,racial,White,1,1,2
440058,Malignant lymphoma of extranodal AND/OR solid organ site,racial,White,1,1,2
434319,Premature orgasm - male,ethnic,Not Hispanic or Latino,0,1,1
136871,Burn any degree involving 20-29 percent of body surface,ethnic,Not Hispanic or Latino,1,0,1
196813,Simple renal cyst,ethnic,Not Hispanic or Latino,1,0,1
78073,Urogenital infection by Trichomonas vaginalis,racial,White,1,1,2
199879,Fistula of the female genital organs,ethnic,Not Hispanic or Latino,1,0,1
81636,Excessive foetal growth affecting management of mother,racial,White,1,0,1
4165091,Lack of exercise,racial,American Indian,1,0,1
30679,Benign tumour major salivary gland,ethnic,Not Hispanic or Latino,1,0,1
443375,Vitamin products adverse reaction,ethnic,Hispanic or Latino,1,0,1
4096666,Diabetes mellitus with hyperosmolar coma,ethnic,Not Hispanic or Latino,0,1,1
4062641,Malaria screening,racial,White,0,1,1
318800,GERD - Gastro-esophageal reflux disease,racial,Alaska Native,1,1,2
4319325,Acquired deformity of trunk,racial,Black or African American ,1,0,1
138913,Second degree burn of two OR more fingers including thumb,racial,Black or African American ,0,1,1
193240,Acute generalized peritonitis,racial,White,1,0,1
4112816,Other respiratory system diseases,racial,Asian,1,0,1
435522,Hypervitaminosis D,racial,Asian,1,1,2
444434,Schizophreniform disorder,racial,White,1,0,1
192679,Renal disease in pregnancy AND/OR puerperium without hypertension,racial,White,1,0,1
78619,"Contusion, knee",racial,American Indian or Alaska Native ,1,0,1
74396,TMJ - Temporomandibular joint disorder,racial,Black or African American ,1,1,2
4198960,Amputated above elbow,ethnic,Hispanic or Latino,1,0,1
434012,Developmental dyslexia,racial,White,1,1,2
317898,Malignant essential hypertension,racial,American Indian or Alaska Native ,1,0,1
4107375,Somatoform pain disorder,ethnic,Not Hispanic or Latino,1,0,1
78524,Acquired deformity of finger,racial,Black or African American ,1,0,1
441678,"Gestation period, 33 weeks",racial,Other Race,1,0,1
141650,Actinic porokeratosis,racial,White,1,0,1
4013526,ESR raised,ethnic,Not Hispanic or Latino,1,0,1
4340380,Hepatitis C carrier,racial,American Indian or Alaska Native ,0,1,1
440535,Abnormal radiographic examination,racial,Unknown,1,1,2
79917,Acquired deformity of toe,racial,American Indian or Alaska Native ,1,0,1
4182210,Dementia,racial,American Indian or Alaska Native ,1,0,1
437657,Simple syndactyly of toes,ethnic,Hispanic or Latino,1,1,2
4016675,"Sprain, ankle joint, medial",racial,Other Race,0,1,1
192691,Diabetes mellitus during pregnancy - baby not yet delivered,racial,Unknown,1,0,1
440694,"Nondependent mixed drug abuse, episodic",racial,Black or African American ,1,1,2
140190,Disorder of back,racial,Asian,0,1,1
436027,Coxsackie virus disease,racial,Other Race,1,1,2
195501,Polycystic ovaries,racial,Middle Eastern or North African,1,0,1
432335,Subclavian artery aneurysm,racial,Unknown,1,0,1
441274,Developmental expressive language disorder,racial,Other Race,0,1,1
138644,Burn erythema of lower limb,ethnic,Not Hispanic or Latino,1,1,2
81336,Rectal prolapse,racial,Asian,0,1,1
433823,"Infections of pregnancy, childbirth and the puerperium",racial,White,1,0,1
4061706,"Disorder of lactation NOS, unspecified",ethnic,Hispanic or Latino,1,0,1
438460,Edentulous alveolar ridge atrophy,ethnic,Not Hispanic or Latino,1,1,2
436826,Closed fracture of shaft of radius,ethnic,Not Hispanic or Latino,0,1,1
4239301,Unwanted pregnancy,racial,Black or African American ,1,0,1
4062921,Asymptomatic bacteriuria in pregnancy unspecified,ethnic,Hispanic or Latino,1,0,1
134074,Oral soft tissue cellulitis,racial,Other Race,1,0,1
443909,"Decreased level, laboratory test",racial,Unknown,1,0,1
4143350,Other deficiency anaemias,racial,White,1,0,1
4117862,Chronic rheumatic mitral valve,ethnic,Hispanic or Latino,1,0,1
31821,Endocrinopathy,racial,Unknown,1,0,1
135892,Erythematous condition,racial,Asian,1,1,2
141650,Actinic porokeratosis,ethnic,Hispanic or Latino,1,0,1
441401,Talipes valgus,ethnic,Hispanic or Latino,1,0,1
81250,Carcinoma in situ of breast,racial,Unknown,1,0,1
4051702,FH: Congenital anomaly,ethnic,Hispanic or Latino,1,0,1
4145823,Inadequate housing,racial,White,0,1,1
442306,Adjustment disorder with depressed mood,racial,Asian,0,1,1
441540,Reactive confusion,ethnic,Hispanic or Latino,1,1,2
4059611,Other disorders of bladder,ethnic,Hispanic or Latino,1,1,2
4094865,Ca intrahepatic bile ducts,racial,Black or African American ,1,0,1
73889,Sprain of distal tibiofibular ligament,ethnic,Hispanic or Latino,1,0,1
197795,Acute hepatitis B,racial,Black or African American ,1,1,2
4337542,Unilateral adrenalectomy,ethnic,Hispanic or Latino,1,0,1
434119,Hidradenitis,racial,Native Hawaiian or Other Pacific Islander ,1,0,1
435227,Nutritional deficiency,racial,Black or African American ,1,1,2
76304,Burn of upper arm,racial,White,1,0,1
254662,Pulmonary infarction,racial,American Indian or Alaska Native ,1,0,1
192496,Unilateral traumatic amputation of leg below knee with complication,racial,White,0,1,1
437382,Urine observation,racial,American Indian or Alaska Native ,1,0,1
443582,Disorder of joint of hand,racial,White,1,1,2
436466,Balanoposthitis,racial,American Indian or Alaska Native ,0,1,1
438250,Congenital talipes varus,ethnic,Not Hispanic or Latino,1,1,2
194408,Hydroureter,racial,White,1,1,2
373474,Seeing double,racial,Other Race,0,1,1
4119298,Late onset asthma,racial,White,1,0,1
438576,Open fracture of ulna,ethnic,Hispanic or Latino,1,0,1
376267,Superficial injury of conjunctiva,racial,Unknown,0,1,1
442598,Fracture of radius AND ulna,ethnic,Not Hispanic or Latino,1,1,2
377680,Facial nerve injury as birth trauma,racial,White,0,1,1
201603,Disease of teeth AND/OR supporting structures,racial,Filipino,1,0,1
193422,Primary malignant neoplasm of body of stomach,racial,Asian,0,1,1
436171,"Syphilis in mother complicating pregnancy, childbirth AND/OR puerperium",racial,White,1,0,1
139110,Intervertebral disc disorder of thoracic region with myelopathy,racial,White,0,1,1
4085075,At risk state,ethnic,Not Hispanic or Latino,1,1,2
316226,Complete TGA,racial,White,1,0,1
438990,Benign neuroendocrine tumor,ethnic,Not Hispanic or Latino,1,0,1
74505,Closed subtrochanteric fracture,ethnic,Hispanic or Latino,1,0,1
76611,Injury of shoulder region,racial,Other Race,1,0,1
193070,Blister of trunk with infection,ethnic,Hispanic or Latino,1,0,1
377545,Episodic tension-type headache,racial,Unknown,1,0,1
441786,Infection due to Bordetella parapertussis,ethnic,Hispanic or Latino,1,0,1
4145796,Family history: Musculoskeletal disease,ethnic,Hispanic or Latino,1,0,1
375539,Haemophthalmos without current injury,ethnic,Hispanic or Latino,1,0,1
435131,Victim of neglect,ethnic,Not Hispanic or Latino,0,1,1
197330,Finding of urethral sphincter function,ethnic,Not Hispanic or Latino,1,0,1
436155,Redundant prepuce and phimosis,racial,Native Hawaiian or Other Pacific Islander ,0,1,1
434183,"Closed fracture distal humerus, medial epicondyle",ethnic,Hispanic or Latino,1,1,2
317002,Hypopiesis,racial,Native Hawaiian or Other Pacific Islander ,1,1,2
440755,"Acute duodenal ulcer without hemorrhage, without perforation AND without obstruction",ethnic,Hispanic or Latino,0,1,1
4001516,Endocervical biopsy,racial,White,1,0,1
4237140,Abnormal sexual function,ethnic,Not Hispanic or Latino,0,1,1
432941,Disease of tongue,racial,American Indian or Alaska Native ,1,0,1
443263,Obstetric breast abscess,racial,White,1,0,1
4016960,Concussion NOS,racial,White,1,0,1
4265479,Acute duodenal ulcer with perforation,racial,White,0,1,1
26942,Hemoglobin SS disease with crisis,ethnic,Not Hispanic or Latino,0,1,1
443773,Damage to pelvic joints AND/OR ligaments during delivery,ethnic,Hispanic or Latino,1,0,1
444272,Contact dermatitis due to drugs AND/OR medicine,ethnic,Not Hispanic or Latino,1,0,1
440325,Rubella without complication,racial,White,1,0,1
140259,Open wound of face without complication,racial,Black or African American ,0,1,1
193807,Anorectal fistula,racial,Black or African American ,0,1,1
254591,Secondary malignant tumour of lung,racial,Other Race,0,1,1
24974,Stenosis of larynx,racial,White,0,1,1
200483,Disease of pelvis,racial,Black or African American ,1,0,1
433911,Contusion of eye AND ocular adnexa,racial,Asian,1,1,2
440653,Infection by toxoplasma gondii,ethnic,Not Hispanic or Latino,1,1,2
75911,Acquired hallux valgus,racial,Native Hawaiian or Other Pacific Islander ,1,0,1
438959,Amoebiasis,racial,Other Race,1,0,1
197494,Viral hepatitis C,racial,American Indian,1,0,1
437671,Abnormal feces,racial,Other Race,1,0,1
4200655,Urostomy present,ethnic,Hispanic or Latino,1,1,2
438808,Mammary duct ectasia,racial,White,1,0,1
74396,TMJ - Temporomandibular joint disorder,racial,Asian,1,0,1
135611,Furuncle of hand,ethnic,Not Hispanic or Latino,1,1,2
375415,Injury of head region,racial,Filipino,1,1,2
312437,Dyspnea,racial,Filipino,0,1,1
440696,Cyclothymia,racial,White,1,1,2
440388,[X]Developmental co - ordination disorder,racial,Unknown,0,1,1
374364,Disorder of middle ear,ethnic,Hispanic or Latino,0,1,1
374049,Acute mucoid otitis media,racial,Asian,0,1,1
78834,Effusion of joint of hand,ethnic,Not Hispanic or Latino,0,1,1
434207,"Insect bite, nonvenomous, of hand, without mention of infection",ethnic,Not Hispanic or Latino,1,1,2
374914,Quadriplegia,racial,Black or African American ,0,1,1
4104388,"Better eye: moderate visual impairment, Lesser eye: near total visual impairment",racial,White,0,1,1
75413,Burn of wrist,ethnic,Hispanic or Latino,1,1,2
4070287,Preauricular sinus and fistula,racial,Other Race,0,1,1
4102738,Screening for mental disorders,ethnic,Not Hispanic or Latino,1,1,2
4004778,Other and unspecified congenital anomalies,racial,White,0,1,1
4053045,Dog bite,racial,American Indian,1,0,1
4326601,Anorectal abscess,racial,Other Race,0,1,1
137548,Cervical root lesion,racial,Filipino,0,1,1
80493,Ankylosis of joint,ethnic,Hispanic or Latino,1,0,1
441488,Adverse reaction to substance,ethnic,Not Hispanic or Latino,0,1,1
77069,Old posterior cruciate ligament disruption,ethnic,Hispanic or Latino,0,1,1
440676,Neoplasm of uncertain behaviour of brain and spinal cord,racial,Unknown,1,0,1
442584,Carbuncle of buttock,racial,Asian,1,0,1
442013,Burn,racial,American Indian or Alaska Native ,0,1,1
196464,Rapidly progressive glomerulonephritis,racial,White,1,1,2
4103726,Subjective visual disturbance NOS,ethnic,Hispanic or Latino,1,0,1
438392,Disorder of hyperalimentation,ethnic,Not Hispanic or Latino,0,1,1
79145,Ehlers-Danlos syndrome,ethnic,Not Hispanic or Latino,0,1,1
442124,Orbital edema,ethnic,Hispanic or Latino,1,0,1
442110,Benign neoplasm of nasal sinus,racial,White,1,1,2
199866,Acute gastritis,racial,Native Hawaiian or Other Pacific Islander ,1,1,2
137991,Sick-euthyroid syndrome,racial,White,1,0,1
432870,Thrombocytopenia,racial,Native Hawaiian or Other Pacific Islander ,1,0,1
440083,Acute stress disorder,racial,American Indian or Alaska Native ,1,0,1
435726,Mechanical complication of device,racial,White,1,1,2
4154623,Fit denture,ethnic,Not Hispanic or Latino,1,0,1
135349,Compartment syndrome of upper limb,ethnic,Hispanic or Latino,1,0,1
79898,Cellulitis and abscess of finger,racial,American Indian or Alaska Native ,0,1,1
437474,Postoperative infection,racial,Black or African American ,1,0,1
443274,Psychostimulant dependence,ethnic,Not Hispanic or Latino,1,1,2
439799,Leg cramps,racial,Black or African American ,1,1,2
437241,Qualitative platelet defect,racial,Other Race,1,1,2
198216,Retroverted incarcerated gravid uterus - delivered,racial,Unknown,1,0,1
141216,MC - Molluscum contagiosum,racial,Native Hawaiian or Other Pacific Islander ,0,1,1
444239,Postprocedural state finding,racial,Filipino,0,1,1
76255,Sprain of iliofemoral ligament,ethnic,Not Hispanic or Latino,0,1,1
4114314,Screening for osteoporosis,racial,Native Hawaiian or Other Pacific Islander ,1,0,1
4196935,Unilateral repair of inguinal hernia with prosthesis or graft,ethnic,Hispanic or Latino,0,1,1
197603,Volvulus,ethnic,Hispanic or Latino,1,0,1
321590,Right bundle branch block AND left posterior fascicular block,racial,White,0,1,1
374044,Droopy eyelid,racial,Other Race,1,1,2
375827,Acute non-suppurative otitis media - serous,racial,Native Hawaiian or Other Pacific Islander ,1,0,1
134569,Erythema infectiosum,racial,Unknown,1,1,2
437316,Fissural cyst of jaw,racial,White,1,0,1
4269719,Finding of growth of fungi,racial,White,1,1,2
380941,Herpetic meningoencephalitis,racial,White,1,0,1
316139,HF - Heart failure,racial,Black or African American ,0,1,1
195977,Contusion of trunk,racial,Asian,1,0,1
433644,Shellfish allergy,ethnic,Hispanic or Latino,1,0,1
192964,Renal infection,racial,Unknown,1,0,1
435299,Failure of dental prosthesis,racial,Unknown,1,0,1
433451,Aggressive unsocial conduct disorder,racial,Unknown,1,0,1
439981,Wound dehiscence,ethnic,Not Hispanic or Latino,1,1,2
433540,Polyhydramnios with antenatal problem,ethnic,Not Hispanic or Latino,1,1,2
317576,Coronary arteriosclerosis,racial,European,0,1,1
439846,LVF - Left ventricular failure,racial,Black or African American ,0,1,1
4104561,Ptosis of eyelid NOS,racial,Asian,1,0,1
442441,Grand multiparity with antenatal problem,ethnic,Not Hispanic or Latino,1,0,1
433577,Hammer toe,racial,Black or African American ,0,1,1
4095302,Malignant tumour of cranial nerve,racial,White,0,1,1
443610,Prolapse of uterine cervical stump,racial,Unknown,1,0,1
139179,Open wound of lip without complication,racial,Black or African American ,0,1,1
376683,Non proliferative diabetic retinopathy,racial,Native Hawaiian or Other Pacific Islander ,1,0,1
442306,Adjustment disorder with depressed mood,racial,Black or African American ,1,1,2
200843,Observation of frequency of urination,racial,Native Hawaiian or Other Pacific Islander ,1,1,2
4062555,"Unspecified hypertension complicating pregnancy, childbirth and the puerperium NOS",racial,White,0,1,1
4174977,Diabetic retinopathy,racial,Filipino,0,1,1
436730,"Appendicitis, unqualified",racial,Other Race,1,0,1
321596,Peripheral venous insufficiency,racial,Filipino,1,0,1
4059157,Family circumstance NOS,racial,Black or African American ,0,1,1
444384,Nonvenomous insect bite of leg with infection,racial,White,1,1,2
317003,Compression of vein,ethnic,Hispanic or Latino,1,0,1
4196206,beta^+^ Thalassemia,ethnic,Not Hispanic or Latino,1,0,1
443372,Lipid-lowering drug adverse reaction,ethnic,Hispanic or Latino,1,1,2
444246,Cirrhosis of liver not due to alcohol,racial,Native Hawaiian or Other Pacific Islander ,0,1,1
432719,Panniculitis,ethnic,Not Hispanic or Latino,1,1,2
132575,Myeloid sarcoma in remission,ethnic,Hispanic or Latino,0,1,1
74127,Elbow joint contracture,racial,White,0,1,1
320752,Influenza with non-respiratory manifestation,racial,Filipino,0,1,1
436081,Immunosecretory disorder,ethnic,Hispanic or Latino,1,0,1
201313,Hypertensive renal disease,racial,Black or African American ,0,1,1
372605,Spinal muscular atrophy,ethnic,Not Hispanic or Latino,0,1,1
81496,Tuberculosis of vertebral column,racial,White,0,1,1
137371,Neonatal septicaemia,racial,White,1,0,1
374027,Lesion of ulnar nerve,racial,Asian,0,1,1
195079,Functional urinary incontinence,racial,Asian,0,1,1
74719,Foot ulcer,racial,American Indian or Alaska Native ,1,0,1
141090,PG - Pyogenic granuloma,racial,Asian,1,1,2
201958,Perinatal dermatological disorders,racial,Unknown,1,1,2
440438,Anodontia,racial,Other Race,1,1,2
373035,Closed fracture of malar AND/OR maxillary bones,ethnic,Hispanic or Latino,1,1,2
72407,Shoulder joint effusion,ethnic,Hispanic or Latino,1,0,1
72786,Burn of finger,racial,Unknown,1,1,2
79165,Closed Monteggia fracture,racial,Unknown,1,0,1
373139,Syphilitic parkinsonism,ethnic,Hispanic or Latino,0,1,1
253788,Nasal polyp,racial,Asian,0,1,1
435570,Pulp and periapical tissue disease,racial,White,1,1,2
194519,Open wound of vagina without complication,ethnic,Hispanic or Latino,1,0,1
440979,Acquired hemolytic anemia,ethnic,Not Hispanic or Latino,1,0,1
433741,Hereditary pure erythrocytosis,ethnic,Hispanic or Latino,1,1,2
200792,Retained placenta with no haemorrhage with postnatal problem,ethnic,Hispanic or Latino,1,0,1
194997,Prostatitis,racial,Asian,0,1,1
436701,Drusen of optic disc,ethnic,Hispanic or Latino,1,0,1
437175,"Fall on same level from slipping, tripping or stumbling",racial,American Indian or Alaska Native ,1,0,1
374139,Buphthalmos,racial,White,1,1,2
197724,Unilateral traumatic amputation of foot without complication,ethnic,Not Hispanic or Latino,0,1,1
199074,Acute pancreatitis,racial,Other Race,0,1,1
317003,Compression of vein,racial,White,1,0,1
434019,"Nondependent cannabis abuse, continuous",racial,Unknown,1,0,1
4148407,Family history: Cardiovascular disease,racial,Asian,0,1,1
315078,Palpitations,racial,Native Hawaiian or Other Pacific Islander ,1,1,2
374957,Acquired stenosis of external ear canal,ethnic,Not Hispanic or Latino,0,1,1
439228,Adverse reaction to sulphonamides,racial,Unknown,0,1,1
375291,Bullous myringitis,ethnic,Not Hispanic or Latino,1,0,1
4100912,Screening for rheumatoid conditions,racial,Other Race,1,0,1
78786,Pleurisy,racial,Other Race,1,0,1
141934,Degenerative skin disorder,racial,White,1,1,2
438261,Neonatal jaundice due to delayed conjugation associated with another disease,racial,Other Race,0,1,1
72434,Congenital hydrocele,racial,White,0,1,1
4016358,Staphylococcus carrier,ethnic,Hispanic or Latino,1,0,1
201061,Diaphragmatic hernia,racial,Native Hawaiian or Other Pacific Islander ,1,1,2
439014,Panuveitis,ethnic,Not Hispanic or Latino,1,0,1
24970,Chronic laryngitis,racial,Asian,1,1,2
441407,Appetite loss - anorexia,racial,American Indian or Alaska Native ,1,1,2
4233605,Cervical spinal cord injury without spinal bone injury,ethnic,Not Hispanic or Latino,1,0,1
378523,Residual foreign body in soft tissue,racial,Asian,0,1,1
197717,Open wound of anterior abdominal wall without complication,racial,Black or African American ,0,1,1
76611,Injury of shoulder region,racial,Black or African American ,1,1,2
440694,"Nondependent mixed drug abuse, episodic",racial,American Indian or Alaska Native ,0,1,1
378256,Abnormal reflex,racial,Unknown,1,1,2
440453,Incomplete legal abortion with delayed or excessive haemorrhage,racial,White,1,0,1
381574,External auditory canal exostosis,racial,White,0,1,1
4081756,Radiotherapy follow-up,racial,White,1,0,1
201350,Placental abruption - not delivered,ethnic,Not Hispanic or Latino,0,1,1
4310085,Accidental poisoning by other drugs acting on central and autonomic nervous system,racial,Unknown,0,1,1
132321,Ichthyosis of eyelid,racial,Unknown,0,1,1
4124299,Incision and evacuation of thrombosed hemorrhoid,racial,White,1,0,1
378256,Abnormal reflex,ethnic,Not Hispanic or Latino,1,1,2
376425,Chronic non-suppurative otitis media,racial,Unknown,0,1,1
379769,Benign brain tumour,racial,American Indian or Alaska Native ,0,1,1
200680,Tumour of urinary bladder,racial,Unknown,1,0,1
373205,Hemorrhage of eyelid,racial,White,0,1,1
194755,Abdominal tenderness of left lower quadrant,racial,White,1,1,2
74809,Crushing injury of hand,racial,White,1,0,1
440387,Cannabis dependence,racial,Unknown,0,1,1
373775,Psychophysical visual disturbance,racial,Black or African American ,0,1,1
439219,Poisoning due to venomous spider,ethnic,Not Hispanic or Latino,0,1,1
136580,Dehiscence of surgical wound,racial,Unknown,1,1,2
372318,Chronic follicular conjunctivitis,racial,Unknown,1,1,2
440543,Fracture of tibia,racial,Asian,1,0,1
200757,Abscess of peritoneum,racial,Unknown,1,0,1
315296,Preinfarction syndrome,racial,Black or African American ,0,1,1
73855,Arrest of bone development AND/OR growth,racial,White,0,1,1
440638,Lyme disease,ethnic,Hispanic or Latino,1,1,2
4064929,Genitourinary disease screening,racial,White,0,1,1
443772,Superficial injury of scalp with infection,racial,White,1,0,1
433885,Closed supracondylar fracture of humerus,racial,Black or African American ,1,1,2
440953,Cysticercosis,racial,Other Race,1,0,1
139753,Primary malignant neoplasm of parathyroid gland,racial,White,0,1,1
433131,Mumps without complication,racial,White,1,1,2
4305187,Control of epistaxis by packing of posterior and anterior nose,racial,White,1,1,2
201617,Prostatic cyst,ethnic,Not Hispanic or Latino,0,1,1
440084,Aphemesthaesia,racial,Black or African American ,0,1,1
434303,Benign neoplasm of rectum and anal canal,racial,Black or African American ,0,1,1
443428,Torus fracture of radius,ethnic,Not Hispanic or Latino,1,1,2
196162,Uterine inflammatory disease,racial,White,1,0,1
378726,Alcoholic dementia,racial,Black or African American ,0,1,1
201531,"Diabetes mellitus, juvenile type, with hyperosmolar coma",racial,White,0,1,1
444382,Thoracic radiculitis,racial,American Indian or Alaska Native ,1,1,2
442597,Meteorism,racial,American Indian or Alaska Native ,1,0,1
80914,Second degree burn of two OR more fingers not including thumb,ethnic,Hispanic or Latino,0,1,1
440069,Drug dependence,racial,American Indian or Alaska Native ,0,1,1
252942,Asthmatic pulmonary eosinophilia,racial,White,0,1,1
4181332,Malignant tumour of posterior third of tongue,ethnic,Hispanic or Latino,0,1,1
432417,Acquired hallux malleus,racial,Unknown,1,0,1
80593,Urinary complication,ethnic,Not Hispanic or Latino,1,1,2
444108,Finding related to sleep,racial,White,1,0,1
4154309,Severe recurrent major depression with psychotic features,racial,Filipino,1,0,1
4100857,Pickwickian syndrome,racial,American Indian,0,1,1
441922,Transient hypertension of pregnancy,racial,White,1,0,1
137063,Corns and callus,racial,Native Hawaiian or Other Pacific Islander ,0,1,1
138790,Chronic periodontitis,ethnic,Not Hispanic or Latino,1,0,1
73241,Anal and rectal polyp,racial,Other Race,0,1,1
442714,"Splinter of finger, without major open wound, infected",ethnic,Hispanic or Latino,1,0,1
377546,Chronic post-traumatic headache,racial,Unknown,1,0,1
435903,Juvenile osteochondrosis of foot,ethnic,Not Hispanic or Latino,0,1,1
440647,Sexually transmitted infectious disease,racial,Other Race,1,0,1
4104050,Other specified strabismus NOS,racial,White,0,1,1
192954,Acute gastric ulcer without hemorrhage AND without perforation but with obstruction,racial,Asian,0,1,1
197324,Disease of peritoneum,racial,Asian,1,0,1
75004,Frank hematuria,racial,Black or African American ,0,1,1
434674,Atrophy of edentulous mandibular alveolar ridge,racial,Unknown,1,0,1
135033,Hair and hair follicle diseases,racial,American Indian,1,1,2
377566,Palsy of conjugate gaze,racial,Unknown,1,0,1
201995,"Contusion, lower limb, multiple sites",racial,White,1,0,1
31057,Disorder of pharynx,ethnic,Not Hispanic or Latino,1,0,1
192502,Contusion of multiple sites of trunk,ethnic,Not Hispanic or Latino,1,0,1
380500,Hypertrophy of fat pad of knee,ethnic,Hispanic or Latino,0,1,1
438546,Congenital anomaly of anterior chamber of eye,racial,Black or African American ,1,0,1
196484,Retroverted incarcerated gravid uterus,ethnic,Hispanic or Latino,1,0,1
74998,Pycocele,racial,White,0,1,1
4144997,Osteoarthritis NOS,racial,American Indian or Alaska Native ,0,1,1
193863,Congenital abnormality of lower limb AND/OR pelvic girdle,ethnic,Not Hispanic or Latino,0,1,1
4098311,Borderline psychosis of childhood,racial,Unknown,1,0,1
81379,Lateral epicondylitis,racial,Asian Indian,0,1,1
436519,Perinatal intraventricular hemorrhage,racial,White,1,1,2
141663,Osteomyelitis,racial,American Indian or Alaska Native ,0,1,1
441258,Anemia in neoplastic disease,racial,White,0,1,1
437784,Pfeiffer's disease,racial,Unknown,1,0,1
378431,Impairment level: better eye: moderate impairment: lesser eye: not further specified,ethnic,Hispanic or Latino,1,1,2
4317122,Adverse reaction to drugs primarily affecting the gastrointestinal system NOS,racial,White,1,0,1
433246,"Chronic duodenal ulcer without hemorrhage, without perforation AND without obstruction",racial,Unknown,1,0,1
196471,Puberty bleeding,ethnic,Hispanic or Latino,1,0,1
192680,Portal hypertension,racial,Other Race,1,0,1
77335,Known OR suspected fetal abnormality affecting management of mother,ethnic,Hispanic or Latino,1,0,1
200485,Decubitus ulcer of buttock,racial,American Indian or Alaska Native ,1,0,1
441545,Somatisation disorder,ethnic,Hispanic or Latino,1,1,2
435216,Disorder associated with type I diabetes mellitus,racial,Black or African American ,0,1,1
377861,Disorder of refraction AND/OR accommodation,racial,Asian Indian,1,0,1
376525,Audiogram abnormal,racial,Asian,0,1,1
4146976,Crushed in between objects,ethnic,Not Hispanic or Latino,1,0,1
139980,Burn erythema of forearm,ethnic,Not Hispanic or Latino,1,0,1
193261,Vaginospasm,ethnic,Not Hispanic or Latino,1,0,1
74816,Contusion of toe,racial,Other Race,1,0,1
76227,Leg oedema,racial,Unknown,1,0,1
197807,Primary malignant neoplasm of soft tissues of abdomen,ethnic,Hispanic or Latino,1,0,1
443367,Antihypertensive adverse reaction,ethnic,Not Hispanic or Latino,1,1,2
377572,Noise effect on inner ear,racial,White,1,1,2
440558,Closed dislocation of interphalangeal joint of finger,racial,Unknown,0,1,1
138278,Sprains and strains of joints and adjacent muscles,racial,Native Hawaiian or Other Pacific Islander ,0,1,1
27516,Neoplasm of uncertain behaviour of paraganglion,racial,White,1,0,1
4145821,Symptom of head and neck region,ethnic,Hispanic or Latino,1,1,2
315505,Benign neoplasm of lymph node,racial,White,1,0,1
4124268,Faecal smear,racial,Unknown,1,0,1
201397,Prune belly syndrome,racial,Other Race,0,1,1
443375,Vitamin products adverse reaction,racial,White,1,0,1
4110029,Chronic pharyngitis and nasopharyngitis NOS,racial,White,0,1,1
81424,Closed dislocation of knee,racial,White,1,0,1
77965,Nodular tendinous disease of finger,racial,Asian Indian,0,1,1
4085104,Dermatosis due to mites,racial,Unknown,1,0,1
4223382,Comprehensive consultation,racial,Unknown,0,1,1
4290927,Impairment level: low vision of both eyes,racial,Filipino,0,1,1
76273,Open wound of shoulder region without complication,racial,Other Race,1,0,1
200164,Urine-induced contact dermatitis,racial,Native Hawaiian or Other Pacific Islander ,1,0,1
374940,Blepharophimosis syndrome,racial,Asian,1,0,1
435381,Closed fracture of base of thumb,racial,Black or African American ,0,1,1
443172,"Splinter of face, without major open wound",racial,White,0,1,1
40490405,Benign shuddering attacks,ethnic,Hispanic or Latino,1,0,1
196443,Gastric ulcer without hemorrhage AND without perforation but with obstruction,ethnic,Not Hispanic or Latino,0,1,1
441855,Epiphora due to excess lacrimation,racial,Unknown,1,0,1
377659,Spina bifida of lumbar region,ethnic,Hispanic or Latino,0,1,1
435563,Acute and subacute infective endocarditis associated with another disorder,racial,Unknown,1,0,1
441191,Poisoning by arthropod,ethnic,Not Hispanic or Latino,1,0,1
377279,"Profound impairment, one eye",racial,Native Hawaiian or Other Pacific Islander ,0,1,1
4025175,Tracheostomy complication NOS,ethnic,Hispanic or Latino,1,0,1
377535,Sleep walking disorder,racial,Black or African American ,0,1,1
440314,Injury of unknown intent by shotgun,racial,White,0,1,1
30361,Hypoglycemic disorder,racial,American Indian,1,0,1
435524,Sleep disorder,racial,Native Hawaiian or Other Pacific Islander ,1,0,1
4181604,Subcutaneous contraceptive implant,racial,Black or African American ,1,0,1
4288725,Lithium therapy,racial,Black or African American ,1,0,1
433606,Closed fracture of base of skull without intracranial injury,racial,White,1,0,1
438843,Non-traumatic rupture of patellar tendon,racial,White,1,0,1
196724,Disease of diaphragm,ethnic,Not Hispanic or Latino,1,0,1
318173,Vascular graft calcification,racial,Asian,1,0,1
442584,Carbuncle of buttock,racial,Other Race,1,0,1
435318,Complete spontaneous abortion with genital tract or pelvic infection,ethnic,Not Hispanic or Latino,1,0,1
4239721,Seafood allergy,racial,Black or African American ,1,0,1
73842,Enthesopathy of elbow region,ethnic,Not Hispanic or Latino,1,0,1
432436,Symbolic dysfunction,ethnic,Not Hispanic or Latino,1,0,1
76563,Late effect of burn of wrist AND/OR hand,ethnic,Hispanic or Latino,1,0,1
320752,Influenza with non-respiratory manifestation,racial,Asian Indian,1,0,1
193530,Follicular cyst of ovary,racial,Black or African American ,1,0,1
78193,Epididymo-orchitis,racial,Native Hawaiian or Other Pacific Islander ,0,1,1
77139,Open wound of finger without complication,racial,American Indian,1,0,1
198197,Male infertility,racial,American Indian or Alaska Native ,0,1,1
192568,Secondary malignant neoplasm of intra-abdominal lymph nodes,racial,Unknown,1,0,1
79957,Traumatic amputation of finger with complication,ethnic,Hispanic or Latino,0,1,1
442565,Gestational edema without hypertension,racial,Asian,1,0,1
434621,Autoimmune disease,ethnic,Hispanic or Latino,1,0,1
81713,Carpal joint sprain,racial,Unknown,0,1,1
4065991,Cellulitis and abscess of finger and toe,racial,White,1,0,1
442124,Orbital edema,racial,White,1,0,1
193863,Congenital abnormality of lower limb AND/OR pelvic girdle,ethnic,Hispanic or Latino,0,1,1
433881,Additional general conditions of patient,racial,Other Race,1,0,1
441541,Lymphocytopenia,racial,Unknown,1,0,1
4015717,Amebiasis carrier,ethnic,Hispanic or Latino,1,0,1
4275257,Detoxication therapy for alcoholism,ethnic,Not Hispanic or Latino,0,1,1
379805,Myopia,racial,American Indian or Alaska Native ,1,0,1
441974,Closed fracture of forearm,racial,Other Race,1,0,1
4140233,"X-ray of ribs, sternum and clavicle",racial,White,0,1,1
376564,Superficial injury of eye,racial,Unknown,0,1,1
444112,Integumentary system finding,racial,Asian,1,0,1
192275,Alpha-1-antitrypsin deficiency,racial,Unknown,0,1,1
444121,"Primary dental caries, proximal smooth surface origin",racial,White,1,0,1
81902,Urinary tract infectious disease,racial,African American,1,0,1
200149,Placenta previa with hemorrhage - not delivered,ethnic,Not Hispanic or Latino,1,0,1
439922,"Gestation period, 24 weeks",racial,White,0,1,1
435656,Neonatal jaundice,racial,American Indian or Alaska Native ,0,1,1
443253,Biological substance poisoning,racial,White,1,0,1
381444,Black eye,racial,Black or African American ,1,0,1
4196362,Genetic counselling,racial,Other Race,1,0,1
435411,Injury at C5-C7 level with spinal cord injury AND without bone injury,ethnic,Hispanic or Latino,0,1,1
138029,Second degree burn of palm,racial,Unknown,0,1,1
444243,Neurotic disorder,racial,Native Hawaiian or Other Pacific Islander ,1,0,1
321683,TTN - Transient tachypnoea of newborn,ethnic,Not Hispanic or Latino,1,0,1
435082,Closed fracture nasal bone,racial,Other Race,0,1,1
30361,Hypoglycemic disorder,ethnic,Not Hispanic or Latino,1,0,1
380120,Strabismus in neuromuscular disorder,racial,Asian Indian,0,1,1
381869,Intermitent squint,ethnic,Hispanic or Latino,1,0,1
256439,Allergic rhinitis due to pollen,racial,Filipino,1,0,1
316126,Crystalline deposits in vitreous,racial,White,1,0,1
75941,Closed fracture of one rib,ethnic,Not Hispanic or Latino,0,1,1
438021,Sequelae of fracture of arm,ethnic,Hispanic or Latino,0,1,1
434951,Lacrimal sac mucocele,ethnic,Hispanic or Latino,1,0,1
197236,Uterine fibroid,racial,Native Hawaiian or Other Pacific Islander ,1,0,1
257683,Postnasal drip,racial,American Indian,1,0,1
436544,Open fracture of distal end of ulna,ethnic,Not Hispanic or Latino,1,0,1
437758,Dependance on enabling machine or device,racial,Unknown,0,1,1
193262,Inflammatory disorder of penis,ethnic,Not Hispanic or Latino,0,1,1
133859,Preauricular cyst,ethnic,Not Hispanic or Latino,1,0,1
81186,Contusion of wrist,racial,Other Race,1,0,1
137951,Acquired keratoderma,racial,Other Race,1,0,1
4110738,Osteoarthritis deformans,ethnic,Not Hispanic or Latino,1,0,1
438268,Closed dislocation of finger,racial,Unknown,1,0,1
381551,Drug-related polyneuropathy,racial,American Indian or Alaska Native ,1,0,1
141370,Toxic erythema,ethnic,Not Hispanic or Latino,1,0,1
433288,Derangement of anterior horn of lateral meniscus,ethnic,Not Hispanic or Latino,1,0,1
435928,Abnormal decrease in weight,racial,American Indian,1,0,1
4062650,Malnutrition screening,racial,Unknown,0,1,1
80225,Sprain of ligament of lumbosacral joint,racial,Other Race,1,0,1
432968,Anemia during pregnancy - baby delivered,ethnic,Not Hispanic or Latino,1,0,1
443389,Cancer of ill-defined site,racial,Asian,1,0,1
433466,Childhood and adolescent relationship problem,racial,White,1,0,1
320425,Heart block,racial,White,1,0,1
138346,Erysipelas,racial,Asian,1,0,1
133551,Vesicular eczema of hands and/or feet,racial,Other Race,0,1,1
201399,Congenital anomaly of adrenal gland,racial,Unknown,0,1,1
432804,Fall from scaffold,racial,White,0,1,1
77880,Circumscribed labyrinthitis,racial,Unknown,1,0,1
4086928,IUCD status,racial,Asian,1,0,1
435647,Congenital folds and cysts of the posterior segment,ethnic,Hispanic or Latino,1,0,1
4305187,Control of epistaxis by packing of posterior and anterior nose,ethnic,Not Hispanic or Latino,1,0,1
435850,Cyst of jaw,racial,Black or African American ,1,0,1
319825,Rheumatic heart disease,racial,Other Race,1,0,1
318443,Arteriosclerotic vascular disease,racial,Other Race,0,1,1
442077,Anxiety disorder,racial,Asian,1,0,1
133294,Prepatellar bursitis,racial,Black or African American ,0,1,1
136937,Benign tumour of endocrine gland,ethnic,Hispanic or Latino,1,0,1
133327,Viremia,ethnic,Not Hispanic or Latino,1,0,1
432366,Hematoma of broad ligament,racial,White,1,0,1
138601,Open wound of face with complication,ethnic,Hispanic or Latino,1,0,1
444226,Dental restoration present,racial,White,0,1,1
376124,Pinguecula,racial,Asian,0,1,1
380403,External hordeolum,racial,American Indian or Alaska Native ,1,0,1
252348,Chronic pulmonary radiation disease,racial,White,1,0,1
258781,Pneumonopathy due to inhalation of dust,ethnic,Hispanic or Latino,1,0,1
4196206,beta^+^ Thalassemia,racial,Black or African American ,1,0,1
440195,Aniridia,ethnic,Not Hispanic or Latino,1,0,1
372930,Rheumatic chorea without heart involvement,racial,Asian,0,1,1
134671,Dental abscess without a sinus,racial,American Indian,1,0,1
439810,VKH syndrome,racial,Unknown,1,0,1
77642,Arthralgia of the forearm,racial,Native Hawaiian or Other Pacific Islander ,1,0,1
140208,Unilateral complete cleft palate with cleft lip,racial,Unknown,1,0,1
201624,Pyelitis associated with another disorder,racial,White,1,0,1
198194,Female genital organ symptoms,racial,Filipino,1,0,1
261782,Herpetic ulceration of vulva,racial,Filipino,1,0,1
433618,Open fracture of patella,racial,White,0,1,1
442281,Sprain of septal cartilage of nose,racial,White,1,0,1
196053,Metastatic tumour in kidney,racial,White,1,0,1
438066,Chlamydial infection,racial,Native Hawaiian or Other Pacific Islander ,1,0,1
197311,Pelvic varices,ethnic,Hispanic or Latino,0,1,1
436816,Vaginal vault smear abnormal,ethnic,Not Hispanic or Latino,1,0,1
444115,Disorder of bursa,racial,Asian,1,0,1
75042,Allergic arthritis of the shoulder region,racial,Black or African American ,0,1,1
432463,"Closed fracture clavicle, lateral end",ethnic,Not Hispanic or Latino,0,1,1
441417,Lack of coordination,racial,Other Race,1,0,1
198964,Chronic type C viral hepatitis,racial,Filipino,0,1,1
436101,Disorder of meninges,ethnic,Hispanic or Latino,0,1,1
201387,Doubling of uterus,racial,White,1,0,1
372627,Transient visual loss,racial,Unknown,1,0,1
433612,Closed fracture of upper end of fibula,ethnic,Hispanic or Latino,1,0,1
75686,Open wound of hand except fingers with complication,ethnic,Not Hispanic or Latino,0,1,1
381281,Degenerative progressive high myopia,racial,Other Race,0,1,1
74135,Disorder of synovium,racial,Asian,0,1,1
4297166,Closed reduction of fracture without internal fixation,racial,White,1,0,1
434833,Adverse reaction to anti-common cold drugs,ethnic,Hispanic or Latino,0,1,1
443708,Cervical Papanicolaou smear positive for malignant neoplasm,racial,Unknown,1,0,1
4016889,Other viral disease contact,ethnic,Hispanic or Latino,0,1,1
258540,Marfan syndrome,ethnic,Not Hispanic or Latino,1,0,1
195731,Shigella dysenteriae (group A),ethnic,Hispanic or Latino,0,1,1
377678,EEG abnormality,racial,Black or African American ,0,1,1
433279,Benign mucous membrane pemphigoid with no eye involvement,ethnic,Hispanic or Latino,0,1,1
436313,Shaken baby syndrome - non-accidental injury,ethnic,Not Hispanic or Latino,0,1,1
440990,Chorea,racial,Unknown,0,1,1
433997,Lymphangioma,ethnic,Hispanic or Latino,1,0,1
435205,Benign tumour of oropharynx,ethnic,Hispanic or Latino,1,0,1
441589,Endocarditis,racial,American Indian or Alaska Native ,0,1,1
72377,Shoulder girdle dystocia,racial,White,0,1,1
381686,PVS - Persistent vegetative state,ethnic,Not Hispanic or Latino,0,1,1
201530,"Diabetes mellitus, adult onset, with hyperosmolar coma",racial,Black or African American ,1,0,1
194081,Acute cystitis,racial,Filipino,1,0,1
138708,Acute leukemia,ethnic,Not Hispanic or Latino,0,1,1
433196,Chorioretinal scar,racial,White,1,0,1
434005,Morbid obesity,racial,Asian Indian,1,0,1
438962,Herpes simplex with complication,racial,Unknown,0,1,1
4086928,IUCD status,racial,American Indian,1,0,1
136025,Gp B streptococcal septicemia,racial,Other Race,1,0,1
201045,Thrombosed external haemorrhoids,racial,American Indian or Alaska Native ,1,0,1
437794,Juvenile syphilis,racial,White,0,1,1
197033,Endometriosis of pelvic peritoneum,racial,Unknown,1,0,1
73686,Tuberculosis of genitourinary system,ethnic,Not Hispanic or Latino,0,1,1
75637,Acquired postural kyphosis,racial,American Indian or Alaska Native ,1,0,1
436235,Taste sense altered,racial,Other Race,1,0,1
443389,Cancer of ill-defined site,ethnic,Not Hispanic or Latino,1,0,1
432347,Chronic disease of tonsils AND/OR adenoids,ethnic,Not Hispanic or Latino,0,1,1
4252234,Repair of gastroschisis,racial,White,0,1,1
194265,Cryptosporidiasis,racial,White,0,1,1
80880,Open wound of foot except toes with tendon involvement,ethnic,Not Hispanic or Latino,0,1,1
442764,Anal pain,racial,Asian,1,0,1
195294,Thrombosed hemorrhoids,racial,Unknown,0,1,1
376114,Severe nonproliferative diabetic retinopathy,ethnic,Not Hispanic or Latino,0,1,1
376712,Purulent otitis media,racial,Black or African American ,1,0,1
436944,Chronic paranoid schizophrenia,racial,Black or African American ,1,0,1
23034,Neonatal hypoglycemia,ethnic,Not Hispanic or Latino,0,1,1
137441,"Insect bite, nonvenomous, of foot and toe, infected",racial,Unknown,1,0,1
201957,Necrotizing enterocolitis in fetus OR newborn,ethnic,Not Hispanic or Latino,1,0,1
4310395,Open reduction of dislocation of elbow,ethnic,Hispanic or Latino,0,1,1
376793,Congenital anomaly of ear with impairment of hearing,racial,Black or African American ,0,1,1
196484,Retroverted incarcerated gravid uterus,racial,Unknown,1,0,1
372315,Anterior subcapsular polar cataract,ethnic,Not Hispanic or Latino,1,0,1
73904,Open wound of buttock without complication,ethnic,Not Hispanic or Latino,1,0,1
199718,Enteritis due to rotavirus,ethnic,Not Hispanic or Latino,0,1,1
435701,Injury of trigeminal nerve,racial,White,1,0,1
442008,Injury at T7-T12 level with spinal cord injury AND without bone injury,racial,Unknown,1,0,1
438411,Endophthalmitis,ethnic,Hispanic or Latino,0,1,1
141370,Toxic erythema,racial,Asian,1,0,1
436957,Functional disorders of polymorphonuclear neutrophils,racial,Black or African American ,0,1,1
79145,Ehlers-Danlos syndrome,racial,Unknown,1,0,1
437738,Motor vehicle accident off public road,racial,Unknown,1,0,1
439234,Poisoning by cardiotonic glycoside,racial,White,1,0,1
26052,Primary malignant neoplasm of larynx,ethnic,Not Hispanic or Latino,1,0,1
373463,Benign cough headache,racial,Other Race,1,0,1
440965,Hodgkin's disease of intrathoracic lymph nodes,ethnic,Hispanic or Latino,0,1,1
4051119,FH: Osteoporosis,racial,White,1,0,1
443858,Superficial injury of ankle with infection,racial,White,0,1,1
78786,Pleurisy,racial,Asian,0,1,1
198550,"Atresia and stenosis of large intestine, rectum and anal canal",ethnic,Not Hispanic or Latino,0,1,1
136710,Perichondritis of pinna,racial,Black or African American ,1,0,1
436876,Toxic effect of lead compound,racial,White,0,1,1
433987,Benign tumour of orbit,ethnic,Not Hispanic or Latino,1,0,1
4145947,Subnormal birth weight,ethnic,Not Hispanic or Latino,0,1,1
4161978,Patient on oxygen,racial,Native Hawaiian or Other Pacific Islander ,1,0,1
256440,Disorder of paranasal sinuses,racial,American Indian or Alaska Native ,1,0,1
4090206,Late effects of tuberculosis NOS,ethnic,Hispanic or Latino,0,1,1
436392,Carotid sinus syncope,ethnic,Hispanic or Latino,1,0,1
441833,Pathological drug intoxication,racial,White,1,0,1
4234990,Cardiac revascularisation with bypass aortocoronary anastomosis of two coronary vessels,racial,White,1,0,1
197330,Finding of urethral sphincter function,racial,Unknown,1,0,1
440374,Obsessive compulsive disorder,racial,Black or African American ,0,1,1
4062488,Thyroid disorder screening,racial,Native Hawaiian or Other Pacific Islander ,1,0,1
137813,Benign neoplasm of mouth region,racial,Unknown,1,0,1
198558,Nycturia,racial,Native Hawaiian or Other Pacific Islander ,0,1,1
196943,Red blood cell sequestration in spleen,racial,Black or African American ,0,1,1
378839,Spina bifida with hydrocephalus,racial,Unknown,1,0,1
133088,Late amputation stump complication,ethnic,Not Hispanic or Latino,0,1,1
439989,Insulin adverse reaction,racial,Unknown,0,1,1
134668,Chronic maxillary sinusitis,racial,Asian,1,0,1
201332,Alveolitis of jaw,ethnic,Hispanic or Latino,1,0,1
440431,Pneumonia due to Mycoplasma pneumoniae,racial,Other Race,1,0,1
372930,Rheumatic chorea without heart involvement,ethnic,Not Hispanic or Latino,0,1,1
197163,Burn of trunk,racial,White,0,1,1
375536,Organic writer's cramp,racial,White,1,0,1
4195231,Acute gastric ulcer without hemorrhage AND without perforation,racial,White,0,1,1
4016352,Tuberculosis contact,racial,Other Race,0,1,1
40485064,Latent syphilis,racial,Asian,0,1,1
436015,Accidental poisoning from foodstuffs and poisonous plants,racial,White,0,1,1
194382,External haemorrhoid,racial,American Indian or Alaska Native ,1,0,1
4069553,Acquired lordosis NOS,ethnic,Hispanic or Latino,1,0,1
194133,Low back pain,racial,African American,1,0,1
435230,Multiple personality disorder,ethnic,Not Hispanic or Latino,1,0,1
132822,Foot-and-mouth disease,ethnic,Not Hispanic or Latino,1,0,1
4101989,Closed fracture of shaft of bone of forearm,racial,Unknown,0,1,1
377885,Disorder of eye movements,racial,Native Hawaiian or Other Pacific Islander ,0,1,1
132466,Lumbar sprain,racial,Filipino,1,0,1
138876,Closed fracture of T1-T6 level with spinal cord injury,racial,White,1,0,1
436833,Open fracture of metacarpal bone,ethnic,Hispanic or Latino,1,0,1
134276,Cutaneous actinomycosis,ethnic,Not Hispanic or Latino,1,0,1
4310254,Mediastinal pneumogram,ethnic,Hispanic or Latino,0,1,1
199868,Incisional hernia with gangrene,ethnic,Hispanic or Latino,1,0,1
4010364,"Closed fracture of distal humerus, not otherwise specified",ethnic,Hispanic or Latino,0,1,1
75375,Closed fracture lunate,racial,Unknown,0,1,1
374053,Sudden hearing loss,ethnic,Hispanic or Latino,0,1,1
196726,Cholelithiasis AND acute cholecystitis without obstruction,racial,Other Race,1,0,1
4201412,Speech therapy,racial,Unknown,0,1,1
138255,Abnormal cardiovascular function,racial,Unknown,1,0,1
4056045,Other functional disorder of bladder,ethnic,Hispanic or Latino,1,0,1
377283,Conjunctival injection,racial,White,1,0,1
444424,Open wound of Eustachian tube with complication,ethnic,Not Hispanic or Latino,0,1,1
443728,Mass of chest wall,racial,Filipino,1,0,1
374940,Blepharophimosis syndrome,ethnic,Not Hispanic or Latino,1,0,1
201340,Gastritis,racial,Other Race,0,1,1
194611,CIN 3 - Cervical intraepithelial neoplasia grade 3,racial,Other Race,1,0,1
196443,Gastric ulcer without hemorrhage AND without perforation but with obstruction,racial,Asian,0,1,1
140960,Secondary malignant neoplasm of breast,ethnic,Hispanic or Latino,1,0,1
436118,After-cataract with vision obscured,racial,Black or African American ,1,0,1
200780,Disease of uterus,ethnic,Not Hispanic or Latino,1,0,1
4005603,Congenital cystic kidney disease NOS,racial,Unknown,0,1,1
432598,Subchronic schizophrenia with acute exacerbations,ethnic,Not Hispanic or Latino,1,0,1
443535,Infection due to enterococcus,racial,American Indian,1,0,1
379782,Gilles de la Tourette's syndrome,ethnic,Not Hispanic or Latino,0,1,1
443535,Infection due to enterococcus,ethnic,Not Hispanic or Latino,1,0,1
77139,Open wound of finger without complication,racial,Asian,1,0,1
441540,Reactive confusion,racial,White,0,1,1
134661,Chronic sphenoidal sinusitis,racial,White,0,1,1
440255,Open wound of axillary region without complication,ethnic,Hispanic or Latino,1,0,1
194265,Cryptosporidiasis,racial,Unknown,0,1,1
380397,Keratoconjunctivitis,racial,Unknown,1,0,1
4083043,Convalescence after surgery,racial,Unknown,0,1,1
373638,Superficial injury of cornea,racial,Asian,1,0,1
201338,Urethral fistula,ethnic,Not Hispanic or Latino,0,1,1
137441,"Insect bite, nonvenomous, of foot and toe, infected",racial,White,1,0,1
192502,Contusion of multiple sites of trunk,racial,Unknown,1,0,1
256142,Dental arch relationship anomaly,racial,Unknown,0,1,1
436747,Legal abortion without complication,ethnic,Not Hispanic or Latino,1,0,1
440788,Hyperemesis gravidarum with metabolic disturbance - not delivered,racial,Arab,1,0,1
435904,Derangement of anterior horn of medial meniscus,racial,Unknown,1,0,1
437985,Disturbance of temperature regulation of newborn,racial,White,1,0,1
136538,Closed fracture larynx and/or trachea,racial,Filipino,0,1,1
138896,Open wound of forehead without complication,racial,Black or African American ,1,0,1
440684,Simple paranoid state,racial,Asian,0,1,1
4099207,Thyroiditis NOS,ethnic,Hispanic or Latino,1,0,1
437557,Eczematous dermatitis of eyelid,racial,Other Race,1,0,1
4208970,History of physical abuse,racial,Other Race,1,0,1
74719,Foot ulcer,racial,Asian Indian,0,1,1
441408,Vomiting,racial,Alaska Native,0,1,1
139036,Systolic dysfunction,racial,Asian,1,0,1
139912,Spondylosis with myelopathy,racial,Unknown,0,1,1
80183,"Localised, secondary osteoarthritis of the ankle and/or foot",ethnic,Hispanic or Latino,1,0,1
432417,Acquired hallux malleus,ethnic,Not Hispanic or Latino,0,1,1
192581,Carcinoma in situ of uterus,ethnic,Hispanic or Latino,1,0,1
78586,Sprain of interphalangeal joint of toe,ethnic,Not Hispanic or Latino,1,0,1
439082,Menopausal syndrome,racial,Filipino,1,0,1
137054,Skin striae,racial,Unknown,1,0,1
437334,Cervical incompetence with antenatal problem,racial,Black or African American ,1,0,1
440431,Pneumonia due to Mycoplasma pneumoniae,racial,Filipino,0,1,1
438223,Sunburn of second degree,racial,Other Race,1,0,1
436027,Coxsackie virus disease,racial,American Indian,1,0,1
4180167,Joint infection,racial,White,0,1,1
78015,Open wound of chest wall without complication,racial,White,1,0,1
435119,Sequela of injury,racial,Black or African American ,0,1,1
200149,Placenta previa with hemorrhage - not delivered,racial,Asian,1,0,1
195313,Urethral abscess,ethnic,Hispanic or Latino,1,0,1
444028,Open wound of alveolar process without complication,ethnic,Not Hispanic or Latino,0,1,1
28974,Candidiasis of oesophagus,racial,Other Race,0,1,1
197135,Ureter injury without mention of open wound into cavity,ethnic,Hispanic or Latino,1,0,1
196858,Late effect of fracture of neck of femur,ethnic,Not Hispanic or Latino,0,1,1
375557,Cerebral embolism,racial,Other Race,0,1,1
140020,Viral exanthem,racial,Native Hawaiian or Other Pacific Islander ,0,1,1
432246,Leptospirosis,racial,White,1,0,1
193359,Open wound of multiple sites of one lower limb AND thigh with complication,ethnic,Hispanic or Latino,1,0,1
439665,Violent spouse,racial,Unknown,1,0,1
433706,Yaws gummata and ulcers,racial,Black or African American ,1,0,1
199839,External haemorrhoids without complication,racial,Filipino,0,1,1
196613,Neuroma of amputation stump,racial,White,1,0,1
381014,Conjunctival pigmentation,racial,Asian,1,0,1
30365,Panhypopituitarism,racial,Other Race,0,1,1
139888,Threatened premature labor - not delivered,racial,Native Hawaiian or Other Pacific Islander ,1,0,1
377680,Facial nerve injury as birth trauma,racial,Unknown,1,0,1
4201472,Varicella contact,racial,Other Race,0,1,1
199151,Must strain to pass urine,racial,Unknown,0,1,1
434374,Anisocoria,ethnic,Not Hispanic or Latino,1,0,1
433319,Fetus OR newborn affected by maternal complication of pregnancy,ethnic,Hispanic or Latino,1,0,1
138821,Seborrhea,racial,Filipino,1,0,1
432522,Transfusion reaction due to serum protein reaction,ethnic,Hispanic or Latino,1,0,1
4265600,Gastric ulcer,racial,Unknown,1,0,1
442325,Furuncle of foot,ethnic,Not Hispanic or Latino,0,1,1
436940,Insulin resistance syndrome,racial,Asian,1,0,1
192273,Benign tumour of adrenal gland,racial,Other Race,1,0,1
432941,Disease of tongue,racial,Black or African American ,0,1,1
79938,Closed fracture of scapula,racial,Other Race,0,1,1
137967,"Muscle, ligament and fascia disorders",racial,Black or African American ,0,1,1
444219,Osteitis deformans without bone tumor,racial,Black or African American ,0,1,1
4103886,Keratoconus NOS,ethnic,Hispanic or Latino,1,0,1
381252,Benign neoplasm of eye,racial,Native Hawaiian or Other Pacific Islander ,0,1,1
432789,Opioid analgesic adverse reaction,ethnic,Hispanic or Latino,1,0,1
433758,Childhood emotional disorder,racial,Black or African American ,0,1,1
380120,Strabismus in neuromuscular disorder,racial,Black or African American ,0,1,1
4222126,Removal of urethral stent,ethnic,Hispanic or Latino,1,0,1
197339,"Congenital abnormality of uterus, affecting pregnancy",racial,Unknown,1,0,1
4323155,Limited consultation,ethnic,Not Hispanic or Latino,1,0,1
4104583,Mechanical strabismus NOS,ethnic,Hispanic or Latino,1,0,1
440999,Choroidal rupture,racial,White,0,1,1
438836,Poliomyelitis osteopathy of the lower leg,racial,Other Race,0,1,1
139902,Allergic urticaria,racial,Filipino,0,1,1
4305187,Control of epistaxis by packing of posterior and anterior nose,ethnic,Hispanic or Latino,0,1,1
437663,Fever,racial,Native Hawaiian or Other Pacific Islander ,1,0,1
443743,Plasma cell neoplasm,ethnic,Hispanic or Latino,1,0,1
4066244,Caesarean wound disruption unspecified,racial,White,1,0,1
442553,Injury of bladder,ethnic,Hispanic or Latino,0,1,1
194702,PROM - Premature rupture of membranes,racial,White,1,0,1
194109,Delayed postpartum haemorrhage,racial,White,1,0,1
376113,Recent subtotal retinal detachment,racial,Unknown,0,1,1
442130,Open wound of tongue with complication,ethnic,Hispanic or Latino,0,1,1
73041,Closed fracture of five ribs,ethnic,Hispanic or Latino,0,1,1
441974,Closed fracture of forearm,racial,American Indian or Alaska Native ,0,1,1
441968,Acetonuria,racial,Native Hawaiian or Other Pacific Islander ,1,0,1
441032,Episcleritis periodica fugax,ethnic,Not Hispanic or Latino,0,1,1
74080,Orthostatic proteinuria,racial,Other Race,0,1,1
4096379,Hemangioma or lymphangioma NOS,racial,White,0,1,1
72737,Microcalcifications of the breast,racial,Native Hawaiian or Other Pacific Islander ,1,0,1
73291,Palindromic rheumatism of the ankle and/or foot,racial,Native Hawaiian or Other Pacific Islander ,0,1,1
434084,Abscess of vulva,racial,Asian,1,0,1
74469,Light-for-dates without mention of fetal malnutrition,racial,Asian,1,0,1
74129,Allergic arthritis of the ankle and/or foot,ethnic,Hispanic or Latino,1,0,1
316995,Coronary occlusion,racial,Filipino,0,1,1
436667,Stammer,racial,Other Race,0,1,1
376964,Partial recent retinal detachment with giant tear,racial,White,1,0,1
435866,Retrograde ejaculation,racial,Asian,0,1,1
196152,Peritonitis,racial,Other Race,0,1,1
433981,Benign neoplasm of short bone of upper limb,racial,White,0,1,1
441840,Clinical finding,racial,American Indian or Alaska Native ,1,0,1
436145,Pneumonia due to respiratory syncytial virus,racial,Asian,1,0,1
72992,Allergic arthritis,racial,White,1,0,1
434241,Accidental poisoning by soap products,ethnic,Hispanic or Latino,1,0,1
321320,Myocardial degeneration,ethnic,Not Hispanic or Latino,0,1,1
76273,Open wound of shoulder region without complication,ethnic,Not Hispanic or Latino,1,0,1
4164707,Canceled operative procedure,racial,American Indian,1,0,1
79915,Hemarthrosis of hand,ethnic,Not Hispanic or Latino,1,0,1
201625,Malposition of uterus,ethnic,Hispanic or Latino,1,0,1
4272341,Physical medicine evaluation and review for prosthetic program,ethnic,Hispanic or Latino,0,1,1
4337834,Hyperthyroidism due to ectopic thyroid nodule,racial,Unknown,0,1,1
253482,Cortical blindness,racial,Black or African American ,0,1,1
40484028,Dental caries extending into dentine,racial,American Indian or Alaska Native ,0,1,1
440059,Recurrent disease,ethnic,Hispanic or Latino,1,0,1
23988,Hemolytic anemia due to glutathione metabolism disorder,racial,Unknown,1,0,1
317299,Disorder of vitreous body,racial,White,0,1,1
201078,Senile atrophic vaginitis,racial,Black or African American ,1,0,1
4208388,Laryngotracheitis,ethnic,Hispanic or Latino,1,0,1
436256,Open fracture metatarsal,racial,White,1,0,1
4221619,Excision of vaginal lesion,ethnic,Hispanic or Latino,1,0,1
432287,Immunodeficiency with IgM hypergammaglobulinaemia,racial,White,0,1,1
433540,Polyhydramnios with antenatal problem,racial,Other Race,1,0,1
193983,Disorder of pancreatic internal secretion,racial,Asian,1,0,1
441961,Congenital pelviureteric junction obstruction,racial,White,0,1,1
438820,Postpartum deep phlebothrombosis,ethnic,Hispanic or Latino,1,0,1
373499,Disorder of eye region,racial,Black or African American ,0,1,1
380397,Keratoconjunctivitis,racial,Other Race,1,0,1
4092845,Candidiasis NOS,racial,Unknown,0,1,1
255841,Chronic bronchitis,racial,Filipino,1,0,1
194700,"Diabetes mellitus in mother complicating pregnancy, childbirth AND/OR puerperium",racial,American Indian or Alaska Native ,1,0,1
435522,Hypervitaminosis D,racial,American Indian or Alaska Native ,1,0,1
441770,Injury of unknown intent due to fall from high man-made structure,ethnic,Hispanic or Latino,1,0,1
442306,Adjustment disorder with depressed mood,racial,American Indian or Alaska Native ,1,0,1
254061,Pleural effusion,racial,Asian,0,1,1
320073,Neutrophil count below reference range,racial,Alaska Native,1,0,1
444287,Carbuncle of neck,racial,Asian,0,1,1
434329,Spinocerebellar disease,racial,Unknown,1,0,1
442073,Malunion and nonunion of fracture,racial,American Indian or Alaska Native ,0,1,1
134870,Pityriasis versicolor,racial,Native Hawaiian or Other Pacific Islander ,1,0,1
312327,Acute myocardial infarction,racial,Filipino,1,0,1
443260,Umbilical lump,racial,Unknown,0,1,1
138821,Seborrhea,racial,Other Race,0,1,1
444239,Postprocedural state finding,racial,American Indian,0,1,1
4239301,Unwanted pregnancy,racial,American Indian or Alaska Native ,1,0,1
433577,Hammer toe,racial,American Indian or Alaska Native ,1,0,1
4007913,Closed fracture mandible (site unspecified),racial,White,1,0,1
4105880,Contact of sexually transmissible disorder,racial,American Indian or Alaska Native ,0,1,1
26935,Disorder of endocrine testis,racial,Black or African American ,0,1,1
435533,"Hypnotic or anxiolytic dependence, continuous",racial,White,1,0,1
433695,Trypanosomiasis,ethnic,Hispanic or Latino,1,0,1
192279,Diabetic nephropathy,racial,Asian Indian,1,0,1
434272,Varicella infection,racial,Asian,0,1,1
194807,Injury of inferior vena cava,ethnic,Hispanic or Latino,0,1,1
432910,Disorder of lacrimal system,racial,Black or African American ,1,0,1
200171,Carbuncle of skin AND/OR subcutaneous tissue,racial,Filipino,0,1,1
4242962,Benign tumour of small intestine,racial,American Indian or Alaska Native ,1,0,1
432719,Panniculitis,racial,White,0,1,1
443438,Claw hand - acquired,racial,White,0,1,1
4109719,Other optic disc disorder NOS,racial,White,1,0,1
375256,Anterior subcapsular polar senile cataract,racial,Asian,1,0,1
4109253,Pterygium NOS,racial,Asian,1,0,1
193525,Abdominal pregnancy,racial,Black or African American ,1,0,1
375067,Microphthalmos associated with other anomalies of eye AND/OR adnexa,ethnic,Hispanic or Latino,1,0,1
133573,Acute osteomyelitis of shoulder region,racial,White,0,1,1
4237140,Abnormal sexual function,racial,Other Race,0,1,1
80165,Fetal disproportion,ethnic,Hispanic or Latino,1,0,1
77234,Benign tumour of colon,racial,Asian Indian,0,1,1
4215445,Arthroplasty of shoulder for recurrent dislocation,racial,White,1,0,1
435094,Open fracture of lower end of femur,ethnic,Hispanic or Latino,0,1,1
378765,TS - Tympanosclerosis,ethnic,Hispanic or Latino,0,1,1
4051568,Family history of mental disorder,racial,Other Race,1,0,1
4299535,Pregnancy confirmed,racial,Alaska Native,1,0,1
257011,Acute upper respiratory infection,racial,Alaska Native,1,0,1
193814,Chronic parametritis and pelvic cellulitis,racial,Other Race,1,0,1
75389,Current tear of lateral cartilage AND/OR meniscus of knee,racial,Other Race,1,0,1
440228,Closed fracture of lower end of humerus,racial,Black or African American ,1,0,1
196259,Injury of gastrointestinal tract without open wound into abdominal cavity,racial,White,0,1,1
433612,Closed fracture of upper end of fibula,ethnic,Not Hispanic or Latino,1,0,1
196569,Contusion of abdominal wall,ethnic,Not Hispanic or Latino,1,0,1
440370,Nutritional marasmus,ethnic,Not Hispanic or Latino,0,1,1
258458,Bacterial pleurisy with effusion,racial,Black or African American ,1,0,1
380688,Hypoglycaemic coma,racial,White,0,1,1
81983,Multiple dislocations,racial,Unknown,0,1,1
4153441,Fetus or neonate affected by breech delivery and extraction,ethnic,Hispanic or Latino,1,0,1
198291,Burn of abdominal wall,ethnic,Hispanic or Latino,1,0,1
77635,Disease of hand,racial,Black or African American ,1,0,1
434701,"Anemia in mother complicating pregnancy, childbirth AND/OR puerperium",racial,Asian,1,0,1
4100912,Screening for rheumatoid conditions,racial,Black or African American ,1,0,1
4012454,"Open fracture of tibia and/or fibula, shaft",racial,Unknown,0,1,1
374035,Keratitis,racial,Black or African American ,1,0,1
4096379,Hemangioma or lymphangioma NOS,ethnic,Hispanic or Latino,0,1,1
255175,Nodular tuberculosis of lung,ethnic,Hispanic or Latino,0,1,1
4147507,Retinal detachments and defects,racial,White,1,0,1
4094126,Family problems,racial,Unknown,1,0,1
78015,Open wound of chest wall without complication,racial,Black or African American ,1,0,1
81988,Sprain of sternum,ethnic,Not Hispanic or Latino,0,1,1
436245,Atypical glandular cells on vaginal Papanicolaou smear,racial,Black or African American ,1,0,1
196895,Viral gastroenteritis due to Norwalk-like agents,ethnic,Hispanic or Latino,1,0,1
4184816,Repair of prostate,ethnic,Hispanic or Latino,0,1,1
443883,Acute disease,racial,Asian,0,1,1
440329,Herpes zoster without complication,racial,American Indian or Alaska Native ,1,0,1
437954,Lateral meniscus derangement,racial,Unknown,1,0,1
74806,Open wound of finger with complication,racial,Unknown,0,1,1
4165091,Lack of exercise,racial,Black or African American ,0,1,1
198216,Retroverted incarcerated gravid uterus - delivered,ethnic,Not Hispanic or Latino,1,0,1
4318718,Limitation of movement of temporomandibular joint,racial,White,1,0,1
257581,Exacerbation of asthma,racial,Alaska Native,0,1,1
201221,Intestinal infection due to Class Cestoda and/or Class Trematoda and/or Phylum Nemata,ethnic,Not Hispanic or Latino,1,0,1
381859,Infective OE,racial,Filipino,0,1,1
193874,Bed wetting,racial,American Indian or Alaska Native ,1,0,1
81878,Benign paroxysmal positional vertigo,racial,Filipino,1,0,1
381118,Congenital vascular anomaly of eye,racial,White,1,0,1
4096347,Gouty arthropathy,racial,American Indian or Alaska Native ,1,0,1
442790,Growth and development,racial,Other Race,0,1,1
4105030,Other endophthalmitis,ethnic,Hispanic or Latino,1,0,1
198363,Candidiasis of vagina,racial,Native Hawaiian or Other Pacific Islander ,1,0,1
442282,Urinary casts,racial,Black or African American ,0,1,1
374377,Paralytic syndrome,ethnic,Not Hispanic or Latino,0,1,1
321314,Abdominal aortic aneurysm without rupture,racial,American Indian or Alaska Native ,0,1,1
313800,Thrombotic microangiopathy,racial,Unknown,1,0,1
40493424,Abdominal rigidity of right upper quadrant,ethnic,Hispanic or Latino,1,0,1
136030,Sweating fever,ethnic,Hispanic or Latino,0,1,1
4111259,Labyrinthine dysfunction NOS,racial,White,1,0,1
4228058,Unilateral mastectomy extended simple,racial,Unknown,1,0,1
441607,Mediastinal abscess,racial,Unknown,0,1,1
75637,Acquired postural kyphosis,racial,Other Race,1,0,1
81382,Tendon sheath giant cell tumor,racial,White,1,0,1
438477,Atrophy of testis,racial,Black or African American ,0,1,1
381285,Peroneal muscular atrophy,ethnic,Not Hispanic or Latino,0,1,1
376102,Partial recent retinal detachment with single defect,racial,Other Race,0,1,1
321726,Injury of blood vessels of lower extremity,ethnic,Hispanic or Latino,1,0,1
440684,Simple paranoid state,ethnic,Not Hispanic or Latino,0,1,1
440098,Rubeosis iridis,racial,White,1,0,1
433315,Feeding difficulties in newborn,racial,American Indian or Alaska Native ,0,1,1
73723,Benign tumour of epididymis,ethnic,Not Hispanic or Latino,0,1,1
140490,Anhidrosis,racial,White,0,1,1
318437,Accelerated secondary hypertension,ethnic,Hispanic or Latino,1,0,1
443012,Diabetes mellitus during pregnancy - baby delivered,racial,Other Race,1,0,1
81106,Acquired genu varum,racial,Other Race,0,1,1
438557,Abnormal glucose level,racial,European,0,1,1
373469,Symptomatic torsion dystonia,ethnic,Not Hispanic or Latino,1,0,1
4110052,Bronchiectasis NOS,ethnic,Hispanic or Latino,1,0,1
195594,Spontaneous abortion complicated by delayed AND/OR excessive hemorrhage,racial,White,1,0,1
436833,Open fracture of metacarpal bone,ethnic,Not Hispanic or Latino,0,1,1
4145479,Other specified candidiasis NOS,racial,Unknown,1,0,1
134276,Cutaneous actinomycosis,ethnic,Hispanic or Latino,0,1,1
192819,Typhoid fever,ethnic,Hispanic or Latino,1,0,1
444084,Extrinsic allergic alveolitis,ethnic,Not Hispanic or Latino,1,0,1
435661,Closed orbital blow-out fracture,racial,Black or African American ,1,0,1
253235,Pneumonia in pertussis,racial,White,0,1,1
373054,Open wound of auricle of ear without complication,ethnic,Not Hispanic or Latino,1,0,1
443782,Tremor,racial,Filipino,0,1,1
72693,Poor fetal growth affecting management,ethnic,Hispanic or Latino,1,0,1
4108389,Generalized tuberculosis,ethnic,Not Hispanic or Latino,0,1,1
4060433,Multiple pregnancy NOS,ethnic,Hispanic or Latino,1,0,1
140364,Disorder of thyrocalcitonin secretion,racial,White,1,0,1
439337,"Motor vehicle traffic accident involving collision, on highway, between motor vehicle and animal, passenger of motor vehicle injured",ethnic,Hispanic or Latino,1,0,1
196471,Puberty bleeding,racial,Unknown,1,0,1
192958,Floating kidney,racial,Unknown,0,1,1
440161,Indication for care AND/OR intervention in labor AND/OR delivery,racial,Unknown,1,0,1
379782,Gilles de la Tourette's syndrome,racial,Asian,0,1,1
201221,Intestinal infection due to Class Cestoda and/or Class Trematoda and/or Phylum Nemata,racial,Asian,1,0,1
315361,Orthopnea,racial,Black or African American ,1,0,1
72748,Strain of rotator cuff of shoulder,racial,Other Race,1,0,1
4087756,Late latent syphilis,racial,Asian,1,0,1
434953,Orbital granuloma,racial,White,0,1,1
4062652,Galactosaemia screening,racial,White,0,1,1
381028,Acute suppurative otitis media - tympanic membrane ruptured,racial,Filipino,0,1,1
433687,Botulism,racial,White,0,1,1
81988,Sprain of sternum,racial,Asian,0,1,1
435914,Metatarsus varus,ethnic,Not Hispanic or Latino,1,0,1
4184252,Observation of neck region,ethnic,Hispanic or Latino,0,1,1
4293175,"Mental state, behaviour and/or psychosocial function finding",racial,Alaska Native,0,1,1
377573,Pars tensa central perforation,racial,White,0,1,1
200769,"Chronic gastric ulcer without hemorrhage, without perforation AND without obstruction",racial,Other Race,1,0,1
436392,Carotid sinus syncope,ethnic,Not Hispanic or Latino,1,0,1
4042836,Disease of head,racial,Other Race,1,0,1
252341,Extrinsic asthma with status asthmaticus,racial,Unknown,1,0,1
437878,Persistent mydriasis,racial,Unknown,1,0,1
320752,Influenza with non-respiratory manifestation,racial,Asian,0,1,1
4273622,Operation on bone injury of carpals and metacarpals,ethnic,Hispanic or Latino,1,0,1
4307254,Closed fracture,racial,Asian,1,0,1
319041,Orthostatic hypotension,racial,Native Hawaiian or Other Pacific Islander ,0,1,1
444121,"Primary dental caries, proximal smooth surface origin",racial,Unknown,1,0,1
197795,Acute hepatitis B,racial,Other Race,0,1,1
193693,Viral hepatitis without hepatic coma,racial,Unknown,1,0,1
134214,Burn erythema of wrist,racial,Unknown,1,0,1
432860,Benign tumor of epipharynx,ethnic,Not Hispanic or Latino,1,0,1
40480943,Lateral cystocele,racial,Other Race,1,0,1
192259,Ascariasis,ethnic,Not Hispanic or Latino,0,1,1
436333,Orf virus disease,racial,Black or African American ,1,0,1
80815,Mucous cyst of skin,racial,Other Race,1,0,1
4036945,Consciousness disturbance NOS,racial,White,1,0,1
4201388,Gastrostomy present,racial,Native Hawaiian or Other Pacific Islander ,1,0,1
438040,"Adverse reaction to analgesics, antipyretics and antirheumatics",ethnic,Hispanic or Latino,1,0,1
4170747,Abnormal amniotic fluid,ethnic,Not Hispanic or Latino,1,0,1
438750,Old total retinal detachment,ethnic,Not Hispanic or Latino,0,1,1
436897,Transport fever,racial,Other Race,0,1,1
81169,Superficial foreign body of finger without major open wound AND without infection,racial,American Indian or Alaska Native ,1,0,1
79061,Colonic constipation,racial,Asian,0,1,1
135215,Hashimoto thyroiditis,racial,Unknown,1,0,1
373756,Exudative retinopathy,racial,Asian,0,1,1
198520,Lumbar spondylosis with myelopathy,racial,Other Race,0,1,1
196523,Diarrhea,racial,Asian Indian,0,1,1
377565,Optic atrophy associated with retinal dystrophy,ethnic,Hispanic or Latino,1,0,1
74864,Gonococcal joint infection,racial,White,0,1,1
199068,Vaginal hematoma,ethnic,Hispanic or Latino,1,0,1
433716,Primary malignant neoplasm of testis,ethnic,Not Hispanic or Latino,0,1,1
201069,"Peptic ulcer without hemorrhage, without perforation AND without obstruction",racial,Black or African American ,0,1,1
373216,Disorder of mastoid,ethnic,Not Hispanic or Latino,0,1,1
4105628,Facial nerve disorder NOS,ethnic,Hispanic or Latino,0,1,1
201332,Alveolitis of jaw,racial,Black or African American ,1,0,1
434164,Glycosuria,racial,Other Race,1,0,1
195500,Benign tumour of uterus,ethnic,Not Hispanic or Latino,0,1,1
443782,Tremor,racial,Other Race,0,1,1
24969,Laryngitis,racial,White,0,1,1
73383,Full thickness burn of foot,racial,White,1,0,1
133848,Non-traumatic slipped upper femoral epiphysis,racial,Unknown,0,1,1
4103726,Subjective visual disturbance NOS,racial,Unknown,1,0,1
4268973,Jaw-blinking,racial,White,1,0,1
374937,Impairment level: better eye: near-total impairment: lesser-eye: not further specified,racial,White,0,1,1
439222,Corticosteroids adverse reaction,racial,White,1,0,1
440071,Gout associated problems,racial,Filipino,0,1,1
4109880,Varicose veins of the leg with ulcer,racial,Alaska Native,1,0,1
4258683,Faeces - impacted,racial,Unknown,1,0,1
381014,Conjunctival pigmentation,ethnic,Not Hispanic or Latino,1,0,1
77067,Bucket handle tear of lateral meniscus,ethnic,Hispanic or Latino,1,0,1
198558,Nycturia,racial,European,0,1,1
438660,Toxic effect of nonpetroleum-based solvent,ethnic,Not Hispanic or Latino,0,1,1
313792,PT - Paroxysmal tachycardia,racial,Asian,1,0,1
4300419,Submammary mastitis associated with childbirth,racial,Unknown,1,0,1
442189,Blister of wrist without infection,racial,White,1,0,1
81943,Rupture of flexor tendons of hand AND/OR wrist,ethnic,Hispanic or Latino,0,1,1
316535,Closed fracture of dorsal vertebra without spinal cord injury,racial,Black or African American ,0,1,1
196455,Hepatorenal syndrome,racial,Unknown,1,0,1
436519,Perinatal intraventricular hemorrhage,racial,Unknown,1,0,1
4070287,Preauricular sinus and fistula,racial,White,1,0,1
373470,Polyneuropathy due to toxic agents,racial,Unknown,1,0,1
254796,Open wound of nose with complication,ethnic,Hispanic or Latino,0,1,1
197612,Abortion complicated by delayed AND/OR excessive hemorrhage,racial,Unknown,1,0,1
434328,"Nondependent cannabis abuse, episodic",racial,Unknown,0,1,1
438259,Umbilical hemorrhage after birth,racial,White,1,0,1
4050091,Open wound of penis,racial,Unknown,0,1,1
436166,Mild hyperemesis gravidarum,racial,American Indian or Alaska Native ,1,0,1
192450,Not passing urine,racial,Asian,0,1,1
435774,Disorder of amino acid metabolism,racial,Unknown,1,0,1
444028,Open wound of alveolar process without complication,racial,Unknown,1,0,1
312998,Pain in thoracic spine,racial,Filipino,0,1,1
432968,Anemia during pregnancy - baby delivered,racial,Black or African American ,1,0,1
432419,Encephalocele,ethnic,Hispanic or Latino,1,0,1
4146235,Other cellulitis and abscess,ethnic,Not Hispanic or Latino,1,0,1
376712,Purulent otitis media,racial,Asian,1,0,1
4104072,Purulent otitis media NOS,racial,White,1,0,1
77624,"Breast engorgement in pregnancy, the puerperium or lactation - delivered",racial,White,1,0,1
4098311,Borderline psychosis of childhood,ethnic,Not Hispanic or Latino,1,0,1
438105,Benign tumour of mediastinum,racial,White,0,1,1
443232,Eyelid and lacrimal drainage system laceration,racial,Unknown,0,1,1
192359,RF - Renal failure,racial,Asian Indian,0,1,1
259865,Cyst of Bartholin's gland duct,racial,American Indian or Alaska Native ,1,0,1
4070557,Incision of testis,racial,White,1,0,1
4029488,Hepatic encephalopathy,racial,Other Race,1,0,1
435925,Very premature - less than 1000g or less than 28 weeks,racial,Black or African American ,0,1,1
4113680,Ruptured tubal pregnancy,ethnic,Hispanic or Latino,1,0,1
78230,Rheumatoid arthritis with organ / system involvement,racial,Black or African American ,1,0,1
197593,Impaction of intestine,ethnic,Not Hispanic or Latino,0,1,1
376229,Abnormal involuntary movement,racial,Native Hawaiian or Other Pacific Islander ,0,1,1
4103737,"Better eye: low vision, Lesser eye: profound visual impairment",ethnic,Hispanic or Latino,1,0,1
197096,Urethra and bladder neck atresia and stenosis,ethnic,Hispanic or Latino,0,1,1
432451,Abnormal results of function studies of central nervous system,ethnic,Not Hispanic or Latino,0,1,1
79915,Hemarthrosis of hand,racial,Asian,1,0,1
440404,Stenosis of lacrimal punctum,racial,Unknown,1,0,1
378742,Blind hypotensive eye,ethnic,Not Hispanic or Latino,1,0,1
75608,Shoulder dystocia with antenatal problem,racial,White,1,0,1
435850,Cyst of jaw,ethnic,Not Hispanic or Latino,1,0,1
432609,"Acute alcoholic intoxication in remission, in alcoholism",racial,Unknown,0,1,1
312664,Influenza with respiratory manifestation other than pneumonia,racial,Native Hawaiian or Other Pacific Islander ,1,0,1
438460,Edentulous alveolar ridge atrophy,racial,Filipino,1,0,1
435866,Retrograde ejaculation,ethnic,Not Hispanic or Latino,0,1,1
4002318,Cleft palate with cleft lip NOS,ethnic,Hispanic or Latino,1,0,1
434183,"Closed fracture distal humerus, medial epicondyle",racial,Unknown,0,1,1
434501,"Open fracture ankle, trimalleolar",ethnic,Hispanic or Latino,1,0,1
4066882,Excision of anal skin tag,ethnic,Hispanic or Latino,1,0,1
4030398,Amputation of arm through shoulder,racial,Unknown,0,1,1
372894,central serous retinopathy,racial,White,0,1,1
80800,Polymyositis,ethnic,Not Hispanic or Latino,0,1,1
194093,Postcoital bleeding,racial,Black or African American ,1,0,1
441829,Hyperosmolality and or hypernatremia,racial,Native Hawaiian or Other Pacific Islander ,0,1,1
434193,Closed dislocation of distal radioulnar joint of wrist,ethnic,Hispanic or Latino,1,0,1
373127,Herpes simplex disciform keratitis,ethnic,Not Hispanic or Latino,0,1,1
78516,Arthralgia of the upper arm,racial,Filipino,1,0,1
4064377,Depression screening,racial,European,0,1,1
193693,Viral hepatitis without hepatic coma,racial,White,1,0,1
78509,Loose body in joint of ankle and/or foot,ethnic,Hispanic or Latino,1,0,1
4114314,Screening for osteoporosis,racial,Asian Indian,1,0,1
376793,Congenital anomaly of ear with impairment of hearing,racial,Asian,1,0,1
442334,Synovitis AND/OR tenosynovitis associated with another disease,ethnic,Hispanic or Latino,1,0,1
40353121,"Accidental cut, puncture, perforation or haemorrhage during medical care",ethnic,Hispanic or Latino,1,0,1
441139,Instantaneous death,racial,Unknown,1,0,1
81424,Closed dislocation of knee,racial,Other Race,0,1,1
197925,Haemorrhage of rectum and anus,racial,Native Hawaiian or Other Pacific Islander ,0,1,1
255841,Chronic bronchitis,racial,American Indian or Alaska Native ,1,0,1
316866,Hyperpiesis,racial,Unknown,1,0,1
436900,Mycoplasmosis,ethnic,Hispanic or Latino,0,1,1
432789,Opioid analgesic adverse reaction,racial,Black or African American ,0,1,1
4001802,"Other muscle, ligament and fascia disorder",racial,White,0,1,1
436446,Cracked tooth syndrome,racial,Black or African American ,0,1,1
442790,Growth and development,racial,Unknown,1,0,1
442073,Malunion and nonunion of fracture,racial,White,1,0,1
437175,"Fall on same level from slipping, tripping or stumbling",racial,Black or African American ,1,0,1
4288725,Lithium therapy,ethnic,Not Hispanic or Latino,1,0,1
432944,Major anomaly of jaw size,ethnic,Not Hispanic or Latino,0,1,1
4242435,Reifenstein syndrome,ethnic,Hispanic or Latino,0,1,1
434758,Exceptionally large baby,ethnic,Hispanic or Latino,1,0,1
30061,Neoplasm of uncertain behaviour of major salivary gland,racial,Asian,1,0,1
378352,Conjunctivitis due to adenovirus,ethnic,Hispanic or Latino,1,0,1
79915,Hemarthrosis of hand,ethnic,Hispanic or Latino,0,1,1
4062636,Bacterial disease screening,racial,Asian,1,0,1
433687,Botulism,racial,Unknown,0,1,1
437240,Carcinoma in situ of skin of upper limb and shoulder,ethnic,Hispanic or Latino,0,1,1
378439,Fourth nerve palsy,ethnic,Not Hispanic or Latino,1,0,1
4235140,Operation for bone injury of phalanges of hand,racial,Other Race,1,0,1
438947,Burning due to contact with hot water,ethnic,Hispanic or Latino,1,0,1
4112831,Extrinsic asthma NOS,racial,Black or African American ,0,1,1
442920,Mental disorder during pregnancy - baby delivered,ethnic,Not Hispanic or Latino,1,0,1
434348,Acute and subacute iridocyclitis,racial,Other Race,1,0,1
78786,Pleurisy,racial,Black or African American ,1,0,1
201958,Perinatal dermatological disorders,racial,Asian,1,0,1
377573,Pars tensa central perforation,racial,Unknown,1,0,1
435658,Atypical squamous cells on vaginal Papanicolaou smear cannot exclude high grade squamous intraepithelial lesion,ethnic,Not Hispanic or Latino,1,0,1
432571,Malignant lymphoma,racial,American Indian or Alaska Native ,1,0,1
4119298,Late onset asthma,racial,Native Hawaiian or Other Pacific Islander ,0,1,1
4249474,Generalized seborrheic dermatitis of infants,racial,Black or African American ,0,1,1
72618,Disorder of muscle,racial,Filipino,0,1,1
4177025,Fracture of patella,ethnic,Hispanic or Latino,0,1,1
195594,Spontaneous abortion complicated by delayed AND/OR excessive hemorrhage,racial,Unknown,1,0,1
201341,Incisional hernia with obstruction but no gangrene,ethnic,Hispanic or Latino,0,1,1
439987,"Accident caused by hot liquid and vapor, including steam",racial,Unknown,1,0,1
439799,Leg cramps,racial,American Indian or Alaska Native ,1,0,1
81636,Excessive foetal growth affecting management of mother,ethnic,Not Hispanic or Latino,1,0,1
73008,Enthesopathy,racial,Filipino,1,0,1
192387,Obstetric perineal wound disruption - delivered with postnatal complication,ethnic,Not Hispanic or Latino,1,0,1
437167,Accident caused by firearm missile,ethnic,Not Hispanic or Latino,0,1,1
134668,Chronic maxillary sinusitis,racial,Black or African American ,1,0,1
432593,Kwashiorkor,ethnic,Not Hispanic or Latino,1,0,1
197484,Diarrhea of presumed infectious origin,racial,Filipino,1,0,1
442604,Hypertensive heart disease,racial,Filipino,0,1,1
4148244,SN - Supernumerary tooth,racial,White,0,1,1
436118,After-cataract with vision obscured,racial,Asian,0,1,1
4179332,Parent-child problem,racial,Black or African American ,1,0,1
315831,Chronic pulmonary heart disease,racial,Native Hawaiian or Other Pacific Islander ,0,1,1
4090094,Unspecified histoplasmosis infection,racial,White,0,1,1
444413,Pyrexial convulsion,racial,Other Race,0,1,1
443219,Dental occlusion observation,ethnic,Hispanic or Latino,1,0,1
201341,Incisional hernia with obstruction but no gangrene,racial,White,0,1,1
139753,Primary malignant neoplasm of parathyroid gland,ethnic,Not Hispanic or Latino,0,1,1
4001965,Infection of multiple bones,racial,White,1,0,1
196471,Puberty bleeding,racial,White,1,0,1
194175,Left upper quadrant pain,racial,American Indian,1,0,1
195317,Incomplete spontaneous abortion with genital tract or pelvic infection,ethnic,Hispanic or Latino,1,0,1
194984,Hepatopathy,racial,Black or African American ,0,1,1
376981,Amblyopia,ethnic,Not Hispanic or Latino,0,1,1
198124,Disorder of kidney,racial,American Indian or Alaska Native ,0,1,1
141213,Scarlet fever,racial,Asian,1,0,1
40421730,"Adverse reaction to mixed bacterial vaccines, excluding combinations with a pertussis component",racial,White,0,1,1
135858,Disorder of lip,racial,Filipino,1,0,1
132579,Giant-cell thyroiditis,racial,Unknown,0,1,1
438460,Edentulous alveolar ridge atrophy,racial,Other Race,1,0,1
435553,Watery eye,racial,Black or African American ,1,0,1
196654,Lipoma of intra-abdominal organs,ethnic,Hispanic or Latino,1,0,1
73231,Arthralgia of temporomandibular joint,racial,Black or African American ,1,0,1
138641,Foreign body in tracheobronchial tree,ethnic,Hispanic or Latino,0,1,1
434810,Burn of genitalia,ethnic,Not Hispanic or Latino,1,0,1
434228,Passenger in vehicular AND/OR traffic accident,ethnic,Hispanic or Latino,0,1,1
4004785,Fetal alcohol syndrome,racial,Other Race,0,1,1
314059,Right bundle branch block,racial,American Indian,0,1,1
372828,Zoster ophthalmicus,ethnic,Not Hispanic or Latino,0,1,1
434327,Cannabis abuse,racial,Other Race,0,1,1
440858,Cortex contusion without open intracranial wound,racial,White,1,0,1
4086918,Viral screening,racial,Alaska Native,0,1,1
4064362,Mycotic infection screening,racial,Unknown,1,0,1
439847,Intracranial hemorrhage,ethnic,Not Hispanic or Latino,0,1,1
81878,Benign paroxysmal positional vertigo,racial,American Indian or Alaska Native ,1,0,1
201823,Benign tumour of penis,ethnic,Hispanic or Latino,0,1,1
314659,Arteritis,ethnic,Not Hispanic or Latino,0,1,1
435658,Atypical squamous cells on vaginal Papanicolaou smear cannot exclude high grade squamous intraepithelial lesion,racial,Asian,1,0,1
4240902,Allergy to peanuts,racial,Filipino,1,0,1
194408,Hydroureter,ethnic,Not Hispanic or Latino,0,1,1
4096347,Gouty arthropathy,racial,Filipino,0,1,1
442632,Abrasion AND/OR friction burn of wrist with infection,racial,Asian,0,1,1
381010,Intralenticular foreign body,ethnic,Hispanic or Latino,1,0,1
377535,Sleep walking disorder,ethnic,Not Hispanic or Latino,0,1,1
440690,Social phobia,racial,Black or African American ,0,1,1
76270,Superficial injury of foot with infection,ethnic,Hispanic or Latino,1,0,1
30061,Neoplasm of uncertain behaviour of major salivary gland,ethnic,Not Hispanic or Latino,1,0,1
442609,Friction blister without infection,racial,Asian,0,1,1
201221,Intestinal infection due to Class Cestoda and/or Class Trematoda and/or Phylum Nemata,ethnic,Hispanic or Latino,0,1,1
81705,Open dislocation of knee,ethnic,Hispanic or Latino,1,0,1
4102738,Screening for mental disorders,racial,Asian,1,0,1
317971,Respiratory system congenital anomalies,racial,Unknown,1,0,1
432441,Finding of length of gestation,racial,Unknown,0,1,1
4256640,Body mass index 40+ - severely obese,racial,American Indian or Alaska Native ,1,0,1
140586,Collapse - heat,racial,Unknown,0,1,1
133088,Late amputation stump complication,racial,Black or African American ,0,1,1
438259,Umbilical hemorrhage after birth,racial,Unknown,0,1,1
435230,Multiple personality disorder,racial,White,1,0,1
315558,Atherosclerosis of arteries of the extremities,racial,Alaska Native,1,0,1
437881,Malignant otitis externa,ethnic,Not Hispanic or Latino,1,0,1
436027,Coxsackie virus disease,racial,Black or African American ,0,1,1
4067061,Psoriasis and similar disorders NOS,ethnic,Hispanic or Latino,1,0,1
440921,Traumatic injury,racial,Other Race,1,0,1
432453,General clinical state finding,racial,Other Race,1,0,1
141022,Orbital tenonitis,racial,Unknown,1,0,1
4310682,Multiple open wounds with complication,racial,Asian,1,0,1
440851,Open fracture of forearm,ethnic,Hispanic or Latino,1,0,1
196433,Aneurysm of iliac artery,racial,Unknown,0,1,1
439303,Horseshoe retinal tear without detachment,ethnic,Hispanic or Latino,0,1,1
4112364,Other upper respiratory tract diseases,racial,Unknown,1,0,1
440370,Nutritional marasmus,ethnic,Hispanic or Latino,0,1,1
433822,Complication related to pregnancy,racial,Asian,1,0,1
435231,Nondependent cannabis abuse in remission,racial,White,0,1,1
438105,Benign tumour of mediastinum,racial,Unknown,1,0,1
378442,Conductive hearing loss of combined sites,racial,Unknown,0,1,1
132822,Foot-and-mouth disease,racial,Black or African American ,1,0,1
441085,Elderly primip,racial,Asian,1,0,1
376113,Recent subtotal retinal detachment,racial,Other Race,0,1,1
444236,Superficial foreign body of hand without major open wound but with infection,racial,Unknown,1,0,1
440422,Noise-induced hearing loss,racial,White,1,0,1
439968,Late effect of tendon injury,ethnic,Hispanic or Latino,0,1,1
81707,Closed fracture cuboid,racial,White,1,0,1
135489,Primary malignant neoplasm of male breast,ethnic,Hispanic or Latino,1,0,1
441274,Developmental expressive language disorder,racial,Asian,0,1,1
253788,Nasal polyp,racial,Filipino,0,1,1
22666,Vomiting after gastrointestinal tract surgery,racial,Unknown,1,0,1
4103726,Subjective visual disturbance NOS,racial,White,1,0,1
195501,Polycystic ovaries,racial,Black or African American ,1,0,1
442289,Death in less then 24 hours from onset of symptoms,ethnic,Hispanic or Latino,0,1,1
81670,Congenital anomaly of spine,racial,Other Race,1,0,1
444070,Tachycardia,racial,American Indian or Alaska Native ,1,0,1
4167069,Aneurysm clipping,racial,Unknown,0,1,1
439222,Corticosteroids adverse reaction,racial,Unknown,1,0,1
378087,Secondary malignant neoplasm of brain and spinal cord,racial,White,1,0,1
437854,Cataplexy and narcolepsy,racial,White,0,1,1
440855,Closed fracture of base of metacarpal bone other than first metacarpal,racial,Other Race,1,0,1
438090,"Overlapping malignant neoplasm of rectum, anus and anal canal",ethnic,Hispanic or Latino,0,1,1
433073,Superficial burn of back of hand,racial,Unknown,1,0,1
4106274,Neonatal cardiac arrest,racial,White,0,1,1
198289,Nonvenomous insect bite of hip without infection,racial,Black or African American ,1,0,1
198291,Burn of abdominal wall,racial,White,1,0,1
434820,Cold injury,ethnic,Hispanic or Latino,0,1,1
438727,Atypical depressive disorder,racial,Asian,1,0,1
73843,Synovial cyst of popliteal space,racial,Black or African American ,0,1,1
80493,Ankylosis of joint,racial,White,1,0,1
77355,Articular cartilage disorder of ankle AND/OR foot,racial,White,0,1,1
79936,Polyuria,racial,American Indian or Alaska Native ,1,0,1
317376,Tachypnoeic,racial,Other Race,0,1,1
4201472,Varicella contact,racial,American Indian or Alaska Native ,1,0,1
438952,Assault by striking with motor vehicle,ethnic,Hispanic or Latino,0,1,1
197044,Female infertility associated with anovulation,racial,Asian,1,0,1
441919,Twin pregnancy,racial,Unknown,1,0,1
437745,Victim of infant/child neglect,ethnic,Not Hispanic or Latino,1,0,1
4051564,FH: Metabolic disorder,racial,Asian,1,0,1
432463,"Closed fracture clavicle, lateral end",racial,Black or African American ,0,1,1
196236,Septicaemic shock,ethnic,Not Hispanic or Latino,0,1,1
77638,Displacement of intervertebral disc without myelopathy,racial,American Indian,0,1,1
436587,"Toxic effect of gas, fumes AND/OR vapors",racial,White,0,1,1
4140734,Amniocentesis for possible chromosomal abnormality,racial,White,1,0,1
373756,Exudative retinopathy,ethnic,Not Hispanic or Latino,0,1,1
432447,Atypical glandular cells on cervical Papanicolaou smear,racial,Black or African American ,1,0,1
443345,Antineoplastic adverse reaction,racial,Unknown,0,1,1
4282316,Recurrent major depression,ethnic,Not Hispanic or Latino,0,1,1
75042,Allergic arthritis of the shoulder region,ethnic,Not Hispanic or Latino,0,1,1
373995,Delirium,racial,Native Hawaiian or Other Pacific Islander ,0,1,1
434903,Ego-dystonic sexual orientation,ethnic,Hispanic or Latino,1,0,1
379032,Acute mastoiditis with complications,racial,Unknown,0,1,1
4299574,Factitious skin disease,racial,Black or African American ,0,1,1
432898,Severe mental handicap,racial,Asian,0,1,1
434246,Burn with deep necrosis of underlying tissues without loss of body part,ethnic,Hispanic or Latino,1,0,1
253009,Thoracogenic scoliosis,racial,White,1,0,1
4023168,Home alone,racial,Unknown,1,0,1
380859,Closed fracture of lower jaw bone,ethnic,Hispanic or Latino,0,1,1
436040,Infection by Strongyloides,ethnic,Not Hispanic or Latino,0,1,1
4055742,Acute pericementitis,ethnic,Not Hispanic or Latino,0,1,1
314965,Embolism and thrombosis of an arm or leg artery,ethnic,Not Hispanic or Latino,0,1,1
4194160,Thyroid function tests abnormal,racial,Filipino,0,1,1
438204,Edema or excessive weight gain in pregnancy without mention of hypertension,ethnic,Not Hispanic or Latino,1,0,1
435320,Acute glomerulonephritis associated with another disorder,racial,Unknown,0,1,1
434584,Epidemic Kaposi's sarcoma,racial,White,0,1,1
444098,"Gestation period, 40 weeks",ethnic,Not Hispanic or Latino,0,1,1
135030,Discoloration of skin,racial,Black or African American ,1,0,1
443404,Postpartum disorder,ethnic,Hispanic or Latino,1,0,1
438438,Acute myocardial infarction of anterolateral wall,racial,Unknown,1,0,1
4273622,Operation on bone injury of carpals and metacarpals,ethnic,Not Hispanic or Latino,0,1,1
442077,Anxiety disorder,racial,Black or African American ,0,1,1
373461,Leukocoria,ethnic,Not Hispanic or Latino,1,0,1
381866,Degenerative disorder of eyelid,racial,Unknown,1,0,1
4172146,Proctostomy,ethnic,Hispanic or Latino,0,1,1
4105030,Other endophthalmitis,racial,White,1,0,1
136865,Injury of radial nerve,ethnic,Hispanic or Latino,0,1,1
4144123,Other kidney and ureter disorders,racial,White,1,0,1
440129,Hypertrophy of nasal turbinates,racial,Other Race,1,0,1
28083,Primary malignant neoplasm of pharynx,ethnic,Not Hispanic or Latino,0,1,1
433752,Impulse control disorder,racial,Black or African American ,0,1,1
435509,Intracranial abscess,ethnic,Hispanic or Latino,0,1,1
438722,Non megaloblastic anemia associated with nutritional deficiency,racial,Black or African American ,1,0,1
435797,Selective immunoglobulin dysfunction,ethnic,Hispanic or Latino,1,0,1
75908,Kissing spine,racial,White,0,1,1
4153727,Closed fracture of other tarsal and metatarsal bones,ethnic,Hispanic or Latino,0,1,1
4314713,Abusive parenting,racial,White,1,0,1
372613,Flaccid hemiplegia,racial,Other Race,0,1,1
197981,Abdominal tenderness,racial,American Indian or Alaska Native ,0,1,1
432598,Subchronic schizophrenia with acute exacerbations,racial,Black or African American ,1,0,1
135030,Discoloration of skin,racial,Filipino,1,0,1
4063304,Rhesus isoimmunization unspecified,ethnic,Hispanic or Latino,1,0,1
432821,Leprosy,ethnic,Hispanic or Latino,0,1,1
4146239,Pruritus of genital organs,racial,Other Race,1,0,1
377545,Episodic tension-type headache,ethnic,Not Hispanic or Latino,0,1,1
442632,Abrasion AND/OR friction burn of wrist with infection,ethnic,Not Hispanic or Latino,0,1,1
437483,Homicide or assault by unarmed fight or brawl,racial,White,1,0,1
440985,Phobia,racial,American Indian or Alaska Native ,0,1,1
4268980,Finding of general development,racial,Black or African American ,1,0,1
4064917,Urinary neoplasm screening,ethnic,Hispanic or Latino,0,1,1
201238,Primary malignant neoplasm of female genital organ,ethnic,Not Hispanic or Latino,0,1,1
139980,Burn erythema of forearm,racial,White,0,1,1
4104054,Vitreous disorders NOS,ethnic,Hispanic or Latino,1,0,1
132736,Bacteremia,racial,Other Race,1,0,1
4311159,Midline cystocele,racial,Black or African American ,1,0,1
443782,Tremor,racial,American Indian or Alaska Native ,1,0,1
438480,"Abnormal glucose tolerance in mother complicating pregnancy, childbirth AND/OR puerperium",racial,Other Race,1,0,1
197593,Impaction of intestine,ethnic,Hispanic or Latino,1,0,1
435875,"Complications of pregnancy, childbirth and the puerperium",racial,Other Race,1,0,1
440422,Noise-induced hearing loss,racial,Unknown,1,0,1
437745,Victim of infant/child neglect,racial,Asian,1,0,1
196236,Septicaemic shock,racial,Asian,0,1,1
433860,IAA - Interrupted aortic arch,racial,White,1,0,1
4056196,Other breast disorders,ethnic,Hispanic or Latino,1,0,1
195007,Female stress incontinence,racial,Filipino,1,0,1
80141,Functional diarrhea,racial,Other Race,0,1,1
193525,Abdominal pregnancy,racial,Asian,1,0,1
440276,"Infection AND/OR inflammatory reaction due to internal prosthetic device, implant AND/OR graft",racial,Native Hawaiian or Other Pacific Islander ,0,1,1
192759,Sequelae of fracture of spine,ethnic,Hispanic or Latino,1,0,1
372651,Chronic mastoiditis,racial,White,1,0,1
74216,Injury of nerves at shoulder and upper arm level,racial,White,1,0,1
196813,Simple renal cyst,racial,Unknown,1,0,1
433706,Yaws gummata and ulcers,ethnic,Not Hispanic or Latino,1,0,1
197911,Hernia of anterior abdominal wall without obstruction AND without gangrene,racial,Asian,1,0,1
314383,Myocarditis,racial,White,1,0,1
77880,Circumscribed labyrinthitis,ethnic,Hispanic or Latino,1,0,1
433886,Closed fracture of trapezium bone of wrist,racial,Unknown,1,0,1
193530,Follicular cyst of ovary,racial,Other Race,1,0,1
4116761,Lateral meniscus derangement unspecified,racial,Unknown,1,0,1
432875,Anemia due to chronic blood loss,racial,Black or African American ,1,0,1
381574,External auditory canal exostosis,racial,Unknown,1,0,1
314426,Congenital cardiovascular disorder during pregnancy - baby not yet delivered,ethnic,Not Hispanic or Latino,1,0,1
443982,Traumatic amputation of thumb,racial,Unknown,0,1,1
432881,Pancytopenia,racial,Black or African American ,1,0,1
374037,Night blindness,ethnic,Hispanic or Latino,1,0,1
195209,Benign neoplasm of liver and/or biliary ducts,racial,Asian,1,0,1
4050929,FH: Skin disease,racial,White,1,0,1
195583,Chronic gastric ulcer without hemorrhage AND without perforation but with obstruction,racial,White,1,0,1
4088083,Tuberculosis of other organs,ethnic,Hispanic or Latino,0,1,1
74124,Traumatic arthropathy,racial,Other Race,0,1,1
373356,Open wound of multiple sites of ear with complication,racial,White,1,0,1
201905,Constipation by outlet obstruction,ethnic,Hispanic or Latino,1,0,1
435231,Nondependent cannabis abuse in remission,racial,Unknown,1,0,1
195588,Cystitis,racial,Filipino,1,0,1
4064362,Mycotic infection screening,racial,White,1,0,1
76255,Sprain of iliofemoral ligament,racial,American Indian or Alaska Native ,0,1,1
4088777,Vagina observation,racial,Other Race,1,0,1
4082086,No home medical services,racial,White,1,0,1
440005,Complication of medical care,racial,Asian,0,1,1
4196206,beta^+^ Thalassemia,racial,Asian,1,0,1
435207,"Nodular lymphoma of lymph nodes of head, face and neck",racial,White,0,1,1
381559,Sensory disorder of eyelid,racial,Unknown,1,0,1
434697,Maternal tobacco abuse,ethnic,Not Hispanic or Latino,1,0,1
80249,Sprain of acromioclavicular ligament,ethnic,Not Hispanic or Latino,0,1,1
4103737,"Better eye: low vision, Lesser eye: profound visual impairment",ethnic,Not Hispanic or Latino,0,1,1
141022,Orbital tenonitis,ethnic,Hispanic or Latino,1,0,1
380421,Tympanic membrane marginal perforation,ethnic,Not Hispanic or Latino,1,0,1
4146239,Pruritus of genital organs,racial,Filipino,0,1,1
376412,Acute follicular conjunctivitis,racial,Unknown,1,0,1
439002,Eating disorder,racial,Native Hawaiian or Other Pacific Islander ,0,1,1
73904,Open wound of buttock without complication,racial,Black or African American ,1,0,1
433751,Prolonged depressive adjustment reaction,racial,Black or African American ,1,0,1
4293175,"Mental state, behaviour and/or psychosocial function finding",racial,American Indian or Alaska Native ,0,1,1
135858,Disorder of lip,racial,American Indian or Alaska Native ,0,1,1
138825,Actinic keratosis,racial,American Indian,1,0,1
433452,"Cannabis dependence, continuous",ethnic,Hispanic or Latino,0,1,1
316478,"Heart disease in mother complicating pregnancy, childbirth AND/OR puerperium",racial,White,1,0,1
196654,Lipoma of intra-abdominal organs,ethnic,Not Hispanic or Latino,1,0,1
140318,"Septicemia due to streptococcus, group A",ethnic,Not Hispanic or Latino,1,0,1
4152047,Lipid screening,racial,Native Hawaiian or Other Pacific Islander ,1,0,1
439968,Late effect of tendon injury,racial,Asian,0,1,1
376416,Chronic dacryoadenitis,racial,Unknown,0,1,1
439025,Dacryocystitis,racial,Other Race,1,0,1
440642,CSD - Cat scratch disease,racial,White,0,1,1
137900,Acute sphenoidal sinusitis,ethnic,Hispanic or Latino,0,1,1
4252735,Mourning,racial,Other Race,1,0,1
139757,Malignant melanoma of skin of lower limb,ethnic,Not Hispanic or Latino,1,0,1
438792,Crowding of teeth,racial,Unknown,1,0,1
433919,Heroin poisoning,ethnic,Hispanic or Latino,0,1,1
4317960,Neonatal respiratory failure,racial,White,1,0,1
133725,Carcinoma in situ of skin of lip,ethnic,Hispanic or Latino,1,0,1
139912,Spondylosis with myelopathy,ethnic,Hispanic or Latino,0,1,1
253797,Post-inflammatory pulmonary fibrosis,racial,Asian Indian,0,1,1
376111,Unqualified visual loss of one eye,racial,Asian,1,0,1
4065992,Cellulitis and abscess of finger unspecified,racial,Unknown,0,1,1
4121123,Haemophagocytic lymphohistiocytosis,racial,White,1,0,1
77357,Intrapelvic protrusion of acetabulum,ethnic,Hispanic or Latino,1,0,1
4299535,Pregnancy confirmed,racial,American Indian or Alaska Native ,1,0,1
139753,Primary malignant neoplasm of parathyroid gland,ethnic,Hispanic or Latino,0,1,1
373101,Injury of ulnar nerve,racial,Other Race,0,1,1
435649,Complication of hemodialysis,ethnic,Hispanic or Latino,0,1,1
81723,Contusion of hand,racial,American Indian or Alaska Native ,1,0,1
377559,Vernal conjunctivitis,racial,Other Race,1,0,1
81943,Rupture of flexor tendons of hand AND/OR wrist,ethnic,Not Hispanic or Latino,0,1,1
317895,Hypertension due to renovascular disease,ethnic,Not Hispanic or Latino,1,0,1
443387,Cancer of stomach,ethnic,Hispanic or Latino,0,1,1
381014,Conjunctival pigmentation,ethnic,Hispanic or Latino,0,1,1
135360,Fainting,racial,Asian Indian,0,1,1
80811,Rupture of extensor tendons of hand AND/OR wrist,racial,White,0,1,1
194087,Hepatitis due to infection,racial,White,0,1,1
321887,Disorder of artery,racial,Black or African American ,1,0,1
435155,Injury of unknown intent by firearms and explosives,ethnic,Hispanic or Latino,0,1,1
4088930,Confirmation of pregnancy,racial,Filipino,1,0,1
132253,Mixed pediculosis,racial,Unknown,1,0,1
313504,Osler hemorrhagic telangiectasia syndrome,racial,White,1,0,1
138225,Disease of sebaceous glands,racial,Filipino,0,1,1
435802,Blepharospasm,racial,Unknown,0,1,1
4128540,Partial excision of pituitary gland by transsphenoidal approach,racial,White,1,0,1
137441,"Insect bite, nonvenomous, of foot and toe, infected",racial,Other Race,1,0,1
258955,Whooping cough due to organism other than Bordetella pertussis,racial,Unknown,1,0,1
318397,Chronic idiopathic thrombocytopenic purpura,ethnic,Not Hispanic or Latino,0,1,1
433243,Anomaly of tooth position,racial,Unknown,1,0,1
4006436,Other congenital musculoskeletal anomalies,racial,White,0,1,1
435795,Fugue,racial,Unknown,1,0,1
438480,"Abnormal glucose tolerance in mother complicating pregnancy, childbirth AND/OR puerperium",racial,Filipino,1,0,1
376807,Congenital macular changes,racial,White,1,0,1
4021168,Natural contraception,racial,Other Race,1,0,1
380669,Benign neoplasm of eyelid including canthus,racial,Asian,0,1,1
138973,Chancroid,racial,Asian,1,0,1
134596,Lymphoid leukemia in remission,ethnic,Hispanic or Latino,1,0,1
197095,Embryonic cyst of fallopian tube and broad ligament,ethnic,Hispanic or Latino,1,0,1
442031,Accidentally struck by or against stationary object,ethnic,Hispanic or Latino,0,1,1
443274,Psychostimulant dependence,racial,Unknown,0,1,1
200579,Superficial injury of hip without infection,racial,Asian,0,1,1
436926,Primary malignant neoplasm of cerebral meninges,ethnic,Hispanic or Latino,0,1,1
4307254,Closed fracture,racial,Black or African American ,0,1,1
195873,Leukorrhagia,racial,American Indian or Alaska Native ,1,0,1
442558,"Gestation period, 32 weeks",racial,Other Race,0,1,1
76201,Non-traumatic rupture of biceps brachii tendon,ethnic,Not Hispanic or Latino,1,0,1
196943,Red blood cell sequestration in spleen,ethnic,Not Hispanic or Latino,0,1,1
4147837,Generalized metabolic disorder,ethnic,Not Hispanic or Latino,0,1,1
73282,"Breast engorgement in pregnancy, the puerperium or lactation with antenatal complication",racial,White,1,0,1
77698,Sprain of coracoclavicular ligament,ethnic,Hispanic or Latino,1,0,1
4211231,Panic disorder without agoraphobia,racial,Black or African American ,0,1,1
437240,Carcinoma in situ of skin of upper limb and shoulder,ethnic,Not Hispanic or Latino,1,0,1
373463,Benign cough headache,racial,White,1,0,1
4065363,Dyschromia NOS,ethnic,Hispanic or Latino,1,0,1
433758,Childhood emotional disorder,ethnic,Not Hispanic or Latino,0,1,1
40479849,Sexual abuse of adult,ethnic,Not Hispanic or Latino,1,0,1
438040,"Adverse reaction to analgesics, antipyretics and antirheumatics",ethnic,Not Hispanic or Latino,0,1,1
252658,Intrinsic asthma without status asthmaticus,racial,American Indian or Alaska Native ,0,1,1
443674,Traumatic amputation of toe(s) with complication,ethnic,Not Hispanic or Latino,1,0,1
444247,Venous thrombosis,racial,Other Race,1,0,1
4124299,Incision and evacuation of thrombosed hemorrhoid,ethnic,Hispanic or Latino,1,0,1
197823,Lipoma of spermatic cord,racial,White,0,1,1
4048191,Enlargement of tonsil or adenoid,racial,Alaska Native,0,1,1
434527,Poisoning by primarily systemic agent,racial,White,1,0,1
4088777,Vagina observation,racial,Filipino,1,0,1
438338,Epidemic meningitis,ethnic,Hispanic or Latino,0,1,1
434254,Heat stroke and sunstroke,racial,White,0,1,1
4175226,Screening for malignant neoplasm of colon,racial,European,0,1,1
380378,Epilepsy,racial,Native Hawaiian or Other Pacific Islander ,1,0,1
442325,Furuncle of foot,racial,Black or African American ,0,1,1
254677,Adenoviral pneumonia,racial,Unknown,1,0,1
139766,Carcinoma in situ of scalp and skin of neck,ethnic,Not Hispanic or Latino,1,0,1
4107655,Observations relating to psychosocial functioning,racial,American Indian or Alaska Native ,1,0,1
376712,Purulent otitis media,racial,Unknown,1,0,1
381285,Peroneal muscular atrophy,racial,Black or African American ,0,1,1
80205,Perinatal condition,racial,Unknown,0,1,1
138896,Open wound of forehead without complication,racial,Asian,0,1,1
4148407,Family history: Cardiovascular disease,racial,Native Hawaiian or Other Pacific Islander ,0,1,1
133737,Acute thyroiditis,racial,Asian,1,0,1
4264281,Open fracture,ethnic,Not Hispanic or Latino,0,1,1
201117,Nonallopathic lesion of pelvic region,racial,Unknown,1,0,1
4177243,Cancer of pharynx,racial,White,0,1,1
438760,Chronic dacryocystitis,racial,Unknown,1,0,1
138973,Chancroid,ethnic,Not Hispanic or Latino,1,0,1
434183,"Closed fracture distal humerus, medial epicondyle",racial,White,1,0,1
436941,Hypervitaminosis A,racial,Unknown,0,1,1
256531,Head and neck swelling,racial,Filipino,1,0,1
79898,Cellulitis and abscess of finger,racial,Native Hawaiian or Other Pacific Islander ,1,0,1
436403,Retinal vasculitis,ethnic,Hispanic or Latino,1,0,1
132412,Failed back syndrome,ethnic,Not Hispanic or Latino,0,1,1
436541,Closed fracture of ulna,racial,Black or African American ,1,0,1
437744,Heat exhaustion,racial,Unknown,1,0,1
261393,Congenital polycystic lung,ethnic,Not Hispanic or Latino,0,1,1
373182,Amyotrophic lateral sclerosis,ethnic,Hispanic or Latino,0,1,1
4012570,High risk sexual behavior,racial,Native Hawaiian or Other Pacific Islander ,1,0,1
443081,Drowning and non-fatal immersion,racial,Other Race,0,1,1
4059178,Gastrojejunal ulcer,ethnic,Not Hispanic or Latino,1,0,1
40484952,Retinal function study abnormal,ethnic,Not Hispanic or Latino,1,0,1
198678,Intestinal infectious disease,racial,Native Hawaiian or Other Pacific Islander ,1,0,1
443012,Diabetes mellitus during pregnancy - baby delivered,racial,White,1,0,1
137944,Bullous dermatosis,racial,Asian,1,0,1
23245,Hemorrhage of esophagus,racial,White,0,1,1
134898,Non-toxic single thyroid nodule,racial,Native Hawaiian or Other Pacific Islander ,1,0,1
255848,Pneumonia,racial,Native Hawaiian or Other Pacific Islander ,1,0,1
436098,Nondependent cocaine abuse in remission,racial,Unknown,1,0,1
381551,Drug-related polyneuropathy,ethnic,Not Hispanic or Latino,1,0,1
4166776,Dupuytren contracture,racial,Other Race,0,1,1
436833,Open fracture of metacarpal bone,racial,Black or African American ,0,1,1
78504,"Arthropathy associated with mycoses, of the hand",racial,White,1,0,1
439968,Late effect of tendon injury,ethnic,Not Hispanic or Latino,0,1,1
72996,"Stiff joint NEC, of the lower leg",racial,Unknown,1,0,1
256716,Asthma with status asthmaticus,racial,Filipino,1,0,1
196654,Lipoma of intra-abdominal organs,racial,Asian,1,0,1
439941,Closed fracture of condyle of humerus,racial,White,0,1,1
435661,Closed orbital blow-out fracture,ethnic,Not Hispanic or Latino,1,0,1
314409,Vascular disorder of penis,ethnic,Hispanic or Latino,0,1,1
261904,Class III buccal segment relationship,ethnic,Not Hispanic or Latino,1,0,1
434821,SIRS - System inflammatory response syndrome,racial,Black or African American ,1,0,1
436097,"Nondependent mixed drug abuse, continuous",racial,Unknown,1,0,1
312939,Thromboangiitis obliterans,ethnic,Hispanic or Latino,1,0,1
319038,Postmyocardial infarction syndrome,ethnic,Not Hispanic or Latino,0,1,1
78518,Observation of shoulder joint,racial,Black or African American ,1,0,1
437116,Closed fracture of distal end of radius,racial,Black or African American ,0,1,1
435028,Puerperal pyrexia of unknown origin,ethnic,Hispanic or Latino,1,0,1
435410,Burn of palm,ethnic,Not Hispanic or Latino,1,0,1
442189,Blister of wrist without infection,racial,Unknown,1,0,1
320073,Neutrophil count below reference range,racial,American Indian or Alaska Native ,1,0,1
4085075,At risk state,racial,Unknown,1,0,1
4179235,Family history of malignant neoplasm of lung,ethnic,Hispanic or Latino,1,0,1
374360,Disorder of optic nerve,racial,Other Race,0,1,1
195771,Secondary diabetes mellitus,racial,Native Hawaiian or Other Pacific Islander ,0,1,1
4179214,Family history of malignant neoplasm of gastrointestinal tract,racial,Asian Indian,0,1,1
40479849,Sexual abuse of adult,racial,Asian,1,0,1
196442,Chronic gastric ulcer with hemorrhage AND with perforation but without obstruction,racial,White,1,0,1
136775,Contact dermatitis due to solar radiation,racial,Asian,1,0,1
74768,Closed fracture of triquetral bone of wrist,ethnic,Hispanic or Latino,1,0,1
74513,Open wound of foot without mention of complication,racial,Other Race,0,1,1
133283,Pyoderma gangrenosum,racial,White,1,0,1
201613,Chronic nonalcoholic liver disease,racial,Filipino,1,0,1
24609,Hypoglycaemia,racial,Filipino,1,0,1
437537,Shyness disorder of childhood,racial,White,0,1,1
4064381,Nephropathy screening,racial,Black or African American ,1,0,1
314090,PET - Mild pre-eclamptic toxaemia,racial,Unknown,1,0,1
444212,Injury of descending left colon without open wound into abdominal cavity,racial,White,0,1,1
4108517,Eustachian tube obstruction NOS,ethnic,Not Hispanic or Latino,0,1,1
439228,Adverse reaction to sulphonamides,racial,White,0,1,1
434891,Hypersomnia disorder related to a known organic factor,racial,Unknown,1,0,1
442023,Poisoning of undetermined intent,ethnic,Not Hispanic or Latino,1,0,1
193306,Situs inversus,racial,Unknown,1,0,1
320136,Disease of respiratory system,racial,Filipino,1,0,1
194408,Hydroureter,ethnic,Hispanic or Latino,1,0,1
432864,Acute schizophrenic episode,racial,Asian,1,0,1
4211527,Operation on globus pallidus,ethnic,Hispanic or Latino,1,0,1
200579,Superficial injury of hip without infection,ethnic,Not Hispanic or Latino,0,1,1
438329,Late effect of motor vehicle accident,racial,Asian,0,1,1
435840,Acute epiglottitis without obstruction,ethnic,Hispanic or Latino,0,1,1
197751,Burn of lower limb,ethnic,Hispanic or Latino,1,0,1
192364,Nephrotic syndrome associated with another disorder,racial,Asian,0,1,1
196158,Disease of penis,racial,Filipino,0,1,1
440692,"Cocaine dependence, episodic",ethnic,Hispanic or Latino,1,0,1
4145010,Knee enthesopathy NOS,ethnic,Hispanic or Latino,0,1,1
4101199,Hearing problem,racial,Asian,0,1,1
444361,Nonvenomous insect bite of toe without infection,ethnic,Not Hispanic or Latino,0,1,1
4097586,Myeloid leukaemia NOS,ethnic,Hispanic or Latino,0,1,1
377788,General paresis,ethnic,Hispanic or Latino,1,0,1
196654,Lipoma of intra-abdominal organs,racial,White,1,0,1
4141622,Asthma NOS,racial,Asian,1,0,1
441482,Administrative reason for encounter,racial,Native Hawaiian or Other Pacific Islander ,1,0,1
194475,Singultus,racial,Other Race,0,1,1
442530,Broken tooth injury with complication,racial,Unknown,1,0,1
4061587,Obstetric pulmonary embolism NOS,racial,White,0,1,1
24970,Chronic laryngitis,racial,Black or African American ,1,0,1
440387,Cannabis dependence,ethnic,Not Hispanic or Latino,0,1,1
4110501,Bilateral total vocal cord paralysis,racial,Unknown,0,1,1
434824,Injury of cranial nerve,ethnic,Hispanic or Latino,1,0,1
28083,Primary malignant neoplasm of pharynx,racial,Unknown,1,0,1
441077,Stenosis of cervix,racial,Black or African American ,1,0,1
441181,Effects of high altitude,ethnic,Not Hispanic or Latino,1,0,1
377888,CHL - Conductive hearing loss,racial,Black or African American ,0,1,1
318521,Displacement of thoracic intervertebral disc without myelopathy,ethnic,Not Hispanic or Latino,0,1,1
377555,Solar retinitis,ethnic,Hispanic or Latino,1,0,1
260125,Acute bronchiolitis,racial,Native Hawaiian or Other Pacific Islander ,0,1,1
4110945,Benign hypertensive heart disease NOS,racial,Unknown,1,0,1
441739,Burn erythema of axilla,racial,Unknown,1,0,1
199886,Simple endometrial hyperplasia,racial,Unknown,1,0,1
4089994,Serological relapse after treatment of latent early syphilis,ethnic,Not Hispanic or Latino,0,1,1
256716,Asthma with status asthmaticus,racial,Other Race,1,0,1
438542,Gestation less than 24 weeks,ethnic,Not Hispanic or Latino,0,1,1
439987,"Accident caused by hot liquid and vapor, including steam",racial,White,0,1,1
444038,Psychoactive substance-induced organic mood disorder,ethnic,Not Hispanic or Latino,1,0,1
30968,Diabetes insipidus,racial,Native Hawaiian or Other Pacific Islander ,1,0,1
441385,Corrected transposition of great vessels,ethnic,Not Hispanic or Latino,1,0,1
378420,Carcinomatous neuropathy,ethnic,Hispanic or Latino,1,0,1
432741,Abnormal immunology finding,racial,Filipino,1,0,1
4164707,Canceled operative procedure,racial,Asian,0,1,1
374384,Cerebral ischemia,racial,Unknown,0,1,1
380421,Tympanic membrane marginal perforation,racial,Asian,1,0,1
442864,"Splinter of elbow, without major open wound, infected",ethnic,Not Hispanic or Latino,1,0,1
139888,Threatened premature labor - not delivered,racial,Asian,1,0,1
373756,Exudative retinopathy,ethnic,Hispanic or Latino,1,0,1
4273630,Patch repair of arteriovenous fistula,racial,Other Race,0,1,1
444375,"Contact dermatitis due to plants, except food",racial,Asian,0,1,1
192698,Hypertonic uterine dysfunction,ethnic,Hispanic or Latino,0,1,1
377869,Conjunctival deposit,racial,White,0,1,1
4136219,Open reduction of dislocation of knee,ethnic,Hispanic or Latino,1,0,1
136237,Cardiovascular system problem,racial,Asian,1,0,1
4103752,Limited eye examination,ethnic,Hispanic or Latino,1,0,1
433678,Infection of central venous catheter,racial,White,1,0,1
436489,Complication of obstetrical surgery AND/OR procedure,ethnic,Not Hispanic or Latino,1,0,1
440556,Closed transcervical fracture of femur,racial,White,0,1,1
254676,Lung involvement associated with another disorder,ethnic,Not Hispanic or Latino,1,0,1
78605,Superficial bruising of elbow,racial,Black or African American ,0,1,1
4062686,Diabetes mellitus in the pueperium - baby delivered during previous episode of care,ethnic,Not Hispanic or Latino,0,1,1
24909,Hereditary spherocytosis,racial,White,1,0,1
432601,Childhood and adolescent disturbance with elective mutism,ethnic,Hispanic or Latino,0,1,1
75337,Cellulitis and abscess of buttock,racial,American Indian or Alaska Native ,1,0,1
79069,Disease of rectum,racial,Black or African American ,0,1,1
138845,Rheumatism,ethnic,Not Hispanic or Latino,1,0,1
140961,Infestation by Phthirus pubis,ethnic,Hispanic or Latino,0,1,1
433507,Loss of teeth due to local periodontal disease,racial,Unknown,0,1,1
78769,Acute petrositis,ethnic,Not Hispanic or Latino,1,0,1
433505,Subclavian steal syndrome,racial,White,0,1,1
444388,Blister of leg without infection,racial,Other Race,0,1,1
437833,Hypokalaemia,racial,Native Hawaiian or Other Pacific Islander ,1,0,1
81403,Osteopetrosis,racial,Other Race,1,0,1
74396,TMJ - Temporomandibular joint disorder,racial,American Indian or Alaska Native ,1,0,1
135766,Leukaemia in remission,racial,Asian,0,1,1
192433,Congenital hypertrophic pyloric stenosis,racial,Unknown,1,0,1
201093,Infection of skin AND/OR subcutaneous tissue,racial,American Indian or Alaska Native ,1,0,1
433032,Pyrexia postprocedure,racial,Other Race,0,1,1
432541,Primary tuberculosis,ethnic,Hispanic or Latino,0,1,1
4060011,Burn: 20-29% of body surface NOS,racial,Unknown,0,1,1
136661,Nodular goiter,racial,Asian,0,1,1
4052931,Abandoned child,ethnic,Not Hispanic or Latino,1,0,1
40481367,Chronic left-sided ulcerative colitis,racial,White,0,1,1
258482,Abscess of Bartholin's gland,racial,Other Race,1,0,1
440865,Closed fracture of epiphysis of femur,racial,White,0,1,1
76548,Closed dislocation of hip,racial,Native Hawaiian or Other Pacific Islander ,0,1,1
373489,Congenital nystagmus,racial,Black or African American ,1,0,1
4001802,"Other muscle, ligament and fascia disorder",racial,Unknown,0,1,1
81539,Mitochondrial disease,racial,Black or African American ,0,1,1
4171115,Low birth weight infant,racial,Unknown,1,0,1
4066163,Ureteric colic,racial,Asian,0,1,1
432864,Acute schizophrenic episode,ethnic,Not Hispanic or Latino,1,0,1
440371,Disorder of immune function,racial,Unknown,1,0,1
75605,Intrauterine death affecting management of mother,racial,Unknown,1,0,1
372309,Mononeuritis,racial,Filipino,0,1,1
4064924,Ear disorder screening,racial,Unknown,1,0,1
79914,Polydactyly of toes,racial,Other Race,0,1,1
434311,Disorder of the urea cycle metabolism,racial,Unknown,1,0,1
31057,Disorder of pharynx,racial,Native Hawaiian or Other Pacific Islander ,1,0,1
4095592,Malignant melanoma of scalp and/or neck,ethnic,Hispanic or Latino,1,0,1
441026,Orbital deformity due to trauma,racial,Unknown,1,0,1
192364,Nephrotic syndrome associated with another disorder,ethnic,Not Hispanic or Latino,0,1,1
436209,Fracture of fibula,racial,Other Race,1,0,1
200459,Endometrial cystic hyperplasia,racial,White,1,0,1
138708,Acute leukemia,racial,Native Hawaiian or Other Pacific Islander ,0,1,1
376415,Hypermetropia,racial,Other Race,1,0,1
381783,Viral disease of central nervous system,ethnic,Hispanic or Latino,0,1,1
79115,"Spondylopathy, NOS",racial,Other Race,1,0,1
374040,Ill-defined disorder of eye,racial,Other Race,1,0,1
434012,Developmental dyslexia,racial,Unknown,0,1,1
194092,Uterine prolapse without vaginal wall prolapse,racial,American Indian or Alaska Native ,1,0,1
4070523,Massive epicranial subaponeurotic haemorrhage due to birth trauma,ethnic,Hispanic or Latino,0,1,1
4003982,Other specified skin anomalies,racial,Unknown,1,0,1
133284,Impetigo herpetiformis,ethnic,Not Hispanic or Latino,1,0,1
196284,Burn of mouth and pharynx,ethnic,Hispanic or Latino,1,0,1
201635,Female infertility of uterine origin,racial,Unknown,1,0,1
436588,Traumatic wound dehiscence,racial,Unknown,1,0,1
442018,Foreign body accidentally left during a procedure,ethnic,Hispanic or Latino,0,1,1
138176,Acute gingivitis,racial,American Indian or Alaska Native ,1,0,1
434301,Benign neoplasm of ribs and/or sternum and/or clavicle,racial,White,1,0,1
73534,Disproportion between fetus and pelvis,ethnic,Hispanic or Latino,1,0,1
318450,Cardiac tamponade,ethnic,Hispanic or Latino,0,1,1
377558,Irregular astigmatism,racial,White,1,0,1
441126,Monosomy and deletion from autosome,racial,Unknown,1,0,1
138965,Myelitis,ethnic,Hispanic or Latino,0,1,1
432585,Blood coagulation disorder,racial,Asian,0,1,1
435574,Abnormal form of root of tooth,ethnic,Not Hispanic or Latino,0,1,1
375806,Idiopathic peripheral neuropathy,racial,American Indian,1,0,1
4063026,Herpes gestationis NOS,racial,White,1,0,1
257423,"Late effect of burns of eye, face, head AND/OR neck",ethnic,Hispanic or Latino,0,1,1
261327,Empyema of pleura without fistula,racial,Unknown,1,0,1
4103722,Cataract NOS,ethnic,Not Hispanic or Latino,1,0,1
318448,"Incomplete atrioventricular block, second degree",racial,Black or African American ,0,1,1
438261,Neonatal jaundice due to delayed conjugation associated with another disease,racial,Asian,0,1,1
135618,Prurigo,racial,Native Hawaiian or Other Pacific Islander ,0,1,1
381275,Anterior horn cell disease,racial,White,1,0,1
318382,Malignant mast cell tumor of extranodal AND/OR solid organ site,ethnic,Hispanic or Latino,0,1,1
81358,Transverse OR oblique presentation of fetus,ethnic,Hispanic or Latino,1,0,1
433596,Abnormal sputum,racial,Asian,1,0,1
375530,Migraine with prolonged aura,racial,Unknown,1,0,1
73819,Painful breasts,racial,American Indian,1,0,1
4196250,Hyperbaric chamber therapy,ethnic,Hispanic or Latino,1,0,1
437505,Nodular lymphoma of lymph nodes of axilla and upper limb,ethnic,Hispanic or Latino,1,0,1
441741,"Motor vehicle accident, passenger",ethnic,Not Hispanic or Latino,1,0,1
444297,Vertiginous syndrome,racial,Filipino,1,0,1
192735,Malignant ascites,racial,Asian,1,0,1
375527,Headache disorder,racial,Black or African American ,0,1,1
434111,Oligohydramnios,racial,White,1,0,1
4147650,"Muscular calcification and ossification, unspecified",ethnic,Not Hispanic or Latino,0,1,1
140966,Benign neoplasm of skin of face,racial,Asian,1,0,1
40484952,Retinal function study abnormal,racial,Asian,1,0,1
75667,Sprain of calcaneofibular ligament,racial,Unknown,0,1,1
374915,Localisation-related epilepsy,racial,Unknown,0,1,1
4191387,Infertility care,racial,White,0,1,1
381677,SBO - Spina bifida occulta,racial,Other Race,0,1,1
138312,Burn of scalp,ethnic,Hispanic or Latino,1,0,1
137322,Oral submucosal fibrosis,ethnic,Hispanic or Latino,1,0,1
439894,Post-term pregnancy - delivered,ethnic,Hispanic or Latino,1,0,1
75954,Sprain of interphalangeal joint of finger,racial,Unknown,0,1,1
432637,Scleritis with corneal involvement,ethnic,Hispanic or Latino,1,0,1
435610,Varicose veins of perineum and vulva in pregnancy and the puerperium - delivered,racial,Black or African American ,1,0,1
75103,Sprain of jaw,racial,Other Race,1,0,1
437986,FTT - Failure to thrive,racial,Native Hawaiian or Other Pacific Islander ,0,1,1
197601,Spermatocele,racial,Unknown,0,1,1
376422,Mucopurulent conjunctivitis,racial,Filipino,0,1,1
436357,Primary malignant neoplasm of soft tissues of upper limb,ethnic,Hispanic or Latino,0,1,1
436972,Glaucoma associated with systemic syndromes,racial,Alaska Native,0,1,1
432878,Drug abuse using speed,racial,Black or African American ,0,1,1
137497,Dermatophytosis of the body,racial,Native Hawaiian or Other Pacific Islander ,0,1,1
76725,Fissure in ano,racial,American Indian or Alaska Native ,1,0,1
199925,Perinatal intestinal perforation,racial,White,0,1,1
436785,Spinal stenosis in cervical region,racial,Black or African American ,1,0,1
200444,Post-cholecystectomy syndrome,ethnic,Not Hispanic or Latino,1,0,1
444382,Thoracic radiculitis,racial,Filipino,1,0,1
79911,Effusion of joint of upper arm,ethnic,Not Hispanic or Latino,0,1,1
443604,Factitious disorder with predominantly psychological signs and symptoms,racial,Unknown,1,0,1
4120666,Conjunctival biopsy,ethnic,Hispanic or Latino,1,0,1
75863,Chronic interstitial cystitis,racial,Black or African American ,1,0,1
79106,Arthralgia of the pelvic region and thigh,racial,Asian Indian,1,0,1
77734,Contusion of lower leg,racial,Other Race,1,0,1
374040,Ill-defined disorder of eye,racial,Filipino,0,1,1
198809,Acute cholecystitis,racial,Asian,1,0,1
436826,Closed fracture of shaft of radius,racial,Black or African American ,0,1,1
4343127,Evans operation,ethnic,Hispanic or Latino,0,1,1
442075,Chronic glomerulonephritis associated with another disorder,racial,White,0,1,1
441979,Open fracture of upper end of tibia,racial,Native Hawaiian or Other Pacific Islander ,0,1,1
4066244,Caesarean wound disruption unspecified,ethnic,Hispanic or Latino,1,0,1
4137583,Interruption of vena cava,ethnic,Hispanic or Latino,1,0,1
198189,Suppurative peritonitis,racial,White,0,1,1
73318,Polydactyly of fingers,racial,Other Race,0,1,1
76565,Shoulder bruise,ethnic,Not Hispanic or Latino,0,1,1
78228,Joint derangement,racial,Asian,0,1,1
439002,Eating disorder,racial,Black or African American ,1,0,1
443801,Exercise-induced asthma,racial,Asian Indian,1,0,1
4089998,Other venereal diseases,racial,White,1,0,1
132703,Lichen planus,racial,Asian,1,0,1
261889,Simple chronic bronchitis,racial,American Indian or Alaska Native ,1,0,1
76819,Congenital unilateral subluxation of hip,ethnic,Not Hispanic or Latino,0,1,1
252663,Pneumonitis due to inhalation of food or vomitus,racial,Alaska Native,1,0,1
4343820,Diagnostic arthroscopy of hip joint,ethnic,Hispanic or Latino,1,0,1
444052,"Bone AND/OR joint disorder of back in mother complicating pregnancy, childbirth AND/OR puerperium",racial,White,1,0,1
258866,Respiratory distress syndrome in the newborn,racial,White,0,1,1
321638,"Benign essential hypertension complicating pregnancy, childbirth and the puerperium",ethnic,Not Hispanic or Latino,1,0,1
442926,"Motor vehicle traffic accident involving collision with another motor vehicle, parked, driver of motor vehicle injured",racial,Other Race,0,1,1
77815,"Benign neoplasm of vertebral column, excluding sacrum and coccyx",racial,White,1,0,1
4296205,Second degree burn,racial,Other Race,1,0,1
4104558,Unspecified blepharitis,ethnic,Not Hispanic or Latino,0,1,1
73851,Effusion of joint of multiple sites,racial,White,1,0,1
433516,Duodenitis,racial,White,0,1,1
200171,Carbuncle of skin AND/OR subcutaneous tissue,racial,Asian,0,1,1
381304,Impulsive acoustic trauma,racial,Asian,1,0,1
434323,Disorder of sulphur-bearing amino acid metabolism,racial,Unknown,1,0,1
257010,Abscess of lung,racial,Black or African American ,1,0,1
4173657,Congenital malformation of the respiratory system,racial,White,1,0,1
80951,Candidiasis of urogenital site,racial,Native Hawaiian or Other Pacific Islander ,0,1,1
253815,Ulceration of vulva,racial,American Indian or Alaska Native ,1,0,1
435271,Mooren ulcer,ethnic,Hispanic or Latino,0,1,1
81695,Sprain of radiocarpal ligament,ethnic,Not Hispanic or Latino,1,0,1
439700,Inhibited sexual desire,racial,American Indian or Alaska Native ,0,1,1
75121,Burn of lower leg,racial,Unknown,1,0,1
4110501,Bilateral total vocal cord paralysis,ethnic,Hispanic or Latino,0,1,1
4073865,Construction of penis,ethnic,Hispanic or Latino,0,1,1
201792,Nongonococcal urethritis,racial,Unknown,0,1,1
440994,Psychic factor associated with another disorder,racial,White,1,0,1
260936,Infiltrative tuberculosis of lung,racial,White,0,1,1
373201,Acute eustachian tube salpingitis,racial,Black or African American ,1,0,1
201595,Thrombosed internal hemorrhoids,racial,Unknown,1,0,1
79911,Effusion of joint of upper arm,racial,Asian,0,1,1
380731,OE - Otitis externa,racial,Other Race,0,1,1
437127,Closed dislocation of acromioclavicular joint,racial,Other Race,0,1,1
140273,"Contusion, forearm area",racial,Asian,1,0,1
73575,Deformity of toe,racial,Other Race,1,0,1
432795,Traumatic AND/OR non-traumatic injury,racial,Native Hawaiian or Other Pacific Islander ,1,0,1
437169,Disorder of transplanted bone marrow,ethnic,Hispanic or Latino,0,1,1
4098582,Hyperemesis gravidarum before end of 22 week gestation with carbohydrate depletion,ethnic,Hispanic or Latino,1,0,1
132704,Lichen nitidus,racial,White,0,1,1
435726,Mechanical complication of device,racial,Asian,1,0,1
4054550,Open wound of scrotum and testes,ethnic,Hispanic or Latino,0,1,1
73925,Burn of upper limb,ethnic,Not Hispanic or Latino,0,1,1
197227,Overlapping malignant neoplasm of gastrointestinal tract,ethnic,Hispanic or Latino,0,1,1
441918,"Emotional AND/OR mental disease in mother complicating pregnancy, childbirth AND/OR puerperium",racial,American Indian or Alaska Native ,1,0,1
30284,Motion sickness,racial,Other Race,1,0,1
199978,Contusion of lower limb,racial,American Indian or Alaska Native ,1,0,1
4261613,Educational problem,racial,American Indian or Alaska Native ,1,0,1
138519,Spondylosis without myelopathy,racial,American Indian or Alaska Native ,1,0,1
4303359,Acute septal infarction,racial,White,1,0,1
4112365,Woakes' ethmoiditis,ethnic,Hispanic or Latino,0,1,1
381304,Impulsive acoustic trauma,ethnic,Not Hispanic or Latino,1,0,1
433125,Infection due to Staphylocccus aureus,racial,Filipino,0,1,1
137666,Congenital ear lobe absence,ethnic,Hispanic or Latino,0,1,1
372913,Impairment level: one eye: near-total impairment: other eye: not specified,ethnic,Not Hispanic or Latino,1,0,1
195223,Renal carnitine transport defect,ethnic,Not Hispanic or Latino,0,1,1
373724,Neoplasm of brain,racial,Black or African American ,1,0,1
4118958,Unilateral total thyroid lobectomy,ethnic,Not Hispanic or Latino,1,0,1
439053,Exostosis of jaw,ethnic,Not Hispanic or Latino,1,0,1
440751,Peritonsillar abscess,racial,Other Race,0,1,1
440988,Antisocial personality disorder,ethnic,Hispanic or Latino,0,1,1
140489,Acquired acanthosis nigricans,racial,Native Hawaiian or Other Pacific Islander ,1,0,1
73866,Congenital anomaly of breast,racial,Native Hawaiian or Other Pacific Islander ,1,0,1
440758,Posteruptive color change of tooth,racial,Unknown,1,0,1
439233,Poisoning by antidiabetic agent,racial,White,0,1,1
4158567,Post percutaneous transluminal coronary angioplasty,racial,American Indian,1,0,1
438912,Chemical burn of eyelid AND/OR periocular area,ethnic,Not Hispanic or Latino,0,1,1
374649,Strabismic amblyopia,racial,Other Race,0,1,1
442068,Cellulitis and abscess of forearm,racial,Native Hawaiian or Other Pacific Islander ,0,1,1
140018,Tuberculous abscess of spinal cord,ethnic,Hispanic or Latino,0,1,1
4104401,Unspecified corneal oedema,ethnic,Hispanic or Latino,1,0,1
4171556,Ankle ulcer,racial,Other Race,0,1,1
441266,Thiamin deficiency,ethnic,Not Hispanic or Latino,1,0,1
375393,Laceration of skin of eyelid AND periocular area,racial,Black or African American ,0,1,1
438737,Acute paranoid reaction,racial,White,0,1,1
432507,Suicide - hanging,ethnic,Not Hispanic or Latino,0,1,1
196462,Unilateral recurrent femoral hernia without obstruction AND without gangrene,racial,Unknown,1,0,1
375817,Conjunctivochalasis,ethnic,Hispanic or Latino,1,0,1
433701,Mycosis,racial,American Indian or Alaska Native ,1,0,1
193239,Diverticulitis of small intestine,racial,Black or African American ,0,1,1
436246,Low libido,racial,Black or African American ,1,0,1
26378,Hyperpituitarism,racial,Other Race,0,1,1
433486,Acute orbital inflammation,racial,Unknown,1,0,1
258079,Histoplasmosis with pneumonia,racial,White,1,0,1
443397,Malignant tumour of small bowel,ethnic,Hispanic or Latino,0,1,1
138239,Observation of limb structure,racial,American Indian or Alaska Native ,1,0,1
436289,Non-medicinal agent causing toxic effects,ethnic,Not Hispanic or Latino,1,0,1
40484010,Unilateral conductive hearing loss,racial,White,1,0,1
198797,Umbilical hernia with gangrene,ethnic,Hispanic or Latino,1,0,1
194871,Trichomonal vulvovaginitis,racial,American Indian or Alaska Native ,1,0,1
440603,Blood transfusion reaction,racial,White,1,0,1
134404,Anal spasm,ethnic,Not Hispanic or Latino,1,0,1
381569,Myogenic ptosis,racial,White,0,1,1
254561,Pneumonic plague,ethnic,Hispanic or Latino,1,0,1
198700,Liver secondary cancer,racial,White,1,0,1
259874,Ulceration of vulva associated with another disorder,racial,White,1,0,1
196735,Acute pyelonephritis without medullary necrosis,racial,Other Race,1,0,1
195793,Neoplasm of uncertain behavior of uterus,racial,Unknown,1,0,1
433260,Mother delivered,racial,Unknown,1,0,1
198892,Internal injury of abdominal organs without open wound into cavity,racial,Unknown,0,1,1
77070,Allergic arthritis of the hand,ethnic,Not Hispanic or Latino,0,1,1
314664,Long Q-T syndrome,racial,Other Race,1,0,1
4109544,"Total, mature senile cataract",ethnic,Not Hispanic or Latino,1,0,1
432611,Explosive personality disorder,racial,Asian,0,1,1
4078366,Repair of syndactyly,ethnic,Hispanic or Latino,0,1,1
436078,Malnutrition of moderate degree (Gomez: 60% to less than 75% of standard weight),racial,Black or African American ,1,0,1
441321,Chronic nasopharyngitis,racial,Asian,1,0,1
4111255,Unspecified labyrinthitis,racial,Black or African American ,0,1,1
434572,"Pinta, intermediate lesion",racial,White,1,0,1
4112831,Extrinsic asthma NOS,racial,Native Hawaiian or Other Pacific Islander ,0,1,1
379010,Macular retinal puckering,racial,Other Race,1,0,1
80591,Superficial injury of hand without infection,ethnic,Hispanic or Latino,0,1,1
4052804,FH: Allergy,ethnic,Not Hispanic or Latino,0,1,1
373870,Neonatal dacryocystitis and conjunctivitis,racial,Black or African American ,1,0,1
433978,Benign tumour of laryngopharynx,ethnic,Hispanic or Latino,0,1,1
4111411,Aortic valve disorders NOS,ethnic,Not Hispanic or Latino,0,1,1
73373,Burn erythema of upper limb,racial,Asian,1,0,1
4169658,No help available,racial,Unknown,0,1,1
438837,Boutonniere deformity,ethnic,Hispanic or Latino,1,0,1
313543,Venous complication in pregnancy AND/OR the puerperium,racial,White,1,0,1
194861,Syphilis of liver,ethnic,Not Hispanic or Latino,0,1,1
260630,"Tuberculosis of lung, bacteriological and histological examination not done",ethnic,Hispanic or Latino,0,1,1
259153,Throat soreness,racial,Asian Indian,0,1,1
434155,"Intraventricular (nontraumatic) haemorrhage, grade 3, of foetus and newborn",ethnic,Hispanic or Latino,0,1,1
80541,Closed fracture of eight OR more ribs,racial,White,1,0,1
4028827,Manual examination of breast,racial,White,1,0,1
133150,Malignant neoplasm of skin of lower limb and hip,racial,White,1,0,1
442864,"Splinter of elbow, without major open wound, infected",ethnic,Hispanic or Latino,0,1,1
434673,Soft tissue impingement on teeth,ethnic,Not Hispanic or Latino,0,1,1
444125,Satisfactory for evaluation but limited by absence of an endocervical/transformation zone component from a patient with a cervix,racial,American Indian or Alaska Native ,1,0,1
4102739,Screening for cardiovascular system disease,racial,Other Race,0,1,1
320299,Complication of transplanted heart,racial,Native Hawaiian or Other Pacific Islander ,0,1,1
4133967,Meckel's diverticulum,ethnic,Hispanic or Latino,0,1,1
73043,Open traumatic dislocation of shoulder,racial,White,0,1,1
435170,Effects of thirst,racial,Unknown,1,0,1
139900,Urticaria,racial,Asian Indian,0,1,1
195213,Aldosteronism,racial,White,0,1,1
76508,Infectious myositis,ethnic,Hispanic or Latino,1,0,1
436485,Hyperemesis gravidarum with metabolic disturbance,racial,Unknown,1,0,1
79903,Effusion of joint,racial,Black or African American ,1,0,1
438171,Rupture of chordae tendineae,ethnic,Hispanic or Latino,1,0,1
193242,Perforation of intestine,racial,Black or African American ,0,1,1
196625,Viral hepatitis A without hepatic coma,racial,Asian,0,1,1
192735,Malignant ascites,ethnic,Not Hispanic or Latino,1,0,1
441015,Pigmentary iris degeneration,ethnic,Not Hispanic or Latino,1,0,1
438542,Gestation less than 24 weeks,ethnic,Hispanic or Latino,1,0,1
80242,Current tear of medial cartilage AND/OR meniscus of knee,racial,Asian,0,1,1
196044,Primary malignant neoplasm of stomach,racial,Asian,1,0,1
25189,Malignant tumour of mouth,racial,White,0,1,1
4089994,Serological relapse after treatment of latent early syphilis,ethnic,Hispanic or Latino,0,1,1
436298,Adverse reaction to food,racial,Native Hawaiian or Other Pacific Islander ,0,1,1
377277,Impairment level: total impairment of both eyes,racial,Black or African American ,0,1,1
438261,Neonatal jaundice due to delayed conjugation associated with another disease,ethnic,Not Hispanic or Latino,0,1,1
373200,Chronic fungal otitis externa,racial,Other Race,1,0,1
4064360,Leprosy screening,ethnic,Hispanic or Latino,0,1,1
440129,Hypertrophy of nasal turbinates,racial,Native Hawaiian or Other Pacific Islander ,0,1,1
378163,Sounds seem unnaturally loud,racial,Unknown,0,1,1
435574,Abnormal form of root of tooth,racial,Asian,0,1,1
136264,Open wound of floor of mouth without complication,racial,Black or African American ,0,1,1
40479583,Iatrogenic pneumothorax,racial,White,0,1,1
138826,Acne varioliformis,racial,Unknown,1,0,1
135975,Blister of finger without infection,racial,Asian,1,0,1
4064061,Other skin and subcutaneous tissue disorders,racial,Unknown,0,1,1
378768,Acute sanguinous otitis media,ethnic,Hispanic or Latino,1,0,1
4283229,Excision of lesion of spleen,ethnic,Hispanic or Latino,0,1,1
194393,CACS - Coeliac axis compression syndrome,ethnic,Hispanic or Latino,1,0,1
436445,Abrasion of teeth,racial,Filipino,0,1,1
435305,Duodenal ulcer without hemorrhage AND without perforation but with obstruction,ethnic,Hispanic or Latino,1,0,1
197751,Burn of lower limb,ethnic,Not Hispanic or Latino,0,1,1
442941,"Nontraffic accident involving being trapped by door of motor vehicle whilst boarding or alighting from motor vehicle, except off-road vehicle, not on highway, driver of motor vehicle injured",racial,Unknown,0,1,1
75052,Enthesopathy of wrist AND/OR carpus,racial,Asian,1,0,1
136575,Nonvenomous insect bite with infection,racial,Asian,1,0,1
437015,Congenital alveolar hyperplasia of mandible,racial,Unknown,1,0,1
441480,Poisoning by androgen AND/OR anabolic congener,ethnic,Hispanic or Latino,0,1,1
138841,Disorder of sacrum,racial,Asian,1,0,1
193238,Acute appendicitis with peritoneal abscess,racial,White,0,1,1
4111998,Esophageal varices associated with another disorder,racial,White,0,1,1
4216906,Suture of laceration of external ear,ethnic,Hispanic or Latino,0,1,1
378429,Rosacea conjunctivitis,ethnic,Hispanic or Latino,0,1,1
4085922,Infection screening,racial,Black or African American ,0,1,1
441628,Menopausal and postmenopausal disorders,racial,Other Race,1,0,1
440647,Sexually transmitted infectious disease,racial,American Indian or Alaska Native ,1,0,1
194856,Viral hepatitis A with hepatic coma,racial,White,0,1,1
438737,Acute paranoid reaction,racial,Unknown,1,0,1
443522,Neonatal bradycardia,ethnic,Hispanic or Latino,0,1,1
442110,Benign neoplasm of nasal sinus,racial,Unknown,1,0,1
140487,Dermatitis herpetiformis,racial,Unknown,0,1,1
194807,Injury of inferior vena cava,racial,White,0,1,1
372324,Eustachian tube disorder,racial,Filipino,1,0,1
433486,Acute orbital inflammation,racial,White,0,1,1
194152,Renal agenesis and dysgenesis,racial,Other Race,1,0,1
435511,Hypercalcemia,racial,Native Hawaiian or Other Pacific Islander ,1,0,1
132659,Acute apical periodontitis,racial,Asian Indian,0,1,1
254662,Pulmonary infarction,racial,Other Race,1,0,1
141104,Intervertebral disc disorder of lumbar region with myelopathy,racial,Native Hawaiian or Other Pacific Islander ,1,0,1
314369,Malignant hypertensive heart disease without congestive heart failure,racial,Other Race,0,1,1
253815,Ulceration of vulva,racial,Other Race,1,0,1
381504,Post-herpetic trigeminal neuralgia,racial,Asian,1,0,1
440577,Late effect of radiation,racial,Unknown,1,0,1
433985,Hypercarotinemia,racial,Native Hawaiian or Other Pacific Islander ,1,0,1
433000,Patellar tendonitis,racial,Asian,1,0,1
377889,Hearing loss,racial,Asian Indian,1,0,1
4214763,Repair of brain,racial,Other Race,0,1,1
4308543,Postoperative infection NOS,ethnic,Hispanic or Latino,1,0,1
138965,Myelitis,ethnic,Not Hispanic or Latino,1,0,1
381580,Conjunctival degeneration,ethnic,Hispanic or Latino,0,1,1
75050,Coxa valga - acquired,ethnic,Not Hispanic or Latino,0,1,1
193523,Broad ligament laceration syndrome,ethnic,Not Hispanic or Latino,1,0,1
77644,Adhesive capsulitis of shoulder,racial,Asian Indian,1,0,1
440758,Posteruptive color change of tooth,racial,White,1,0,1
197926,Female genital tract-skin fistula,ethnic,Hispanic or Latino,1,0,1
439120,Aseptic necrosis of head AND/OR neck of femur,racial,Asian,1,0,1
442573,Nonpurulent mastitis associated with childbirth,ethnic,Hispanic or Latino,1,0,1
373216,Disorder of mastoid,racial,Unknown,0,1,1
192963,Disease of pancreas,racial,Other Race,0,1,1
72996,"Stiff joint NEC, of the lower leg",racial,White,0,1,1
380728,Filamentary keratitis,racial,White,1,0,1
4109544,"Total, mature senile cataract",racial,Asian,1,0,1
260430,Pneumonia due to E. coli,racial,White,0,1,1
312358,CGN - Chronic glomerulonephritis,racial,Black or African American ,0,1,1
133278,Disorder of hair,racial,American Indian or Alaska Native ,1,0,1
435805,Cerebrospinal rhinorrhoea,ethnic,Not Hispanic or Latino,1,0,1
432262,Primary malignant neoplasm of trachea,ethnic,Hispanic or Latino,1,0,1
378081,Overlapping malignant neoplasm of connective and other soft tissues,racial,Unknown,0,1,1
196284,Burn of mouth and pharynx,ethnic,Not Hispanic or Latino,1,0,1
192815,Intestinal infection due to E. coli,ethnic,Not Hispanic or Latino,0,1,1
256450,Pulmonary asbestosis,racial,White,0,1,1
432537,Assault by handgun,racial,White,0,1,1
373472,Pigmentary retinal dystrophy,racial,Other Race,1,0,1
444256,Polyp of labia,racial,White,1,0,1
437249,Recurrent manic episodes,ethnic,Not Hispanic or Latino,1,0,1
373982,Benign tumour of conjunctiva,racial,White,0,1,1
192357,Paralytic ileus,racial,American Indian or Alaska Native ,1,0,1
4012320,Autotransplantation of thyroid tissue,racial,Other Race,1,0,1
375824,Abnormal auditory perception,racial,Asian,0,1,1
439093,Traumatic lesion during delivery,ethnic,Hispanic or Latino,1,0,1
315831,Chronic pulmonary heart disease,racial,Black or African American ,1,0,1
435141,Haemorrhage AND/OR haematoma complicating procedure,racial,Other Race,1,0,1
4154309,Severe recurrent major depression with psychotic features,racial,Other Race,1,0,1
133803,Periapical abscess with sinus tract,racial,Unknown,1,0,1
372247,Candidal otomycosis,racial,Asian Indian,1,0,1
137351,Epidermoid cyst of skin,racial,American Indian or Alaska Native ,1,0,1
379021,Impairment level: one eye: moderate impairment: other eye: near-normal vision,racial,White,0,1,1
4104391,"Better eye: moderate visual impairment, Lesser eye: moderate visual impairment",racial,White,1,0,1
197440,Nonvenomous insect bite of trunk without infection,racial,Black or African American ,1,0,1
201792,Nongonococcal urethritis,racial,White,1,0,1
440516,Congenital ureterovesical obstruction,ethnic,Hispanic or Latino,0,1,1
432814,Device withdrawn and / or removed,ethnic,Hispanic or Latino,0,1,1
81247,Carcinoma in situ of urinary system,racial,White,1,0,1
138102,Benign tumour of skin,racial,Filipino,1,0,1
81696,Closed fracture of acetabulum,racial,White,1,0,1
4147961,Screening for malignant neoplasm of breast,racial,Asian Indian,1,0,1
436238,Elevated levels of transaminase and lactic acid dehydrogenase,racial,Asian Indian,0,1,1
4151727,Back disorders - other,ethnic,Hispanic or Latino,0,1,1
4104386,"Better eye: profound visual impairment, Lesser eye: profound visual impairment",ethnic,Hispanic or Latino,0,1,1
372309,Mononeuritis,racial,American Indian or Alaska Native ,1,0,1
375292,Perforation of tympanic membrane,racial,American Indian,0,1,1
137111,"Closed fracture scapula, coracoid",racial,White,0,1,1
4097704,Other specified leukaemia,racial,White,1,0,1
443539,Motor vehicle injury,racial,Other Race,0,1,1
316994,Malignant hypertensive heart disease with congestive cardiac failure,racial,Black or African American ,0,1,1
440637,Relapsing fever,ethnic,Not Hispanic or Latino,0,1,1
443752,Ventricular hemorrhage,ethnic,Not Hispanic or Latino,1,0,1
193666,Hip injury,racial,Other Race,1,0,1
438761,Acute dacryocystitis,racial,White,1,0,1
135157,Observation of cardiovascular device,racial,Unknown,0,1,1
440977,Megaloblastic anemia due to folate deficiency,racial,Asian,0,1,1
4064925,Hypertension screening,racial,Native Hawaiian or Other Pacific Islander ,0,1,1
4097567,Nodular lymphoma of unspecified site,ethnic,Hispanic or Latino,1,0,1
376989,Duane's syndrome,racial,White,1,0,1
312723,Congenital heart disease,racial,American Indian or Alaska Native ,1,0,1
4062921,Asymptomatic bacteriuria in pregnancy unspecified,ethnic,Not Hispanic or Latino,1,0,1
201093,Infection of skin AND/OR subcutaneous tissue,racial,Filipino,1,0,1
4210149,Substance abuse counseling,racial,American Indian,0,1,1
4008517,"Fracture of rib(s), sternum, larynx and trachea",racial,White,0,1,1
435243,Alcohol dependence,racial,Asian,0,1,1
373449,Drug-induced delirium,racial,Unknown,1,0,1
440927,High risk drug monitoring status,racial,Other Race,0,1,1
4147630,Other disorders of binocular eye movements,racial,White,1,0,1
4064908,Trypanosomiasis screening,racial,Unknown,1,0,1
4008566,Atypical schizophrenia,racial,Unknown,1,0,1
441259,Non-thrombocytopenic purpura,racial,Asian,1,0,1
442425,Lumbar post-laminectomy syndrome,racial,Black or African American ,0,1,1
443545,Nonvenomous insect bite,racial,American Indian,0,1,1
72995,Joint contracture of hand,racial,Native Hawaiian or Other Pacific Islander ,0,1,1
201820,Diabetes mellitus,racial,Black or African American ,0,1,1
4094448,Pregnancy test negative,racial,Filipino,1,0,1
4058984,Small kidneys unspecified,ethnic,Hispanic or Latino,1,0,1
437186,Hypothermia - accidental,ethnic,Not Hispanic or Latino,1,0,1
434156,Congenital anemia,racial,Black or African American ,1,0,1
444421,Congenital malformation of liver,racial,White,1,0,1
141371,PR - Pityriasis rosea,racial,Asian,1,0,1
378419,AD - Alzheimer's disease,racial,Alaska Native,1,0,1
22426,Congenital macrostomia,racial,White,0,1,1
435726,Mechanical complication of device,ethnic,Not Hispanic or Latino,1,0,1
141673,Aseptic necrosis of head of humerus,racial,Asian,1,0,1
4104558,Unspecified blepharitis,ethnic,Hispanic or Latino,1,0,1
140633,Vaccinia,ethnic,Hispanic or Latino,1,0,1
4051241,FH: Asthma,racial,White,0,1,1
4238737,Offending behavior,ethnic,Hispanic or Latino,0,1,1
436134,Disorder of sclera,racial,Unknown,1,0,1
437464,"Injury undetermined whether accidentally or purposely inflicted, fall from residential premises",ethnic,Not Hispanic or Latino,0,1,1
195581,Peritoneal adhesion,ethnic,Hispanic or Latino,1,0,1
74722,Secondary localized osteoarthrosis of pelvic region,ethnic,Hispanic or Latino,0,1,1
28457,Hypertrophy of tonsils,racial,American Indian,1,0,1
432919,Discoid lupus erythematosus eyelid,racial,White,1,0,1
141248,Benign neoplasm of skin of lip,ethnic,Not Hispanic or Latino,1,0,1
374040,Ill-defined disorder of eye,racial,American Indian or Alaska Native ,1,0,1
435368,Congenital pigeon chest,racial,Other Race,0,1,1
261116,Acquired nasal deformity,racial,Other Race,0,1,1
4179963,Family history of malignant neoplasm of breast,racial,Asian,1,0,1
373692,West Nile encephalitis,ethnic,Hispanic or Latino,1,0,1
78593,Open wound of wrist without complication,racial,Filipino,0,1,1
432729,Crying infant,racial,American Indian or Alaska Native ,0,1,1
316084,Lymphadenitis,racial,American Indian or Alaska Native ,1,0,1
4053387,Family history of polycystic kidney,ethnic,Hispanic or Latino,1,0,1
316457,Mallory-Weiss syndrome,racial,White,0,1,1
380513,Congenital cataract,racial,Black or African American ,1,0,1
440105,Aqueous humour misdirect,racial,White,1,0,1
258441,Cholesteatoma of attic,ethnic,Hispanic or Latino,1,0,1
373179,Senile degeneration of brain,racial,White,0,1,1
4113683,Spontaneous abortion unspecified,racial,Unknown,1,0,1
137520,Chronic thyroiditis,racial,Unknown,1,0,1
253954,PTB - Pulmonary tuberculosis,racial,Black or African American ,0,1,1
433659,Delayed healing of surgical wound,ethnic,Not Hispanic or Latino,1,0,1
193597,Visible peristalsis,ethnic,Hispanic or Latino,0,1,1
141094,Lichen,racial,Asian,1,0,1
4148115,Ectopic beats unspecified,ethnic,Hispanic or Latino,0,1,1
137652,Specific bursitis often of occupational origin,racial,Unknown,0,1,1
137721,Abrasion AND/OR friction burn of finger with infection,ethnic,Hispanic or Latino,1,0,1
313324,Cheyne-Stokes respiration,racial,White,1,0,1
443774,"Disease condition determination, uncontrolled",racial,Other Race,1,0,1
373747,Extrapyramidal disease,racial,Asian,1,0,1
81902,Urinary tract infectious disease,racial,Asian Indian,1,0,1
4015842,Viral hepatitis carrier,racial,Unknown,1,0,1
443235,Ankle and/or foot joint stiffness,racial,Unknown,0,1,1
434203,Late effect of contusion,racial,Other Race,1,0,1
4307254,Closed fracture,racial,Other Race,0,1,1
195867,Noninflammatory vaginal disorders,racial,Other Race,1,0,1
320116,Acute pericarditis,racial,Unknown,0,1,1
437384,Raised laboratory findings,ethnic,Not Hispanic or Latino,1,0,1
31339,Dental restoration esthetically inadequate or displeasing,ethnic,Hispanic or Latino,1,0,1
4088072,Pulmonary tuberculosis NOS,ethnic,Hispanic or Latino,1,0,1
374044,Droopy eyelid,racial,Native Hawaiian or Other Pacific Islander ,0,1,1
4220063,"Repair of knee, five-in-one",racial,Unknown,1,0,1
432816,Tuberculosis of limb bones,ethnic,Hispanic or Latino,0,1,1
4173811,Congenital quadriplegia,racial,Native Hawaiian or Other Pacific Islander ,1,0,1
375530,Migraine with prolonged aura,racial,White,1,0,1
435795,Fugue,ethnic,Hispanic or Latino,1,0,1
4194895,Screening for disorder,racial,Native Hawaiian or Other Pacific Islander ,0,1,1
4087763,Gonococcal infection of other specified sites,racial,White,0,1,1
435810,After-cataract,racial,Black or African American ,1,0,1
441398,Anomaly of sex chromosome,racial,Black or African American ,0,1,1
137057,Paronychia,racial,Filipino,0,1,1
133351,Open wound of cheek without complication,racial,Unknown,1,0,1
380510,Congenital abnormality of eyelid,racial,Black or African American ,0,1,1
438912,Chemical burn of eyelid AND/OR periocular area,ethnic,Hispanic or Latino,1,0,1
196364,Benign tumour of cervix,racial,Unknown,1,0,1
4060011,Burn: 20-29% of body surface NOS,ethnic,Hispanic or Latino,0,1,1
439382,Disorder of hypothalamus,racial,Unknown,1,0,1
4143490,Blindness or low vision NOS,racial,Unknown,0,1,1
381007,Impairment level: better eye: profound impairment: lesser eye: not further specified,racial,White,0,1,1
312653,Acute myocarditis,racial,White,0,1,1
442262,Blister of toe without infection,racial,Black or African American ,0,1,1
79916,Acquired hallux rigidus,racial,Unknown,0,1,1
317576,Coronary arteriosclerosis,racial,Alaska Native,1,0,1
133414,Candidiasis of skin and nails,racial,Native Hawaiian or Other Pacific Islander ,1,0,1
4237906,Poisoning by caffeine,ethnic,Hispanic or Latino,0,1,1
372913,Impairment level: one eye: near-total impairment: other eye: not specified,ethnic,Hispanic or Latino,0,1,1
433393,Fall into hole,ethnic,Not Hispanic or Latino,1,0,1
76521,"Fetus OR newborn affected by malpresentation, malposition AND/OR disproportion during labor AND/OR delivery",ethnic,Hispanic or Latino,0,1,1
200174,Disease of skin AND/OR subcutaneous tissue,racial,American Indian,0,1,1
444401,Delusions,ethnic,Not Hispanic or Latino,1,0,1
194704,Spontaneous abortion complicated by embolism,ethnic,Hispanic or Latino,1,0,1
193402,Bacterial enteritis,racial,Asian,1,0,1
74726,Dislocated joint,racial,White,1,0,1
137666,Congenital ear lobe absence,ethnic,Not Hispanic or Latino,1,0,1
4153745,Late effect of musculoskeletal and connective tissue injury NOS,racial,White,0,1,1
200962,Primary malignant neoplasm of prostate,racial,Native Hawaiian or Other Pacific Islander ,0,1,1
377552,Moderate nonproliferative diabetic retinopathy,ethnic,Not Hispanic or Latino,0,1,1
373487,AION - Acute ischaemic optic neuropathy,ethnic,Not Hispanic or Latino,1,0,1
443887,Superficial foreign body of ankle without major open wound AND without infection,racial,Other Race,1,0,1
438064,Bacterial infection due to Pseudomonas,racial,White,0,1,1
433316,Giddiness,racial,Alaska Native,1,0,1
4166443,Family history: Arthritis,ethnic,Not Hispanic or Latino,1,0,1
4104864,Migraine NOS,racial,Black or African American ,0,1,1
437369,Postmature infancy,ethnic,Not Hispanic or Latino,0,1,1
4102739,Screening for cardiovascular system disease,racial,American Indian or Alaska Native ,0,1,1
442216,Kernicterus not due to isoimmunization,ethnic,Hispanic or Latino,1,0,1
4081759,Transplant follow-up,ethnic,Hispanic or Latino,1,0,1
77882,Vestibular active Meniere's disease,ethnic,Hispanic or Latino,1,0,1
73673,Disorder of prosthetic joint,ethnic,Not Hispanic or Latino,0,1,1
438541,Fetus OR newborn affected by abnormality of chorion,ethnic,Hispanic or Latino,0,1,1
434926,Iridocyclitis,racial,Black or African American ,1,0,1
4286638,Childhood,ethnic,Not Hispanic or Latino,0,1,1
444234,Late effect of complications of trauma,racial,Unknown,1,0,1
438872,Hyperphagia,racial,Unknown,1,0,1
4086927,Contraception status,racial,Asian,1,0,1
438865,Complete trisomy 18 syndrome,racial,White,0,1,1
73075,Contusion of upper limb,racial,Black or African American ,0,1,1
196735,Acute pyelonephritis without medullary necrosis,racial,American Indian or Alaska Native ,1,0,1
433527,Endometriosis,racial,Asian,1,0,1
434002,Mineral deficiency,ethnic,Hispanic or Latino,1,0,1
133566,Necrotizing fasciitis,racial,White,1,0,1
258780,Chronic obstructive bronchitis,racial,Native Hawaiian or Other Pacific Islander ,1,0,1
375275,Hypertropia,racial,White,1,0,1
439162,"Closed fracture ankle, medial malleolus",racial,Unknown,1,0,1
80494,Arthropathy associated with another disorder,racial,Unknown,0,1,1
4204904,Education about sexually transmitted disease prevention,racial,Asian,1,0,1
434339,Adolescent - emotional problem,racial,Other Race,0,1,1
313500,Acute rheumatic heart disease,racial,White,0,1,1
4183058,Fitting of hearing aid,ethnic,Hispanic or Latino,1,0,1
4104431,Alcohol intoxication,ethnic,Hispanic or Latino,0,1,1
252947,Acute pulmonary edema due to fumes AND/OR vapors,racial,White,1,0,1
433405,Proteus infection,ethnic,Hispanic or Latino,1,0,1
73845,Ankylosis of joint of shoulder region,racial,Unknown,1,0,1
81659,Traumatic arthropathy of the pelvic region and thigh,ethnic,Not Hispanic or Latino,0,1,1
435979,Late effect of open wound of extremities without tendon injury,ethnic,Hispanic or Latino,0,1,1
439318,Complete illegal abortion with metabolic disorder,racial,White,0,1,1
440448,Appendicitis,ethnic,Hispanic or Latino,0,1,1
433376,Burning due to contact with hot solid objects and materials,racial,Unknown,1,0,1
201621,Chronic cystitis,racial,Other Race,1,0,1
77076,Diastasis of muscle,racial,Unknown,0,1,1
133569,Fasciitis,racial,Black or African American ,0,1,1
4100912,Screening for rheumatoid conditions,racial,Native Hawaiian or Other Pacific Islander ,1,0,1
196488,Atonic postpartum hemorrhage,racial,White,1,0,1
139737,Pediculosis corporis,racial,Unknown,1,0,1
376394,Menstrual migraine,ethnic,Not Hispanic or Latino,1,0,1
4263370,R.I.N.D. syndrome,racial,Native Hawaiian or Other Pacific Islander ,0,1,1
77635,Disease of hand,racial,Native Hawaiian or Other Pacific Islander ,1,0,1
193641,Lumbar nerve root injury,ethnic,Not Hispanic or Latino,0,1,1
141056,Acute ethmoidal sinusitis,racial,American Indian or Alaska Native ,1,0,1
437993,Closed fracture of cervical spine,racial,White,0,1,1
374923,Bell palsy,racial,American Indian or Alaska Native ,1,0,1
440417,Pulmonary embolism,racial,White,0,1,1
436445,Abrasion of teeth,racial,American Indian or Alaska Native ,1,0,1
76202,Non-traumatic rupture of Achilles tendon,ethnic,Not Hispanic or Latino,1,0,1
198695,"Malignant neoplasm, overlapping lesion of biliary tract",ethnic,Hispanic or Latino,1,0,1
140062,Iodine hypothyroidism,ethnic,Not Hispanic or Latino,0,1,1
373198,Unqualified visual loss of both eyes,racial,Other Race,0,1,1
436253,Sprain of foot,racial,American Indian or Alaska Native ,0,1,1
441716,Open wound of axillary region with complication,ethnic,Hispanic or Latino,0,1,1
437754,Toxic effect of metal,ethnic,Hispanic or Latino,0,1,1
74507,Sprain of radiohumeral joint,ethnic,Hispanic or Latino,1,0,1
440369,Histrionic personality disorder,ethnic,Hispanic or Latino,1,0,1
80815,Mucous cyst of skin,racial,Asian,1,0,1
4162218,Vaginal enterocele,racial,White,1,0,1
436666,Psychosexual disorder,racial,Unknown,0,1,1
443414,Chronic post-traumatic stress disorder,racial,Filipino,0,1,1
438941,Poisoning by hydantoin derivative,racial,Unknown,1,0,1
444239,Postprocedural state finding,racial,Native Hawaiian or Other Pacific Islander ,1,0,1
440158,"Venereal disease in mother complicating pregnancy, childbirth AND/OR puerperium",ethnic,Not Hispanic or Latino,1,0,1
381504,Post-herpetic trigeminal neuralgia,ethnic,Not Hispanic or Latino,1,0,1
4223530,Spondylitis,ethnic,Not Hispanic or Latino,1,0,1
192859,Postablative ovarian failure,ethnic,Not Hispanic or Latino,1,0,1
134870,Pityriasis versicolor,racial,American Indian,1,0,1
4201717,Ileostomy present,racial,Unknown,0,1,1
78909,"Contusion, shoulder and upper arm, multiple sites",racial,Unknown,1,0,1
4183977,Oligohydramnios without rupture of membranes,racial,White,1,0,1
77636,Primary localized osteoarthrosis of upper arm,ethnic,Hispanic or Latino,1,0,1
134116,Dermatitis due to drug AND/OR medicine taken internally,racial,Other Race,1,0,1
437791,Chickenpox with complication,racial,White,0,1,1
132835,Pediculosis capitis,racial,American Indian or Alaska Native ,1,0,1
435651,Atypical squamous cells on cervical Papanicolaou smear cannot exclude high grade squamous intraepithelial lesion,racial,Asian,1,0,1
434688,Tight hymenal ring,racial,White,1,0,1
372909,Impairment level: better eye: severe impairment: lesser eye: not further specified,ethnic,Hispanic or Latino,1,0,1
435444,Poisoning due to venomous marine animals or plants,ethnic,Hispanic or Latino,1,0,1
256717,Bronchospasm,racial,Filipino,1,0,1
4109395,Other visual pathway disorder,ethnic,Hispanic or Latino,1,0,1
382003,Burn of face AND/OR head,racial,White,1,0,1
440940,Methicillin resistant Staphylococcus aureus infection,racial,Other Race,0,1,1
443081,Drowning and non-fatal immersion,racial,White,1,0,1
4112658,Chest infection - pneumonia organism OS,racial,White,1,0,1
77647,Mallet finger,racial,Asian,0,1,1
381384,Congenital absence of external ear,racial,Unknown,0,1,1
134569,Erythema infectiosum,ethnic,Not Hispanic or Latino,1,0,1
439242,Adverse reaction to tetanus vaccine,racial,Unknown,0,1,1
443709,Atypical squamous cells of undetermined significance on anal Papanicolaou smear,ethnic,Hispanic or Latino,0,1,1
434003,GSD - Glycogen storage disease,racial,White,1,0,1
443367,Antihypertensive adverse reaction,racial,Unknown,1,0,1
200433,Dissecting aneurysm of renal artery,racial,White,0,1,1
437461,Disorder of prosthetic cardiac valve,racial,White,1,0,1
376680,Generalized nonconvulsive epilepsy,racial,Black or African American ,1,0,1
134243,Second degree burn of knee,racial,White,1,0,1
141159,Open wound of buccal mucosa without complication,racial,White,1,0,1
132412,Failed back syndrome,racial,Black or African American ,0,1,1
316376,Eosinophilia,racial,Alaska Native,1,0,1
4178964,Malignant tumour of roof of mouth,racial,White,0,1,1
441918,"Emotional AND/OR mental disease in mother complicating pregnancy, childbirth AND/OR puerperium",racial,Other Race,1,0,1
436541,Closed fracture of ulna,ethnic,Not Hispanic or Latino,0,1,1
443604,Factitious disorder with predominantly psychological signs and symptoms,racial,White,1,0,1
4269584,Finding relating to religious movement or belief,racial,Asian,1,0,1
136917,Primary malignant neoplasm of skin of face,ethnic,Not Hispanic or Latino,1,0,1
261393,Congenital polycystic lung,racial,Black or African American ,0,1,1
76196,Palindromic rheumatism,racial,Unknown,0,1,1
195301,Acute dilatation of stomach,racial,Unknown,0,1,1
193541,Perineal laceration involving anal sphincter,ethnic,Hispanic or Latino,1,0,1
432969,Multiple pregnancy,racial,Unknown,1,0,1
4063429,Other specified erythematous conditions,ethnic,Hispanic or Latino,1,0,1
443539,Motor vehicle injury,racial,Unknown,1,0,1
374748,Perinatal anoxic-ischemic brain injury,ethnic,Hispanic or Latino,0,1,1
40489926,Removal of dental prosthesis,ethnic,Hispanic or Latino,0,1,1
76784,Bleeding into joint,racial,White,0,1,1
4111411,Aortic valve disorders NOS,ethnic,Hispanic or Latino,0,1,1
372888,Sciatic nerve lesion,racial,Black or African American ,0,1,1
4156802,"Blister of finger, infected",racial,White,0,1,1
4111113,Other external ear disorder NOS,racial,White,1,0,1
437643,Gait abnormality,racial,American Indian,1,0,1
312733,"Abnormal foetal heart beat, not clear if noted before OR after onset of labour in liveborn infant",racial,White,1,0,1
374955,Spasm of conjugate gaze,racial,White,0,1,1
192359,RF - Renal failure,racial,Native Hawaiian or Other Pacific Islander ,0,1,1
442031,Accidentally struck by or against stationary object,racial,Unknown,0,1,1
432600,Stress reaction causing mixed disturbance of emotion and conduct,ethnic,Not Hispanic or Latino,1,0,1
443406,Eosinophilic gastroenteritis,ethnic,Hispanic or Latino,1,0,1
441764,Inhalation or ingestion of foreign body with respiratory obstruction or suffocation,racial,Black or African American ,0,1,1
444435,Superficial injury of elbow without infection,racial,Unknown,1,0,1
372610,Post-concussion syndrome,racial,Other Race,1,0,1
440409,Disorder of orbit proper,ethnic,Hispanic or Latino,1,0,1
24230,Laryngeal FB - foreign body,racial,Unknown,0,1,1
196792,Acquired claw foot,racial,White,0,1,1
435011,Vulvar vestibulitis,racial,Other Race,1,0,1
197006,Residual hemorrhoidal skin tags,racial,Unknown,1,0,1
201240,Metastasis to female genital organ,ethnic,Not Hispanic or Latino,1,0,1
443715,Atypical squamous cells on anal Papanicolaou smear cannot exclude high grade squamous intraepithelial lesion,ethnic,Hispanic or Latino,1,0,1
73090,Superficial bruising of foot,racial,American Indian or Alaska Native ,1,0,1
440518,5p partial monosomy syndrome,racial,White,0,1,1
434766,Open supracondylar fracture of humerus,ethnic,Hispanic or Latino,1,0,1
140641,Verruca vulgaris,racial,Native Hawaiian or Other Pacific Islander ,0,1,1
4103471,Observation of body mass index,racial,European,0,1,1
372435,Periventricular leukomalacia,racial,White,0,1,1
436826,Closed fracture of shaft of radius,racial,Asian,0,1,1
193353,Abrasion AND/OR friction burn of trunk with infection,ethnic,Hispanic or Latino,1,0,1
4273622,Operation on bone injury of carpals and metacarpals,racial,Native Hawaiian or Other Pacific Islander ,0,1,1
374342,Headache associated with sexual activity,racial,White,1,0,1
440922,Diabetic on insulin,racial,Black or African American ,0,1,1
439134,Acrocephalosyndactyly,racial,Unknown,0,1,1
195769,Submucous uterine leiomyoma,racial,American Indian or Alaska Native ,1,0,1
4296024,Family disruption due to divorce,ethnic,Not Hispanic or Latino,1,0,1
75044,"Stiff joint NEC, of the hand",racial,Asian,0,1,1
4021807,Interpersonal relationship observations,racial,White,0,1,1
133794,Chronic gingivitis,racial,Filipino,0,1,1
195464,Epidemic pleurodynia,racial,Unknown,0,1,1
201257,Disorder of endocrine ovary,ethnic,Not Hispanic or Latino,1,0,1
442943,Abrasion or friction burn of shoulder and upper arm without mention of infection,ethnic,Not Hispanic or Latino,0,1,1
442540,Liver moderate laceration without mention of open wound into cavity,racial,White,0,1,1
4064926,Ischemic heart disease screening,racial,White,1,0,1
381568,Pseudomembranous conjunctivitis,ethnic,Hispanic or Latino,0,1,1
135895,Variation in hair color,ethnic,Hispanic or Latino,0,1,1
377865,Acquired color vision deficiency,racial,White,0,1,1
317100,Fetal tachycardia,racial,White,1,0,1
4305303,Sleep deprivation,racial,Other Race,1,0,1
4215909,Artificial pacemaker rate check,racial,Unknown,1,0,1
433516,Duodenitis,racial,Other Race,1,0,1
134596,Lymphoid leukemia in remission,racial,Unknown,1,0,1
443459,Pathological fracture of neck of femur,ethnic,Hispanic or Latino,1,0,1
4243973,Laparoscopic appendectomy,racial,Other Race,1,0,1
4054908,Closed injury of kidney,racial,White,1,0,1
4108982,Cataract associated with other syndromes,ethnic,Not Hispanic or Latino,0,1,1
4105880,Contact of sexually transmissible disorder,racial,American Indian,1,0,1
442926,"Motor vehicle traffic accident involving collision with another motor vehicle, parked, driver of motor vehicle injured",racial,White,0,1,1
4275756,Dependent drug abuse,ethnic,Hispanic or Latino,1,0,1
435503,Hemolytic anemia,racial,White,1,0,1
437872,Rupture in Descemet membrane,racial,White,1,0,1
254980,Intrinsic asthma with asthma attack,racial,Black or African American ,1,0,1
441447,Open wound of external genital organs without complication,racial,White,1,0,1
198062,"Infectious colitis, enteritis and gastroenteritis",racial,Black or African American ,1,0,1
27674,N&V - Nausea and vomiting,racial,Filipino,1,0,1
443367,Antihypertensive adverse reaction,racial,Other Race,1,0,1
434819,Benzodiazepine poisoning,ethnic,Not Hispanic or Latino,1,0,1
440237,Open fracture of upper end of lower leg,racial,White,1,0,1
29735,Candidiasis of mouth,racial,American Indian or Alaska Native ,0,1,1
76801,Polyostotic fibrous dysplasia of bone,racial,White,0,1,1
439406,Allergy to animal,racial,Other Race,0,1,1
257004,Acute exacerbation of chronic obstructive airways disease,racial,American Indian,0,1,1
437120,Closed dislocation of foot,ethnic,Not Hispanic or Latino,0,1,1
373786,Abnormal vision,racial,Other Race,0,1,1
200275,Burn erythema of multiple sites of trunk,ethnic,Hispanic or Latino,1,0,1
379823,Acute myringitis without otitis media,ethnic,Hispanic or Latino,0,1,1
4062635,Measles screening,ethnic,Hispanic or Latino,1,0,1
380094,Carpal tunnel syndrome,racial,American Indian,1,0,1
436510,Acquired cavus foot deformity,racial,Unknown,0,1,1
30770,Chronic peptic ulcer with hemorrhage but without obstruction,racial,Unknown,1,0,1
438739,Sympathetic uveitis,racial,Asian,0,1,1
4150157,Other anemias,ethnic,Not Hispanic or Latino,1,0,1
72710,Effusion of joint of forearm,ethnic,Hispanic or Latino,0,1,1
199875,Vaginal wall prolapse without uterine prolapse,racial,Unknown,1,0,1
192971,"Pelvic soft tissue abnormality in pregnancy, childbirth and the puerperium - delivered with postnatal complication",racial,White,1,0,1
198334,Campylobacter diarrhoea,racial,Unknown,1,0,1
381854,Disorder of conjunctiva,racial,Unknown,0,1,1
136057,Benign neoplasm of skin of trunk,racial,Asian,1,0,1
373494,Cholesterin granuloma of middle ear,racial,Other Race,0,1,1
79884,Galactorrhea not associated with childbirth,racial,American Indian or Alaska Native ,1,0,1
376707,Acute conjunctivitis,racial,American Indian,1,0,1
443753,Abrasion AND/OR friction burn of wrist without infection,racial,American Indian or Alaska Native ,1,0,1
80294,Foreign body in genitourinary tract,racial,White,1,0,1
78619,"Contusion, knee",racial,Native Hawaiian or Other Pacific Islander ,1,0,1
4085803,Microsporosis nigra,ethnic,Hispanic or Latino,1,0,1
372766,Open wound of head with complication,racial,White,0,1,1
141933,Alopecia areata,racial,Filipino,0,1,1
4020669,Coronary arteriography using single catheter,ethnic,Hispanic or Latino,1,0,1
199771,Carcinoid syndrome,racial,White,1,0,1
4041798,"Hodgkin's disease, lymphocytic depletion",racial,White,0,1,1
195019,"Pelvic soft tissue abnormality in pregnancy, childbirth and the puerperium with antenatal problem",racial,Unknown,1,0,1
439348,Pregnancy complications,racial,Asian,1,0,1
437663,Fever,racial,American Indian,1,0,1
441153,Closed supracondylar fracture of femur,ethnic,Hispanic or Latino,1,0,1
442943,Abrasion or friction burn of shoulder and upper arm without mention of infection,racial,Asian,0,1,1
443545,Nonvenomous insect bite,racial,Asian Indian,1,0,1
436089,"Nondependent cocaine abuse, episodic",ethnic,Not Hispanic or Latino,1,0,1
257086,Incomplete bilateral cleft palate,racial,White,0,1,1
433915,Burn of thigh,racial,White,1,0,1
197218,Capillaria infection,ethnic,Hispanic or Latino,1,0,1
379779,Subacute delirium,racial,White,1,0,1
4312857,Incision of spleen,racial,White,0,1,1
141825,Non-toxic goiter,racial,Unknown,1,0,1
4147639,Cellulitis and abscess of toe NOS,racial,Black or African American ,1,0,1
4110815,"Sensorineural hearing loss, bilateral",racial,Native Hawaiian or Other Pacific Islander ,0,1,1
40414926,"Accidental cut, puncture, perforation or haemorrhage during administration of enema",racial,Unknown,0,1,1
372903,Retinal edema,racial,Filipino,0,1,1
137940,Transient hypertension of pregnancy - delivered,racial,Unknown,1,0,1
4085075,At risk state,racial,American Indian or Alaska Native ,1,0,1
136775,Contact dermatitis due to solar radiation,racial,Black or African American ,1,0,1
374950,Oedema of eyelid,racial,Black or African American ,1,0,1
378425,Eyelid inflammation,racial,American Indian or Alaska Native ,1,0,1
141253,Disease of thyroid gland,racial,American Indian,1,0,1
436246,Low libido,racial,American Indian,1,0,1
436299,Fall from one level to another,ethnic,Hispanic or Latino,1,0,1
434156,Congenital anemia,ethnic,Hispanic or Latino,0,1,1
4111255,Unspecified labyrinthitis,racial,Asian,0,1,1
253121,"Tuberculosis of lung, confirmed by culture only",racial,White,0,1,1
437041,Mother not delivered,racial,Middle Eastern or North African,1,0,1
196757,Fetal-maternal haemorrhage with antenatal problem,ethnic,Not Hispanic or Latino,0,1,1
4052921,FH: Consanguinity,racial,Unknown,0,1,1
201626,Mid-cycle pain,racial,Asian,1,0,1
375475,Meningoencephalitis due to acquired toxoplasmosis,racial,Unknown,0,1,1
73649,Contusion of finger,racial,Asian Indian,1,0,1
434821,SIRS - System inflammatory response syndrome,racial,Asian,1,0,1
76887,Disorders of urogenital prostheses or implants,racial,American Indian or Alaska Native ,1,0,1
200040,Acute gonococcal endometritis,racial,White,1,0,1
444129,Wrist injury,racial,Asian,0,1,1
432682,Complete spontaneous abortion with delayed or excessive haemorrhage,ethnic,Hispanic or Latino,1,0,1
434344,Accommodative spasm,ethnic,Hispanic or Latino,0,1,1
442038,Anaphylactic shock due to serum,ethnic,Not Hispanic or Latino,1,0,1
81659,Traumatic arthropathy of the pelvic region and thigh,racial,Asian,0,1,1
373489,Congenital nystagmus,ethnic,Not Hispanic or Latino,1,0,1
198558,Nycturia,racial,Black or African American ,0,1,1
441571,Retained old foreign body following penetrating wound of orbit,racial,Unknown,0,1,1
4133311,Tetanus vaccination,racial,White,1,0,1
4058089,Mild hyperemesis gravidarum NOS,racial,White,1,0,1
198401,Neoplasm of uncertain behavior of bladder,ethnic,Not Hispanic or Latino,0,1,1
198363,Candidiasis of vagina,racial,American Indian,1,0,1
4019044,Sprain of ischiocapsular ligament,ethnic,Not Hispanic or Latino,1,0,1
81893,Chronic ulcerative colitis,racial,Other Race,1,0,1
4287237,Vascular hamartoma of skin,ethnic,Not Hispanic or Latino,0,1,1
437187,Assault by striking by blunt or thrown object,ethnic,Hispanic or Latino,0,1,1
436238,Elevated levels of transaminase and lactic acid dehydrogenase,racial,American Indian,1,0,1
74138,Pathological fracture of vertebra,racial,Black or African American ,1,0,1
437557,Eczematous dermatitis of eyelid,racial,Asian,0,1,1
195009,Leukoplakia of penis,racial,White,0,1,1
133002,Acute osteomyelitis,ethnic,Not Hispanic or Latino,0,1,1
377551,Blind hypertensive eye,ethnic,Not Hispanic or Latino,1,0,1
439743,Late effects of respiratory tuberculosis,racial,Unknown,1,0,1
4095304,Malignant neoplasm of pituitary gland and craniopharyngeal duct,racial,White,1,0,1
4234299,Repair of cystocele,racial,White,1,0,1
443464,Central pain syndrome,racial,White,0,1,1
4062733,Neurological screening,ethnic,Hispanic or Latino,0,1,1
435024,Precipitate labour with antenatal problem,racial,Unknown,1,0,1
194802,Foreign body in vulva and vagina,racial,Native Hawaiian or Other Pacific Islander ,1,0,1
4147650,"Muscular calcification and ossification, unspecified",racial,Black or African American ,0,1,1
198846,Enthesopathy of hip region,racial,Black or African American ,1,0,1
75311,Fibrosclerosis of breast,racial,White,1,0,1
4148412,Family history: Genitourinary disease,racial,Other Race,1,0,1
432661,Stomatitis,racial,Black or African American ,1,0,1
136960,Vascular myelopathies,racial,White,1,0,1
433032,Pyrexia postprocedure,racial,White,0,1,1
436612,Gaseous hydrocarbon causing toxic effect,racial,White,1,0,1
199885,Acute female pelvic peritonitis,racial,White,1,0,1
439982,Infection as complication of medical care,ethnic,Hispanic or Latino,1,0,1
72576,Benign tumour of breast,racial,Other Race,1,0,1
441460,Late effect of sprain AND/OR strain without tendon injury,racial,Black or African American ,1,0,1
4053600,Open wound of elbow,ethnic,Not Hispanic or Latino,1,0,1
442167,Neoplasm of uncertain behaviour of craniopharyngeal duct,racial,Unknown,0,1,1
433565,Juvenile osteochondrosis of spine,ethnic,Hispanic or Latino,1,0,1
261116,Acquired nasal deformity,racial,Unknown,0,1,1
443789,Victim of trauma,racial,Unknown,1,0,1
4052804,FH: Allergy,racial,Black or African American ,0,1,1
76573,Full thickness burn of hand,ethnic,Hispanic or Latino,0,1,1
4311114,Sensory disorder,ethnic,Hispanic or Latino,1,0,1
312664,Influenza with respiratory manifestation other than pneumonia,racial,American Indian,1,0,1
443577,Asymmetric sensorineural hearing loss,racial,Filipino,1,0,1
373870,Neonatal dacryocystitis and conjunctivitis,ethnic,Not Hispanic or Latino,1,0,1
78605,Superficial bruising of elbow,racial,Asian,0,1,1
4048727,Neoplasm screening,racial,Asian,1,0,1
192380,Failed attempted abortion without complication,racial,Unknown,1,0,1
199764,Benign ovarian tumour,ethnic,Not Hispanic or Latino,1,0,1
27411,Open wound of multiple sites of mouth with complication,racial,White,0,1,1
72778,Open wound of toe(s) without mention of complication,racial,Other Race,1,0,1
134404,Anal spasm,racial,Black or African American ,1,0,1
321815,Malignant histiocytosis of lymph nodes of multiple sites,ethnic,Hispanic or Latino,1,0,1
4287844,alpha Thalassemia,racial,White,1,0,1
438975,Multisystemic disseminated toxoplasmosis,racial,White,1,0,1
432656,Embolism and thrombosis of the thoracic aorta,racial,White,1,0,1
76737,Hydrocele,ethnic,Not Hispanic or Latino,0,1,1
433746,"Combined drug dependence, excluding opioid, continuous",racial,Unknown,1,0,1
436075,Adjustment disorder with anxious mood,racial,Other Race,0,1,1
77070,Allergic arthritis of the hand,racial,Black or African American ,0,1,1
377844,Status migrainosus,racial,White,1,0,1
313833,Puerperal cerebrovascular disorder with postnatal complication,racial,Unknown,1,0,1
380719,Impairment level: one eye: moderate impairment: other eye: normal vision,racial,Unknown,1,0,1
75045,Climacteric arthritis of the pelvic region and thigh,ethnic,Hispanic or Latino,0,1,1
437247,Anaemia of chronic disease,racial,American Indian or Alaska Native ,0,1,1
137648,Osteomyelitis of hand,racial,White,0,1,1
4103961,Removal of acoustic neuroma,racial,White,1,0,1
198199,Pyelonephritis,racial,American Indian,1,0,1
139202,"Burn involving 20-29 percent of body surface, with 10-19 percent of body surface with full thickness burn",racial,White,0,1,1
138676,Gram negative septicemia,racial,Unknown,0,1,1
4110022,Acute bronchitis and/or bronchiolitis,racial,Unknown,1,0,1
438668,Accidents due to travel and motion,racial,Unknown,0,1,1
433111,Effects of hunger,racial,White,1,0,1
441615,Trigonitis,racial,Unknown,1,0,1
72471,Sprain of carpometacarpal joint,ethnic,Not Hispanic or Latino,1,0,1
4112819,Pneumonia due to other specified bacteria,racial,Unknown,0,1,1
441680,Fetus OR newborn affected by multiple pregnancy,racial,White,1,0,1
193636,Foreign body in bladder AND/OR urethra,ethnic,Hispanic or Latino,1,0,1
4292726,Contact - infectious disease,racial,Filipino,1,0,1
433455,Teeth grinding whilst asleep,racial,Asian,1,0,1
440989,Intermittent explosive disorder,ethnic,Not Hispanic or Latino,1,0,1
132932,Chronic ethmoidal sinusitis,racial,Other Race,1,0,1
437027,Acute duodenitis,racial,Unknown,0,1,1
434628,Separation anxiety,ethnic,Not Hispanic or Latino,0,1,1
4050797,Family history of urological neoplasm,ethnic,Not Hispanic or Latino,0,1,1
434605,Benign tumor of lacrimal drainage structure,racial,White,0,1,1
136516,Congenital pes planus,racial,Asian,1,0,1
4108374,Other specified peripheral vascular disease NOS,racial,Unknown,0,1,1
440612,Toxic effect of tobacco and nicotine,racial,Asian,1,0,1
4053600,Open wound of elbow,racial,Asian,1,0,1
199063,"Hernia, with obstruction",ethnic,Not Hispanic or Latino,1,0,1
4169009,FH: CVA,racial,Asian,0,1,1
4008089,Dysentery,racial,American Indian or Alaska Native ,1,0,1
78472,Microscopic haematuria,racial,American Indian or Alaska Native ,1,0,1
436956,Evans syndrome,racial,White,0,1,1
256571,FB - Nasal foreign body,racial,Unknown,0,1,1
134870,Pityriasis versicolor,racial,Asian Indian,1,0,1
78607,Open wound of multiple sites of one upper limb with complication,ethnic,Hispanic or Latino,0,1,1
438812,Abortion complicated by genital-pelvic infection,racial,White,1,0,1
440853,Closed fracture of surgical neck of humerus,ethnic,Hispanic or Latino,1,0,1
201618,Disease of intestine,racial,American Indian,1,0,1
193804,Achlorhydria,ethnic,Hispanic or Latino,1,0,1
433536,Severe pre-eclampsia,ethnic,Hispanic or Latino,1,0,1
80573,Contusion of ankle,racial,Black or African American ,0,1,1
74511,Open wound of knee and/or leg and/or ankle with complication,racial,Other Race,1,0,1
81425,Closed fracture of sacrum AND/OR coccyx with complete cauda equina lesion,racial,White,1,0,1
4287237,Vascular hamartoma of skin,racial,Asian,0,1,1
432975,Trauma to perineum and/or vulva during delivery,ethnic,Hispanic or Latino,1,0,1
317002,Hypopiesis,racial,American Indian or Alaska Native ,0,1,1
444369,Hyperosmolality,racial,White,1,0,1
433015,Congenital anomaly of aortic arch,racial,Unknown,1,0,1
434673,Soft tissue impingement on teeth,racial,Black or African American ,0,1,1
378419,AD - Alzheimer's disease,racial,American Indian or Alaska Native ,1,0,1
257293,Disorder of visual pathways,ethnic,Not Hispanic or Latino,0,1,1
376955,Gouty tophi of ear,racial,White,0,1,1
201627,Abnormal vaginal bleeding,racial,Black or African American ,1,0,1
132253,Mixed pediculosis,ethnic,Hispanic or Latino,1,0,1
434119,Hidradenitis,racial,American Indian or Alaska Native ,1,0,1
194411,Unilateral simple inguinal hernia,racial,Native Hawaiian or Other Pacific Islander ,0,1,1
439372,"Motor vehicle traffic accident involving collision, on highway, between motor vehicle and fallen stone, traffic sign, tree or utility pole, pedestrian injured",ethnic,Hispanic or Latino,1,0,1
196715,Budd-Chiari syndrome,racial,White,1,0,1
316994,Malignant hypertensive heart disease with congestive cardiac failure,racial,Asian,1,0,1
432289,Drug-induced neutropenia,racial,Asian,0,1,1
373201,Acute eustachian tube salpingitis,ethnic,Not Hispanic or Latino,1,0,1
372925,Cholesteatoma,ethnic,Not Hispanic or Latino,1,0,1
4171434,Immunization refused,racial,American Indian,1,0,1
4049954,Open wound of nasal sinus,racial,Unknown,0,1,1
81659,Traumatic arthropathy of the pelvic region and thigh,ethnic,Hispanic or Latino,1,0,1
441579,Acute inferoposterior infarction,racial,White,0,1,1
201257,Disorder of endocrine ovary,racial,Asian,1,0,1
380714,Minor opacity of cornea,ethnic,Not Hispanic or Latino,1,0,1
79904,Secondary localised osteoarthrosis of hand,racial,White,0,1,1
75954,Sprain of interphalangeal joint of finger,racial,Other Race,0,1,1
195012,Metrorrhagia,racial,American Indian or Alaska Native ,1,0,1
438067,Malaria,racial,White,0,1,1
138864,Congenital anomaly of nail,racial,Unknown,1,0,1
75863,Chronic interstitial cystitis,racial,Asian,1,0,1
432308,Mononeuritis of lower limb,racial,Asian,1,0,1
198809,Acute cholecystitis,racial,Black or African American ,1,0,1
4193570,Abnormal results of hearing screening test,racial,Other Race,0,1,1
4270051,Arthrodesis of ankle,ethnic,Hispanic or Latino,1,0,1
199771,Carcinoid syndrome,racial,Unknown,1,0,1
4210636,Transient tic disorder,ethnic,Hispanic or Latino,1,0,1
4228073,Peripheral nerve block,ethnic,Hispanic or Latino,1,0,1
441259,Non-thrombocytopenic purpura,racial,Black or African American ,0,1,1
381392,Congenital subcapsular cataract,racial,Unknown,1,0,1
198853,Congenital anomaly of ovary,ethnic,Hispanic or Latino,1,0,1
435269,Optic papillitis,ethnic,Hispanic or Latino,1,0,1
432810,Injury of unknown intent by burns or fire,racial,Unknown,1,0,1
440396,Glaucoma associated with ocular trauma,racial,White,0,1,1
443677,Open wound of knee and/or leg and/or ankle,racial,Asian,0,1,1
439147,Amnesia,racial,Native Hawaiian or Other Pacific Islander ,0,1,1
197601,Spermatocele,racial,Other Race,0,1,1
434885,Benign neoplasm of skull and facial bones,racial,White,0,1,1
441692,Finding of serum tumour marker level,racial,Unknown,0,1,1
440529,Abnormal findings on diagnostic imaging of urinary organs,racial,Asian,1,0,1
199855,Acute gastric ulcer with hemorrhage AND with perforation but without obstruction,racial,White,0,1,1
440980,Atypical manic disorder,racial,White,0,1,1
193591,Meconium ileus,racial,White,0,1,1
73065,"Contusion, genital organs",racial,Other Race,0,1,1
4113027,Dietary intake observations,racial,Black or African American ,0,1,1
4046893,Lifestyle,racial,Filipino,0,1,1
435859,Acute duodenal ulcer without hemorrhage AND without perforation but with obstruction,racial,White,1,0,1
313780,Mobitz type 2 second degree atrioventricular block,ethnic,Hispanic or Latino,1,0,1
441546,Functional vomiting,racial,Other Race,0,1,1
74150,"Congenital subluxation of hip, bilateral",racial,Asian,1,0,1
194071,Pylorospasm,racial,White,1,0,1
4150157,Other anemias,racial,Asian,1,0,1
258955,Whooping cough due to organism other than Bordetella pertussis,ethnic,Hispanic or Latino,1,0,1
40484010,Unilateral conductive hearing loss,racial,Other Race,1,0,1
373412,Otitis externa due to Herpes zoster,racial,White,0,1,1
200763,Chronic hepatitis,racial,Native Hawaiian or Other Pacific Islander ,0,1,1
375115,Nonmagnetic foreign body penetrating eyeball,ethnic,Hispanic or Latino,0,1,1
4062480,Diphtheria screening,ethnic,Hispanic or Latino,0,1,1
435786,Disorder of sleep-wake cycle,ethnic,Not Hispanic or Latino,1,0,1
372765,Open wound of head without complication,racial,Asian,0,1,1
4005743,Female sterility,racial,Asian,1,0,1
201820,Diabetes mellitus,racial,Asian,0,1,1
436839,Closed fracture of metacarpal bone,racial,Asian,1,0,1
137063,Corns and callus,racial,American Indian or Alaska Native ,1,0,1
439053,Exostosis of jaw,racial,Black or African American ,1,0,1
200200,Lumbar spina bifida with hydrocephalus,ethnic,Hispanic or Latino,1,0,1
134681,Spasm of oesophagus,racial,Unknown,0,1,1
4215445,Arthroplasty of shoulder for recurrent dislocation,ethnic,Hispanic or Latino,1,0,1
139179,Open wound of lip without complication,racial,American Indian,1,0,1
135178,Streptococcal septicaemia,racial,White,0,1,1
75555,Viral labyrinthitis,ethnic,Not Hispanic or Latino,1,0,1
438559,Abnormal vaginal Papanicolaou smear,racial,Asian,1,0,1
194412,Dysplasia of vagina,racial,Unknown,1,0,1
433911,Contusion of eye AND ocular adnexa,racial,Other Race,0,1,1
440067,"Moderate bipolar I disorder, single manic episode",ethnic,Not Hispanic or Latino,1,0,1
137425,"Insect bite, nonvenomous, of trunk, infected",ethnic,Hispanic or Latino,1,0,1
438391,Amino acid transport disorder,racial,Unknown,1,0,1
441266,Thiamin deficiency,racial,Black or African American ,1,0,1
138824,Contact dermatitis due to metal,ethnic,Not Hispanic or Latino,0,1,1
4087756,Late latent syphilis,racial,Other Race,0,1,1
441132,Laboratory finding abnormal,racial,Other Race,0,1,1
379832,Mixed conductive and sensorineural deafness,racial,Black or African American ,0,1,1
435120,Blister of toe with infection,racial,Black or African American ,1,0,1
436134,Disorder of sclera,racial,Filipino,0,1,1
77455,Burn of chest wall,ethnic,Hispanic or Latino,1,0,1
4108982,Cataract associated with other syndromes,racial,Asian,0,1,1
432507,Suicide - hanging,racial,Black or African American ,0,1,1
75311,Fibrosclerosis of breast,racial,Unknown,1,0,1
4155527,Unspecified polyarthropathy or polyarthritis,racial,White,1,0,1
438077,Disseminated candidiasis,racial,White,0,1,1
75667,Sprain of calcaneofibular ligament,racial,Filipino,0,1,1
444291,Cochlear hearing loss,racial,Other Race,1,0,1
317009,Hyperreactive airway disease,racial,Alaska Native,0,1,1
432596,Immune defect,racial,White,0,1,1
315523,Hemoglobin S-F disease,racial,Unknown,1,0,1
373200,Chronic fungal otitis externa,racial,Unknown,0,1,1
72993,Primary localised osteoarthrosis,racial,Asian,0,1,1
81936,Monoarthritis,racial,Other Race,0,1,1
193016,Cystic disease of kidney,racial,American Indian or Alaska Native ,1,0,1
436466,Balanoposthitis,racial,Asian,0,1,1
438365,Phaeohyphomycosis,racial,White,0,1,1
253670,Injury of optic pathways,racial,White,0,1,1
198191,Acquired hypertrophic pyloric stenosis,ethnic,Not Hispanic or Latino,0,1,1
80186,Recurrent dislocation of shoulder region,racial,Other Race,0,1,1
197032,Hyperplasia of prostate,racial,Asian Indian,0,1,1
437400,Closed fracture of shaft of ulna,ethnic,Not Hispanic or Latino,0,1,1
441201,"[X]Fall from, out of or through building or structure",ethnic,Not Hispanic or Latino,1,0,1
4062641,Malaria screening,racial,Native Hawaiian or Other Pacific Islander ,1,0,1
313459,Sleep apnea,racial,Alaska Native,0,1,1
435093,Closed fracture of femur,racial,Black or African American ,1,0,1
81425,Closed fracture of sacrum AND/OR coccyx with complete cauda equina lesion,racial,Unknown,1,0,1
436804,Fetus OR newborn affected by premature rupture of membranes,racial,White,1,0,1
436906,Rickettsial disease,racial,Unknown,1,0,1
4103889,Unspecified blepharoconjunctivitis,racial,White,1,0,1
432827,Infection due to Bacteroides,racial,Other Race,0,1,1
442651,"Noncollision motor vehicle traffic accident involving fire starting in motor vehicle whilst in motion, passenger of motor vehicle injured",ethnic,Hispanic or Latino,1,0,1
443228,"Abrasion or friction burn of foot and toe, without mention of infection",racial,Asian,1,0,1
438559,Abnormal vaginal Papanicolaou smear,ethnic,Not Hispanic or Latino,1,0,1
4059445,Chronic glomerulonephritis NOS,racial,White,0,1,1
443084,"Periostitis without mention of osteomyelitis, of the ankle and/or foot",ethnic,Hispanic or Latino,1,0,1
442324,Psychologic dyspareunia,ethnic,Hispanic or Latino,1,0,1
4129665,Hearing aid care,racial,Unknown,1,0,1
442610,Degenerative AND/OR vascular disorder of ear,racial,White,0,1,1
373126,Non-arthropod-borne viral disease of the central nervous system,racial,White,1,0,1
254514,Contusion of lung without open wound into thorax,ethnic,Hispanic or Latino,1,0,1
374025,Retinal haemorrhages,racial,Asian,0,1,1
444438,Leucoplakia of tongue,racial,Unknown,1,0,1
441189,Pertussis vaccine adverse reaction,ethnic,Not Hispanic or Latino,0,1,1
259995,Foreign body in orifice,racial,White,0,1,1
73012,Saddle back,ethnic,Hispanic or Latino,1,0,1
433257,Mesangiocapillary glomerulonephritis,racial,Black or African American ,0,1,1
4005933,Urethral meatus underneath penis,racial,Black or African American ,0,1,1
4280605,Common duodenal ulcer,racial,White,1,0,1
372247,Candidal otomycosis,racial,Asian,1,0,1
435299,Failure of dental prosthesis,racial,Other Race,1,0,1
141997,Open wound of forearm with complication,ethnic,Hispanic or Latino,1,0,1
4024567,Respiratory observation,racial,Other Race,1,0,1
4150002,Retained placenta with no haemorrhage NOS,racial,Asian,1,0,1
4143915,Cholestasis,ethnic,Not Hispanic or Latino,1,0,1
433949,Human bite,racial,White,0,1,1
201129,Newborn swallowing maternal blood causing hematemesis or melena,racial,Black or African American ,0,1,1
380650,Epidemic haemorrhagic conjunctivitis,ethnic,Hispanic or Latino,1,0,1
134453,Inflammation of bursa,racial,Other Race,0,1,1
443438,Claw hand - acquired,ethnic,Hispanic or Latino,0,1,1
74582,Primary malignant neoplasm of rectum,racial,American Indian or Alaska Native ,1,0,1
74150,"Congenital subluxation of hip, bilateral",ethnic,Not Hispanic or Latino,1,0,1
433668,Burn of two OR more fingers including thumb,racial,White,0,1,1
443449,Acute laryngitis with obstruction,racial,White,0,1,1
440409,Disorder of orbit proper,ethnic,Not Hispanic or Latino,1,0,1
141693,Elevated blood-pressure reading without diagnosis of hypertension,racial,Middle Eastern or North African,1,0,1
4009601,Fracture of one or more phalanges of hand NOS,racial,White,1,0,1
376115,Cystoid macular retinal degeneration,racial,Unknown,0,1,1
192731,Digestive symptom,racial,American Indian or Alaska Native ,1,0,1
197023,Bilateral inguinal hernia,racial,Other Race,0,1,1
4085803,Microsporosis nigra,ethnic,Not Hispanic or Latino,1,0,1
200675,Neoplasm of uncertain behavior of ovary,ethnic,Not Hispanic or Latino,1,0,1
77079,SS - Spinal stenosis,racial,Black or African American ,1,0,1
438130,Opioid abuse,racial,Black or African American ,1,0,1
199075,Neurogenic bladder,racial,Asian,1,0,1
440465,Postpartum state,racial,American Indian,0,1,1
77653,Traumatic myositis ossificans,ethnic,Hispanic or Latino,0,1,1
438749,Posterior subcapsular polar senile cataract,racial,Unknown,0,1,1
196821,Observation of urethral discharge,racial,Other Race,0,1,1
435799,Adjustment disorder with disturbance of conduct,ethnic,Not Hispanic or Latino,0,1,1
133299,Swelling of limb,racial,Asian Indian,1,0,1
4098410,Atrial cardioversion,ethnic,Hispanic or Latino,0,1,1
72576,Benign tumour of breast,racial,American Indian or Alaska Native ,1,0,1
432454,Excessive thirst,racial,Native Hawaiian or Other Pacific Islander ,0,1,1
443915,Poisoning by autonomous nervous system drug,racial,White,1,0,1
4062733,Neurological screening,ethnic,Not Hispanic or Latino,1,0,1
4066820,Ingestion dermatitis due to food,racial,Black or African American ,1,0,1
75050,Coxa valga - acquired,racial,Black or African American ,0,1,1
375067,Microphthalmos associated with other anomalies of eye AND/OR adnexa,racial,White,1,0,1
4197217,Arteriovenous anastomosis for renal dialysis,racial,Unknown,1,0,1
255711,Optic nerve and pathway injury,racial,White,0,1,1
78907,Superficial injury of foot without infection,ethnic,Not Hispanic or Latino,1,0,1
440953,Cysticercosis,ethnic,Not Hispanic or Latino,1,0,1
435416,Poisoning by anti-infective agent,ethnic,Hispanic or Latino,1,0,1
254387,Upper respiratory tract hypersensitivity reaction,racial,Filipino,0,1,1
78009,Open traumatic pneumothorax,racial,Unknown,0,1,1
443586,Transient organic mental disorder,ethnic,Hispanic or Latino,1,0,1
435956,Closed fracture of base of neck of femur,ethnic,Not Hispanic or Latino,1,0,1
443392,Malignant neoplastic disease,ethnic,Not Hispanic or Latino,1,0,1
432807,Accidents caused by cutting and piercing instruments or objects,racial,White,1,0,1
434344,Accommodative spasm,ethnic,Not Hispanic or Latino,0,1,1
195197,Primary malignant neoplasm of vulva,racial,White,1,0,1
72991,Traumatic arthropathy of multiple sites,racial,Unknown,0,1,1
441968,Acetonuria,racial,Asian,1,0,1
4324788,Articular cartilage disorder of wrist,racial,White,1,0,1
195513,Vaginal intraepithelial neoplasia grade III,ethnic,Hispanic or Latino,1,0,1
438392,Disorder of hyperalimentation,ethnic,Hispanic or Latino,1,0,1
434173,Fever symptoms,ethnic,Not Hispanic or Latino,0,1,1
432526,Needs influenza immunisation,racial,Middle Eastern or North African,1,0,1
74698,Breech presentation,racial,Asian,0,1,1
380707,Distortion of visual image,racial,White,0,1,1
378679,Acute poliomyelitis,racial,White,1,0,1
440396,Glaucoma associated with ocular trauma,racial,Unknown,0,1,1
138858,Pale complexion,ethnic,Not Hispanic or Latino,1,0,1
4059736,Infective urethral stricture NOS,racial,White,0,1,1
72996,"Stiff joint NEC, of the lower leg",racial,Other Race,0,1,1
442740,"Nontraffic accident involving fall from motor vehicle, except off-road motor vehicle, whilst in motion, not on public highway, motor cyclist injured",ethnic,Hispanic or Latino,1,0,1
195976,Burn of gastrointestinal tract,racial,White,1,0,1
4173452,Exteriorisation of appendix,racial,Unknown,1,0,1
436007,Complication of introduction procedure,racial,White,0,1,1
441819,"Carcinoma in situ of lip, oral cavity and pharynx",racial,White,1,0,1
444125,Satisfactory for evaluation but limited by absence of an endocervical/transformation zone component from a patient with a cervix,racial,Unknown,1,0,1
434069,"Mottled teeth, congenital",racial,White,0,1,1
432451,Abnormal results of function studies of central nervous system,racial,Native Hawaiian or Other Pacific Islander ,0,1,1
193070,Blister of trunk with infection,racial,White,1,0,1
198899,Open wound of trunk with complication,racial,Unknown,1,0,1
195314,Nephrotic syndrome,racial,Black or African American ,0,1,1
439926,Malaise and fatigue,racial,Alaska Native,1,0,1
4144876,Contact dermatitis and other eczemas,ethnic,Not Hispanic or Latino,1,0,1
440385,Obstructive hydrocephalus,racial,American Indian or Alaska Native ,1,0,1
436098,Nondependent cocaine abuse in remission,racial,Other Race,1,0,1
438123,Disorder of corticoadrenal overactivity,racial,White,0,1,1
438067,Malaria,racial,Unknown,1,0,1
312358,CGN - Chronic glomerulonephritis,ethnic,Not Hispanic or Latino,0,1,1
200657,Trichomonal urethritis,ethnic,Hispanic or Latino,0,1,1
4022073,Dependance on wheel chair,racial,Black or African American ,1,0,1
433455,Teeth grinding whilst asleep,ethnic,Not Hispanic or Latino,1,0,1
193523,Broad ligament laceration syndrome,racial,Black or African American ,1,0,1
376512,Microphthalmos,ethnic,Hispanic or Latino,0,1,1
436729,Chronic gastrojejunal ulcer with haemorrhage AND obstruction,ethnic,Hispanic or Latino,1,0,1
372435,Periventricular leukomalacia,racial,Unknown,0,1,1
198483,Stricture or atresia of the vagina,racial,White,1,0,1
440158,"Venereal disease in mother complicating pregnancy, childbirth AND/OR puerperium",racial,Black or African American ,1,0,1
4314253,Visual cortex dysfunction,ethnic,Hispanic or Latino,0,1,1
255348,Polymyalgia rheumatica,racial,Asian,1,0,1
438303,Fall on same level from sports contact,racial,Unknown,1,0,1
441784,Disease due to Hantavirus,racial,White,0,1,1
73300,Radial styloid tenosynovitis,racial,Asian Indian,1,0,1
200662,Lymphosarcoma,racial,American Indian or Alaska Native ,1,0,1
434300,Neuroendocrine tumour,racial,White,1,0,1
319835,Congestive cardiac failure,racial,Alaska Native,1,0,1
4146709,Enteritis due to specified virus,racial,White,1,0,1
137077,Chronic osteomyelitis of the ankle and/or foot,racial,White,1,0,1
315586,Priapism,ethnic,Hispanic or Latino,0,1,1
79884,Galactorrhea not associated with childbirth,racial,Other Race,1,0,1
4063177,Fetal malposition and malpresentation NOS,ethnic,Hispanic or Latino,1,0,1
194419,Infertility due to oligospermia,ethnic,Hispanic or Latino,0,1,1
76221,Neonatal infective mastitis,ethnic,Hispanic or Latino,1,0,1
77029,Epididymo-orchitis without abscess,racial,Unknown,0,1,1
73065,"Contusion, genital organs",racial,American Indian or Alaska Native ,0,1,1
4054908,Closed injury of kidney,racial,Unknown,0,1,1
4093460,Leptospirosis NOS,racial,White,1,0,1
4242435,Reifenstein syndrome,racial,White,0,1,1
4171075,Bite of animal,ethnic,Not Hispanic or Latino,1,0,1
78243,Congenital spondylolysis of lumbosacral region,racial,White,0,1,1
134057,Disease of cardiovascular system,racial,Native Hawaiian or Other Pacific Islander ,0,1,1
442747,Contact dermatitis due to food in contact with skin,racial,Asian,1,0,1
4232595,Platinum asthma,ethnic,Hispanic or Latino,1,0,1
140958,Kaposi's sarcoma of palate,racial,White,0,1,1
381252,Benign neoplasm of eye,ethnic,Not Hispanic or Latino,1,0,1
4019044,Sprain of ischiocapsular ligament,ethnic,Hispanic or Latino,0,1,1
320682,Finding of white blood cell number,racial,Unknown,1,0,1
318712,Peripheral circulatory disorder associated with type I diabetes mellitus,racial,American Indian or Alaska Native ,0,1,1
4258683,Faeces - impacted,ethnic,Not Hispanic or Latino,1,0,1
443752,Ventricular hemorrhage,racial,Black or African American ,1,0,1
440213,Consciousness and/or awareness finding,racial,Asian,0,1,1
380714,Minor opacity of cornea,racial,Asian,1,0,1
435648,Testicular retraction,racial,Unknown,0,1,1
4032877,Chronic amoebic dysentery,racial,Unknown,1,0,1
79119,Thoracic spondylosis with myelopathy,ethnic,Not Hispanic or Latino,0,1,1
4070919,Other specified heart anomalies,ethnic,Hispanic or Latino,0,1,1
436010,Heat edema,ethnic,Hispanic or Latino,1,0,1
439937,C-reactive protein abnormal,racial,Asian,1,0,1
441447,Open wound of external genital organs without complication,racial,Unknown,1,0,1
196165,Cervical intraepithelial neoplasia grade 2,racial,American Indian or Alaska Native ,1,0,1
4143292,Varicose veins of legs in the puerperium,ethnic,Not Hispanic or Latino,1,0,1
320744,Complete atrioventricular block,racial,Other Race,1,0,1
440155,Postartificial menopausal syndrome,racial,Other Race,1,0,1
4171430,Screening for malignant neoplasm of rectum,racial,Native Hawaiian or Other Pacific Islander ,0,1,1
194861,Syphilis of liver,racial,White,0,1,1
40482203,Karyotype evaluation abnormal,racial,Unknown,0,1,1
4062495,Glaucoma screening,racial,Asian Indian,1,0,1
196735,Acute pyelonephritis without medullary necrosis,racial,Black or African American ,0,1,1
196454,Colostomy and enterostomy malfunction,racial,Unknown,1,0,1
40489926,Removal of dental prosthesis,racial,White,0,1,1
73043,Open traumatic dislocation of shoulder,ethnic,Not Hispanic or Latino,0,1,1
141159,Open wound of buccal mucosa without complication,ethnic,Hispanic or Latino,1,0,1
197036,Vesicoureteral reflux,ethnic,Not Hispanic or Latino,0,1,1
80805,Primary localized osteoarthrosis of forearm,racial,American Indian,1,0,1
439134,Acrocephalosyndactyly,racial,White,0,1,1
4144876,Contact dermatitis and other eczemas,racial,Asian,1,0,1
196473,Hypertrophy of uterus,racial,American Indian or Alaska Native ,1,0,1
4178964,Malignant tumour of roof of mouth,ethnic,Hispanic or Latino,0,1,1
195464,Epidemic pleurodynia,racial,White,0,1,1
441829,Hyperosmolality and or hypernatremia,racial,Other Race,0,1,1
192353,Disorder of gallbladder,racial,American Indian or Alaska Native ,1,0,1
319047,Necrosis of artery,ethnic,Hispanic or Latino,0,1,1
72714,Chronic polyarticular juvenile rheumatoid arthritis,racial,Black or African American ,1,0,1
136057,Benign neoplasm of skin of trunk,racial,Other Race,0,1,1
77070,Allergic arthritis of the hand,racial,White,1,0,1
438130,Opioid abuse,racial,Unknown,0,1,1
433410,Primary syphilis,racial,Unknown,0,1,1
4147635,Unspecified otorrhea,racial,White,0,1,1
436357,Primary malignant neoplasm of soft tissues of upper limb,racial,Unknown,0,1,1
443406,Eosinophilic gastroenteritis,racial,White,1,0,1
441764,Inhalation or ingestion of foreign body with respiratory obstruction or suffocation,ethnic,Not Hispanic or Latino,0,1,1
4052804,FH: Allergy,racial,White,1,0,1
76772,Galactorrhea in pregnancy and the puerperium with antenatal complication,ethnic,Hispanic or Latino,1,0,1
133803,Periapical abscess with sinus tract,racial,American Indian or Alaska Native ,1,0,1
193874,Bed wetting,racial,Native Hawaiian or Other Pacific Islander ,1,0,1
378756,Conjunctival hemorrhage,racial,American Indian or Alaska Native ,1,0,1
4144395,Enlarged angioscotoma,ethnic,Not Hispanic or Latino,1,0,1
4037738,Visual alteration,ethnic,Not Hispanic or Latino,1,0,1
438648,Vitamin poisoning,racial,Unknown,1,0,1
434926,Iridocyclitis,racial,American Indian or Alaska Native ,1,0,1
436546,Strain of subscapularis muscle,racial,Filipino,1,0,1
436837,Closed fracture of neck of radius,racial,White,1,0,1
137658,Congenital pigmentary anomaly of skin,racial,Unknown,0,1,1
197324,Disease of peritoneum,racial,Other Race,0,1,1
77965,Nodular tendinous disease of finger,racial,Native Hawaiian or Other Pacific Islander ,1,0,1
440067,"Moderate bipolar I disorder, single manic episode",ethnic,Hispanic or Latino,0,1,1
437699,Strain of infraspinatus muscle AND/OR tendon,ethnic,Not Hispanic or Latino,0,1,1
441398,Anomaly of sex chromosome,ethnic,Not Hispanic or Latino,0,1,1
4239301,Unwanted pregnancy,racial,Native Hawaiian or Other Pacific Islander ,1,0,1
439235,Self inflicted injury,racial,White,0,1,1
4183977,Oligohydramnios without rupture of membranes,ethnic,Hispanic or Latino,1,0,1
193238,Acute appendicitis with peritoneal abscess,ethnic,Not Hispanic or Latino,1,0,1
4168226,Micturition frequency and polyuria,racial,Black or African American ,1,0,1
192679,Renal disease in pregnancy AND/OR puerperium without hypertension,racial,Other Race,1,0,1
201951,Gonadal dysgenesis,ethnic,Not Hispanic or Latino,1,0,1
440417,Pulmonary embolism,ethnic,Hispanic or Latino,0,1,1
199885,Acute female pelvic peritonitis,racial,Unknown,1,0,1
75621,Acute polyarticular juvenile rheumatoid arthritis,racial,White,1,0,1
440369,Histrionic personality disorder,racial,White,1,0,1
4220385,Transection of isthmus of thyroid,ethnic,Hispanic or Latino,1,0,1
376399,Incipient cataract,racial,Asian,1,0,1
4062491,Anemia screening,racial,American Indian,1,0,1
200433,Dissecting aneurysm of renal artery,ethnic,Hispanic or Latino,0,1,1
80204,IUGR - Intrauterine growth retardation,ethnic,Not Hispanic or Latino,0,1,1
135611,Furuncle of hand,racial,Black or African American ,1,0,1
432504,Accident caused by fire and flames,ethnic,Hispanic or Latino,1,0,1
381573,Acute mastoiditis without complications,racial,Unknown,1,0,1
437273,Glaucoma capsulare,ethnic,Not Hispanic or Latino,0,1,1
4062795,Twin pregnancy unspecified,racial,Unknown,1,0,1
4008089,Dysentery,racial,Other Race,0,1,1
433390,Immunosuppressant adverse reaction,racial,Asian,0,1,1
441699,"Closed fracture proximal humerus, greater tuberosity",ethnic,Hispanic or Latino,1,0,1
197019,Bile duct calculus with acute cholecystitis and no obstruction,racial,White,1,0,1
4058089,Mild hyperemesis gravidarum NOS,racial,Unknown,1,0,1
4111103,Disorder of eye and adnexa NOS,racial,Unknown,0,1,1
4112658,Chest infection - pneumonia organism OS,ethnic,Hispanic or Latino,1,0,1
137063,Corns and callus,racial,Filipino,1,0,1
438739,Sympathetic uveitis,ethnic,Hispanic or Latino,0,1,1
4126282,Chlamydial urethritis,ethnic,Not Hispanic or Latino,1,0,1
437478,Bite of nonvenomous arthropod,racial,Native Hawaiian or Other Pacific Islander ,1,0,1
434311,Disorder of the urea cycle metabolism,racial,Other Race,0,1,1
375807,Degenerative disorder of globe,ethnic,Hispanic or Latino,1,0,1
4109699,Unspecified chronic conjunctivitis,racial,Unknown,1,0,1
443629,Generalised abdominal tenderness,racial,White,1,0,1
440971,Neoplasm of uncertain behaviour of testis,ethnic,Not Hispanic or Latino,0,1,1
438865,Complete trisomy 18 syndrome,ethnic,Hispanic or Latino,0,1,1
4017388,Closed dislocation lumbar spine,racial,Other Race,1,0,1
194403,Obstructed diaphragmatic hernia,ethnic,Hispanic or Latino,0,1,1
375819,TM - Tympanic membrane disorder,ethnic,Not Hispanic or Latino,0,1,1
440409,Disorder of orbit proper,racial,Asian,1,0,1
434928,Glaucoma due to iris anomaly,ethnic,Hispanic or Latino,1,0,1
372924,Cerebral arterial occlusion,ethnic,Not Hispanic or Latino,1,0,1
376387,Spasmodic torticollis,racial,Asian,1,0,1
77961,Disseminated idiopathic skeletal hyperostosis,racial,White,1,0,1
440396,Glaucoma associated with ocular trauma,racial,Black or African American ,1,0,1
4303805,Allergic reaction to bite and/or sting,racial,Native Hawaiian or Other Pacific Islander ,0,1,1
4153745,Late effect of musculoskeletal and connective tissue injury NOS,ethnic,Hispanic or Latino,0,1,1
437127,Closed dislocation of acromioclavicular joint,racial,Black or African American ,0,1,1
438660,Toxic effect of nonpetroleum-based solvent,racial,Unknown,0,1,1
433413,Disease due to Adenovirus,racial,White,1,0,1
372903,Retinal edema,racial,Asian,0,1,1
437580,Retropharyngeal abscess,ethnic,Hispanic or Latino,1,0,1
379963,Open wound of external ear without complication,racial,White,0,1,1
433823,"Infections of pregnancy, childbirth and the puerperium",ethnic,Hispanic or Latino,1,0,1
4150002,Retained placenta with no haemorrhage NOS,ethnic,Not Hispanic or Latino,1,0,1
77661,Congenital dislocation of one hip with subluxation of other,racial,White,0,1,1
195862,Urethritis,racial,Asian,0,1,1
442308,Abrasion AND/OR friction burn of thigh without infection,racial,Asian,1,0,1
441980,Closed fracture of foot,racial,American Indian or Alaska Native ,1,0,1
440058,Malignant lymphoma of extranodal AND/OR solid organ site,racial,Other Race,1,0,1
134619,Toxic nodular goiter,ethnic,Hispanic or Latino,1,0,1
313219,Phlebitis and thrombophlebitis,racial,Other Race,1,0,1
320752,Influenza with non-respiratory manifestation,racial,Native Hawaiian or Other Pacific Islander ,1,0,1
193641,Lumbar nerve root injury,racial,Black or African American ,0,1,1
437525,Overweight,racial,European,0,1,1
196488,Atonic postpartum hemorrhage,ethnic,Hispanic or Latino,1,0,1
374639,Chronic headache disorder,racial,Unknown,1,0,1
436228,Fetal death due to termination of pregnancy,racial,Unknown,1,0,1
4004621,Other bone and cartilage disorders,racial,Asian,1,0,1
438064,Bacterial infection due to Pseudomonas,racial,Other Race,0,1,1
440035,European cryptococcosis,racial,American Indian or Alaska Native ,1,0,1
438067,Malaria,racial,Black or African American ,0,1,1
378416,Retinal disorder,racial,Black or African American ,0,1,1
312349,Venous varices,racial,Black or African American ,1,0,1
4202322,Amputated big toe,racial,Black or African American ,1,0,1
4064924,Ear disorder screening,ethnic,Hispanic or Latino,1,0,1
373201,Acute eustachian tube salpingitis,ethnic,Hispanic or Latino,1,0,1
375275,Hypertropia,ethnic,Hispanic or Latino,1,0,1
4183058,Fitting of hearing aid,racial,White,1,0,1
4104431,Alcohol intoxication,racial,White,0,1,1
313324,Cheyne-Stokes respiration,ethnic,Hispanic or Latino,1,0,1
441836,Depressed bipolar I disorder,racial,Native Hawaiian or Other Pacific Islander ,0,1,1
199925,Perinatal intestinal perforation,ethnic,Not Hispanic or Latino,0,1,1
439081,Premenstrual tension syndrome,racial,Black or African American ,1,0,1
140976,Toxic uninodular goiter,racial,Unknown,0,1,1
438737,Acute paranoid reaction,ethnic,Not Hispanic or Latino,0,1,1
373756,Exudative retinopathy,racial,Unknown,1,0,1
441739,Burn erythema of axilla,ethnic,Hispanic or Latino,1,0,1
374915,Localisation-related epilepsy,ethnic,Hispanic or Latino,0,1,1
4087763,Gonococcal infection of other specified sites,ethnic,Hispanic or Latino,0,1,1
443617,Conduct disorder,racial,Native Hawaiian or Other Pacific Islander ,0,1,1
258441,Cholesteatoma of attic,racial,White,1,0,1
198246,Congenital hiatus hernia,ethnic,Not Hispanic or Latino,1,0,1
374649,Strabismic amblyopia,racial,Black or African American ,1,0,1
139841,Chronic frontal sinusitis,racial,Other Race,0,1,1
380727,Transient refractive change,racial,Unknown,1,0,1
4148115,Ectopic beats unspecified,racial,White,0,1,1
193597,Visible peristalsis,racial,White,0,1,1
432308,Mononeuritis of lower limb,racial,American Indian or Alaska Native ,1,0,1
197751,Burn of lower limb,racial,Unknown,1,0,1
443677,Open wound of knee and/or leg and/or ankle,racial,American Indian or Alaska Native ,1,0,1
432816,Tuberculosis of limb bones,racial,White,0,1,1
315831,Chronic pulmonary heart disease,racial,American Indian or Alaska Native ,0,1,1
76887,Disorders of urogenital prostheses or implants,racial,American Indian,1,0,1
372913,Impairment level: one eye: near-total impairment: other eye: not specified,racial,White,0,1,1
381007,Impairment level: better eye: profound impairment: lesser eye: not further specified,ethnic,Hispanic or Latino,0,1,1
432878,Drug abuse using speed,racial,Other Race,0,1,1
80861,Closed fracture of ischium,racial,Unknown,1,0,1
432382,Complication of labor AND/OR delivery,racial,White,1,0,1
77653,Traumatic myositis ossificans,racial,Other Race,0,1,1
4173657,Congenital malformation of the respiratory system,racial,Asian,0,1,1
201254,Insulin dependent diabetes mellitus,racial,American Indian or Alaska Native ,0,1,1
198978,Acute gonorrhea of lower genitourinary tract,racial,Asian,0,1,1
438912,Chemical burn of eyelid AND/OR periocular area,racial,White,0,1,1
200792,Retained placenta with no haemorrhage with postnatal problem,racial,White,1,0,1
200774,Detrusor and sphincter dyssynergia,racial,Unknown,1,0,1
442018,Foreign body accidentally left during a procedure,racial,Unknown,0,1,1
435018,Twin pregnancy - delivered,ethnic,Not Hispanic or Latino,1,0,1
312653,Acute myocarditis,ethnic,Hispanic or Latino,0,1,1
77069,Old posterior cruciate ligament disruption,racial,White,0,1,1
313209,Left bundle branch hemiblock,racial,American Indian,0,1,1
4104558,Unspecified blepharitis,racial,White,0,1,1
4088777,Vagina observation,racial,Native Hawaiian or Other Pacific Islander ,1,0,1
373692,West Nile encephalitis,racial,White,1,0,1
440211,Fetus OR newborn affected by morphologic abnormality of placenta,ethnic,Hispanic or Latino,0,1,1
4176874,Infantile melanodontia,racial,Asian,0,1,1
433862,Congenital anomaly of tongue,racial,Other Race,1,0,1
4004621,Other bone and cartilage disorders,ethnic,Not Hispanic or Latino,1,0,1
437240,Carcinoma in situ of skin of upper limb and shoulder,racial,White,1,0,1
197988,General abdominal pain-symptom,racial,Filipino,0,1,1
4152047,Lipid screening,racial,Filipino,1,0,1
140633,Vaccinia,racial,White,1,0,1
436166,Mild hyperemesis gravidarum,racial,Native Hawaiian or Other Pacific Islander ,1,0,1
197506,Malignant tumor of abdomen,racial,White,0,1,1
79098,Suppressed lactation,racial,White,0,1,1
73872,Congenital deformity of knee joint,ethnic,Not Hispanic or Latino,0,1,1
437088,Fetus OR newborn affected by oligohydramnios,racial,Unknown,1,0,1
192353,Disorder of gallbladder,racial,Asian,0,1,1
4062557,False labor,racial,Unknown,1,0,1
81695,Sprain of radiocarpal ligament,racial,White,1,0,1
27137,Open wound of mouth with complication,racial,Unknown,1,0,1
444421,Congenital malformation of liver,ethnic,Hispanic or Latino,1,0,1
40479575,Dysphasia as late effect of cerebrovascular disease,racial,Asian,0,1,1
195581,Peritoneal adhesion,racial,White,1,0,1
4169658,No help available,ethnic,Not Hispanic or Latino,1,0,1
432919,Discoid lupus erythematosus eyelid,ethnic,Hispanic or Latino,1,0,1
141499,Septicemia,racial,Black or African American ,0,1,1
260630,"Tuberculosis of lung, bacteriological and histological examination not done",racial,Unknown,0,1,1
133278,Disorder of hair,racial,Black or African American ,1,0,1
192286,Intestinal disaccharidase deficiency,racial,Black or African American ,1,0,1
432944,Major anomaly of jaw size,racial,White,0,1,1
432827,Infection due to Bacteroides,ethnic,Hispanic or Latino,0,1,1
133803,Periapical abscess with sinus tract,racial,Asian,1,0,1
198189,Suppurative peritonitis,ethnic,Not Hispanic or Latino,0,1,1
381021,Lagophthalmos,ethnic,Not Hispanic or Latino,0,1,1
74722,Secondary localized osteoarthrosis of pelvic region,racial,White,0,1,1
193249,Acute erosive gastritis,ethnic,Not Hispanic or Latino,0,1,1
436948,Benign neoplasm of choroid,racial,Unknown,1,0,1
137063,Corns and callus,racial,American Indian,1,0,1
137345,Pressure ulcer stage 4,racial,White,0,1,1
436485,Hyperemesis gravidarum with metabolic disturbance,ethnic,Not Hispanic or Latino,1,0,1
195007,Female stress incontinence,racial,Native Hawaiian or Other Pacific Islander ,1,0,1
441906,Prolapse of urethra,racial,White,1,0,1
4048727,Neoplasm screening,racial,Filipino,0,1,1
195793,Neoplasm of uncertain behavior of uterus,ethnic,Hispanic or Latino,1,0,1
434339,Adolescent - emotional problem,racial,Asian,0,1,1
197320,ARF - Acute renal failure,racial,American Indian,1,0,1
440105,Aqueous humour misdirect,ethnic,Hispanic or Latino,1,0,1
440516,Congenital ureterovesical obstruction,racial,White,0,1,1
137626,Seborrhoeic eczema of scalp,racial,Black or African American ,0,1,1
436254,Closed fractures of multiple bones of lower limb,racial,American Indian or Alaska Native ,1,0,1
432791,Urticaria-angio-oedema,racial,Filipino,0,1,1
4151727,Back disorders - other,racial,White,0,1,1
440695,Encopresis,racial,Other Race,0,1,1
4019044,Sprain of ischiocapsular ligament,racial,Other Race,1,0,1
437536,Somatoform autonomic dysfunction - gastrointestinal tract,racial,Black or African American ,1,0,1
81672,Nonallopathic lesion of thoracic region,racial,White,1,0,1
74250,Burn of foot,racial,Unknown,0,1,1
4153727,Closed fracture of other tarsal and metatarsal bones,racial,Unknown,0,1,1
4218764,Gastroschisis,ethnic,Not Hispanic or Latino,1,0,1
201117,Nonallopathic lesion of pelvic region,ethnic,Hispanic or Latino,1,0,1
4097567,Nodular lymphoma of unspecified site,racial,White,1,0,1
72410,Infection of bone,racial,Black or African American ,0,1,1
200459,Endometrial cystic hyperplasia,ethnic,Not Hispanic or Latino,1,0,1
374948,Acute nonsuppurative otitis media,racial,Asian,0,1,1
135027,"Carbuncle of leg, except foot",racial,Black or African American ,0,1,1
4296205,Second degree burn,racial,Black or African American ,1,0,1
312383,Postpartum cardiomyopathy,racial,Asian,1,0,1
196456,Cholecystolithiasis,racial,Filipino,1,0,1
438338,Epidemic meningitis,racial,Unknown,0,1,1
197344,Caesarean wound disruption,ethnic,Hispanic or Latino,1,0,1
435875,"Complications of pregnancy, childbirth and the puerperium",racial,Native Hawaiian or Other Pacific Islander ,1,0,1
4051241,FH: Asthma,ethnic,Hispanic or Latino,0,1,1
312349,Venous varices,racial,Asian Indian,1,0,1
4097704,Other specified leukaemia,ethnic,Hispanic or Latino,1,0,1
136916,Primary malignant neoplasm of skin of external auditory canal,racial,Unknown,1,0,1
141094,Lichen,racial,Unknown,1,0,1
4108664,Hypertensive heart disease NOS,ethnic,Not Hispanic or Latino,0,1,1
195312,Functional voiding disorder,racial,American Indian or Alaska Native ,1,0,1
376989,Duane's syndrome,ethnic,Hispanic or Latino,1,0,1
432672,Fissure of nipple,ethnic,Not Hispanic or Latino,0,1,1
434908,Disorder of porphyrin and haem metabolism,ethnic,Not Hispanic or Latino,0,1,1
256717,Bronchospasm,racial,Asian,0,1,1
443865,Non-infective colitis,racial,American Indian,1,0,1
22426,Congenital macrostomia,ethnic,Hispanic or Latino,0,1,1
4058984,Small kidneys unspecified,racial,White,1,0,1
200031,Viral hepatitis B with hepatic coma,racial,White,0,1,1
438171,Rupture of chordae tendineae,racial,Unknown,1,0,1
137626,Seborrhoeic eczema of scalp,racial,Native Hawaiian or Other Pacific Islander ,0,1,1
137989,Abnormal results of cardiovascular function studies,racial,Asian,1,0,1
438058,Rape - assault,ethnic,Not Hispanic or Latino,1,0,1
73373,Burn erythema of upper limb,racial,White,0,1,1
378352,Conjunctivitis due to adenovirus,racial,White,1,0,1
4104391,"Better eye: moderate visual impairment, Lesser eye: moderate visual impairment",ethnic,Hispanic or Latino,1,0,1
4112365,Woakes' ethmoiditis,racial,Unknown,0,1,1
443315,"Motor vehicle traffic accident due to motor vehicle going out of control due to burst tire, without collision on the highway, driver of motor vehicle injured",ethnic,Hispanic or Latino,0,1,1
379021,Impairment level: one eye: moderate impairment: other eye: near-normal vision,ethnic,Hispanic or Latino,0,1,1
432729,Crying infant,racial,Black or African American ,1,0,1
135766,Leukaemia in remission,racial,White,1,0,1
4062491,Anemia screening,racial,Other Race,0,1,1
192676,Cervical intraepithelial neoplasia grade 1,racial,Other Race,1,0,1
435792,Drug-induced sleep disorder,racial,Black or African American ,1,0,1
256450,Pulmonary asbestosis,ethnic,Hispanic or Latino,0,1,1
376657,Lipoma of face,racial,Other Race,1,0,1
27587,Disturbance of salivary secretion,racial,Asian,1,0,1
72471,Sprain of carpometacarpal joint,racial,Other Race,1,0,1
377558,Irregular astigmatism,ethnic,Not Hispanic or Latino,1,0,1
439791,Emotional upset,racial,Black or African American ,0,1,1
432537,Assault by handgun,ethnic,Hispanic or Latino,0,1,1
4109564,Unspecified corneal ulcer,racial,Unknown,1,0,1
435235,Chronic latent schizophrenia,ethnic,Hispanic or Latino,1,0,1
374040,Ill-defined disorder of eye,racial,Black or African American ,0,1,1
319049,Acute respiratory failure,racial,Asian,0,1,1
380103,Retinal detachment with retinal defect,racial,Asian,1,0,1
441980,Closed fracture of foot,racial,Asian,1,0,1
197018,Chronic gastric ulcer with hemorrhage but without obstruction,racial,Unknown,1,0,1
378425,Eyelid inflammation,racial,American Indian,1,0,1
4166443,Family history: Arthritis,racial,Other Race,1,0,1
4104386,"Better eye: profound visual impairment, Lesser eye: profound visual impairment",racial,White,0,1,1
433033,Abnormal cervical Papanicolaou smear,racial,Other Race,1,0,1
4143292,Varicose veins of legs in the puerperium,racial,Asian,1,0,1
24660,Acute tonsillitis,racial,American Indian,1,0,1
443750,Nonvenomous insect bite of finger without infection,racial,White,1,0,1
436075,Adjustment disorder with anxious mood,racial,Asian,1,0,1
443428,Torus fracture of radius,racial,Unknown,1,0,1
441181,Effects of high altitude,racial,White,1,0,1
439796,"Nondependent cocaine abuse, continuous",ethnic,Not Hispanic or Latino,0,1,1
77076,Diastasis of muscle,ethnic,Not Hispanic or Latino,1,0,1
73560,Calcaneal spur,racial,American Indian or Alaska Native ,1,0,1
72501,Superficial foreign body of foot without major open wound AND without infection,ethnic,Not Hispanic or Latino,1,0,1
441480,Poisoning by androgen AND/OR anabolic congener,racial,White,0,1,1
432637,Scleritis with corneal involvement,racial,Unknown,1,0,1
437384,Raised laboratory findings,racial,Unknown,1,0,1
4216906,Suture of laceration of external ear,racial,White,0,1,1
378429,Rosacea conjunctivitis,racial,White,0,1,1
320116,Acute pericarditis,ethnic,Not Hispanic or Latino,0,1,1
198797,Umbilical hernia with gangrene,racial,Unknown,1,0,1
441741,"Motor vehicle accident, passenger",racial,White,1,0,1
376399,Incipient cataract,ethnic,Not Hispanic or Latino,1,0,1
4111998,Esophageal varices associated with another disorder,ethnic,Hispanic or Latino,0,1,1
133547,Pyoderma,ethnic,Not Hispanic or Latino,0,1,1
4166080,Decompression of median nerve,racial,Unknown,1,0,1
4104401,Unspecified corneal oedema,racial,Unknown,1,0,1
437537,Shyness disorder of childhood,ethnic,Not Hispanic or Latino,1,0,1
141673,Aseptic necrosis of head of humerus,racial,Unknown,0,1,1
437273,Glaucoma capsulare,racial,Asian,0,1,1
380375,Organic personality disorder,ethnic,Not Hispanic or Latino,1,0,1
378768,Acute sanguinous otitis media,racial,White,1,0,1
198313,Burn erythema of abdominal wall,racial,Unknown,1,0,1
437186,Hypothermia - accidental,racial,Unknown,0,1,1
4056620,Other urethritis,racial,Asian,0,1,1
79916,Acquired hallux rigidus,ethnic,Not Hispanic or Latino,0,1,1
442764,Anal pain,racial,Other Race,0,1,1
433978,Benign tumour of laryngopharynx,racial,White,0,1,1
4138253,Malabsorption syndrome,racial,Other Race,1,0,1
438837,Boutonniere deformity,racial,White,1,0,1
136516,Congenital pes planus,racial,Other Race,1,0,1
435271,Mooren ulcer,racial,Unknown,0,1,1
75971,Open wound of multiple sites of one upper limb with tendon involvement,racial,White,1,0,1
434155,"Intraventricular (nontraumatic) haemorrhage, grade 3, of foetus and newborn",racial,White,0,1,1
80541,Closed fracture of eight OR more ribs,ethnic,Hispanic or Latino,1,0,1
440556,Closed transcervical fracture of femur,ethnic,Not Hispanic or Latino,0,1,1
436489,Complication of obstetrical surgery AND/OR procedure,racial,White,1,0,1
4078366,Repair of syndactyly,racial,White,0,1,1
4308543,Postoperative infection NOS,racial,White,1,0,1
4063026,Herpes gestationis NOS,ethnic,Not Hispanic or Latino,1,0,1
4091319,Streptococcal sore throat with scarlatina NOS,racial,Native Hawaiian or Other Pacific Islander ,1,0,1
137350,Radiation dermatitis,racial,Unknown,1,0,1
135611,Furuncle of hand,racial,Unknown,0,1,1
436230,Blood chemistry abnormal,racial,Native Hawaiian or Other Pacific Islander ,1,0,1
80591,Superficial injury of hand without infection,racial,White,0,1,1
72715,Exostosis,racial,Native Hawaiian or Other Pacific Islander ,0,1,1
376394,Menstrual migraine,racial,Other Race,1,0,1
434572,"Pinta, intermediate lesion",ethnic,Hispanic or Latino,1,0,1
78769,Acute petrositis,racial,White,1,0,1
24977,Mucocele of salivary gland,racial,Other Race,0,1,1
195213,Aldosteronism,ethnic,Hispanic or Latino,0,1,1
25189,Malignant tumour of mouth,ethnic,Hispanic or Latino,0,1,1
75555,Viral labyrinthitis,racial,American Indian or Alaska Native ,1,0,1
433942,Accident whilst engaged in household activity,racial,Black or African American ,0,1,1
315296,Preinfarction syndrome,racial,Filipino,1,0,1
440202,Multiple congenital malformations,racial,Other Race,1,0,1
194393,CACS - Coeliac axis compression syndrome,racial,White,1,0,1
4343820,Diagnostic arthroscopy of hip joint,racial,Unknown,1,0,1
441364,Complications of the puerperium,racial,Unknown,1,0,1
440940,Methicillin resistant Staphylococcus aureus infection,racial,Black or African American ,1,0,1
22856,Polyglandular dysfunction,ethnic,Not Hispanic or Latino,0,1,1
442864,"Splinter of elbow, without major open wound, infected",racial,White,1,0,1
74513,Open wound of foot without mention of complication,racial,Native Hawaiian or Other Pacific Islander ,1,0,1
436235,Taste sense altered,racial,Asian,1,0,1
4056620,Other urethritis,ethnic,Hispanic or Latino,0,1,1
440703,Trigeminal nerve disorder,racial,Other Race,1,0,1
193238,Acute appendicitis with peritoneal abscess,ethnic,Hispanic or Latino,0,1,1
321638,"Benign essential hypertension complicating pregnancy, childbirth and the puerperium",racial,Unknown,1,0,1
437896,Disorder of language,racial,American Indian or Alaska Native ,0,1,1
434657,Weakness of face muscles,racial,Unknown,1,0,1
434742,Congenital abnormality of skull and face bones,racial,Native Hawaiian or Other Pacific Islander ,1,0,1
437791,Chickenpox with complication,ethnic,Not Hispanic or Latino,0,1,1
194984,Hepatopathy,racial,American Indian or Alaska Native ,1,0,1
192859,Postablative ovarian failure,racial,White,1,0,1
437902,Teeth development and eruption disorders,racial,American Indian or Alaska Native ,1,0,1
4064917,Urinary neoplasm screening,racial,Unknown,0,1,1
372887,Disease of brain,racial,Black or African American ,0,1,1
199726,Granuloma inguinale,racial,Unknown,1,0,1
137652,Specific bursitis often of occupational origin,ethnic,Hispanic or Latino,0,1,1
140018,Tuberculous abscess of spinal cord,racial,White,0,1,1
192667,Atrophic gastritis,racial,Filipino,1,0,1
4104072,Purulent otitis media NOS,ethnic,Hispanic or Latino,1,0,1
4014230,Ankle sprain NOS,racial,Native Hawaiian or Other Pacific Islander ,0,1,1
439136,"Asphyxia, in liveborn infant",ethnic,Not Hispanic or Latino,0,1,1
4156802,"Blister of finger, infected",ethnic,Not Hispanic or Latino,1,0,1
375252,Disorder of eye,racial,Filipino,1,0,1
438134,Excessive sleep,racial,Asian,0,1,1
436948,Benign neoplasm of choroid,racial,White,0,1,1
80819,Acquired hallux varus,racial,Black or African American ,1,0,1
197006,Residual hemorrhoidal skin tags,racial,Black or African American ,1,0,1
254561,Pneumonic plague,racial,White,1,0,1
4053387,Family history of polycystic kidney,racial,Unknown,1,0,1
193322,Right lower quadrant pain,racial,Native Hawaiian or Other Pacific Islander ,0,1,1
441906,Prolapse of urethra,racial,Unknown,1,0,1
440603,Blood transfusion reaction,ethnic,Hispanic or Latino,1,0,1
75605,Intrauterine death affecting management of mother,ethnic,Hispanic or Latino,1,0,1
24230,Laryngeal FB - foreign body,racial,Black or African American ,0,1,1
40484952,Retinal function study abnormal,racial,White,1,0,1
440371,Disorder of immune function,ethnic,Hispanic or Latino,1,0,1
372409,Sciatica neuralgia,racial,Filipino,1,0,1
254068,Upper respiratory disease,racial,Other Race,1,0,1
441026,Orbital deformity due to trauma,ethnic,Hispanic or Latino,1,0,1
4256640,Body mass index 40+ - severely obese,racial,Native Hawaiian or Other Pacific Islander ,0,1,1
135975,Blister of finger without infection,racial,Unknown,1,0,1
79911,Effusion of joint of upper arm,racial,Unknown,1,0,1
438170,Acute myocardial infarction of inferior wall,racial,Filipino,0,1,1
436256,Open fracture metatarsal,ethnic,Hispanic or Latino,1,0,1
320682,Finding of white blood cell number,racial,Black or African American ,1,0,1
4100382,Acute hysterical psychosis,racial,White,1,0,1
321483,Respiratory complication,ethnic,Not Hispanic or Latino,1,0,1
194475,Singultus,racial,Native Hawaiian or Other Pacific Islander ,0,1,1
81696,Closed fracture of acetabulum,racial,Asian,1,0,1
381569,Myogenic ptosis,ethnic,Hispanic or Latino,0,1,1
259874,Ulceration of vulva associated with another disorder,ethnic,Hispanic or Latino,1,0,1
443081,Drowning and non-fatal immersion,racial,Black or African American ,0,1,1
4133967,Meckel's diverticulum,racial,White,0,1,1
373449,Drug-induced delirium,ethnic,Not Hispanic or Latino,0,1,1
196159,Old laceration of pelvic floor muscle,racial,Other Race,1,0,1
261255,Benign neoplasm of bronchus and lung,ethnic,Hispanic or Latino,1,0,1
434254,Heat stroke and sunstroke,ethnic,Not Hispanic or Latino,0,1,1
193552,Furuncle of skin AND/OR subcutaneous tissue,racial,Asian,0,1,1
437505,Nodular lymphoma of lymph nodes of axilla and upper limb,racial,Unknown,1,0,1
140487,Dermatitis herpetiformis,ethnic,Not Hispanic or Latino,0,1,1
435410,Burn of palm,racial,White,1,0,1
437169,Disorder of transplanted bone marrow,racial,White,0,1,1
440988,Antisocial personality disorder,racial,White,0,1,1
4073865,Construction of penis,racial,White,0,1,1
81395,Metatarsus primus varus,racial,White,0,1,1
136264,Open wound of floor of mouth without complication,racial,American Indian or Alaska Native ,1,0,1
439799,Leg cramps,racial,Native Hawaiian or Other Pacific Islander ,0,1,1
75971,Open wound of multiple sites of one upper limb with tendon involvement,racial,Unknown,1,0,1
436919,Primary malignant neoplasm of unspecified site,racial,Black or African American ,0,1,1
76498,Arthropathy associated with bacterial disease,racial,White,1,0,1
74726,Dislocated joint,ethnic,Not Hispanic or Latino,1,0,1
440994,Psychic factor associated with another disorder,ethnic,Hispanic or Latino,1,0,1
133669,Superficial burn of lower leg,ethnic,Hispanic or Latino,0,1,1
443257,Swellings and lumps,racial,American Indian,1,0,1
199867,CPH - Chronic persistent hepatitis,racial,Asian,1,0,1
440577,Late effect of radiation,ethnic,Hispanic or Latino,1,0,1
4285417,Incision of pituitary gland,ethnic,Not Hispanic or Latino,0,1,1
443111,Tenosynovitis of foot,racial,American Indian or Alaska Native ,0,1,1
381035,Vertigo of central origin,ethnic,Not Hispanic or Latino,1,0,1
261904,Class III buccal segment relationship,racial,White,1,0,1
201635,Female infertility of uterine origin,ethnic,Hispanic or Latino,1,0,1
197227,Overlapping malignant neoplasm of gastrointestinal tract,racial,White,0,1,1
436588,Traumatic wound dehiscence,ethnic,Hispanic or Latino,1,0,1
435574,Abnormal form of root of tooth,racial,Unknown,1,0,1
201254,Insulin dependent diabetes mellitus,racial,Filipino,0,1,1
258079,Histoplasmosis with pneumonia,ethnic,Hispanic or Latino,1,0,1
439941,Closed fracture of condyle of humerus,ethnic,Not Hispanic or Latino,0,1,1
315296,Preinfarction syndrome,racial,Other Race,1,0,1
373205,Hemorrhage of eyelid,ethnic,Not Hispanic or Latino,0,1,1
4089998,Other venereal diseases,ethnic,Hispanic or Latino,1,0,1
440238,Closed fracture of metatarsal bone,racial,American Indian or Alaska Native ,1,0,1
141038,Diastolic dysfunction,ethnic,Not Hispanic or Latino,1,0,1
444291,Cochlear hearing loss,racial,Asian,1,0,1
436730,"Appendicitis, unqualified",racial,Black or African American ,1,0,1
372765,Open wound of head without complication,racial,Other Race,1,0,1
192676,Cervical intraepithelial neoplasia grade 1,racial,American Indian or Alaska Native ,1,0,1
440905,Toxic effect of venom,racial,Asian,1,0,1
436253,Sprain of foot,racial,Asian,1,0,1
192854,Interstitial uterine fibroid,racial,Asian,1,0,1
441737,Bruising,racial,Filipino,1,0,1
438737,Acute paranoid reaction,ethnic,Hispanic or Latino,1,0,1
433930,Motor vehicle on road in collision with another motor vehicle,racial,Unknown,1,0,1
81379,Lateral epicondylitis,racial,Filipino,0,1,1
443753,Abrasion AND/OR friction burn of wrist without infection,racial,Asian,0,1,1
136057,Benign neoplasm of skin of trunk,racial,American Indian or Alaska Native ,1,0,1
260936,Infiltrative tuberculosis of lung,ethnic,Hispanic or Latino,0,1,1
440066,Disorder of purine and pyrimidine metabolism,racial,Asian,1,0,1
197925,Haemorrhage of rectum and anus,racial,Filipino,0,1,1
258866,Respiratory distress syndrome in the newborn,ethnic,Hispanic or Latino,0,1,1
4143915,Cholestasis,racial,Other Race,1,0,1
78272,Sprain of wrist,racial,Native Hawaiian or Other Pacific Islander ,1,0,1
72245,Chlamydial infection of lower genitourinary tract,racial,Black or African American ,0,1,1
73754,Restless legs,racial,Native Hawaiian or Other Pacific Islander ,0,1,1
440211,Fetus OR newborn affected by morphologic abnormality of placenta,ethnic,Not Hispanic or Latino,0,1,1
432814,Device withdrawn and / or removed,racial,Unknown,0,1,1
73851,Effusion of joint of multiple sites,ethnic,Hispanic or Latino,1,0,1
140057,Chronic leukemia,ethnic,Hispanic or Latino,0,1,1
135858,Disorder of lip,racial,Native Hawaiian or Other Pacific Islander ,0,1,1
433823,"Infections of pregnancy, childbirth and the puerperium",ethnic,Not Hispanic or Latino,1,0,1
374168,Complex febrile seizure,racial,Unknown,0,1,1
74132,Degeneration of lumbosacral intervertebral disc,racial,Filipino,1,0,1
434012,Developmental dyslexia,ethnic,Not Hispanic or Latino,0,1,1
442794,Poisoning by wasp sting,racial,Asian,1,0,1
198528,Acquired unequal leg length,racial,Other Race,0,1,1
4303359,Acute septal infarction,ethnic,Hispanic or Latino,1,0,1
441269,Autoimmune hemolytic anemia,racial,Black or African American ,1,0,1
77961,Disseminated idiopathic skeletal hyperostosis,racial,Black or African American ,0,1,1
133803,Periapical abscess with sinus tract,ethnic,Hispanic or Latino,1,0,1
314090,PET - Mild pre-eclamptic toxaemia,ethnic,Not Hispanic or Latino,1,0,1
4286638,Childhood,racial,White,0,1,1
4054550,Open wound of scrotum and testes,racial,White,0,1,1
133284,Impetigo herpetiformis,racial,Unknown,0,1,1
434459,Ganglion of tendon sheath,racial,Native Hawaiian or Other Pacific Islander ,0,1,1
435887,Antepartum deep phlebothrombosis,ethnic,Hispanic or Latino,0,1,1
4299535,Pregnancy confirmed,racial,Native Hawaiian or Other Pacific Islander ,1,0,1
434111,Oligohydramnios,ethnic,Hispanic or Latino,1,0,1
443458,Closed fracture of facial bone,ethnic,Not Hispanic or Latino,1,0,1
133569,Fasciitis,racial,Other Race,1,0,1
4085803,Microsporosis nigra,racial,Other Race,1,0,1
442941,"Nontraffic accident involving being trapped by door of motor vehicle whilst boarding or alighting from motor vehicle, except off-road vehicle, not on highway, driver of motor vehicle injured",ethnic,Hispanic or Latino,0,1,1
437015,Congenital alveolar hyperplasia of mandible,ethnic,Hispanic or Latino,1,0,1
381569,Myogenic ptosis,racial,Asian,0,1,1
433390,Immunosuppressant adverse reaction,racial,Other Race,1,0,1
4008089,Dysentery,racial,Asian,1,0,1
443709,Atypical squamous cells of undetermined significance on anal Papanicolaou smear,racial,Unknown,1,0,1
4120666,Conjunctival biopsy,racial,White,1,0,1
378849,Microtia,racial,Black or African American ,0,1,1
4016888,Rabies contact,ethnic,Hispanic or Latino,1,0,1
4110945,Benign hypertensive heart disease NOS,ethnic,Not Hispanic or Latino,1,0,1
438205,Maternal syphilis during pregnancy - baby not yet delivered,ethnic,Not Hispanic or Latino,1,0,1
443750,Nonvenomous insect bite of finger without infection,racial,Unknown,1,0,1
254390,Malignant effusion,racial,Asian,0,1,1
438872,Hyperphagia,racial,Black or African American ,1,0,1
434633,Disorder of autonomic nervous system,racial,Unknown,0,1,1
78529,Kyphoscoliosis and scoliosis,racial,Other Race,1,0,1
318174,Phlebitis,racial,Unknown,0,1,1
442075,Chronic glomerulonephritis associated with another disorder,ethnic,Hispanic or Latino,0,1,1
378735,Migraine without aura,racial,Black or African American ,0,1,1
23798,Acute laryngopharyngitis,racial,Asian,0,1,1
137785,Verruca plantaris,racial,Asian Indian,0,1,1
73090,Superficial bruising of foot,racial,Asian,1,0,1
197096,Urethra and bladder neck atresia and stenosis,racial,White,0,1,1
75053,Fracture of bone,racial,Asian,1,0,1
434323,Disorder of sulphur-bearing amino acid metabolism,racial,Asian,1,0,1
193256,Alcoholic fatty liver,racial,Other Race,0,1,1
195562,Hemorrhoids,racial,Asian Indian,1,0,1
4098600,Gouty nephropathy unspecified,racial,Unknown,1,0,1
442300,"Thyroid disease in mother complicating pregnancy, childbirth AND/OR puerperium",ethnic,Hispanic or Latino,1,0,1
4149353,"Attention deficit hyperactivity disorder, predominantly inattentive type",racial,Native Hawaiian or Other Pacific Islander ,0,1,1
72996,"Stiff joint NEC, of the lower leg",ethnic,Not Hispanic or Latino,0,1,1
4287237,Vascular hamartoma of skin,racial,American Indian or Alaska Native ,0,1,1
380728,Filamentary keratitis,ethnic,Not Hispanic or Latino,1,0,1
78517,Arthralgia of multiple joints,racial,Filipino,1,0,1
200445,Chronic prostatitis,racial,Asian,0,1,1
440953,Cysticercosis,racial,Filipino,1,0,1
433320,Excessive crying of child,racial,Asian,0,1,1
444052,"Bone AND/OR joint disorder of back in mother complicating pregnancy, childbirth AND/OR puerperium",ethnic,Hispanic or Latino,1,0,1
439391,Physical abuse of adult,racial,Asian,1,0,1
375290,Chronic suppurative otitis media - tubotympanic,ethnic,Not Hispanic or Latino,0,1,1
4098582,Hyperemesis gravidarum before end of 22 week gestation with carbohydrate depletion,racial,Unknown,1,0,1
436373,DSD - Developmental speech disorder,racial,Native Hawaiian or Other Pacific Islander ,0,1,1
437838,"Cannabis dependence, episodic",ethnic,Hispanic or Latino,0,1,1
198191,Acquired hypertrophic pyloric stenosis,racial,Other Race,1,0,1
438941,Poisoning by hydantoin derivative,ethnic,Hispanic or Latino,1,0,1
380038,Viral conjunctivitis,racial,Black or African American ,0,1,1
77815,"Benign neoplasm of vertebral column, excluding sacrum and coccyx",ethnic,Hispanic or Latino,1,0,1
4046893,Lifestyle,racial,Asian,0,1,1
439894,Post-term pregnancy - delivered,racial,White,1,0,1
433759,Developmental reading disorder,racial,Unknown,1,0,1
440865,Closed fracture of epiphysis of femur,ethnic,Hispanic or Latino,0,1,1
436546,Strain of subscapularis muscle,racial,Asian,0,1,1
137322,Oral submucosal fibrosis,racial,White,1,0,1
195312,Functional voiding disorder,racial,Filipino,1,0,1
4191387,Infertility care,ethnic,Hispanic or Latino,0,1,1
444200,Neoplasm of nervous system,ethnic,Not Hispanic or Latino,1,0,1
4073858,Excision of cyst of epididymis,ethnic,Hispanic or Latino,0,1,1
432541,Primary tuberculosis,racial,White,0,1,1
138312,Burn of scalp,racial,White,1,0,1
434614,Disorder of iron metabolism,racial,White,0,1,1
197039,Male genital organ vascular diseases,racial,White,0,1,1
381549,Migraine with aura,racial,Filipino,1,0,1
76797,Congenital deformity of genital organ,racial,American Indian,0,1,1
439960,Late effect of external cause,ethnic,Not Hispanic or Latino,1,0,1
4017388,Closed dislocation lumbar spine,racial,Asian,1,0,1
197601,Spermatocele,racial,Asian,0,1,1
72992,Allergic arthritis,racial,Black or African American ,1,0,1
432725,Congenital anomaly of integument,racial,Black or African American ,1,0,1
4175807,Rheumatic disease of tricuspid valve,ethnic,Not Hispanic or Latino,1,0,1
4101660,Amputated below knee,racial,Alaska Native,1,0,1
4147630,Other disorders of binocular eye movements,ethnic,Not Hispanic or Latino,1,0,1
199726,Granuloma inguinale,racial,White,1,0,1
436466,Balanoposthitis,racial,Filipino,0,1,1
4343127,Evans operation,racial,White,0,1,1
200459,Endometrial cystic hyperplasia,ethnic,Hispanic or Latino,1,0,1
372330,Acute allergic mucoid otitis media,ethnic,Hispanic or Latino,1,0,1
375817,Conjunctivochalasis,racial,Unknown,1,0,1
80205,Perinatal condition,ethnic,Not Hispanic or Latino,0,1,1
193541,Perineal laceration involving anal sphincter,racial,Unknown,1,0,1
436366,Benign tumour of testis,racial,Unknown,0,1,1
4292726,Contact - infectious disease,racial,American Indian,1,0,1
440309,Adverse reaction to diphtheria vaccine,racial,Other Race,0,1,1
435170,Effects of thirst,ethnic,Not Hispanic or Latino,1,0,1
436222,Altered mental status,racial,American Indian,1,0,1
196462,Unilateral recurrent femoral hernia without obstruction AND without gangrene,ethnic,Hispanic or Latino,1,0,1
4234546,Nasolacrimal duct probe - diag,ethnic,Hispanic or Latino,0,1,1
76196,Palindromic rheumatism,ethnic,Hispanic or Latino,0,1,1
438931,Foreign body accidentally entering eye and adnexa,ethnic,Not Hispanic or Latino,0,1,1
440525,Prematurity of fetus,racial,Filipino,1,0,1
4118958,Unilateral total thyroid lobectomy,racial,Unknown,1,0,1
134441,Chronic ulcer of skin,racial,Black or African American ,1,0,1
439053,Exostosis of jaw,racial,Unknown,1,0,1
75413,Burn of wrist,racial,Unknown,1,0,1
437744,Heat exhaustion,ethnic,Not Hispanic or Latino,1,0,1
4095592,Malignant melanoma of scalp and/or neck,racial,White,1,0,1
257423,"Late effect of burns of eye, face, head AND/OR neck",racial,White,0,1,1
432296,Coagulation factor deficiency syndrome,racial,Black or African American ,1,0,1
194704,Spontaneous abortion complicated by embolism,racial,Unknown,1,0,1
442920,Mental disorder during pregnancy - baby delivered,racial,White,1,0,1
375525,Athetoid cerebral palsy,racial,Unknown,0,1,1
438912,Chemical burn of eyelid AND/OR periocular area,racial,Unknown,1,0,1
193666,Hip injury,racial,Asian Indian,0,1,1
195584,Acute peptic ulcer without hemorrhage AND without perforation but with obstruction,ethnic,Not Hispanic or Latino,0,1,1
77069,Old posterior cruciate ligament disruption,racial,Unknown,0,1,1
433320,Excessive crying of child,ethnic,Not Hispanic or Latino,0,1,1
73534,Disproportion between fetus and pelvis,racial,White,1,0,1
4143490,Blindness or low vision NOS,ethnic,Hispanic or Latino,0,1,1
318450,Cardiac tamponade,racial,White,0,1,1
194152,Renal agenesis and dysgenesis,racial,Black or African American ,1,0,1
443421,Gallbladder and bile duct calculi,ethnic,Not Hispanic or Latino,1,0,1
441015,Pigmentary iris degeneration,racial,White,1,0,1
375290,Chronic suppurative otitis media - tubotympanic,racial,Asian,0,1,1
77673,Sign or symptom of the urinary system,racial,Black or African American ,1,0,1
313209,Left bundle branch hemiblock,racial,Asian,0,1,1
442011,Mechanical complication due to cardiac pacemaker electrode,racial,Unknown,1,0,1
443235,Ankle and/or foot joint stiffness,ethnic,Hispanic or Latino,0,1,1
254669,Disease of vocal cords,ethnic,Not Hispanic or Latino,1,0,1
381275,Anterior horn cell disease,ethnic,Hispanic or Latino,1,0,1
378420,Carcinomatous neuropathy,racial,White,1,0,1
4104558,Unspecified blepharitis,racial,Unknown,1,0,1
140961,Infestation by Phthirus pubis,racial,White,0,1,1
75046,Old bucket handle tear of medial meniscus,racial,Black or African American ,0,1,1
318382,Malignant mast cell tumor of extranodal AND/OR solid organ site,racial,White,0,1,1
257293,Disorder of visual pathways,racial,Other Race,0,1,1
443178,"Insect bite, nonvenomous, of face",racial,Unknown,1,0,1
375475,Meningoencephalitis due to acquired toxoplasmosis,racial,Black or African American ,0,1,1
317576,Coronary arteriosclerosis,racial,American Indian,1,0,1
440820,Contracture of wrist joint,racial,Unknown,0,1,1
4109544,"Total, mature senile cataract",racial,White,1,0,1
433376,Burning due to contact with hot solid objects and materials,ethnic,Hispanic or Latino,1,0,1
74698,Breech presentation,racial,Other Race,1,0,1
440021,Herpes simplex without complication,racial,American Indian,1,0,1
140266,Superficial bruising of back,racial,Black or African American ,1,0,1
316822,Finding of heart murmur,racial,African American,1,0,1
4062557,False labor,racial,White,1,0,1
4103752,Limited eye examination,racial,White,1,0,1
318222,Acute adenitis,racial,Asian,1,0,1
78621,Crushing injury of knee,racial,White,0,1,1
313543,Venous complication in pregnancy AND/OR the puerperium,ethnic,Not Hispanic or Latino,1,0,1
197751,Burn of lower limb,racial,White,0,1,1
75667,Sprain of calcaneofibular ligament,ethnic,Not Hispanic or Latino,0,1,1
443533,"Epispadias, male",ethnic,Hispanic or Latino,0,1,1
434002,Mineral deficiency,racial,Unknown,1,0,1
444453,Benign tumour of soft tissue of leg,ethnic,Not Hispanic or Latino,0,1,1
4104555,Other and unspecified conjunctivitis,racial,Asian,1,0,1
437093,Congenital ptosis of upper eyelid,racial,Asian,0,1,1
314666,Healed coronary,racial,Asian Indian,0,1,1
4097586,Myeloid leukaemia NOS,racial,White,0,1,1
196364,Benign tumour of cervix,ethnic,Hispanic or Latino,1,0,1
73845,Ankylosis of joint of shoulder region,ethnic,Hispanic or Latino,1,0,1
81696,Closed fracture of acetabulum,ethnic,Not Hispanic or Latino,1,0,1
75863,Chronic interstitial cystitis,racial,American Indian or Alaska Native ,1,0,1
78233,Old disruption of medial collateral ligament,racial,Unknown,1,0,1
435796,Dehydration,racial,Native Hawaiian or Other Pacific Islander ,1,0,1
433316,Giddiness,racial,American Indian,1,0,1
195401,Superficial bruising of hip,ethnic,Not Hispanic or Latino,1,0,1
81984,Sprain of shoulder and upper arm,racial,Filipino,0,1,1
80946,Tinea manus,racial,Black or African American ,1,0,1
198192,Renal and perinephric abscess,ethnic,Hispanic or Latino,1,0,1
437249,Recurrent manic episodes,racial,White,1,0,1
4145010,Knee enthesopathy NOS,racial,White,0,1,1
4088072,Pulmonary tuberculosis NOS,racial,Unknown,1,0,1
444212,Injury of descending left colon without open wound into abdominal cavity,ethnic,Hispanic or Latino,0,1,1
4220063,"Repair of knee, five-in-one",ethnic,Hispanic or Latino,1,0,1
133547,Pyoderma,ethnic,Hispanic or Latino,1,0,1
196284,Burn of mouth and pharynx,racial,White,1,0,1
195306,Gastroduodenitis,racial,American Indian,0,1,1
80205,Perinatal condition,racial,Asian,0,1,1
318137,Phlebitis and thrombophlebitis of intracranial sinuses,ethnic,Hispanic or Latino,0,1,1
260430,Pneumonia due to E. coli,ethnic,Not Hispanic or Latino,0,1,1
200792,Retained placenta with no haemorrhage with postnatal problem,racial,Unknown,1,0,1
133737,Acute thyroiditis,racial,Unknown,1,0,1
377555,Solar retinitis,racial,White,1,0,1
255302,Spontaneous pneumothorax,racial,Other Race,0,1,1
4104391,"Better eye: moderate visual impairment, Lesser eye: moderate visual impairment",ethnic,Not Hispanic or Latino,1,0,1
444437,Congenital abnormality of cervix,racial,Black or African American ,1,0,1
4175807,Rheumatic disease of tricuspid valve,racial,Asian,1,0,1
23808,"Chronic peptic ulcer without hemorrhage, without perforation AND without obstruction",racial,Unknown,1,0,1
4156802,"Blister of finger, infected",racial,Asian,1,0,1
40479583,Iatrogenic pneumothorax,ethnic,Not Hispanic or Latino,0,1,1
432620,Disorder of choroid of eye,racial,White,1,0,1
4061587,Obstetric pulmonary embolism NOS,ethnic,Hispanic or Latino,0,1,1
381783,Viral disease of central nervous system,racial,White,0,1,1
440396,Glaucoma associated with ocular trauma,ethnic,Not Hispanic or Latino,0,1,1
432588,Megaloblastic anemia due to vitamin B>12< deficiency,racial,Asian,0,1,1
443111,Tenosynovitis of foot,racial,Filipino,1,0,1
141004,Lesion of radial nerve,racial,White,0,1,1
4192676,Born by caesarean section,ethnic,Not Hispanic or Latino,1,0,1
73925,Burn of upper limb,racial,White,0,1,1
433413,Disease due to Adenovirus,ethnic,Hispanic or Latino,1,0,1
437580,Retropharyngeal abscess,racial,White,1,0,1
77317,Chronic ulcerative rectosigmoiditis,ethnic,Hispanic or Latino,1,0,1
314409,Vascular disorder of penis,racial,White,0,1,1
378081,Overlapping malignant neoplasm of connective and other soft tissues,ethnic,Hispanic or Latino,0,1,1
23245,Hemorrhage of esophagus,ethnic,Hispanic or Latino,0,1,1
375807,Degenerative disorder of globe,racial,White,1,0,1
379812,Exposure keratitis,racial,White,1,0,1
434089,Antepartum hemorrhage,racial,Unknown,1,0,1
73231,Arthralgia of temporomandibular joint,racial,American Indian or Alaska Native ,1,0,1
4285417,Incision of pituitary gland,ethnic,Hispanic or Latino,1,0,1
441546,Functional vomiting,ethnic,Not Hispanic or Latino,0,1,1
440066,Disorder of purine and pyrimidine metabolism,ethnic,Not Hispanic or Latino,1,0,1
441153,Closed supracondylar fracture of femur,racial,Unknown,1,0,1
137275,Disorder of muscle,racial,Other Race,0,1,1
434165,Abnormal cervical smear,racial,Filipino,1,0,1
195019,"Pelvic soft tissue abnormality in pregnancy, childbirth and the puerperium with antenatal problem",ethnic,Hispanic or Latino,1,0,1
436222,Altered mental status,racial,Black or African American ,0,1,1
381677,SBO - Spina bifida occulta,racial,Asian,0,1,1
79904,Secondary localised osteoarthrosis of hand,ethnic,Not Hispanic or Latino,0,1,1
194686,Acquired renal cyst,racial,American Indian,0,1,1
132776,Injury involving multiple body regions,racial,Unknown,1,0,1
373201,Acute eustachian tube salpingitis,racial,White,1,0,1
4168396,Dilation of cervix uteri and curettage for termination of pregnancy,racial,White,1,0,1
437894,Ventricular fibrillation,racial,Native Hawaiian or Other Pacific Islander ,0,1,1
133283,Pyoderma gangrenosum,ethnic,Hispanic or Latino,1,0,1
443228,"Abrasion or friction burn of foot and toe, without mention of infection",racial,Other Race,0,1,1
373724,Neoplasm of brain,racial,Other Race,0,1,1
140582,Superficial burn of foot,racial,Other Race,1,0,1
141038,Diastolic dysfunction,racial,Asian,1,0,1
4110945,Benign hypertensive heart disease NOS,racial,Asian,1,0,1
433621,Sprain of sternoclavicular joint AND/OR ligament,racial,Unknown,1,0,1
24970,Chronic laryngitis,racial,American Indian or Alaska Native ,0,1,1
254390,Malignant effusion,ethnic,Not Hispanic or Latino,0,1,1
201418,"Flatulence, eructation and gas pain",racial,American Indian or Alaska Native ,0,1,1
135178,Streptococcal septicaemia,ethnic,Not Hispanic or Latino,0,1,1
439794,CSA - Central sleep apnoea,racial,White,1,0,1
440213,Consciousness and/or awareness finding,racial,Unknown,1,0,1
4064908,Trypanosomiasis screening,ethnic,Hispanic or Latino,1,0,1
438744,"Pigment epitheliopathy, disseminated retinitis AND retinochoroiditis",racial,Asian,0,1,1
444129,Wrist injury,racial,American Indian or Alaska Native ,1,0,1
439035,Otosclerosis,racial,White,0,1,1
318186,Achalasia of esophagus,racial,Asian,1,0,1
75621,Acute polyarticular juvenile rheumatoid arthritis,ethnic,Hispanic or Latino,1,0,1
4088920,Womb absent,racial,Filipino,1,0,1
381569,Myogenic ptosis,ethnic,Not Hispanic or Latino,0,1,1
80509,Bone cyst,racial,Other Race,1,0,1
73290,Contracture of joint,ethnic,Not Hispanic or Latino,1,0,1
375551,Blepharochalasis,racial,White,1,0,1
435024,Precipitate labour with antenatal problem,ethnic,Hispanic or Latino,1,0,1
4062733,Neurological screening,racial,Unknown,0,1,1
313761,Central retinal vein occlusion,racial,Other Race,0,1,1
4171115,Low birth weight infant,ethnic,Not Hispanic or Latino,1,0,1
4063522,Congenital absence of uterus,ethnic,Hispanic or Latino,1,0,1
318712,Peripheral circulatory disorder associated with type I diabetes mellitus,racial,Black or African American ,0,1,1
441545,Somatisation disorder,racial,Unknown,1,0,1
259153,Throat soreness,racial,Alaska Native,1,0,1
435666,Closed fracture of upper end of tibia,ethnic,Not Hispanic or Latino,1,0,1
434893,Selective IgM immunodeficiency,racial,White,0,1,1
436403,Retinal vasculitis,racial,White,1,0,1
437784,Pfeiffer's disease,racial,Native Hawaiian or Other Pacific Islander ,1,0,1
134452,Miners' elbow,racial,Native Hawaiian or Other Pacific Islander ,0,1,1
77029,Epididymo-orchitis without abscess,racial,Asian,0,1,1
439937,C-reactive protein abnormal,racial,American Indian,1,0,1
197023,Bilateral inguinal hernia,racial,Asian,0,1,1
134898,Non-toxic single thyroid nodule,racial,American Indian or Alaska Native ,1,0,1
316501,Disorder of blood vessels affecting skin,racial,Other Race,1,0,1
377845,Anoxic encephalopathy,racial,Black or African American ,0,1,1
72404,Joint stiffness,racial,Asian,1,0,1
443178,"Insect bite, nonvenomous, of face",racial,Other Race,1,0,1
432504,Accident caused by fire and flames,racial,White,1,0,1
374957,Acquired stenosis of external ear canal,racial,Unknown,0,1,1
80186,Recurrent dislocation of shoulder region,ethnic,Not Hispanic or Latino,0,1,1
28457,Hypertrophy of tonsils,racial,Filipino,0,1,1
315505,Benign neoplasm of lymph node,ethnic,Not Hispanic or Latino,1,0,1
438827,Foreign body granuloma of subcutaneous tissue,ethnic,Not Hispanic or Latino,0,1,1
4063177,Fetal malposition and malpresentation NOS,racial,White,1,0,1
374905,Non-organic sleep disorder,racial,American Indian or Alaska Native ,1,0,1
197019,Bile duct calculus with acute cholecystitis and no obstruction,ethnic,Hispanic or Latino,1,0,1
256215,"Lung agenesis, hypoplasia and dysplasia",racial,Unknown,0,1,1
441571,Retained old foreign body following penetrating wound of orbit,ethnic,Hispanic or Latino,0,1,1
441333,Geographic tongue,racial,Other Race,0,1,1
4218764,Gastroschisis,racial,Black or African American ,1,0,1
438905,Sequelae of injury of spinal cord,ethnic,Hispanic or Latino,0,1,1
4052804,FH: Allergy,racial,Other Race,1,0,1
432969,Multiple pregnancy,ethnic,Hispanic or Latino,1,0,1
440538,Closed fracture of lower end of radius AND ulna,racial,Unknown,1,0,1
200459,Endometrial cystic hyperplasia,racial,Black or African American ,1,0,1
441980,Closed fracture of foot,racial,Black or African American ,1,0,1
434241,Accidental poisoning by soap products,racial,White,1,0,1
72410,Infection of bone,ethnic,Not Hispanic or Latino,0,1,1
377551,Blind hypertensive eye,racial,White,1,0,1
132449,Transient limb paralysis,racial,Unknown,1,0,1
314664,Long Q-T syndrome,ethnic,Not Hispanic or Latino,1,0,1
194419,Infertility due to oligospermia,racial,White,0,1,1
4050797,Family history of urological neoplasm,racial,White,0,1,1
439134,Acrocephalosyndactyly,ethnic,Hispanic or Latino,0,1,1
135615,Pityriasis,racial,Native Hawaiian or Other Pacific Islander ,0,1,1
441784,Disease due to Hantavirus,ethnic,Hispanic or Latino,0,1,1
73300,Radial styloid tenosynovitis,racial,American Indian or Alaska Native ,1,0,1
439242,Adverse reaction to tetanus vaccine,ethnic,Hispanic or Latino,0,1,1
4150307,Dental restoration observation,racial,American Indian,1,0,1
442038,Anaphylactic shock due to serum,racial,White,1,0,1
444438,Leucoplakia of tongue,ethnic,Not Hispanic or Latino,1,0,1
441189,Pertussis vaccine adverse reaction,racial,Unknown,1,0,1
435242,Cerebellar ataxia,racial,Black or African American ,0,1,1
435444,Poisoning due to venomous marine animals or plants,racial,Unknown,1,0,1
4109395,Other visual pathway disorder,racial,Unknown,1,0,1
140949,Scabies,racial,Native Hawaiian or Other Pacific Islander ,0,1,1
72714,Chronic polyarticular juvenile rheumatoid arthritis,ethnic,Not Hispanic or Latino,1,0,1
436480,Dystrophy of vulva,racial,Unknown,1,0,1
321876,Disease of capillaries,ethnic,Not Hispanic or Latino,0,1,1
372909,Impairment level: better eye: severe impairment: lesser eye: not further specified,racial,Unknown,1,0,1
72576,Benign tumour of breast,racial,Black or African American ,1,0,1
140958,Kaposi's sarcoma of palate,ethnic,Hispanic or Latino,0,1,1
433846,Ankylosis of joint of lower leg,ethnic,Not Hispanic or Latino,0,1,1
4019044,Sprain of ischiocapsular ligament,racial,White,0,1,1
438975,Multisystemic disseminated toxoplasmosis,ethnic,Not Hispanic or Latino,1,0,1
136282,"Burn erythema of single finger, not thumb",racial,Unknown,0,1,1
4146709,Enteritis due to specified virus,ethnic,Hispanic or Latino,1,0,1
134870,Pityriasis versicolor,racial,Filipino,0,1,1
256439,Allergic rhinitis due to pollen,racial,Native Hawaiian or Other Pacific Islander ,0,1,1
433596,Abnormal sputum,racial,Other Race,1,0,1
75426,Burn of hand,racial,Unknown,0,1,1
200452,Disease of female genital organ,racial,American Indian or Alaska Native ,1,0,1
197236,Uterine fibroid,racial,Filipino,1,0,1
317109,Respiratory arrest,racial,Unknown,1,0,1
139202,"Burn involving 20-29 percent of body surface, with 10-19 percent of body surface with full thickness burn",ethnic,Not Hispanic or Latino,0,1,1
4051770,"Contusion, ankle and foot, excluding toe(s)",racial,White,0,1,1
441828,Disorganized schizophrenia,ethnic,Not Hispanic or Latino,1,0,1
136237,Cardiovascular system problem,racial,Other Race,1,0,1
432746,"Open fracture of radius and ulna, shaft",racial,Unknown,0,1,1
442740,"Nontraffic accident involving fall from motor vehicle, except off-road motor vehicle, whilst in motion, not on public highway, motor cyclist injured",racial,White,1,0,1
193353,Abrasion AND/OR friction burn of trunk with infection,racial,Unknown,1,0,1
195562,Hemorrhoids,racial,American Indian,1,0,1
140273,"Contusion, forearm area",racial,American Indian or Alaska Native ,1,0,1
437464,"Injury undetermined whether accidentally or purposely inflicted, fall from residential premises",racial,American Indian or Alaska Native ,1,0,1
443864,Multi-infarct dementia with depression,racial,Other Race,0,1,1
434689,Incomplete abortion,racial,Unknown,1,0,1
4232595,Platinum asthma,racial,White,1,0,1
376512,Microphthalmos,racial,White,0,1,1
4070919,Other specified heart anomalies,racial,White,0,1,1
435917,Fetus OR newborn affected by incompetent cervix,racial,Unknown,1,0,1
436010,Heat edema,racial,White,1,0,1
259048,Pneumonia in systemic mycosis,ethnic,Hispanic or Latino,0,1,1
438485,Postoperative state,ethnic,Hispanic or Latino,1,0,1
433083,Opiate and narcotic poisoning,ethnic,Not Hispanic or Latino,1,0,1
76221,Neonatal infective mastitis,racial,White,1,0,1
442601,Sedative abuse,racial,Other Race,0,1,1
4185302,Chronic myocardial ischemia,racial,Native Hawaiian or Other Pacific Islander ,1,0,1
437703,Closed fracture of intracapsular section of femur,racial,White,1,0,1
4145004,Osteoarthritis of spine NOS,racial,Unknown,0,1,1
381568,Pseudomembranous conjunctivitis,racial,Unknown,0,1,1
80204,IUGR - Intrauterine growth retardation,racial,Black or African American ,0,1,1
436956,Evans syndrome,ethnic,Not Hispanic or Latino,0,1,1
75365,Oliguria and anuria,racial,Asian,1,0,1
377844,Status migrainosus,ethnic,Not Hispanic or Latino,1,0,1
443459,Pathological fracture of neck of femur,racial,Unknown,1,0,1
200657,Trichomonal urethritis,racial,White,0,1,1
440325,Rubella without complication,ethnic,Not Hispanic or Latino,1,0,1
4049954,Open wound of nasal sinus,ethnic,Not Hispanic or Latino,0,1,1
435262,Primary open angle glaucoma,racial,Filipino,0,1,1
316376,Eosinophilia,racial,Black or African American ,1,0,1
440971,Neoplasm of uncertain behaviour of testis,racial,Unknown,0,1,1
192372,Placenta praevia without haemorrhage - not delivered,racial,Asian,1,0,1
435308,Acute exudative glomerulonephritis,racial,White,0,1,1
442747,Contact dermatitis due to food in contact with skin,racial,Unknown,1,0,1
4064377,Depression screening,racial,Middle Eastern or North African,1,0,1
441819,"Carcinoma in situ of lip, oral cavity and pharynx",ethnic,Hispanic or Latino,1,0,1
135975,Blister of finger without infection,racial,American Indian or Alaska Native ,0,1,1
436007,Complication of introduction procedure,ethnic,Hispanic or Latino,0,1,1
434069,"Mottled teeth, congenital",ethnic,Hispanic or Latino,0,1,1
138519,Spondylosis without myelopathy,racial,American Indian,1,0,1
80294,Foreign body in genitourinary tract,ethnic,Not Hispanic or Latino,1,0,1
4270051,Arthrodesis of ankle,racial,Unknown,1,0,1
432677,Habitual aborter-not pregnant,racial,Unknown,1,0,1
441896,Plicated tongue,racial,Other Race,0,1,1
436832,Closed fracture of sternum,racial,Asian,1,0,1
432807,Accidents caused by cutting and piercing instruments or objects,ethnic,Hispanic or Latino,1,0,1
4059736,Infective urethral stricture NOS,ethnic,Hispanic or Latino,0,1,1
73558,Allergic arthritis of the lower leg,racial,White,1,0,1
4324788,Articular cartilage disorder of wrist,ethnic,Hispanic or Latino,1,0,1
381392,Congenital subcapsular cataract,ethnic,Hispanic or Latino,1,0,1
4269584,Finding relating to religious movement or belief,racial,White,1,0,1
439937,C-reactive protein abnormal,racial,Black or African American ,1,0,1
4215971,Obstructed incisional ventral hernia,racial,White,1,0,1
200768,Inflammatory disease of vagina and/or vulva,racial,Other Race,1,0,1
200444,Post-cholecystectomy syndrome,racial,Other Race,0,1,1
4041798,"Hodgkin's disease, lymphocytic depletion",ethnic,Not Hispanic or Latino,0,1,1
435244,Developmental disorder,racial,Unknown,1,0,1
443913,Congenital anomaly of trachea,racial,Other Race,1,0,1
135333,Pressure sore,racial,Black or African American ,1,0,1
436729,Chronic gastrojejunal ulcer with haemorrhage AND obstruction,racial,White,1,0,1
439796,"Nondependent cocaine abuse, continuous",racial,Black or African American ,0,1,1
256909,Primary pulmonary coccidioidomycosis,racial,Asian,0,1,1
444082,False labor without delivery,racial,Unknown,1,0,1
439615,Fall from stationary vehicle,ethnic,Hispanic or Latino,1,0,1
373126,Non-arthropod-borne viral disease of the central nervous system,ethnic,Hispanic or Latino,1,0,1
259995,Foreign body in orifice,ethnic,Hispanic or Latino,0,1,1
73012,Saddle back,racial,White,1,0,1
433915,Burn of thigh,ethnic,Not Hispanic or Latino,1,0,1
442139,Primary bronchial cancer,racial,American Indian or Alaska Native ,0,1,1
73318,Polydactyly of fingers,ethnic,Not Hispanic or Latino,0,1,1
80070,Uric acid urolithiasis,ethnic,Not Hispanic or Latino,0,1,1
4012320,Autotransplantation of thyroid tissue,ethnic,Hispanic or Latino,1,0,1
134870,Pityriasis versicolor,racial,Other Race,1,0,1
4059445,Chronic glomerulonephritis NOS,ethnic,Hispanic or Latino,0,1,1
4178537,Family history: nervous system disorder,racial,White,0,1,1
4103889,Unspecified blepharoconjunctivitis,ethnic,Hispanic or Latino,1,0,1
436252,Closed fracture of shaft of tibia,ethnic,Not Hispanic or Latino,0,1,1
136775,Contact dermatitis due to solar radiation,racial,Other Race,1,0,1
200837,Congenital anomaly of fixation of intestine,racial,Other Race,1,0,1
438836,Poliomyelitis osteopathy of the lower leg,ethnic,Not Hispanic or Latino,1,0,1
438478,Hemorrhage in early pregnancy,racial,White,1,0,1
435723,Wound seroma,ethnic,Not Hispanic or Latino,0,1,1
381021,Lagophthalmos,racial,Black or African American ,0,1,1
4085626,Other protozoal intestinal diseases,ethnic,Hispanic or Latino,0,1,1
139750,Primary malignant neoplasm of skin,ethnic,Not Hispanic or Latino,1,0,1
200174,Disease of skin AND/OR subcutaneous tissue,racial,Filipino,0,1,1
199839,External haemorrhoids without complication,racial,Native Hawaiian or Other Pacific Islander ,1,0,1
439237,Assault,racial,Other Race,0,1,1
196156,Urethral diverticulum,racial,White,1,0,1
141693,Elevated blood-pressure reading without diagnosis of hypertension,racial,Asian Indian,0,1,1
27017,Defective dental restoration,racial,Other Race,0,1,1
4009601,Fracture of one or more phalanges of hand NOS,ethnic,Hispanic or Latino,1,0,1
72501,Superficial foreign body of foot without major open wound AND without infection,racial,Black or African American ,1,0,1
80242,Current tear of medial cartilage AND/OR meniscus of knee,racial,American Indian or Alaska Native ,1,0,1
74138,Pathological fracture of vertebra,racial,Other Race,0,1,1
4312857,Incision of spleen,ethnic,Not Hispanic or Latino,0,1,1
4280605,Common duodenal ulcer,ethnic,Hispanic or Latino,1,0,1
439982,Infection as complication of medical care,racial,Unknown,1,0,1
381842,Petit mal status,racial,Other Race,1,0,1
196757,Fetal-maternal haemorrhage with antenatal problem,racial,White,0,1,1
197230,Malignant neoplasm of uterus,racial,Asian,1,0,1
441460,Late effect of sprain AND/OR strain without tendon injury,racial,Other Race,1,0,1
77352,Pyogenic arthritis of the lower leg,ethnic,Not Hispanic or Latino,1,0,1
441561,Low tension glaucoma,racial,White,0,1,1
23325,Heartburn,racial,American Indian or Alaska Native ,1,0,1
197440,Nonvenomous insect bite of trunk without infection,racial,Unknown,1,0,1
255711,Optic nerve and pathway injury,ethnic,Hispanic or Latino,0,1,1
442936,"Motor vehicle traffic accident due to motor vehicle going out of control due to failure of mechanical part, without collision on the highway, passenger of motor vehicle injured",racial,Unknown,0,1,1
433125,Infection due to Staphylocccus aureus,racial,Asian,0,1,1
196159,Old laceration of pelvic floor muscle,racial,White,1,0,1
443751,"Late effect of open wound of head, neck AND/OR trunk",ethnic,Hispanic or Latino,1,0,1
436832,Closed fracture of sternum,ethnic,Not Hispanic or Latino,1,0,1
193255,"Noninflammatory disorders of the ovary, fallopian tube and broad ligament",racial,Asian,1,0,1
314754,Wheezing,racial,Asian Indian,1,0,1
76784,Bleeding into joint,ethnic,Not Hispanic or Latino,0,1,1
440035,European cryptococcosis,racial,Unknown,1,0,1
135287,Non-neoplastic naevus,racial,Other Race,1,0,1
77734,Contusion of lower leg,racial,Asian,1,0,1
439136,"Asphyxia, in liveborn infant",racial,Black or African American ,0,1,1
439743,Late effects of respiratory tuberculosis,ethnic,Hispanic or Latino,1,0,1
254514,Contusion of lung without open wound into thorax,racial,White,1,0,1
80819,Acquired hallux varus,ethnic,Not Hispanic or Latino,1,0,1
4090114,Toxoplasmosis chorioretinitis,racial,White,0,1,1
442610,Degenerative AND/OR vascular disorder of ear,ethnic,Hispanic or Latino,0,1,1
434616,Haemoglobinuria due to haemolysis from external causes,racial,Asian,0,1,1
138117,Benign tumour of spinal cord,racial,Unknown,1,0,1
443081,Drowning and non-fatal immersion,ethnic,Not Hispanic or Latino,0,1,1
141499,Septicemia,ethnic,Not Hispanic or Latino,0,1,1
377556,Sudden visual loss,racial,Unknown,1,0,1
437027,Acute duodenitis,ethnic,Hispanic or Latino,0,1,1
196454,Colostomy and enterostomy malfunction,ethnic,Not Hispanic or Latino,0,1,1
434688,Tight hymenal ring,ethnic,Not Hispanic or Latino,1,0,1
4046500,Acute peptic ulcer with hemorrhage,racial,Unknown,1,0,1
140480,Impetigo,racial,Native Hawaiian or Other Pacific Islander ,1,0,1
374009,Organic mental disorder,racial,Black or African American ,1,0,1
4113351,Unspecified spontaneous abortion with complication NOS,racial,White,1,0,1
433496,Unilateral sensory hearing loss,ethnic,Hispanic or Latino,1,0,1
442651,"Noncollision motor vehicle traffic accident involving fire starting in motor vehicle whilst in motion, passenger of motor vehicle injured",racial,White,1,0,1
437461,Disorder of prosthetic cardiac valve,ethnic,Not Hispanic or Latino,1,0,1
444391,Pain around eye,racial,American Indian or Alaska Native ,1,0,1
198928,Mechanical complication due to intrauterine contraceptive device,racial,Other Race,1,0,1
73847,Observation of elbow joint,racial,Unknown,0,1,1
375115,Nonmagnetic foreign body penetrating eyeball,racial,White,0,1,1
439346,"Motor vehicle traffic accident involving pedestrian run over by motor vehicle, occupant of tram injured",racial,White,1,0,1
381854,Disorder of conjunctiva,racial,American Indian,0,1,1
440464,Complication following molar AND/OR ectopic pregnancy,racial,White,1,0,1
439246,"Mixed bipolar affective disorder, severe, with psychosis",racial,Unknown,1,0,1
443716,Blister of shoulder without infection,ethnic,Not Hispanic or Latino,1,0,1
435933,Closed fracture of lumbar vertebra without spinal cord injury,racial,American Indian or Alaska Native ,1,0,1
433031,Hallucinations,racial,Black or African American ,0,1,1
75045,Climacteric arthritis of the pelvic region and thigh,racial,Unknown,0,1,1
4085922,Infection screening,racial,Unknown,1,0,1
435912,Endocardial cushion defect,ethnic,Not Hispanic or Latino,1,0,1
142026,Disorder of cardiovascular prostheses and implants,racial,Black or African American ,1,0,1
80862,"Closed fractures of phalanx or phalanges, multiple sites",racial,Unknown,1,0,1
443449,Acute laryngitis with obstruction,ethnic,Hispanic or Latino,0,1,1
433565,Juvenile osteochondrosis of spine,racial,Unknown,1,0,1
4204989,Disturbance in sleep behavior,racial,Unknown,1,0,1
440922,Diabetic on insulin,racial,Other Race,0,1,1
319844,Acute ischemic heart disease,ethnic,Not Hispanic or Latino,1,0,1
381297,Xanthoma of eyelid,racial,White,1,0,1
201240,Metastasis to female genital organ,racial,White,1,0,1
78909,"Contusion, shoulder and upper arm, multiple sites",racial,Black or African American ,1,0,1
193693,Viral hepatitis without hepatic coma,ethnic,Not Hispanic or Latino,0,1,1
4171556,Ankle ulcer,racial,Asian,0,1,1
137591,Chronic apical periodontitis,racial,Unknown,1,0,1
434819,Benzodiazepine poisoning,racial,White,1,0,1
381028,Acute suppurative otitis media - tympanic membrane ruptured,racial,Native Hawaiian or Other Pacific Islander ,0,1,1
438365,Phaeohyphomycosis,ethnic,Hispanic or Latino,0,1,1
197913,Disorder of function of stomach,racial,Filipino,1,0,1
439372,"Motor vehicle traffic accident involving collision, on highway, between motor vehicle and fallen stone, traffic sign, tree or utility pole, pedestrian injured",racial,Unknown,1,0,1
436445,Abrasion of teeth,racial,Asian,0,1,1
438077,Disseminated candidiasis,ethnic,Hispanic or Latino,0,1,1
440233,Strain of supraspinatus muscle AND/OR tendon,ethnic,Not Hispanic or Latino,1,0,1
192380,Failed attempted abortion without complication,ethnic,Hispanic or Latino,1,0,1
74451,Palindromic rheumatism of the forearm,racial,Asian,1,0,1
4155527,Unspecified polyarthropathy or polyarthritis,ethnic,Hispanic or Latino,1,0,1
437536,Somatoform autonomic dysfunction - gastrointestinal tract,ethnic,Not Hispanic or Latino,1,0,1
133566,Necrotizing fasciitis,ethnic,Not Hispanic or Latino,1,0,1
432975,Trauma to perineum and/or vulva during delivery,racial,Unknown,1,0,1
437982,Semen observations,racial,Unknown,0,1,1
438297,"Mechanical complication of cardiac device, implant AND/OR graft",racial,Unknown,0,1,1
442189,Blister of wrist without infection,ethnic,Hispanic or Latino,1,0,1
443207,Single organ dysfunction,racial,White,0,1,1
195014,Renal failure following molar AND/OR ectopic pregnancy,ethnic,Hispanic or Latino,1,0,1
73290,Contracture of joint,racial,Asian,1,0,1
436510,Acquired cavus foot deformity,ethnic,Hispanic or Latino,0,1,1
200275,Burn erythema of multiple sites of trunk,racial,Unknown,1,0,1
133298,Musculoskeletal disorder of the neck,racial,Filipino,0,1,1
432661,Stomatitis,racial,Filipino,1,0,1
438168,Aneurysm of heart,racial,Unknown,1,0,1
443367,Antihypertensive adverse reaction,racial,Black or African American ,0,1,1
137991,Sick-euthyroid syndrome,racial,Other Race,0,1,1
376415,Hypermetropia,racial,Asian,1,0,1
439318,Complete illegal abortion with metabolic disorder,ethnic,Not Hispanic or Latino,0,1,1
376422,Mucopurulent conjunctivitis,racial,Asian,1,0,1
443750,Nonvenomous insect bite of finger without infection,racial,Other Race,0,1,1
253670,Injury of optic pathways,ethnic,Hispanic or Latino,0,1,1
435503,Hemolytic anemia,ethnic,Not Hispanic or Latino,1,0,1
438744,"Pigment epitheliopathy, disseminated retinitis AND retinochoroiditis",ethnic,Not Hispanic or Latino,0,1,1
433393,Fall into hole,racial,White,1,0,1
193591,Meconium ileus,ethnic,Hispanic or Latino,0,1,1
197206,Balantidiasis,ethnic,Not Hispanic or Latino,0,1,1
381252,Benign neoplasm of eye,racial,Unknown,1,0,1
435269,Optic papillitis,racial,White,1,0,1
198853,Congenital anomaly of ovary,racial,White,1,0,1
132834,White piedra,ethnic,Not Hispanic or Latino,1,0,1
437369,Postmature infancy,racial,White,0,1,1
377280,Corneal disorder,racial,Asian,1,0,1
442862,"Abrasion or friction burn of hand, without mention of infection",racial,Asian,1,0,1
74468,Congenital anomaly of rib,racial,Unknown,1,0,1
72991,Traumatic arthropathy of multiple sites,ethnic,Hispanic or Latino,0,1,1
139180,Open wound of multiple sites of face without complication,racial,Asian,0,1,1
4062480,Diphtheria screening,racial,White,0,1,1
435859,Acute duodenal ulcer without hemorrhage AND without perforation but with obstruction,ethnic,Hispanic or Latino,1,0,1
435416,Poisoning by anti-infective agent,racial,Unknown,1,0,1
201244,Benign tumour of vagina,ethnic,Not Hispanic or Latino,1,0,1
441561,Low tension glaucoma,racial,Unknown,1,0,1
437390,Hypoxaemia,racial,Black or African American ,1,0,1
140654,Deep seated dermatophytosis,racial,Asian,1,0,1
372765,Open wound of head without complication,racial,Unknown,1,0,1
434605,Benign tumor of lacrimal drainage structure,ethnic,Hispanic or Latino,0,1,1
194071,Pylorospasm,ethnic,Hispanic or Latino,1,0,1
134569,Erythema infectiosum,racial,Filipino,1,0,1
433596,Abnormal sputum,racial,American Indian or Alaska Native ,0,1,1
435243,Alcohol dependence,racial,Other Race,1,0,1
439235,Self inflicted injury,ethnic,Not Hispanic or Latino,0,1,1
437993,Closed fracture of cervical spine,ethnic,Not Hispanic or Latino,0,1,1
433263,Complications following abortion and ectopic and molar pregnancies,racial,White,1,0,1
136760,Transient hypertension of pregnancy - not delivered,racial,Black or African American ,1,0,1
77455,Burn of chest wall,racial,White,1,0,1
439907,Spontaneous tendon rupture,racial,White,1,0,1
200843,Observation of frequency of urination,racial,Asian Indian,0,1,1
200452,Disease of female genital organ,racial,Other Race,1,0,1
137940,Transient hypertension of pregnancy - delivered,ethnic,Hispanic or Latino,1,0,1
439183,Concussion,racial,American Indian or Alaska Native ,0,1,1
77354,Primary localised osteoarthrosis of lower leg,racial,American Indian,1,0,1
76545,Closed traumatic dislocation of patella,racial,Other Race,0,1,1
193804,Achlorhydria,racial,White,1,0,1
140062,Iodine hypothyroidism,racial,White,0,1,1
432600,Stress reaction causing mixed disturbance of emotion and conduct,racial,Unknown,1,0,1
4204989,Disturbance in sleep behavior,racial,White,0,1,1
381017,Ametropic amblyopia,racial,Black or African American ,1,0,1
137425,"Insect bite, nonvenomous, of trunk, infected",racial,Unknown,1,0,1
432656,Embolism and thrombosis of the thoracic aorta,ethnic,Hispanic or Latino,1,0,1
81938,Climacteric arthritis of the shoulder region,racial,White,1,0,1
4098410,Atrial cardioversion,racial,Unknown,0,1,1
438630,Exposure to radiation,ethnic,Hispanic or Latino,1,0,1
4311114,Sensory disorder,racial,White,1,0,1
380109,Exophoria,racial,White,1,0,1
321320,Myocardial degeneration,racial,Other Race,0,1,1
199071,Nephrotic syndrome with minimal change glomerulonephritis,ethnic,Hispanic or Latino,1,0,1
436204,Subcutaneous hematoma,racial,Unknown,1,0,1
76573,Full thickness burn of hand,racial,White,0,1,1
440179,"Chondrocalcinosis due to dicalcium phosphate crystals, of the lower leg",ethnic,Hispanic or Latino,1,0,1
438367,Primary malignant neoplasm of nasal cavity,racial,White,0,1,1
4002318,Cleft palate with cleft lip NOS,racial,White,1,0,1
137591,Chronic apical periodontitis,racial,White,0,1,1
259048,Pneumonia in systemic mycosis,ethnic,Not Hispanic or Latino,0,1,1
24966,OV - Oesophageal varices,racial,Native Hawaiian or Other Pacific Islander ,0,1,1
27411,Open wound of multiple sites of mouth with complication,ethnic,Hispanic or Latino,0,1,1
4022073,Dependance on wheel chair,racial,Other Race,0,1,1
380095,Lesions of nerves plexuses and roots,racial,White,1,0,1
78473,Solitary cyst of breast,racial,Native Hawaiian or Other Pacific Islander ,1,0,1
436954,Drug abuse,racial,Native Hawaiian or Other Pacific Islander ,0,1,1
440392,Retinal vascular occlusion,racial,Asian,0,1,1
256811,Congenital anomaly of nose,ethnic,Hispanic or Latino,0,1,1
198899,Open wound of trunk with complication,ethnic,Hispanic or Latino,1,0,1
443452,Bleeding of unknown origin,racial,American Indian or Alaska Native ,1,0,1
4101602,Henoch-Schonlein purpura,racial,Asian,0,1,1
378679,Acute poliomyelitis,ethnic,Not Hispanic or Latino,1,0,1
4173452,Exteriorisation of appendix,ethnic,Hispanic or Latino,1,0,1
76506,Effusion of joint of lower leg,racial,American Indian or Alaska Native ,1,0,1
136775,Contact dermatitis due to solar radiation,racial,American Indian or Alaska Native ,1,0,1
138790,Chronic periodontitis,racial,American Indian,1,0,1
40414926,"Accidental cut, puncture, perforation or haemorrhage during administration of enema",ethnic,Not Hispanic or Latino,0,1,1
440980,Atypical manic disorder,ethnic,Hispanic or Latino,0,1,1
4103961,Removal of acoustic neuroma,ethnic,Hispanic or Latino,1,0,1
436700,Eye displaced forwards,racial,Asian,1,0,1
437878,Persistent mydriasis,ethnic,Not Hispanic or Latino,1,0,1
25572,Disease of salivary gland,racial,Black or African American ,0,1,1
438392,Disorder of hyperalimentation,racial,Unknown,1,0,1
436522,Irregular sleep-wake pattern,ethnic,Hispanic or Latino,0,1,1
4105880,Contact of sexually transmissible disorder,racial,Native Hawaiian or Other Pacific Islander ,0,1,1
4094876,"Malignant neoplasm of lower lobe, bronchus or lung",racial,White,1,0,1
77661,Congenital dislocation of one hip with subluxation of other,ethnic,Not Hispanic or Latino,0,1,1
4185471,Disorder of pigmentation,racial,Native Hawaiian or Other Pacific Islander ,1,0,1
4263370,R.I.N.D. syndrome,racial,American Indian,1,0,1
4214763,Repair of brain,ethnic,Not Hispanic or Latino,0,1,1
80862,"Closed fractures of phalanx or phalanges, multiple sites",racial,White,1,0,1
77961,Disseminated idiopathic skeletal hyperostosis,ethnic,Not Hispanic or Latino,0,1,1
134741,Congenital anomaly of limb,racial,Asian,1,0,1
441269,Autoimmune hemolytic anemia,ethnic,Not Hispanic or Latino,1,0,1
372924,Cerebral arterial occlusion,racial,White,1,0,1
75052,Enthesopathy of wrist AND/OR carpus,racial,Other Race,0,1,1
443562,Closed dislocation of radiocarpal joint,ethnic,Hispanic or Latino,1,0,1
318247,Apnea in the newborn,racial,Other Race,0,1,1
261116,Acquired nasal deformity,racial,Asian,1,0,1
436906,Rickettsial disease,ethnic,Hispanic or Latino,1,0,1
195009,Leukoplakia of penis,ethnic,Hispanic or Latino,0,1,1
437187,Assault by striking by blunt or thrown object,racial,White,0,1,1
78838,Acquired deformity of knee,racial,Unknown,1,0,1
81425,Closed fracture of sacrum AND/OR coccyx with complete cauda equina lesion,ethnic,Hispanic or Latino,1,0,1
4113351,Unspecified spontaneous abortion with complication NOS,racial,Unknown,1,0,1
433536,Severe pre-eclampsia,racial,White,1,0,1
378140,Inflammatory and toxic neuropathy,racial,Asian,0,1,1
438391,Amino acid transport disorder,racial,Asian,1,0,1
80286,Prosthetic joint loosening,ethnic,Hispanic or Latino,0,1,1
201418,"Flatulence, eructation and gas pain",racial,Alaska Native,0,1,1
261889,Simple chronic bronchitis,racial,Asian,0,1,1
79119,Thoracic spondylosis with myelopathy,racial,White,0,1,1
444100,Mood disorder,racial,American Indian or Alaska Native ,0,1,1
379805,Myopia,racial,Native Hawaiian or Other Pacific Islander ,0,1,1
132703,Lichen planus,racial,American Indian or Alaska Native ,1,0,1
438931,Foreign body accidentally entering eye and adnexa,racial,Black or African American ,0,1,1
436612,Gaseous hydrocarbon causing toxic effect,ethnic,Hispanic or Latino,1,0,1
377574,Presbycusis,racial,Black or African American ,0,1,1
4129404,Open wound of upper arm,racial,Unknown,1,0,1
434261,"Motor vehicle nontraffic accident involving collision, not on public highway, between motor vehicle, except off-road motor vehicle, and nonmotor vehicle, motor cyclist injured",ethnic,Not Hispanic or Latino,0,1,1
441868,Optic disc oedema,racial,Other Race,1,0,1
442792,Pes anserinus bursitis,racial,Asian,0,1,1
4008683,Anxiety neurosis,racial,Filipino,1,0,1
376955,Gouty tophi of ear,ethnic,Hispanic or Latino,0,1,1
437744,Heat exhaustion,racial,Black or African American ,1,0,1
4234299,Repair of cystocele,ethnic,Hispanic or Latino,1,0,1
435080,Biliuria,racial,Other Race,1,0,1
75347,Spinal enthesopathy,ethnic,Hispanic or Latino,1,0,1
443616,Refractory migraine without aura,ethnic,Not Hispanic or Latino,1,0,1
437791,Chickenpox with complication,racial,Black or African American ,0,1,1
74716,Galactorrhea associated with childbirth,ethnic,Hispanic or Latino,1,0,1
443464,Central pain syndrome,ethnic,Hispanic or Latino,0,1,1
4095304,Malignant neoplasm of pituitary gland and craniopharyngeal duct,ethnic,Hispanic or Latino,1,0,1
433025,Complication of vaccination,racial,Unknown,1,0,1
435940,"Closed fracture of humerus, shaft",racial,Asian,0,1,1
315505,Benign neoplasm of lymph node,ethnic,Hispanic or Latino,1,0,1
444369,Hyperosmolality,ethnic,Hispanic or Latino,1,0,1
4112819,Pneumonia due to other specified bacteria,racial,Asian,0,1,1
434300,Neuroendocrine tumour,ethnic,Not Hispanic or Latino,1,0,1
74150,"Congenital subluxation of hip, bilateral",racial,White,1,0,1
22856,Polyglandular dysfunction,racial,Black or African American ,0,1,1
441701,Sprain of hip joint,racial,Asian,0,1,1
139888,Threatened premature labor - not delivered,racial,American Indian or Alaska Native ,1,0,1
4147635,Unspecified otorrhea,ethnic,Not Hispanic or Latino,0,1,1
78607,Open wound of multiple sites of one upper limb with complication,racial,Unknown,0,1,1
379779,Subacute delirium,ethnic,Hispanic or Latino,1,0,1
441764,Inhalation or ingestion of foreign body with respiratory obstruction or suffocation,racial,White,1,0,1
257086,Incomplete bilateral cleft palate,ethnic,Hispanic or Latino,0,1,1
321815,Malignant histiocytosis of lymph nodes of multiple sites,racial,White,1,0,1
440454,Abortion without complication,racial,Asian,1,0,1
444202,Abscess,racial,Asian Indian,1,0,1
24230,Laryngeal FB - foreign body,ethnic,Not Hispanic or Latino,0,1,1
261326,Viral pneumonia,racial,Asian,0,1,1
437969,Acquired pes planus,racial,American Indian or Alaska Native ,0,1,1
432301,Opioid dependence in remission,racial,Black or African American ,1,0,1
436398,Glaucoma associated with ocular disorder,racial,Unknown,1,0,1
4210149,Substance abuse counseling,racial,American Indian or Alaska Native ,0,1,1
440925,Suicide,racial,Black or African American ,1,0,1
4115379,"Localised, primary osteoarthritis of the pelvic region and thigh",racial,American Indian,1,0,1
437295,Abnormal pupillary function,racial,White,1,0,1
434203,Late effect of contusion,ethnic,Not Hispanic or Latino,1,0,1
443774,"Disease condition determination, uncontrolled",ethnic,Not Hispanic or Latino,1,0,1
435524,Sleep disorder,racial,American Indian or Alaska Native ,1,0,1
138841,Disorder of sacrum,racial,Filipino,0,1,1
442295,Disorder of carbohydrate transport,racial,White,1,0,1
80805,Primary localized osteoarthrosis of forearm,racial,Black or African American ,1,0,1
442597,Meteorism,racial,Other Race,1,0,1
193636,Foreign body in bladder AND/OR urethra,racial,White,1,0,1
195197,Primary malignant neoplasm of vulva,ethnic,Not Hispanic or Latino,1,0,1
432810,Injury of unknown intent by burns or fire,ethnic,Hispanic or Latino,1,0,1
4275756,Dependent drug abuse,racial,White,1,0,1
4296024,Family disruption due to divorce,racial,Unknown,0,1,1
439134,Acrocephalosyndactyly,ethnic,Not Hispanic or Latino,0,1,1
24075,Esophageal stricture and stenosis,racial,Black or African American ,0,1,1
81186,Contusion of wrist,racial,Native Hawaiian or Other Pacific Islander ,1,0,1
193787,Varicose veins of lower extremity with ulcer AND inflammation,racial,Other Race,0,1,1
436804,Fetus OR newborn affected by premature rupture of membranes,racial,Asian,0,1,1
200447,Gastrointestinal complication,ethnic,Hispanic or Latino,1,0,1
192971,"Pelvic soft tissue abnormality in pregnancy, childbirth and the puerperium - delivered with postnatal complication",ethnic,Hispanic or Latino,1,0,1
4129482,Ovary observations,racial,Unknown,1,0,1
4228073,Peripheral nerve block,racial,Unknown,1,0,1
438872,Hyperphagia,ethnic,Not Hispanic or Latino,1,0,1
4085803,Microsporosis nigra,racial,White,1,0,1
434616,Haemoglobinuria due to haemolysis from external causes,ethnic,Hispanic or Latino,0,1,1
200675,Neoplasm of uncertain behavior of ovary,racial,White,1,0,1
442324,Psychologic dyspareunia,racial,Unknown,1,0,1
435150,Effects of heat AND/OR light,racial,White,1,0,1
260427,Common cold,racial,Native Hawaiian or Other Pacific Islander ,0,1,1
4020669,Coronary arteriography using single catheter,racial,White,1,0,1
199771,Carcinoid syndrome,ethnic,Hispanic or Latino,1,0,1
433111,Effects of hunger,ethnic,Hispanic or Latino,1,0,1
201257,Disorder of endocrine ovary,racial,Unknown,1,0,1
75911,Acquired hallux valgus,racial,American Indian or Alaska Native ,0,1,1
442444,"Motor vehicle traffic accident involving pedestrian hit by motor vehicle, pedestrian injured",racial,Unknown,1,0,1
132416,Chronic haematoma of pinna,racial,Unknown,0,1,1
439221,"Adverse effect, due to correct medicinal substance properly administered",racial,Native Hawaiian or Other Pacific Islander ,1,0,1
443915,Poisoning by autonomous nervous system drug,ethnic,Not Hispanic or Latino,1,0,1
196821,Observation of urethral discharge,racial,Black or African American ,0,1,1
440940,Methicillin resistant Staphylococcus aureus infection,racial,Asian,1,0,1
4133029,Primigravida,racial,American Indian or Alaska Native ,1,0,1
201727,Superficial injury of trunk without infection,racial,Unknown,1,0,1
75614,Acrodermatitis continua,racial,American Indian or Alaska Native ,0,1,1
4062635,Measles screening,racial,White,1,0,1
4220385,Transection of isthmus of thyroid,racial,Unknown,1,0,1
81659,Traumatic arthropathy of the pelvic region and thigh,racial,Unknown,1,0,1
4133311,Tetanus vaccination,ethnic,Hispanic or Latino,1,0,1
4111103,Disorder of eye and adnexa NOS,ethnic,Hispanic or Latino,0,1,1
437257,Continuous acute alcoholic intoxication in alcoholism,ethnic,Not Hispanic or Latino,0,1,1
196792,Acquired claw foot,ethnic,Hispanic or Latino,0,1,1
26711,Chronic pharyngitis,racial,Black or African American ,0,1,1
444258,Abrasion AND/OR friction burn of neck with infection,racial,Asian,0,1,1
321638,"Benign essential hypertension complicating pregnancy, childbirth and the puerperium",racial,American Indian or Alaska Native ,1,0,1
432682,Complete spontaneous abortion with delayed or excessive haemorrhage,racial,White,1,0,1
136960,Vascular myelopathies,ethnic,Hispanic or Latino,1,0,1
31967,Nausea,racial,Native Hawaiian or Other Pacific Islander ,1,0,1
443715,Atypical squamous cells on anal Papanicolaou smear cannot exclude high grade squamous intraepithelial lesion,racial,White,1,0,1
444283,Superficial foreign body of hand without major open wound AND without infection,ethnic,Not Hispanic or Latino,1,0,1
374955,Spasm of conjugate gaze,ethnic,Hispanic or Latino,0,1,1
4111113,Other external ear disorder NOS,ethnic,Hispanic or Latino,1,0,1
319844,Acute ischemic heart disease,ethnic,Hispanic or Latino,0,1,1
442181,Secondary malignant neoplasm of lymph nodes of neck,ethnic,Hispanic or Latino,1,0,1
132659,Acute apical periodontitis,racial,Arab,1,0,1
4062733,Neurological screening,racial,White,1,0,1
440938,Infection by Shigella,racial,Unknown,0,1,1
373166,Benign neoplasm of lower jaw bone,ethnic,Hispanic or Latino,1,0,1
79939,Sprain of tarsometatarsal joint AND/OR ligament,ethnic,Not Hispanic or Latino,1,0,1
254980,Intrinsic asthma with asthma attack,racial,American Indian or Alaska Native ,1,0,1
80809,Rheumatoid arthritis,racial,Native Hawaiian or Other Pacific Islander ,1,0,1
438391,Amino acid transport disorder,ethnic,Not Hispanic or Latino,1,0,1
4064926,Ischemic heart disease screening,ethnic,Hispanic or Latino,1,0,1
4021807,Interpersonal relationship observations,ethnic,Hispanic or Latino,0,1,1
255302,Spontaneous pneumothorax,racial,White,0,1,1
74816,Contusion of toe,racial,Native Hawaiian or Other Pacific Islander ,0,1,1
444453,Benign tumour of soft tissue of leg,racial,Black or African American ,0,1,1
377865,Acquired color vision deficiency,ethnic,Hispanic or Latino,0,1,1
435141,Haemorrhage AND/OR haematoma complicating procedure,ethnic,Not Hispanic or Latino,1,0,1
317100,Fetal tachycardia,ethnic,Hispanic or Latino,1,0,1
79115,"Spondylopathy, NOS",ethnic,Hispanic or Latino,1,0,1
138538,Longitudinal deficiency of limb,racial,Black or African American ,0,1,1
438123,Disorder of corticoadrenal overactivity,ethnic,Not Hispanic or Latino,0,1,1
435933,Closed fracture of lumbar vertebra without spinal cord injury,racial,Other Race,0,1,1
433915,Burn of thigh,ethnic,Hispanic or Latino,1,0,1
432746,"Open fracture of radius and ulna, shaft",racial,White,0,1,1
4060318,Chest pain NOS,racial,Native Hawaiian or Other Pacific Islander ,0,1,1
373472,Pigmentary retinal dystrophy,ethnic,Not Hispanic or Latino,0,1,1
4186238,Louse infestation,racial,Black or African American ,1,0,1
444132,Knee injury,racial,Asian,1,0,1
4053378,FH: Blood disorder,racial,Black or African American ,1,0,1
372766,Open wound of head with complication,ethnic,Hispanic or Latino,0,1,1
72471,Sprain of carpometacarpal joint,racial,Unknown,1,0,1
78633,Stokers' cramp,racial,Unknown,1,0,1
196284,Burn of mouth and pharynx,racial,Other Race,1,0,1
435805,Cerebrospinal rhinorrhoea,racial,Other Race,1,0,1
197032,Hyperplasia of prostate,racial,Filipino,0,1,1
441918,"Emotional AND/OR mental disease in mother complicating pregnancy, childbirth AND/OR puerperium",racial,Asian,1,0,1
380707,Distortion of visual image,ethnic,Not Hispanic or Latino,0,1,1
4112819,Pneumonia due to other specified bacteria,ethnic,Not Hispanic or Latino,0,1,1
373412,Otitis externa due to Herpes zoster,ethnic,Not Hispanic or Latino,0,1,1
436859,"Insect bite, nonvenomous, of shoulder and upper arm, infected",racial,Unknown,1,0,1
434689,Incomplete abortion,racial,White,1,0,1
253121,"Tuberculosis of lung, confirmed by culture only",ethnic,Hispanic or Latino,0,1,1
79914,Polydactyly of toes,ethnic,Hispanic or Latino,0,1,1
373489,Congenital nystagmus,racial,Unknown,1,0,1
382003,Burn of face AND/OR head,ethnic,Hispanic or Latino,1,0,1
432586,Mental disorder,racial,American Indian or Alaska Native ,0,1,1
438698,"Malignant lymphoma of lymph nodes of head, face AND/OR neck",racial,Unknown,1,0,1
195976,Burn of gastrointestinal tract,ethnic,Not Hispanic or Latino,1,0,1
436804,Fetus OR newborn affected by premature rupture of membranes,ethnic,Not Hispanic or Latino,0,1,1
372907,Macular scar,racial,Other Race,1,0,1
136282,"Burn erythema of single finger, not thumb",racial,White,1,0,1
377885,Disorder of eye movements,racial,Filipino,1,0,1
377551,Blind hypertensive eye,racial,Unknown,1,0,1
4032877,Chronic amoebic dysentery,ethnic,Hispanic or Latino,1,0,1
442299,Injury of female external genital organs,racial,Unknown,0,1,1
436730,"Appendicitis, unqualified",racial,Asian,0,1,1
4108374,Other specified peripheral vascular disease NOS,ethnic,Not Hispanic or Latino,0,1,1
40481819,Early satiety,ethnic,Not Hispanic or Latino,0,1,1
4064383,Rheumatoid arthritis screening,racial,Filipino,1,0,1
436289,Non-medicinal agent causing toxic effects,racial,Other Race,1,0,1
437872,Rupture in Descemet membrane,ethnic,Hispanic or Latino,1,0,1
197684,Dysuria,racial,Alaska Native,1,0,1
438303,Fall on same level from sports contact,ethnic,Hispanic or Latino,1,0,1
376125,Disorder of eyelid,racial,Black or African American ,1,0,1
314958,Benign secondary hypertension,racial,Unknown,0,1,1
434872,Infection by Trichomonas,racial,Other Race,1,0,1
201927,Cellulitis and abscess of leg,racial,Asian Indian,1,0,1
435508,Adrenal cortical hypofunction,racial,Filipino,1,0,1
135895,Variation in hair color,racial,White,0,1,1
443564,Malignant neoplasm of bone,ethnic,Not Hispanic or Latino,1,0,1
432877,Socialised behaviour disorder,racial,Unknown,0,1,1
443774,"Disease condition determination, uncontrolled",racial,Asian,1,0,1
192963,Disease of pancreas,racial,Asian,1,0,1
197324,Disease of peritoneum,racial,Unknown,0,1,1
256440,Disorder of paranasal sinuses,racial,Native Hawaiian or Other Pacific Islander ,1,0,1
198695,"Malignant neoplasm, overlapping lesion of biliary tract",racial,White,1,0,1
4110499,Allergic rhinitis NOS,racial,Black or African American ,0,1,1
441716,Open wound of axillary region with complication,racial,White,0,1,1
132932,Chronic ethmoidal sinusitis,racial,Black or African American ,0,1,1
4061081,Other male genital organ diseases OS,racial,Unknown,0,1,1
199860,Hernia of abdominal cavity,racial,Native Hawaiian or Other Pacific Islander ,0,1,1
4179235,Family history of malignant neoplasm of lung,racial,Unknown,1,0,1
253321,Stridor,racial,Native Hawaiian or Other Pacific Islander ,0,1,1
141955,Pectus excavatum,racial,Asian,0,1,1
140654,Deep seated dermatophytosis,ethnic,Not Hispanic or Latino,1,0,1
435000,Complete spontaneous abortion with metabolic disorder,ethnic,Hispanic or Latino,1,0,1
254669,Disease of vocal cords,racial,Black or African American ,1,0,1
74507,Sprain of radiohumeral joint,racial,White,1,0,1
373747,Extrapyramidal disease,racial,Other Race,0,1,1
438812,Abortion complicated by genital-pelvic infection,ethnic,Not Hispanic or Latino,1,0,1
4051770,"Contusion, ankle and foot, excluding toe(s)",racial,Unknown,0,1,1
443865,Non-infective colitis,racial,Asian Indian,0,1,1
372328,Otitis media,racial,Alaska Native,0,1,1
440237,Open fracture of upper end of lower leg,ethnic,Hispanic or Latino,1,0,1
76801,Polyostotic fibrous dysplasia of bone,ethnic,Hispanic or Latino,0,1,1
378679,Acute poliomyelitis,racial,Asian,1,0,1
4088930,Confirmation of pregnancy,racial,African American,1,0,1
135029,Peeling of skin,ethnic,Hispanic or Latino,1,0,1
440309,Adverse reaction to diphtheria vaccine,racial,White,1,0,1
434766,Open supracondylar fracture of humerus,racial,White,1,0,1
439155,Carcinoembryonic antigen present,racial,Asian,0,1,1
198928,Mechanical complication due to intrauterine contraceptive device,racial,American Indian or Alaska Native ,1,0,1
4052921,FH: Consanguinity,ethnic,Not Hispanic or Latino,0,1,1
440518,5p partial monosomy syndrome,ethnic,Hispanic or Latino,0,1,1
433527,Endometriosis,racial,Other Race,1,0,1
77636,Primary localized osteoarthrosis of upper arm,racial,White,1,0,1
433746,"Combined drug dependence, excluding opioid, continuous",ethnic,Not Hispanic or Latino,1,0,1
443449,Acute laryngitis with obstruction,ethnic,Not Hispanic or Latino,0,1,1
75046,Old bucket handle tear of medial meniscus,ethnic,Not Hispanic or Latino,0,1,1
442013,Burn,racial,Black or African American ,0,1,1
435368,Congenital pigeon chest,ethnic,Not Hispanic or Latino,0,1,1
440409,Disorder of orbit proper,racial,White,1,0,1
436480,Dystrophy of vulva,racial,White,1,0,1
375475,Meningoencephalitis due to acquired toxoplasmosis,ethnic,Not Hispanic or Latino,0,1,1
440069,Drug dependence,racial,Asian Indian,0,1,1
76737,Hydrocele,racial,Unknown,0,1,1
254662,Pulmonary infarction,racial,Asian,0,1,1
4273630,Patch repair of arteriovenous fistula,ethnic,Hispanic or Latino,0,1,1
76772,Galactorrhea in pregnancy and the puerperium with antenatal complication,racial,Unknown,1,0,1
443753,Abrasion AND/OR friction burn of wrist without infection,racial,Black or African American ,1,0,1
442540,Liver moderate laceration without mention of open wound into cavity,ethnic,Hispanic or Latino,0,1,1
380719,Impairment level: one eye: moderate impairment: other eye: normal vision,ethnic,Not Hispanic or Latino,1,0,1
441170,Superficial injury with infection,racial,Native Hawaiian or Other Pacific Islander ,0,1,1
139850,Acute frontal sinusitis,racial,American Indian,1,0,1
4059178,Gastrojejunal ulcer,racial,American Indian or Alaska Native ,1,0,1
4081759,Transplant follow-up,racial,White,1,0,1
319047,Necrosis of artery,racial,Unknown,0,1,1
435219,Schizophrenia in remission,racial,Unknown,1,0,1
77882,Vestibular active Meniere's disease,racial,White,1,0,1
201527,Neoplasm of uncertain behaviour of prostate,racial,Asian,0,1,1
195513,Vaginal intraepithelial neoplasia grade III,racial,Unknown,1,0,1
439960,Late effect of external cause,racial,Black or African American ,1,0,1
77960,Joint observation,racial,Black or African American ,0,1,1
74458,Enthesopathy of knee region,racial,American Indian,1,0,1
442216,Kernicterus not due to isoimmunization,racial,White,1,0,1
442610,Degenerative AND/OR vascular disorder of ear,ethnic,Not Hispanic or Latino,0,1,1
4100367,Simple schizophrenia NOS,ethnic,Hispanic or Latino,0,1,1
438021,Sequelae of fracture of arm,racial,Unknown,0,1,1
433454,Adjustment disorder with mixed emotional features,racial,Filipino,0,1,1
78009,Open traumatic pneumothorax,ethnic,Hispanic or Latino,0,1,1
443586,Transient organic mental disorder,racial,Unknown,1,0,1
435231,Nondependent cannabis abuse in remission,racial,Black or African American ,0,1,1
442792,Pes anserinus bursitis,ethnic,Not Hispanic or Latino,0,1,1
435979,Late effect of open wound of extremities without tendon injury,racial,White,0,1,1
378140,Inflammatory and toxic neuropathy,ethnic,Not Hispanic or Latino,0,1,1
76725,Fissure in ano,racial,Asian,0,1,1
4184252,Observation of neck region,racial,White,0,1,1
252947,Acute pulmonary edema due to fumes AND/OR vapors,ethnic,Hispanic or Latino,1,0,1
443753,Abrasion AND/OR friction burn of wrist without infection,racial,Asian Indian,0,1,1
132706,Nail disease,racial,Native Hawaiian or Other Pacific Islander ,1,0,1
133088,Late amputation stump complication,racial,White,0,1,1
440600,Assault by bite of human being,racial,White,0,1,1
377282,Conjunctivitis with mucocutaneous disorder,ethnic,Not Hispanic or Latino,1,0,1
440432,Accretion on teeth,ethnic,Not Hispanic or Latino,0,1,1
4110787,Other otitis externa,racial,Other Race,1,0,1
439391,Physical abuse of adult,racial,Native Hawaiian or Other Pacific Islander ,1,0,1
80183,"Localised, secondary osteoarthritis of the ankle and/or foot",racial,White,1,0,1
443447,Iatrogenic hypotension,racial,Native Hawaiian or Other Pacific Islander ,0,1,1
132553,Herpangina,racial,Black or African American ,0,1,1
4200655,Urostomy present,racial,Unknown,0,1,1
77638,Displacement of intervertebral disc without myelopathy,racial,American Indian or Alaska Native ,1,0,1
137213,Fungal dermatosis,racial,Filipino,1,0,1
76791,Acquired deformity of hip,racial,Other Race,0,1,1
440329,Herpes zoster without complication,racial,Asian Indian,1,0,1
195977,Contusion of trunk,racial,Black or African American ,0,1,1
4048191,Enlargement of tonsil or adenoid,racial,Black or African American ,1,0,1
435320,Acute glomerulonephritis associated with another disorder,ethnic,Hispanic or Latino,0,1,1
4059637,Work environment deleterious,racial,Black or African American ,1,0,1
312934,Atherosclerosis of aorta,racial,Filipino,1,0,1
4057346,"Contusion, hip and thigh",ethnic,Hispanic or Latino,0,1,1
437985,Disturbance of temperature regulation of newborn,ethnic,Hispanic or Latino,1,0,1
435647,Congenital folds and cysts of the posterior segment,racial,Unknown,1,0,1
4237140,Abnormal sexual function,racial,Asian,0,1,1
75346,Disorder of meniscus of knee,racial,Other Race,1,0,1
434172,Insomnia with sleep apnoea,racial,Black or African American ,0,1,1
373748,Grand mal status,racial,White,1,0,1
140490,Anhidrosis,ethnic,Hispanic or Latino,0,1,1
439776,Pervasive developmental disorder,racial,Asian,0,1,1
193359,Open wound of multiple sites of one lower limb AND thigh with complication,racial,White,1,0,1
432246,Leptospirosis,ethnic,Hispanic or Latino,1,0,1
254677,Adenoviral pneumonia,ethnic,Hispanic or Latino,1,0,1
436339,Bacterial infection due to Klebsiella pneumoniae,racial,White,1,0,1
438460,Edentulous alveolar ridge atrophy,racial,Asian,0,1,1
437779,Streptococcal infectious disease,racial,Unknown,0,1,1
435081,Abnormal findings on diagnostic imaging of heart and coronary circulation,racial,Black or African American ,1,0,1
195313,Urethral abscess,racial,White,1,0,1
4180167,Joint infection,ethnic,Hispanic or Latino,0,1,1
40480082,Hemicrania continua,ethnic,Not Hispanic or Latino,1,0,1
438407,BN - Bulimia nervosa,racial,American Indian,1,0,1
434272,Varicella infection,racial,Other Race,1,0,1
374053,Sudden hearing loss,racial,White,0,1,1
4175331,Congenital haemolytic anaemia,ethnic,Not Hispanic or Latino,0,1,1
199079,Hypertrophy of clitoris,ethnic,Not Hispanic or Latino,1,0,1
433813,Bladder neck obstruction,racial,White,0,1,1
78834,Effusion of joint of hand,racial,Black or African American ,0,1,1
373755,Thunderclap headache,ethnic,Hispanic or Latino,1,0,1
441170,Superficial injury with infection,racial,Black or African American ,1,0,1
193525,Abdominal pregnancy,racial,American Indian or Alaska Native ,1,0,1
141370,Toxic erythema,racial,Unknown,1,0,1
435170,Effects of thirst,racial,Native Hawaiian or Other Pacific Islander ,1,0,1
4087437,Other specified bacterial disease NOS,ethnic,Hispanic or Latino,0,1,1
140364,Disorder of thyrocalcitonin secretion,ethnic,Hispanic or Latino,1,0,1
437221,Chlamydia trachomatis infection,racial,Asian,1,0,1
433457,Agoraphobia without mention of panic attacks,racial,Other Race,0,1,1
257008,Abscess of parapharyngeal space,ethnic,Not Hispanic or Latino,0,1,1
375791,Uncomplicated senile dementia,racial,Alaska Native,1,0,1
435563,Acute and subacute infective endocarditis associated with another disorder,ethnic,Hispanic or Latino,1,0,1
436015,Accidental poisoning from foodstuffs and poisonous plants,ethnic,Hispanic or Latino,0,1,1
194018,"Functional enuresis, NOS",racial,Asian,0,1,1
199868,Incisional hernia with gangrene,racial,White,1,0,1
255175,Nodular tuberculosis of lung,racial,White,0,1,1
137974,Abnormal fetal heart beat noted before labor in liveborn infant,racial,White,1,0,1
77960,Joint observation,racial,Native Hawaiian or Other Pacific Islander ,0,1,1
377126,Concussion with brief loss of consciousness,ethnic,Not Hispanic or Latino,1,0,1
252942,Asthmatic pulmonary eosinophilia,ethnic,Hispanic or Latino,0,1,1
381040,Acute myringitis,ethnic,Hispanic or Latino,0,1,1
4085104,Dermatosis due to mites,ethnic,Hispanic or Latino,1,0,1
4092879,Absent kidney,racial,Black or African American ,0,1,1
440653,Infection by toxoplasma gondii,racial,Black or African American ,1,0,1
4153441,Fetus or neonate affected by breech delivery and extraction,racial,White,1,0,1
433750,"Single major depressive episode, in full remission",racial,Other Race,1,0,1
432463,"Closed fracture clavicle, lateral end",racial,White,1,0,1
441855,Epiphora due to excess lacrimation,ethnic,Hispanic or Latino,1,0,1
438250,Congenital talipes varus,racial,Black or African American ,0,1,1
380688,Hypoglycaemic coma,ethnic,Hispanic or Latino,0,1,1
134661,Chronic sphenoidal sinusitis,ethnic,Hispanic or Latino,0,1,1
138644,Burn erythema of lower limb,racial,Asian,0,1,1
440255,Open wound of axillary region without complication,racial,White,1,0,1
434459,Ganglion of tendon sheath,racial,Asian,0,1,1
440847,Neonatal jaundice associated with preterm delivery,ethnic,Hispanic or Latino,0,1,1
135032,Dermatitis due to substances taken internally,racial,Black or African American ,1,0,1
441589,Endocarditis,racial,Black or African American ,1,0,1
435186,Disease due to Rhinovirus,racial,White,0,1,1
4285734,Instability of joint,racial,Unknown,0,1,1
442013,Burn,racial,Native Hawaiian or Other Pacific Islander ,0,1,1
434212,Contusion of axillary region,racial,Unknown,1,0,1
442325,Furuncle of foot,racial,Unknown,1,0,1
433862,Congenital anomaly of tongue,racial,Unknown,0,1,1
196895,Viral gastroenteritis due to Norwalk-like agents,racial,White,1,0,1
438820,Postpartum deep phlebothrombosis,racial,White,1,0,1
437449,Victim of child abuse,racial,Other Race,1,0,1
197917,Disorder of biliary tract,racial,Asian,1,0,1
193079,Injury of nerve of trunk,racial,Unknown,1,0,1
4147507,Retinal detachments and defects,ethnic,Hispanic or Latino,1,0,1
196053,Metastatic tumour in kidney,ethnic,Not Hispanic or Latino,0,1,1
201901,Abscess of liver,racial,White,0,1,1
443858,Superficial injury of ankle with infection,ethnic,Hispanic or Latino,0,1,1
201519,Ca liver - primary,racial,Asian,1,0,1
4090206,Late effects of tuberculosis NOS,racial,White,0,1,1
4096038,Diabetes mellitus NOS with ophthalmic manifestation,ethnic,Hispanic or Latino,1,0,1
4001138,Other soft tissue disorders,racial,Unknown,1,0,1
138918,Partial thickness burn of lip,ethnic,Hispanic or Latino,0,1,1
196360,Primary malignant neoplasm of bladder,racial,Other Race,1,0,1
40481792,Acquired auditory processing disorder,racial,Black or African American ,0,1,1
76240,Closed fracture of pubis,racial,White,1,0,1
381575,Disorder of external ear,racial,Asian,1,0,1
258785,Pneumococcal pneumonia,racial,Asian,1,0,1
376208,Soft tissue disorder,racial,Asian,1,0,1
4065992,Cellulitis and abscess of finger unspecified,racial,Black or African American ,0,1,1
438760,Chronic dacryocystitis,ethnic,Hispanic or Latino,1,0,1
79742,Primary genital syphilis,racial,Unknown,0,1,1
4112816,Other respiratory system diseases,racial,Other Race,0,1,1
201332,Alveolitis of jaw,racial,White,1,0,1
4117578,Other and unspecified joint disorders,racial,Unknown,1,0,1
375536,Organic writer's cramp,ethnic,Hispanic or Latino,1,0,1
432967,Anemia during pregnancy - baby not yet delivered,racial,Arab,1,0,1
439221,"Adverse effect, due to correct medicinal substance properly administered",racial,Black or African American ,0,1,1
4194160,Thyroid function tests abnormal,racial,American Indian,1,0,1
193863,Congenital abnormality of lower limb AND/OR pelvic girdle,racial,Unknown,0,1,1
133655,Burn of forearm,racial,Unknown,1,0,1
372316,ARC - Abnormal retinal correspondence,ethnic,Hispanic or Latino,1,0,1
4109719,Other optic disc disorder NOS,ethnic,Hispanic or Latino,1,0,1
4234990,Cardiac revascularisation with bypass aortocoronary anastomosis of two coronary vessels,ethnic,Hispanic or Latino,1,0,1
4062641,Malaria screening,racial,Unknown,1,0,1
442067,Atopic dermatitis and related conditions,racial,American Indian,1,0,1
31057,Disorder of pharynx,racial,Unknown,1,0,1
312327,Acute myocardial infarction,racial,Alaska Native,1,0,1
4067459,Heterotopic liver transplant,racial,Black or African American ,0,1,1
436118,After-cataract with vision obscured,racial,Filipino,0,1,1
256142,Dental arch relationship anomaly,racial,Asian,0,1,1
435094,Open fracture of lower end of femur,racial,White,0,1,1
4215568,Sensory disturbance in limb,ethnic,Not Hispanic or Latino,1,0,1
252442,Neonatal aspiration of blood,ethnic,Hispanic or Latino,1,0,1
437841,Somatoform autonomic dysfunction - respiratory tract,racial,Unknown,1,0,1
373054,Open wound of auricle of ear without complication,racial,Filipino,1,0,1
139188,Open wound of scalp without complication,racial,Black or African American ,1,0,1
441193,Accident caused by nonpowered hand tools and implements,racial,Unknown,1,0,1
196259,Injury of gastrointestinal tract without open wound into abdominal cavity,ethnic,Hispanic or Latino,0,1,1
192568,Secondary malignant neoplasm of intra-abdominal lymph nodes,ethnic,Hispanic or Latino,1,0,1
436076,Adjustment disorder with mixed disturbance of emotions AND conduct,ethnic,Not Hispanic or Latino,1,0,1
80165,Fetal disproportion,racial,White,1,0,1
4252594,Subconjunctival injection,racial,Asian,1,0,1
78586,Sprain of interphalangeal joint of toe,racial,Unknown,0,1,1
433540,Polyhydramnios with antenatal problem,racial,Asian,0,1,1
197917,Disorder of biliary tract,ethnic,Not Hispanic or Latino,1,0,1
441191,Poisoning by arthropod,racial,Unknown,1,0,1
4147972,Specific academic or work inhibition,ethnic,Hispanic or Latino,0,1,1
196053,Metastatic tumour in kidney,racial,Asian,0,1,1
195731,Shigella dysenteriae (group A),racial,White,0,1,1
194680,Acute gastric ulcer with perforation but without obstruction,racial,Unknown,1,0,1
435640,"Gestation period, 25 weeks",racial,Asian,1,0,1
199881,Endometriosis of ovary,racial,Unknown,1,0,1
442105,Benign tumor of soft tissue,racial,White,1,0,1
441961,Congenital pelviureteric junction obstruction,ethnic,Hispanic or Latino,0,1,1
321587,Bilateral bundle branch block,racial,White,1,0,1
321683,TTN - Transient tachypnoea of newborn,racial,White,1,0,1
440059,Recurrent disease,racial,White,1,0,1
4208388,Laryngotracheitis,racial,White,1,0,1
74124,Traumatic arthropathy,ethnic,Hispanic or Latino,0,1,1
78230,Rheumatoid arthritis with organ / system involvement,racial,White,1,0,1
435835,Non-infectious disorder of lymphatics,racial,Asian,1,0,1
435914,Metatarsus varus,racial,Unknown,1,0,1
199856,Varicose veins of lower extremity with inflammation,racial,Asian,1,0,1
439922,"Gestation period, 24 weeks",ethnic,Not Hispanic or Latino,0,1,1
193322,Right lower quadrant pain,racial,American Indian,1,0,1
441481,Adult victim of abuse,racial,Other Race,1,0,1
437794,Juvenile syphilis,ethnic,Hispanic or Latino,0,1,1
314059,Right bundle branch block,racial,Other Race,1,0,1
4025663,Obstructed inguinal hernia,racial,White,0,1,1
433886,Closed fracture of trapezium bone of wrist,ethnic,Hispanic or Latino,1,0,1
438411,Endophthalmitis,racial,Unknown,0,1,1
435904,Derangement of anterior horn of medial meniscus,ethnic,Not Hispanic or Latino,1,0,1
197311,Pelvic varices,racial,White,0,1,1
256142,Dental arch relationship anomaly,ethnic,Not Hispanic or Latino,0,1,1
381444,Black eye,racial,American Indian or Alaska Native ,0,1,1
192259,Ascariasis,racial,Unknown,1,0,1
197596,Toxic gastroenteritis,racial,White,0,1,1
437165,Motor vehicle traffic accident,racial,Native Hawaiian or Other Pacific Islander ,0,1,1
437738,Motor vehicle accident off public road,ethnic,Hispanic or Latino,1,0,1
195058,Nonallopathic lesion of abdomen,ethnic,Not Hispanic or Latino,1,0,1
437693,Open fracture shaft of tibia,racial,White,0,1,1
194109,Delayed postpartum haemorrhage,ethnic,Hispanic or Latino,1,0,1
442281,Sprain of septal cartilage of nose,ethnic,Hispanic or Latino,1,0,1
4242962,Benign tumour of small intestine,ethnic,Hispanic or Latino,1,0,1
201817,Benign tumour of female genital organs,ethnic,Not Hispanic or Latino,1,0,1
378125,Presenile dementia,racial,Unknown,1,0,1
4201472,Varicella contact,ethnic,Not Hispanic or Latino,0,1,1
313800,Thrombotic microangiopathy,ethnic,Not Hispanic or Latino,1,0,1
435836,Disorder of nasopharynx,racial,Black or African American ,0,1,1
73041,Closed fracture of five ribs,racial,White,0,1,1
78267,Closed anterior dislocation of humerus,racial,Unknown,1,0,1
201624,Pyelitis associated with another disorder,ethnic,Hispanic or Latino,1,0,1
198551,"Embryonic cyst of cervix, vagina and external female genitalia",racial,Unknown,1,0,1
81186,Contusion of wrist,racial,Black or African American ,1,0,1
134057,Disease of cardiovascular system,racial,Filipino,0,1,1
4297166,Closed reduction of fracture without internal fixation,ethnic,Hispanic or Latino,1,0,1
141323,Acute maxillary sinusitis,racial,American Indian or Alaska Native ,1,0,1
4222126,Removal of urethral stent,racial,White,1,0,1
80225,Sprain of ligament of lumbosacral joint,racial,Black or African American ,0,1,1
133327,Viremia,racial,White,1,0,1
316457,Mallory-Weiss syndrome,racial,Native Hawaiian or Other Pacific Islander ,0,1,1
132408,Back problem,racial,Native Hawaiian or Other Pacific Islander ,1,0,1
75375,Closed fracture lunate,ethnic,Hispanic or Latino,0,1,1
79061,Colonic constipation,racial,Other Race,1,0,1
443743,Plasma cell neoplasm,racial,White,1,0,1
4056045,Other functional disorder of bladder,racial,Unknown,1,0,1
74080,Orthostatic proteinuria,ethnic,Not Hispanic or Latino,0,1,1
133280,Alopecia,racial,American Indian,0,1,1
434164,Glycosuria,racial,Asian,1,0,1
433981,Benign neoplasm of short bone of upper limb,ethnic,Hispanic or Latino,0,1,1
444219,Osteitis deformans without bone tumor,racial,White,0,1,1
444084,Extrinsic allergic alveolitis,racial,Unknown,0,1,1
376703,Disorder of pinna,ethnic,Not Hispanic or Latino,1,0,1
436097,"Nondependent mixed drug abuse, continuous",racial,Black or African American ,0,1,1
4101989,Closed fracture of shaft of bone of forearm,ethnic,Hispanic or Latino,0,1,1
133859,Preauricular cyst,racial,White,1,0,1
4093048,Reduction deformity of leg,racial,White,0,1,1
432804,Fall from scaffold,ethnic,Hispanic or Latino,1,0,1
260759,Malocclusion of teeth,racial,Black or African American ,0,1,1
4104583,Mechanical strabismus NOS,racial,White,1,0,1
432454,Excessive thirst,racial,Other Race,0,1,1
4139420,Foreign body in auditory canal,racial,American Indian or Alaska Native ,0,1,1
4069541,Other acquired ankle and foot deformity,racial,Unknown,1,0,1
435642,Disturbance in speech,racial,Black or African American ,1,0,1
433466,Childhood and adolescent relationship problem,ethnic,Not Hispanic or Latino,1,0,1
440930,Adverse effect of radiation therapy,ethnic,Hispanic or Latino,1,0,1
24818,Neck injury,racial,Asian,1,0,1
201346,Oedema of penis,ethnic,Not Hispanic or Latino,0,1,1
435835,Non-infectious disorder of lymphatics,ethnic,Not Hispanic or Latino,1,0,1
434348,Acute and subacute iridocyclitis,ethnic,Hispanic or Latino,1,0,1
4228475,Peripheral degeneration of retina,ethnic,Hispanic or Latino,1,0,1
442019,Complication of procedure,racial,Unknown,1,0,1
440112,Chloasma of eyelid,racial,Other Race,1,0,1
196613,Neuroma of amputation stump,ethnic,Hispanic or Latino,1,0,1
443535,Infection due to enterococcus,racial,Unknown,1,0,1
440088,Academic underachievement disorder,racial,Black or African American ,1,0,1
435993,Foreign body in conjunctival sac,ethnic,Not Hispanic or Latino,0,1,1
199192,Abrasion AND/OR friction burn of trunk without infection,racial,American Indian or Alaska Native ,0,1,1
317009,Hyperreactive airway disease,racial,African American,1,0,1
439847,Intracranial hemorrhage,racial,Unknown,1,0,1
4066260,Galactorrhea in pregnancy and the puerperium,ethnic,Not Hispanic or Latino,1,0,1
373766,Retinopathy of prematurity,racial,Other Race,1,0,1
437954,Lateral meniscus derangement,ethnic,Not Hispanic or Latino,1,0,1
442306,Adjustment disorder with depressed mood,racial,Asian Indian,1,0,1
201078,Senile atrophic vaginitis,racial,American Indian or Alaska Native ,1,0,1
74806,Open wound of finger with complication,ethnic,Not Hispanic or Latino,0,1,1
437579,Paroxysmal ventricular tachycardia,racial,Native Hawaiian or Other Pacific Islander ,0,1,1
316999,Cardiac arrhythmia,racial,Alaska Native,0,1,1
432789,Opioid analgesic adverse reaction,racial,White,1,0,1
4263748,Recurrent major depression in complete remission,racial,Black or African American ,1,0,1
77644,Adhesive capsulitis of shoulder,racial,American Indian,0,1,1
4094126,Family problems,ethnic,Not Hispanic or Latino,1,0,1
378256,Abnormal reflex,racial,Black or African American ,0,1,1
378165,Nystagmus,racial,Other Race,1,0,1
432478,Intracranial hemorrhage following injury without open intracranial wound AND with concussion,ethnic,Hispanic or Latino,0,1,1
79957,Traumatic amputation of finger with complication,racial,White,0,1,1
4290000,Mumps,ethnic,Not Hispanic or Latino,1,0,1
4062495,Glaucoma screening,racial,American Indian,1,0,1
433319,Fetus OR newborn affected by maternal complication of pregnancy,racial,White,1,0,1
439776,Pervasive developmental disorder,ethnic,Not Hispanic or Latino,0,1,1
79069,Disease of rectum,racial,Unknown,0,1,1
440583,Secondary AND/OR recurrent hemorrhage as early complication of trauma,ethnic,Hispanic or Latino,1,0,1
438733,Profound mental handicap,racial,Unknown,0,1,1
75354,Osteochondropathy,racial,Asian Indian,1,0,1
434621,Autoimmune disease,racial,White,1,0,1
377091,Fits - convulsions,racial,Native Hawaiian or Other Pacific Islander ,0,1,1
436624,Late congenital syphilis - latent,racial,White,0,1,1
134461,Tietze disease,racial,American Indian or Alaska Native ,1,0,1
439989,Insulin adverse reaction,ethnic,Not Hispanic or Latino,1,0,1
318776,Rheumatic mitral regurgitation,racial,White,1,0,1
4237458,Fracture of clavicle,racial,Unknown,1,0,1
137813,Benign neoplasm of mouth region,ethnic,Not Hispanic or Latino,1,0,1
194158,Perinatal gastrointestinal hemorrhage,ethnic,Not Hispanic or Latino,0,1,1
195588,Cystitis,racial,American Indian,1,0,1
443274,Psychostimulant dependence,racial,Black or African American ,1,0,1
372424,Congenital anolmaly of eye,racial,Other Race,0,1,1
4141622,Asthma NOS,racial,American Indian or Alaska Native ,1,0,1
74469,Light-for-dates without mention of fetal malnutrition,racial,Unknown,0,1,1
376961,Disturbance of consciousness,racial,Asian,1,0,1
4275257,Detoxication therapy for alcoholism,racial,White,0,1,1
4185471,Disorder of pigmentation,racial,Asian Indian,1,0,1
443748,Congenital anomaly of the bladder,racial,Unknown,0,1,1
377659,Spina bifida of lumbar region,racial,White,0,1,1
439139,Infections specific to perinatal period,racial,White,0,1,1
438997,Neoplasm of uncertain behavior of meninges,ethnic,Hispanic or Latino,1,0,1
381292,Chronic allergic conjunctivitis,racial,Asian Indian,1,0,1
4143966,Essential hypertension NOS,racial,Unknown,1,0,1
133294,Prepatellar bursitis,racial,Filipino,1,0,1
440314,Injury of unknown intent by shotgun,ethnic,Hispanic or Latino,0,1,1
4227745,Infertility test,ethnic,Not Hispanic or Latino,0,1,1
252477,Extradural haemorrhage following injury without open intracranial wound,ethnic,Hispanic or Latino,0,1,1
192242,Acute hepatitis C,racial,Asian,1,0,1
432517,Posttraumatic wound infection,racial,Black or African American ,1,0,1
433678,Infection of central venous catheter,racial,Asian,1,0,1
438028,Poisoning by drug AND/OR medicinal substance,racial,Asian,0,1,1
196569,Contusion of abdominal wall,racial,Other Race,0,1,1
376981,Amblyopia,racial,Other Race,0,1,1
4099207,Thyroiditis NOS,racial,White,1,0,1
75091,Closed fracture of carpal bone,racial,Filipino,1,0,1
377283,Conjunctival injection,racial,Asian,0,1,1
75343,Contracture of hip joint,racial,White,1,0,1
194703,Leucoplakia of vagina,ethnic,Not Hispanic or Latino,1,0,1
435649,Complication of hemodialysis,racial,Other Race,0,1,1
437922,Hematoma of vulva,racial,White,1,0,1
73302,Curvature of spine,racial,Black or African American ,1,0,1
4269719,Finding of growth of fungi,ethnic,Hispanic or Latino,0,1,1
441267,Cystic fibrosis,racial,Unknown,1,0,1
194081,Acute cystitis,racial,Asian Indian,1,0,1
373469,Symptomatic torsion dystonia,racial,White,1,0,1
4310254,Mediastinal pneumogram,racial,White,0,1,1
30133,Acute laryngitis,racial,Asian,1,0,1
314658,Cardiomegaly,racial,Filipino,1,0,1
436334,Infection by Trypanosoma cruzi,racial,White,1,0,1
436833,Open fracture of metacarpal bone,racial,White,1,0,1
4177115,Malignant tumour of testis,racial,Unknown,0,1,1
138813,Early or threatened labour,racial,Unknown,1,0,1
441540,Reactive confusion,racial,Asian,1,0,1
437255,Passive aggressive personality disorder,ethnic,Not Hispanic or Latino,1,0,1
135892,Erythematous condition,racial,Black or African American ,1,0,1
31120,Congenital anomaly of upper alimentary tract,racial,Unknown,1,0,1
4092896,Stool contents abnormal,racial,Native Hawaiian or Other Pacific Islander ,0,1,1
4069553,Acquired lordosis NOS,racial,White,1,0,1
74129,Allergic arthritis of the ankle and/or foot,racial,Unknown,1,0,1
4303805,Allergic reaction to bite and/or sting,racial,Other Race,0,1,1
374947,Acute infection of pinna,ethnic,Hispanic or Latino,1,0,1
75406,Crush injury of finger,racial,Black or African American ,0,1,1
201957,Necrotizing enterocolitis in fetus OR newborn,racial,Unknown,1,0,1
442553,Injury of bladder,racial,Unknown,0,1,1
438843,Non-traumatic rupture of patellar tendon,ethnic,Hispanic or Latino,1,0,1
4093311,Latent early syphilis NOS,racial,Black or African American ,1,0,1
75066,Nonallopathic lesion of cervical region,ethnic,Not Hispanic or Latino,0,1,1
380702,Cerebral cysts,racial,Other Race,1,0,1
23988,Hemolytic anemia due to glutathione metabolism disorder,racial,Black or African American ,1,0,1
138601,Open wound of face with complication,racial,Unknown,1,0,1
379816,Simple chronic conjunctivitis,ethnic,Hispanic or Latino,1,0,1
443877,Nonvenomous insect bite of shoulder without infection,ethnic,Not Hispanic or Latino,1,0,1
315361,Orthopnea,racial,Other Race,1,0,1
435485,Primary malignant neoplasm of ill-defined site,ethnic,Hispanic or Latino,1,0,1
194684,Crohn's disease of large bowel,racial,American Indian or Alaska Native ,1,0,1
256717,Bronchospasm,racial,Native Hawaiian or Other Pacific Islander ,0,1,1
258781,Pneumonopathy due to inhalation of dust,racial,Unknown,1,0,1
136834,Closed intertrochanteric fracture,racial,Unknown,1,0,1
443535,Infection due to enterococcus,racial,White,0,1,1
4108905,Congenital malformation of the urinary system,racial,Black or African American ,1,0,1
443357,Ankle joint observation,ethnic,Not Hispanic or Latino,1,0,1
374139,Buphthalmos,ethnic,Not Hispanic or Latino,1,0,1
4169009,FH: CVA,racial,Black or African American ,0,1,1
433451,Aggressive unsocial conduct disorder,racial,White,0,1,1
374035,Keratitis,racial,Filipino,1,0,1
440965,Hodgkin's disease of intrathoracic lymph nodes,racial,White,0,1,1
30234,Cervical sprain,racial,Native Hawaiian or Other Pacific Islander ,1,0,1
4112003,Hypotension NOS,racial,Unknown,1,0,1
372610,Post-concussion syndrome,racial,Native Hawaiian or Other Pacific Islander ,1,0,1
376971,Retinal tear,racial,Asian,0,1,1
78282,Closed dislocation of coccyx,racial,White,1,0,1
194406,Urinary tract obstruction,racial,Other Race,0,1,1
438730,Alkalosis,ethnic,Hispanic or Latino,0,1,1
372616,Werdnig-Hoffmann disease,racial,Asian,0,1,1
4069541,Other acquired ankle and foot deformity,racial,White,1,0,1
374360,Disorder of optic nerve,ethnic,Not Hispanic or Latino,0,1,1
435701,Injury of trigeminal nerve,ethnic,Hispanic or Latino,1,0,1
441770,Injury of unknown intent due to fall from high man-made structure,racial,Unknown,1,0,1
258787,Spontaneous tension pneumothorax,ethnic,Not Hispanic or Latino,0,1,1
75943,Open fracture of pubis,ethnic,Hispanic or Latino,1,0,1
138713,Disease of parathyroid glands,racial,Asian,1,0,1
261053,Pneumonia with aspergillosis,ethnic,Not Hispanic or Latino,0,1,1
442170,Blister of neck with infection,ethnic,Not Hispanic or Latino,0,1,1
444424,Open wound of Eustachian tube with complication,racial,White,0,1,1
439234,Poisoning by cardiotonic glycoside,ethnic,Hispanic or Latino,1,0,1
4062652,Galactosaemia screening,ethnic,Not Hispanic or Latino,0,1,1
434328,"Nondependent cannabis abuse, episodic",racial,Black or African American ,0,1,1
437758,Dependance on enabling machine or device,ethnic,Hispanic or Latino,0,1,1
436828,Saliva abnormal,ethnic,Hispanic or Latino,1,0,1
140352,AML - Acute myeloid leukemia,racial,White,0,1,1
4092845,Candidiasis NOS,racial,Black or African American ,0,1,1
438783,Erosion of teeth,ethnic,Hispanic or Latino,0,1,1
25582,Tracheesophageal fistula,racial,Unknown,1,0,1
78647,Peroneal nerve injury,racial,White,0,1,1
73241,Anal and rectal polyp,racial,Black or African American ,0,1,1
4330220,Family history of malignant neoplasm of genital structure,racial,White,1,0,1
441833,Pathological drug intoxication,ethnic,Hispanic or Latino,1,0,1
314463,Congenital anomaly of aorta,racial,Other Race,0,1,1
4057348,"Contusion, knee and lower leg NOS",racial,Unknown,0,1,1
442023,Poisoning of undetermined intent,racial,Other Race,1,0,1
319843,Mitral valve disorder,racial,American Indian,0,1,1
436940,Insulin resistance syndrome,racial,American Indian or Alaska Native ,1,0,1
141729,Burn of forehead AND/OR cheek,ethnic,Not Hispanic or Latino,1,0,1
194683,Obstructed umbilical hernia,racial,White,1,0,1
260336,Primary malignant neoplasm of glottis,racial,White,0,1,1
75721,Prosthetic joint mechanical failure,racial,White,1,0,1
374341,Huntington's chorea,racial,Black or African American ,1,0,1
437671,Abnormal feces,racial,Black or African American ,1,0,1
443262,Lack or loss of sexual desire,racial,Unknown,1,0,1
314381,Kawasaki syndrome,racial,Unknown,0,1,1
27918,Eosinophilic esophagitis,racial,Asian,0,1,1
435357,Conjoined twins,ethnic,Not Hispanic or Latino,1,0,1
141213,Scarlet fever,racial,Filipino,1,0,1
196858,Late effect of fracture of neck of femur,racial,White,0,1,1
434833,Adverse reaction to anti-common cold drugs,racial,White,0,1,1
192785,Second degree burn of abdominal wall,racial,Unknown,1,0,1
443323,Papyraceous fetus - not delivered,ethnic,Hispanic or Latino,1,0,1
432436,Symbolic dysfunction,racial,Unknown,1,0,1
440193,Wristdrop,racial,Unknown,0,1,1
72377,Shoulder girdle dystocia,ethnic,Hispanic or Latino,0,1,1
434321,Schizoaffective schizophrenia in remission,ethnic,Hispanic or Latino,1,0,1
432879,Pneumococcal meningitis,ethnic,Hispanic or Latino,0,1,1
133573,Acute osteomyelitis of shoulder region,ethnic,Not Hispanic or Latino,0,1,1
4064382,Skin disease screening,racial,Unknown,0,1,1
4311591,Cramp in limb,racial,American Indian or Alaska Native ,1,0,1
375823,Optic nerve hypoplasia,ethnic,Not Hispanic or Latino,0,1,1
374049,Acute mucoid otitis media,racial,Other Race,1,0,1
378125,Presenile dementia,racial,White,1,0,1
439810,VKH syndrome,ethnic,Hispanic or Latino,1,0,1
78267,Closed anterior dislocation of humerus,racial,White,0,1,1
75343,Contracture of hip joint,racial,Unknown,1,0,1
4249474,Generalized seborrheic dermatitis of infants,racial,Unknown,1,0,1
140208,Unilateral complete cleft palate with cleft lip,ethnic,Hispanic or Latino,1,0,1
440855,Closed fracture of base of metacarpal bone other than first metacarpal,racial,Asian,0,1,1
80249,Sprain of acromioclavicular ligament,racial,Other Race,0,1,1
133794,Chronic gingivitis,racial,Native Hawaiian or Other Pacific Islander ,0,1,1
23034,Neonatal hypoglycemia,racial,White,0,1,1
441977,Closed dislocation of carpometacarpal joint of wrist,racial,Black or African American ,0,1,1
434007,Congenital factor VIII deficiency,racial,Unknown,0,1,1
372316,ARC - Abnormal retinal correspondence,ethnic,Not Hispanic or Latino,1,0,1
441541,Lymphocytopenia,ethnic,Not Hispanic or Latino,1,0,1
80177,Pyogenic arthritis of the pelvic region and thigh,ethnic,Not Hispanic or Latino,1,0,1
4310395,Open reduction of dislocation of elbow,racial,White,0,1,1
73686,Tuberculosis of genitourinary system,racial,White,0,1,1
80813,Lumbosacral spondylosis without myelopathy,racial,Filipino,1,0,1
4147971,Personality disorder NOS,racial,White,1,0,1
441385,Corrected transposition of great vessels,racial,Other Race,1,0,1
133414,Candidiasis of skin and nails,racial,Filipino,1,0,1
4345458,Staphylococcal toxic shock syndrome,racial,Other Race,1,0,1
436642,Adamantiades-Behcet disease,ethnic,Hispanic or Latino,1,0,1
4252234,Repair of gastroschisis,ethnic,Hispanic or Latino,0,1,1
76550,Sprain of metatarsophalangeal joint,racial,Unknown,1,0,1
320416,Diseases of mitral and aortic valves,racial,Asian,1,0,1
4051568,Family history of mental disorder,racial,Black or African American ,0,1,1
443748,Congenital anomaly of the bladder,racial,White,0,1,1
436313,Shaken baby syndrome - non-accidental injury,racial,White,0,1,1
438536,Congenital anomaly of jaw,racial,Black or African American ,1,0,1
439139,Infections specific to perinatal period,racial,Unknown,0,1,1
439025,Dacryocystitis,ethnic,Not Hispanic or Latino,1,0,1
438208,Atrophy of vulva,racial,Black or African American ,1,0,1
196053,Metastatic tumour in kidney,ethnic,Hispanic or Latino,1,0,1
440794,Elderly primigravida - delivered,racial,Other Race,1,0,1
140318,"Septicemia due to streptococcus, group A",racial,Other Race,1,0,1
438409,Attention deficit hyperactivity disorder,racial,American Indian or Alaska Native ,1,0,1
197928,Menstruation absent,racial,Arab,1,0,1
23798,Acute laryngopharyngitis,racial,Black or African American ,0,1,1
73341,Closed fracture of head of radius,racial,Asian,0,1,1
4077080,Biopsy of chest wall,ethnic,Hispanic or Latino,0,1,1
433618,Open fracture of patella,ethnic,Hispanic or Latino,0,1,1
432287,Immunodeficiency with IgM hypergammaglobulinaemia,racial,Asian,1,0,1
317299,Disorder of vitreous body,racial,Asian,0,1,1
444226,Dental restoration present,ethnic,Hispanic or Latino,0,1,1
374377,Paralytic syndrome,racial,White,0,1,1
378143,Encephalitis,ethnic,Hispanic or Latino,1,0,1
4122175,Carbuncle/boil,ethnic,Not Hispanic or Latino,1,0,1
432366,Hematoma of broad ligament,ethnic,Hispanic or Latino,1,0,1
260315,Tuberculosis of lung with cavitation,ethnic,Not Hispanic or Latino,1,0,1
438134,Excessive sleep,racial,Black or African American ,0,1,1
381686,PVS - Persistent vegetative state,racial,White,0,1,1
4103886,Keratoconus NOS,racial,Unknown,1,0,1
440847,Neonatal jaundice associated with preterm delivery,ethnic,Not Hispanic or Latino,1,0,1
4223382,Comprehensive consultation,ethnic,Hispanic or Latino,0,1,1
4148404,Family history: Anemia,racial,Unknown,1,0,1
435642,Disturbance in speech,racial,Asian,0,1,1
436101,Disorder of meninges,racial,White,0,1,1
318789,Respiratory condition due to chemical fumes AND/OR vapors,ethnic,Hispanic or Latino,0,1,1
4091319,Streptococcal sore throat with scarlatina NOS,ethnic,Not Hispanic or Latino,1,0,1
4052931,Abandoned child,racial,Other Race,1,0,1
377539,Syringomyelia and syringobulbia,racial,Black or African American ,0,1,1
437894,Ventricular fibrillation,ethnic,Hispanic or Latino,0,1,1
321107,AR - Congenital aortic regurgitation,racial,Asian,0,1,1
137144,Open wound of palate with complication,racial,White,0,1,1
380102,Corneal edema,racial,White,1,0,1
434327,Cannabis abuse,racial,Asian,0,1,1
317895,Hypertension due to renovascular disease,racial,Other Race,0,1,1
197135,Ureter injury without mention of open wound into cavity,racial,Unknown,1,0,1
4095918,Other disorders of thyroid,ethnic,Not Hispanic or Latino,1,0,1
435510,Hypocalcemia,racial,Asian,1,0,1
441553,Myoclonus,racial,Black or African American ,0,1,1
321873,Dissection of carotid artery,ethnic,Hispanic or Latino,1,0,1
197163,Burn of trunk,ethnic,Not Hispanic or Latino,0,1,1
140168,Psoriasis,racial,Black or African American ,0,1,1
4026029,Primary ulcer of intestine,ethnic,Hispanic or Latino,1,0,1
439347,"Motor vehicle traffic accident involving pedestrian dragged by motor vehicle, passenger on motor cycle injured",racial,White,0,1,1
439665,Violent spouse,ethnic,Hispanic or Latino,1,0,1
138029,Second degree burn of palm,ethnic,Hispanic or Latino,0,1,1
443372,Lipid-lowering drug adverse reaction,ethnic,Not Hispanic or Latino,1,0,1
381036,Multiple AND bilateral precerebral artery stenosis,racial,Asian,0,1,1
78232,Shoulder joint pain,racial,Alaska Native,0,1,1
320416,Diseases of mitral and aortic valves,ethnic,Not Hispanic or Latino,1,0,1
4021168,Natural contraception,ethnic,Not Hispanic or Latino,1,0,1
381278,Cluster headache,racial,Asian,0,1,1
4110052,Bronchiectasis NOS,racial,Unknown,1,0,1
4145947,Subnormal birth weight,racial,White,0,1,1
441541,Lymphocytopenia,racial,Asian,1,0,1
4016359,Streptococcus carrier,racial,Other Race,1,0,1
372316,ARC - Abnormal retinal correspondence,racial,Asian,1,0,1
140949,Scabies,racial,Asian Indian,1,0,1
137944,Bullous dermatosis,racial,Filipino,0,1,1
197684,Dysuria,racial,Middle Eastern or North African,1,0,1
437590,Pulp necrosis,ethnic,Hispanic or Latino,0,1,1
72992,Allergic arthritis,ethnic,Not Hispanic or Latino,1,0,1
4290927,Impairment level: low vision of both eyes,racial,Asian Indian,0,1,1
31821,Endocrinopathy,racial,Other Race,1,0,1
137989,Abnormal results of cardiovascular function studies,racial,Native Hawaiian or Other Pacific Islander ,1,0,1
379019,Inflammation of conjunctiva,racial,American Indian,0,1,1
433749,Heparin-induced thrombocytopenia,racial,White,0,1,1
4083043,Convalescence after surgery,ethnic,Hispanic or Latino,0,1,1
138255,Abnormal cardiovascular function,ethnic,Not Hispanic or Latino,1,0,1
4303805,Allergic reaction to bite and/or sting,racial,American Indian or Alaska Native ,1,0,1
444259,Psychogenic amnesia,ethnic,Hispanic or Latino,1,0,1
377274,Nonsenile cataract,ethnic,Not Hispanic or Latino,0,1,1
136937,Benign tumour of endocrine gland,racial,White,1,0,1
443897,Disruption of perineal wound in the puerperium,racial,Unknown,1,0,1
442454,"Motor vehicle traffic accident involving collision between motor vehicle and pedal cycle, passenger of motor vehicle injured",racial,White,0,1,1
136030,Sweating fever,racial,Unknown,0,1,1
436339,Bacterial infection due to Klebsiella pneumoniae,racial,Unknown,1,0,1
4228058,Unilateral mastectomy extended simple,ethnic,Hispanic or Latino,1,0,1
252348,Chronic pulmonary radiation disease,ethnic,Not Hispanic or Latino,1,0,1
439025,Dacryocystitis,racial,Asian,0,1,1
441032,Episcleritis periodica fugax,racial,White,0,1,1
194702,PROM - Premature rupture of membranes,ethnic,Not Hispanic or Latino,1,0,1
435063,Fetus OR newborn affected by ectopic pregnancy,racial,White,1,0,1
4110738,Osteoarthritis deformans,racial,White,1,0,1
435835,Non-infectious disorder of lymphatics,ethnic,Hispanic or Latino,0,1,1
434261,"Motor vehicle nontraffic accident involving collision, not on public highway, between motor vehicle, except off-road motor vehicle, and nonmotor vehicle, motor cyclist injured",racial,Black or African American ,0,1,1
318443,Arteriosclerotic vascular disease,racial,Black or African American ,0,1,1
4188027,Food allergy,racial,Other Race,1,0,1
4235140,Operation for bone injury of phalanges of hand,ethnic,Not Hispanic or Latino,0,1,1
378439,Fourth nerve palsy,racial,Other Race,1,0,1
435418,Accidental poisoning by caustic alkalis,ethnic,Hispanic or Latino,0,1,1
4062555,"Unspecified hypertension complicating pregnancy, childbirth and the puerperium NOS",racial,American Indian or Alaska Native ,1,0,1
438970,Disease due to West Nile virus,ethnic,Hispanic or Latino,1,0,1
432804,Fall from scaffold,ethnic,Not Hispanic or Latino,0,1,1
4101068,Observation of ear discharge,racial,Black or African American ,0,1,1
441691,Atypical squamous cells of undetermined significance on vaginal Papanicolaou smear,racial,Asian,1,0,1
443253,Biological substance poisoning,ethnic,Hispanic or Latino,1,0,1
443430,HPV - Human papillomavirus test positive,racial,Other Race,0,1,1
433675,Toxic effect of chemical,racial,Asian,1,0,1
442008,Injury at T7-T12 level with spinal cord injury AND without bone injury,ethnic,Not Hispanic or Latino,1,0,1
4034214,Open wound of ear,ethnic,Not Hispanic or Latino,0,1,1
253482,Cortical blindness,racial,Other Race,1,0,1
140168,Psoriasis,ethnic,Not Hispanic or Latino,0,1,1
201387,Doubling of uterus,ethnic,Not Hispanic or Latino,1,0,1
374041,External ophthalmoplegia,racial,White,0,1,1
4007913,Closed fracture mandible (site unspecified),ethnic,Not Hispanic or Latino,1,0,1
320136,Disease of respiratory system,racial,Asian,0,1,1
252341,Extrinsic asthma with status asthmaticus,ethnic,Hispanic or Latino,1,0,1
380669,Benign neoplasm of eyelid including canthus,racial,Other Race,0,1,1
435533,"Hypnotic or anxiolytic dependence, continuous",ethnic,Not Hispanic or Latino,1,0,1
436882,[X]Fall involving bed,racial,Asian,1,0,1
435517,Acidosis,racial,Asian,1,0,1
432868,Hemoglobinopathy,racial,Black or African American ,0,1,1
4232212,Hypoglycemic shock,ethnic,Not Hispanic or Latino,1,0,1
434951,Lacrimal sac mucocele,racial,White,1,0,1
317299,Disorder of vitreous body,ethnic,Not Hispanic or Latino,0,1,1
436630,Visceral herpes simplex,racial,White,0,1,1
438302,Accidental poisoning by fumigants,ethnic,Hispanic or Latino,1,0,1
315830,Variant angina,racial,Unknown,1,0,1
440776,Abortion with complication,racial,White,1,0,1
436080,"Neoplasm of uncertain behaviour of lip, oral cavity and pharynx",racial,Unknown,1,0,1
440786,Threatened premature labor,ethnic,Not Hispanic or Latino,1,0,1
260315,Tuberculosis of lung with cavitation,racial,Asian,1,0,1
197911,Hernia of anterior abdominal wall without obstruction AND without gangrene,racial,Filipino,1,0,1
437176,Late effect of accidental fall,racial,Asian,0,1,1
4110815,"Sensorineural hearing loss, bilateral",racial,Other Race,0,1,1
437828,Disorder of calcium metabolism,racial,American Indian or Alaska Native ,1,0,1
201617,Prostatic cyst,ethnic,Hispanic or Latino,0,1,1
441192,Accidentally struck by or against objects or persons,racial,Black or African American ,1,0,1
378253,HA - Headache,racial,Asian Indian,1,0,1
321042,Cardiac arrest,racial,Unknown,1,0,1
443883,Acute disease,racial,Other Race,1,0,1
433315,Feeding difficulties in newborn,racial,Asian,0,1,1
434675,Complication of gastrostomy,racial,Asian,1,0,1
377294,Exotropia,racial,Other Race,1,0,1
378413,Partial recent retinal detachment with multiple defects,racial,Other Race,0,1,1
381869,Intermitent squint,racial,White,1,0,1
197377,Abnormal bowel sounds,ethnic,Hispanic or Latino,1,0,1
197950,Cellulitis and abscess of trunk,racial,Native Hawaiian or Other Pacific Islander ,0,1,1
4155526,Acute otitis media with effusion,ethnic,Not Hispanic or Latino,1,0,1
433905,Open wound of vulva without complication,racial,Unknown,1,0,1
440589,Toxic effect of caustic substance,ethnic,Not Hispanic or Latino,0,1,1
192581,Carcinoma in situ of uterus,racial,Unknown,1,0,1
142016,Nonvenomous insect bite of finger with infection,ethnic,Not Hispanic or Latino,1,0,1
73383,Full thickness burn of foot,ethnic,Hispanic or Latino,0,1,1
433187,Cyclitis,ethnic,Hispanic or Latino,0,1,1
194802,Foreign body in vulva and vagina,racial,Other Race,1,0,1
432310,Meningitis due to cryptococcus,racial,Black or African American ,0,1,1
432513,Animal bite wound,racial,Other Race,0,1,1
72726,Light-for-dates with signs of fetal malnutrition,racial,Unknown,1,0,1
313867,Double outlet right ventricle,racial,Black or African American ,1,0,1
201900,Neurogenic bowel,racial,Unknown,0,1,1
198860,Congenital anomaly of lower alimentary tract,racial,Black or African American ,1,0,1
441827,Disorder of amino acid and organic acid metabolism,racial,White,0,1,1
4326601,Anorectal abscess,racial,Black or African American ,0,1,1
4111875,Varicose veins of the leg NOS,ethnic,Not Hispanic or Latino,0,1,1
433606,Closed fracture of base of skull without intracranial injury,ethnic,Hispanic or Latino,1,0,1
76563,Late effect of burn of wrist AND/OR hand,racial,White,1,0,1
4058364,Superficial injury of foot and toe(s),ethnic,Hispanic or Latino,0,1,1
442116,Allergy to eggs,racial,Other Race,0,1,1
78015,Open wound of chest wall without complication,ethnic,Not Hispanic or Latino,1,0,1
4181604,Subcutaneous contraceptive implant,racial,Other Race,1,0,1
441540,Reactive confusion,ethnic,Not Hispanic or Latino,1,0,1
376971,Retinal tear,ethnic,Not Hispanic or Latino,0,1,1
193688,Clostridium difficile infection,racial,Other Race,1,0,1
434490,Shivering,racial,Asian,0,1,1
444364,Superficial foreign body of shoulder without major open wound AND without infection,ethnic,Hispanic or Latino,1,0,1
257010,Abscess of lung,ethnic,Not Hispanic or Latino,0,1,1
4102348,Common migraine NOS,racial,Unknown,1,0,1
136710,Perichondritis of pinna,ethnic,Not Hispanic or Latino,1,0,1
258787,Spontaneous tension pneumothorax,racial,Asian,0,1,1
444028,Open wound of alveolar process without complication,racial,Black or African American ,0,1,1
81380,Cervical syndrome,racial,Unknown,1,0,1
443375,Vitamin products adverse reaction,ethnic,Not Hispanic or Latino,1,0,1
443430,HPV - Human papillomavirus test positive,racial,Filipino,1,0,1
435610,Varicose veins of perineum and vulva in pregnancy and the puerperium - delivered,ethnic,Not Hispanic or Latino,1,0,1
439439,Injury of unknown intent by cutting instrument,racial,Unknown,1,0,1
4015717,Amebiasis carrier,racial,White,1,0,1
435205,Benign tumour of oropharynx,racial,Unknown,1,0,1
440195,Aniridia,racial,Unknown,1,0,1
4062653,Gout screening,racial,White,1,0,1
4195572,"Mild major depression, single episode",racial,Black or African American ,0,1,1
381278,Cluster headache,racial,Black or African American ,0,1,1
438903,Injury of external jugular vein,racial,White,1,0,1
81942,Enthesopathy of ankle AND/OR tarsus,racial,Other Race,1,0,1
4290000,Mumps,ethnic,Hispanic or Latino,1,0,1
441563,Lacrimal sac granuloma,ethnic,Hispanic or Latino,1,0,1
438701,UKP - Disseminated malignancy of unknown primary,racial,Unknown,1,0,1
72715,Exostosis,racial,Asian,1,0,1
197415,"Spleen capsular tear without major disruption of parenchyma, with open wound into cavity",racial,White,1,0,1
440855,Closed fracture of base of metacarpal bone other than first metacarpal,ethnic,Not Hispanic or Latino,1,0,1
433458,"Combined drug dependence, excluding opioid, in remission",ethnic,Hispanic or Latino,0,1,1
376104,Posttraumatic headache,racial,Filipino,0,1,1
134461,Tietze disease,racial,Filipino,1,0,1
198194,Female genital organ symptoms,racial,Asian Indian,1,0,1
77984,Congenital cleft hand,racial,White,0,1,1
4223536,Classical cesarean section,racial,White,1,0,1
438583,Open fracture of femur,racial,White,1,0,1
442276,Closed medial dislocation of proximal end of tibia,racial,Unknown,1,0,1
4061056,Endometriosis NOS,racial,Unknown,1,0,1
4293175,"Mental state, behaviour and/or psychosocial function finding",racial,American Indian,0,1,1
437841,Somatoform autonomic dysfunction - respiratory tract,racial,White,1,0,1
374360,Disorder of optic nerve,racial,Asian,0,1,1
435082,Closed fracture nasal bone,racial,Black or African American ,0,1,1
194985,Postgastric surgery syndrome,racial,Unknown,1,0,1
4025175,Tracheostomy complication NOS,racial,White,1,0,1
4012454,"Open fracture of tibia and/or fibula, shaft",ethnic,Hispanic or Latino,0,1,1
435011,Vulvar vestibulitis,racial,White,1,0,1
4001138,Other soft tissue disorders,racial,White,1,0,1
141771,"Injury undetermined whether accidentally or purposely inflicted, by crashing of motor vehicle",racial,Unknown,1,0,1
438112,Neoplastic disease,racial,Other Race,0,1,1
320420,Vitreous degeneration,racial,Black or African American ,1,0,1
4110029,Chronic pharyngitis and nasopharyngitis NOS,ethnic,Hispanic or Latino,0,1,1
4299653,Unilateral orchidectomy,ethnic,Hispanic or Latino,0,1,1
432463,"Closed fracture clavicle, lateral end",racial,Unknown,0,1,1
443172,"Splinter of face, without major open wound",ethnic,Hispanic or Latino,0,1,1
72332,Serous labyrinthitis,ethnic,Hispanic or Latino,1,0,1
74513,Open wound of foot without mention of complication,racial,Asian,1,0,1
380415,Acute swimmer's ear,racial,American Indian or Alaska Native ,1,0,1
195209,Benign neoplasm of liver and/or biliary ducts,racial,Unknown,1,0,1
377869,Conjunctival deposit,ethnic,Hispanic or Latino,0,1,1
443627,Adverse reaction to aromatic analgesic,ethnic,Not Hispanic or Latino,1,0,1
4268973,Jaw-blinking,ethnic,Not Hispanic or Latino,1,0,1
316999,Cardiac arrhythmia,racial,American Indian or Alaska Native ,0,1,1
435155,Injury of unknown intent by firearms and explosives,racial,White,0,1,1
192698,Hypertonic uterine dysfunction,racial,White,0,1,1
435785,Meningitis,ethnic,Not Hispanic or Latino,1,0,1
315523,Hemoglobin S-F disease,racial,White,0,1,1
378765,TS - Tympanosclerosis,racial,Unknown,0,1,1
434758,Exceptionally large baby,racial,Unknown,1,0,1
434164,Glycosuria,racial,Black or African American ,1,0,1
194696,Menorrhalgia,racial,Filipino,1,0,1
40490888,Herniation of rectum into vagina,racial,Asian,1,0,1
438701,UKP - Disseminated malignancy of unknown primary,racial,Other Race,1,0,1
192964,Renal infection,ethnic,Not Hispanic or Latino,1,0,1
198197,Male infertility,racial,Other Race,0,1,1
381014,Conjunctival pigmentation,racial,White,0,1,1
436228,Fetal death due to termination of pregnancy,racial,White,1,0,1
437240,Carcinoma in situ of skin of upper limb and shoulder,racial,Unknown,0,1,1
313217,Atrial fibrillation,racial,Alaska Native,1,0,1
137350,Radiation dermatitis,racial,White,0,1,1
381281,Degenerative progressive high myopia,ethnic,Not Hispanic or Latino,0,1,1
4204966,Regurgitant esophagitis,racial,Asian,0,1,1
138616,Superficial burn of hand,racial,White,0,1,1
435640,"Gestation period, 25 weeks",racial,Black or African American ,0,1,1
40481367,Chronic left-sided ulcerative colitis,ethnic,Hispanic or Latino,0,1,1
199192,Abrasion AND/OR friction burn of trunk without infection,racial,Alaska Native,0,1,1
443387,Cancer of stomach,racial,White,0,1,1
4071485,Foetus or neonate affected by caesarean section,racial,American Indian or Alaska Native ,1,0,1
437394,Closed fracture of lower end of forearm,racial,American Indian,1,0,1
133364,Second degree burn of back,racial,White,1,0,1
438112,Neoplastic disease,racial,Unknown,1,0,1
77634,Transient arthropathy of the lower leg,ethnic,Hispanic or Latino,1,0,1
433695,Trypanosomiasis,racial,Unknown,1,0,1
439191,"Late effect of poison due to drug, medicament or biological substance",ethnic,Hispanic or Latino,1,0,1
4067459,Heterotopic liver transplant,ethnic,Not Hispanic or Latino,0,1,1
193253,Nephritis,racial,Filipino,1,0,1
4090255,Colloid bodies in retina,ethnic,Not Hispanic or Latino,1,0,1
73553,Arthropathy,racial,Asian Indian,1,0,1
73282,"Breast engorgement in pregnancy, the puerperium or lactation with antenatal complication",ethnic,Hispanic or Latino,1,0,1
77698,Sprain of coracoclavicular ligament,racial,White,1,0,1
78509,Loose body in joint of ankle and/or foot,racial,Unknown,1,0,1
376807,Congenital macular changes,ethnic,Hispanic or Latino,1,0,1
373216,Disorder of mastoid,racial,White,1,0,1
132579,Giant-cell thyroiditis,ethnic,Hispanic or Latino,0,1,1
140570,Open wound of back without complication,racial,Unknown,0,1,1
200588,Injury of abdomen,ethnic,Not Hispanic or Latino,1,0,1
195212,Hypercortisolism,ethnic,Not Hispanic or Latino,0,1,1
441641,FTND - Full term normal delivery,racial,Unknown,1,0,1
194802,Foreign body in vulva and vagina,racial,Unknown,1,0,1
443541,Recurrent inguinal hernia with gangrene,racial,White,0,1,1
377788,General paresis,racial,White,1,0,1
314457,Congenital stenosis of aortic valve,racial,Asian,1,0,1
434824,Injury of cranial nerve,racial,White,1,0,1
4065992,Cellulitis and abscess of finger unspecified,ethnic,Not Hispanic or Latino,0,1,1
4059157,Family circumstance NOS,racial,Asian,0,1,1
4038835,HD - Hodgkin's disease,racial,White,0,1,1
40493424,Abdominal rigidity of right upper quadrant,racial,Unknown,1,0,1
376400,Combined form of senile cataract,racial,Black or African American ,1,0,1
381583,Acquired deformity of pinna,ethnic,Hispanic or Latino,1,0,1
4190189,Menstruation finding,ethnic,Hispanic or Latino,1,0,1
438531,Chondromalacia,racial,Filipino,0,1,1
201998,Unilateral traumatic amputation of leg at OR above knee without complication,racial,White,1,0,1
140214,Eruption of skin,racial,Alaska Native,0,1,1
373356,Open wound of multiple sites of ear with complication,ethnic,Hispanic or Latino,1,0,1
192674,Allergic gastroenteritis and colitis,ethnic,Not Hispanic or Latino,1,0,1
4184816,Repair of prostate,racial,Unknown,0,1,1
381864,Subjective tinnitus,racial,Black or African American ,1,0,1
432522,Transfusion reaction due to serum protein reaction,racial,White,1,0,1
74724,Transient arthropathy of multiple sites,ethnic,Hispanic or Latino,0,1,1
437334,Cervical incompetence with antenatal problem,racial,Unknown,1,0,1
435836,Disorder of nasopharynx,racial,Asian,1,0,1
436941,Hypervitaminosis A,racial,Asian,0,1,1
375550,Senile corneal changes,ethnic,Not Hispanic or Latino,0,1,1
81186,Contusion of wrist,racial,Asian,0,1,1
77631,Secondary localized osteoarthrosis of shoulder region,racial,White,0,1,1
436147,Glossitis,racial,Asian,1,0,1
196444,Angiodysplasia of intestine,racial,White,1,0,1
74864,Gonococcal joint infection,ethnic,Hispanic or Latino,0,1,1
433919,Heroin poisoning,racial,White,0,1,1
4114451,"Localized, primary osteoarthritis of unspecified site",racial,Asian,0,1,1
434842,Cause of overdose - accidental,ethnic,Not Hispanic or Latino,0,1,1
260125,Acute bronchiolitis,racial,American Indian or Alaska Native ,0,1,1
438259,Umbilical hemorrhage after birth,ethnic,Not Hispanic or Latino,1,0,1
433997,Lymphangioma,racial,Other Race,1,0,1
4060318,Chest pain NOS,ethnic,Not Hispanic or Latino,0,1,1
434810,Burn of genitalia,racial,White,1,0,1
433243,Anomaly of tooth position,ethnic,Not Hispanic or Latino,1,0,1
4108242,Atrial fibrillation and flutter NOS,racial,Other Race,0,1,1
4023168,Home alone,racial,Asian,1,0,1
4232212,Hypoglycemic shock,racial,Black or African American ,1,0,1
444069,Abrasion AND/OR friction burn of leg with infection,ethnic,Not Hispanic or Latino,1,0,1
432719,Panniculitis,racial,Asian,1,0,1
433860,IAA - Interrupted aortic arch,ethnic,Hispanic or Latino,1,0,1
434887,Disorders of bilirubin excretion,racial,Asian,0,1,1
136661,Nodular goiter,racial,Unknown,1,0,1
436519,Perinatal intraventricular hemorrhage,ethnic,Hispanic or Latino,1,0,1
198678,Intestinal infectious disease,racial,American Indian or Alaska Native ,0,1,1
373470,Polyneuropathy due to toxic agents,ethnic,Hispanic or Latino,1,0,1
441973,Closed fracture of proximal end of radius,ethnic,Hispanic or Latino,0,1,1
140435,Arrested dental caries,racial,Asian,0,1,1
313023,Neonatal chronic respiratory disease,racial,Other Race,1,0,1
378256,Abnormal reflex,racial,Asian,1,0,1
199059,Ventral hernia with obstruction but no gangrene,racial,White,1,0,1
26052,Primary malignant neoplasm of larynx,racial,Other Race,1,0,1
377291,"Peripheral pterygium, progressive",racial,Asian,1,0,1
141104,Intervertebral disc disorder of lumbar region with myelopathy,racial,Filipino,1,0,1
4058247,Anaemia during pregnancy/childbirth/puerperium NOS,ethnic,Not Hispanic or Latino,1,0,1
435231,Nondependent cannabis abuse in remission,ethnic,Not Hispanic or Latino,0,1,1
4280828,"Carrier, infectious agent",racial,Asian,1,0,1
4111259,Labyrinthine dysfunction NOS,ethnic,Not Hispanic or Latino,1,0,1
376578,Otitic barotrauma,ethnic,Not Hispanic or Latino,1,0,1
4088083,Tuberculosis of other organs,racial,White,0,1,1
81496,Tuberculosis of vertebral column,ethnic,Hispanic or Latino,0,1,1
374037,Night blindness,racial,White,1,0,1
196455,Hepatorenal syndrome,ethnic,Hispanic or Latino,1,0,1
435840,Acute epiglottitis without obstruction,racial,White,0,1,1
372324,Eustachian tube disorder,racial,Native Hawaiian or Other Pacific Islander ,1,0,1
321887,Disorder of artery,racial,American Indian or Alaska Native ,1,0,1
373212,Esophoria,racial,Asian,0,1,1
377126,Concussion with brief loss of consciousness,racial,Black or African American ,1,0,1
30133,Acute laryngitis,racial,Black or African American ,1,0,1
4172146,Proctostomy,racial,White,0,1,1
440858,Cortex contusion without open intracranial wound,ethnic,Not Hispanic or Latino,1,0,1
440692,"Cocaine dependence, episodic",racial,White,1,0,1
432447,Atypical glandular cells on cervical Papanicolaou smear,racial,Filipino,1,0,1
197921,Renal osteodystrophy,ethnic,Not Hispanic or Latino,1,0,1
441170,Superficial injury with infection,ethnic,Not Hispanic or Latino,1,0,1
28779,Oesophageal varices with bleeding,racial,Asian,1,0,1
377565,Optic atrophy associated with retinal dystrophy,racial,Unknown,1,0,1
81711,Glenoid labrum detachment,ethnic,Hispanic or Latino,0,1,1
435368,Congenital pigeon chest,racial,Native Hawaiian or Other Pacific Islander ,0,1,1
4211527,Operation on globus pallidus,racial,White,1,0,1
443429,Endothelial corneal dystrophy,ethnic,Not Hispanic or Latino,1,0,1
433957,Progressive multifocal leukoencephalopathy,ethnic,Not Hispanic or Latino,0,1,1
436080,"Neoplasm of uncertain behaviour of lip, oral cavity and pharynx",racial,Other Race,0,1,1
4337834,Hyperthyroidism due to ectopic thyroid nodule,ethnic,Hispanic or Latino,0,1,1
444433,Open wound of toe with complication,ethnic,Not Hispanic or Latino,1,0,1
434944,Scleritis,racial,Black or African American ,0,1,1
193518,Intestinal obstruction,racial,Native Hawaiian or Other Pacific Islander ,0,1,1
432899,Normal pressure hydrocephalus,ethnic,Not Hispanic or Latino,1,0,1
440694,"Nondependent mixed drug abuse, episodic",racial,Asian,0,1,1
378087,Secondary malignant neoplasm of brain and spinal cord,ethnic,Not Hispanic or Latino,1,0,1
435226,"Bipolar affective disorder, current episode mixed",racial,Unknown,0,1,1
316998,Left bundle branch block,racial,Other Race,1,0,1
433687,Botulism,ethnic,Not Hispanic or Latino,0,1,1
4106274,Neonatal cardiac arrest,ethnic,Not Hispanic or Latino,0,1,1
253797,Post-inflammatory pulmonary fibrosis,racial,American Indian or Alaska Native ,1,0,1
192687,Vulvovaginitis associated with another disease,racial,Native Hawaiian or Other Pacific Islander ,1,0,1
4300419,Submammary mastitis associated with childbirth,ethnic,Hispanic or Latino,1,0,1
440380,"Combined drug dependence, excluding opioid, episodic",ethnic,Not Hispanic or Latino,1,0,1
199878,Light and infrequent menstruation,racial,American Indian or Alaska Native ,1,0,1
443232,Eyelid and lacrimal drainage system laceration,ethnic,Hispanic or Latino,0,1,1
436249,Closed fracture of femoral condyle of femur,racial,Unknown,1,0,1
199079,Hypertrophy of clitoris,racial,Black or African American ,1,0,1
197612,Abortion complicated by delayed AND/OR excessive hemorrhage,ethnic,Hispanic or Latino,1,0,1
443295,Maternal care for diminished foetal movements,racial,Unknown,1,0,1
76153,Low compliance bladder,racial,Other Race,0,1,1
432941,Disease of tongue,racial,Filipino,1,0,1
135489,Primary malignant neoplasm of male breast,racial,White,1,0,1
252280,Neoplasm of respiratory tract,ethnic,Not Hispanic or Latino,1,0,1
440422,Noise-induced hearing loss,ethnic,Not Hispanic or Latino,1,0,1
140435,Arrested dental caries,ethnic,Not Hispanic or Latino,0,1,1
432893,Myasthenic syndrome due to another disorder,ethnic,Hispanic or Latino,1,0,1
434246,Burn with deep necrosis of underlying tissues without loss of body part,racial,White,1,0,1
441073,Complete legal abortion,racial,White,1,0,1
442073,Malunion and nonunion of fracture,ethnic,Not Hispanic or Latino,0,1,1
4065363,Dyschromia NOS,racial,White,1,0,1
372914,Optic atrophy,racial,Native Hawaiian or Other Pacific Islander ,1,0,1
312622,BVO - Branch retinal occlusion,racial,Other Race,0,1,1
4059637,Work environment deleterious,racial,Asian,1,0,1
77592,Articular crepitus of temporomandibular joint,racial,Asian,0,1,1
134312,Iatrogenic hypothyroidism,racial,Asian,0,1,1
316427,Aneurysm of coronary vessels,ethnic,Hispanic or Latino,1,0,1
254676,Lung involvement associated with another disorder,racial,Unknown,0,1,1
194079,Post-surgical malabsorption,racial,Unknown,0,1,1
4144274,Housing lack,racial,Other Race,0,1,1
77355,Articular cartilage disorder of ankle AND/OR foot,ethnic,Hispanic or Latino,0,1,1
435999,Local astringent and detergent poisoning,ethnic,Hispanic or Latino,0,1,1
197921,Renal osteodystrophy,racial,Asian,1,0,1
76201,Non-traumatic rupture of biceps brachii tendon,racial,Unknown,1,0,1
4050929,FH: Skin disease,ethnic,Not Hispanic or Latino,1,0,1
436587,"Toxic effect of gas, fumes AND/OR vapors",ethnic,Hispanic or Latino,0,1,1
432609,"Acute alcoholic intoxication in remission, in alcoholism",ethnic,Hispanic or Latino,0,1,1
4060813,Cystitis NOS,racial,Unknown,1,0,1
4058247,Anaemia during pregnancy/childbirth/puerperium NOS,racial,Asian,1,0,1
76491,Obstetric non-purulent mastitis with antenatal complication,racial,White,1,0,1
4066882,Excision of anal skin tag,racial,Unknown,1,0,1
375278,Acquired stenosis of external ear canal secondary to inflammation,ethnic,Hispanic or Latino,1,0,1
434501,"Open fracture ankle, trimalleolar",racial,Unknown,1,0,1
434527,Poisoning by primarily systemic agent,ethnic,Hispanic or Latino,1,0,1
314665,Atrial flutter,racial,Black or African American ,1,0,1
440404,Stenosis of lacrimal punctum,ethnic,Hispanic or Latino,1,0,1
4227745,Infertility test,racial,Black or African American ,0,1,1
316995,Coronary occlusion,racial,Black or African American ,1,0,1
201221,Intestinal infection due to Class Cestoda and/or Class Trematoda and/or Phylum Nemata,racial,White,0,1,1
440112,Chloasma of eyelid,racial,White,0,1,1
200970,CIS - Carcinoma in situ of prostate,racial,Unknown,0,1,1
381010,Intralenticular foreign body,racial,White,1,0,1
76270,Superficial injury of foot with infection,racial,White,1,0,1
443429,Endothelial corneal dystrophy,racial,Asian,1,0,1
192433,Congenital hypertrophic pyloric stenosis,ethnic,Not Hispanic or Latino,0,1,1
377678,EEG abnormality,racial,Unknown,1,0,1
440032,CMV - Cytomegalovirus infection,racial,Unknown,1,0,1
376124,Pinguecula,racial,Filipino,1,0,1
197823,Lipoma of spermatic cord,ethnic,Hispanic or Latino,0,1,1
75708,Foreign body in anus and rectum,racial,White,0,1,1
4001965,Infection of multiple bones,ethnic,Not Hispanic or Latino,1,0,1
440370,Nutritional marasmus,racial,White,0,1,1
77357,Intrapelvic protrusion of acetabulum,racial,White,1,0,1
440851,Open fracture of forearm,racial,White,1,0,1
254163,Pulmonary aspiration of gastric contents,ethnic,Hispanic or Latino,0,1,1
194093,Postcoital bleeding,racial,American Indian or Alaska Native ,1,0,1
194871,Trichomonal vulvovaginitis,racial,Filipino,1,0,1
134305,Acute lymphoid leukaemia,racial,White,0,1,1
443675,Traumatic amputation of toe(s) without mention of complication,racial,Unknown,0,1,1
78834,Effusion of joint of hand,racial,Asian,0,1,1
316478,"Heart disease in mother complicating pregnancy, childbirth AND/OR puerperium",ethnic,Hispanic or Latino,1,0,1
433452,"Cannabis dependence, continuous",racial,White,0,1,1
4296204,First degree burn,ethnic,Not Hispanic or Latino,1,0,1
198187,"Acute peptic ulcer without hemorrhage, without perforation AND without obstruction",racial,Black or African American ,0,1,1
192387,Obstetric perineal wound disruption - delivered with postnatal complication,racial,White,1,0,1
4012297,Closed fracture of one or more phalanges of hand NOS,racial,Unknown,1,0,1
133725,Carcinoma in situ of skin of lip,racial,White,1,0,1
194158,Perinatal gastrointestinal hemorrhage,racial,Black or African American ,0,1,1
434063,Jaw to cranial base anomaly,racial,Other Race,1,0,1
73302,Curvature of spine,ethnic,Not Hispanic or Latino,1,0,1
196724,Disease of diaphragm,racial,Other Race,1,0,1
4317960,Neonatal respiratory failure,ethnic,Hispanic or Latino,1,0,1
4173811,Congenital quadriplegia,racial,Filipino,1,0,1
4062685,Diabetes mellitus in the puerperium - baby delivered during current episode of care,ethnic,Hispanic or Latino,1,0,1
140318,"Septicemia due to streptococcus, group A",racial,Unknown,1,0,1
442749,Inhibited female orgasm,racial,Unknown,1,0,1
432593,Kwashiorkor,racial,White,1,0,1
437753,Seen by surgical fitting - service,ethnic,Not Hispanic or Latino,1,0,1
197145,Open wound of pelvic region without complication,racial,American Indian or Alaska Native ,1,0,1
435903,Juvenile osteochondrosis of foot,racial,Black or African American ,0,1,1
4006436,Other congenital musculoskeletal anomalies,ethnic,Hispanic or Latino,0,1,1
4097716,"Benign neoplasm of lip, oral cavity and pharynx NOS",racial,Unknown,1,0,1
434153,Chromosomopathy,racial,Asian,1,0,1
141666,Acute osteomyelitis of lower leg,racial,White,1,0,1
432941,Disease of tongue,racial,Other Race,0,1,1
4154309,Severe recurrent major depression with psychotic features,racial,Native Hawaiian or Other Pacific Islander ,1,0,1
439111,Pathological dislocation of pelvic region,ethnic,Hispanic or Latino,0,1,1
192958,Floating kidney,ethnic,Hispanic or Latino,0,1,1
40353121,"Accidental cut, puncture, perforation or haemorrhage during medical care",ethnic,Not Hispanic or Latino,0,1,1
440999,Choroidal rupture,ethnic,Not Hispanic or Latino,0,1,1
80811,Rupture of extensor tendons of hand AND/OR wrist,ethnic,Hispanic or Latino,0,1,1
195306,Gastroduodenitis,racial,European,0,1,1
4090094,Unspecified histoplasmosis infection,ethnic,Hispanic or Latino,0,1,1
78073,Urogenital infection by Trichomonas vaginalis,ethnic,Hispanic or Latino,1,0,1
4148244,SN - Supernumerary tooth,ethnic,Not Hispanic or Latino,0,1,1
4170576,Pressure ulcer,racial,Black or African American ,1,0,1
25297,Acute pharyngitis,racial,Asian Indian,1,0,1
440993,Psychogenic skin disease,ethnic,Hispanic or Latino,1,0,1
4128540,Partial excision of pituitary gland by transsphenoidal approach,ethnic,Hispanic or Latino,1,0,1
73889,Sprain of distal tibiofibular ligament,ethnic,Not Hispanic or Latino,0,1,1
4112364,Other upper respiratory tract diseases,ethnic,Hispanic or Latino,1,0,1
443460,Pathological fracture of femur,racial,White,1,0,1
438546,Congenital anomaly of anterior chamber of eye,ethnic,Not Hispanic or Latino,0,1,1
442189,Blister of wrist without infection,ethnic,Not Hispanic or Latino,1,0,1
74728,Synovitis and tenosynovitis,racial,Black or African American ,0,1,1
141216,MC - Molluscum contagiosum,racial,Filipino,0,1,1
74606,Benign bone tumor,racial,Other Race,1,0,1
4333977,Acquired anophthalmos,racial,Other Race,0,1,1
26727,Vomiting blood,racial,Asian,1,0,1
192964,Renal infection,racial,Asian,1,0,1
201603,Disease of teeth AND/OR supporting structures,racial,Asian Indian,0,1,1
318437,Accelerated secondary hypertension,racial,Unknown,1,0,1
433701,Mycosis,racial,Native Hawaiian or Other Pacific Islander ,0,1,1
376703,Disorder of pinna,racial,Black or African American ,1,0,1
314383,Myocarditis,ethnic,Hispanic or Latino,1,0,1
4345578,Rhabdomyolysis,ethnic,Not Hispanic or Latino,1,0,1
441593,Arteriovenous fistula of pulmonary vessels,racial,White,1,0,1
381574,External auditory canal exostosis,ethnic,Not Hispanic or Latino,0,1,1
441607,Mediastinal abscess,ethnic,Hispanic or Latino,0,1,1
192675,Biliary cirrhosis,ethnic,Not Hispanic or Latino,1,0,1
4050929,FH: Skin disease,ethnic,Hispanic or Latino,1,0,1
314426,Congenital cardiovascular disorder during pregnancy - baby not yet delivered,racial,Unknown,1,0,1
314463,Congenital anomaly of aorta,racial,Unknown,1,0,1
194018,"Functional enuresis, NOS",racial,Black or African American ,1,0,1
439815,Choroidal degeneration,racial,Unknown,1,0,1
4059014,Spontaneous bruising,racial,Asian,1,0,1
433985,Hypercarotinemia,racial,Filipino,0,1,1
435808,Diffuse secondary choroid atrophy,ethnic,Hispanic or Latino,1,0,1
4178898,Economic problem,racial,Unknown,1,0,1
73383,Full thickness burn of foot,ethnic,Not Hispanic or Latino,1,0,1
436358,Primary malignant neoplasm of exocervix,ethnic,Not Hispanic or Latino,1,0,1
439700,Inhibited sexual desire,racial,Native Hawaiian or Other Pacific Islander ,0,1,1
134214,Burn erythema of wrist,ethnic,Hispanic or Latino,1,0,1
24969,Laryngitis,ethnic,Not Hispanic or Latino,0,1,1
4070415,Fetus or neonate affected by chorioamnionitis,racial,White,1,0,1
444093,Patient status finding,racial,Native Hawaiian or Other Pacific Islander ,0,1,1
141216,MC - Molluscum contagiosum,racial,American Indian or Alaska Native ,0,1,1
193739,Ovarian failure,racial,White,1,0,1
139980,Burn erythema of forearm,ethnic,Hispanic or Latino,0,1,1
378742,Blind hypotensive eye,racial,White,1,0,1
4104054,Vitreous disorders NOS,racial,White,1,0,1
73562,Solitary sacroiliitis,racial,Asian,1,0,1
381866,Degenerative disorder of eyelid,ethnic,Not Hispanic or Latino,0,1,1
4052837,Open wound of breast,racial,White,1,0,1
434193,Closed dislocation of distal radioulnar joint of wrist,racial,White,1,0,1
4114451,"Localized, primary osteoarthritis of unspecified site",ethnic,Not Hispanic or Latino,0,1,1
197484,Diarrhea of presumed infectious origin,racial,Black or African American ,1,0,1
135473,Dermatophytosis,racial,American Indian or Alaska Native ,1,0,1
373499,Disorder of eye region,racial,Other Race,1,0,1
436941,Hypervitaminosis A,ethnic,Not Hispanic or Latino,0,1,1
194871,Trichomonal vulvovaginitis,racial,Other Race,1,0,1
378142,Retinal ischemia,ethnic,Hispanic or Latino,1,0,1
432821,Leprosy,racial,White,0,1,1
4063304,Rhesus isoimmunization unspecified,racial,White,1,0,1
438129,"Severe manic bipolar I disorder with psychotic features, mood-congruent",racial,Black or African American ,0,1,1
194519,Open wound of vagina without complication,racial,Unknown,1,0,1
375550,Senile corneal changes,racial,Asian,0,1,1
376964,Partial recent retinal detachment with giant tear,ethnic,Not Hispanic or Latino,1,0,1
77139,Open wound of finger without complication,racial,American Indian or Alaska Native ,0,1,1
441918,"Emotional AND/OR mental disease in mother complicating pregnancy, childbirth AND/OR puerperium",racial,Native Hawaiian or Other Pacific Islander ,1,0,1
4099356,Haemangioma of unspecified site,ethnic,Not Hispanic or Latino,0,1,1
443415,Gestation greater than 24 weeks,racial,Asian,0,1,1
439695,Hypertensive heart and renal disease with renal failure,racial,Asian,1,0,1
78073,Urogenital infection by Trichomonas vaginalis,ethnic,Not Hispanic or Latino,0,1,1
314457,Congenital stenosis of aortic valve,ethnic,Not Hispanic or Latino,1,0,1
4056196,Other breast disorders,racial,White,1,0,1
319825,Rheumatic heart disease,ethnic,Not Hispanic or Latino,1,0,1
436088,Nondependent opioid abuse in remission,racial,Black or African American ,0,1,1
261687,Hemoptysis,racial,Other Race,1,0,1
197606,Female infertility of tubal origin,racial,Unknown,1,0,1
138102,Benign tumour of skin,racial,Native Hawaiian or Other Pacific Islander ,0,1,1
439314,Thrombophlebitis of the femoral vein,racial,American Indian or Alaska Native ,1,0,1
4151244,Fracture NOS,racial,White,0,1,1
79915,Hemarthrosis of hand,racial,White,0,1,1
200783,Previous cesarean section,racial,Asian,1,0,1
432874,Lipidosis,racial,Unknown,1,0,1
373035,Closed fracture of malar AND/OR maxillary bones,racial,White,1,0,1
444363,Drug-related disorder,ethnic,Hispanic or Latino,0,1,1
77624,"Breast engorgement in pregnancy, the puerperium or lactation - delivered",ethnic,Hispanic or Latino,1,0,1
439303,Horseshoe retinal tear without detachment,racial,Unknown,1,0,1
373648,Superficial injury of eyelid AND/OR periocular area,ethnic,Not Hispanic or Latino,0,1,1
4080568,Problem behaviour,racial,Asian,0,1,1
444236,Superficial foreign body of hand without major open wound but with infection,ethnic,Hispanic or Latino,1,0,1
4113680,Ruptured tubal pregnancy,racial,White,1,0,1
194092,Uterine prolapse without vaginal wall prolapse,racial,Native Hawaiian or Other Pacific Islander ,1,0,1
434584,Epidemic Kaposi's sarcoma,ethnic,Hispanic or Latino,0,1,1
4103737,"Better eye: low vision, Lesser eye: profound visual impairment",racial,White,0,1,1
375547,Anisometropia,ethnic,Not Hispanic or Latino,0,1,1
4070557,Incision of testis,ethnic,Hispanic or Latino,1,0,1
200780,Disease of uterus,racial,American Indian or Alaska Native ,1,0,1
437167,Accident caused by firearm missile,racial,Unknown,1,0,1
438259,Umbilical hemorrhage after birth,ethnic,Hispanic or Latino,0,1,1
441691,Atypical squamous cells of undetermined significance on vaginal Papanicolaou smear,racial,Black or African American ,1,0,1
441977,Closed dislocation of carpometacarpal joint of wrist,ethnic,Not Hispanic or Latino,0,1,1
4067061,Psoriasis and similar disorders NOS,racial,Unknown,1,0,1
439696,Hypertensive heart and renal disease with (congestive) heart failure,racial,Other Race,0,1,1
314383,Myocarditis,ethnic,Not Hispanic or Latino,1,0,1
435247,Metallosis,ethnic,Hispanic or Latino,0,1,1
4177115,Malignant tumour of testis,racial,Other Race,0,1,1
78890,Sprain of elbow and forearm,racial,American Indian or Alaska Native ,1,0,1
444419,Quadriparesis,racial,Unknown,0,1,1
4179925,Basic learning problem,racial,Other Race,0,1,1
440389,MR - Mental retardation,racial,Native Hawaiian or Other Pacific Islander ,0,1,1
441385,Corrected transposition of great vessels,racial,White,0,1,1
140586,Collapse - heat,ethnic,Hispanic or Latino,0,1,1
79165,Closed Monteggia fracture,racial,White,0,1,1
443570,Cervicovaginal cytology: Low grade squamous intraepithelial lesion,racial,American Indian,1,0,1
380859,Closed fracture of lower jaw bone,racial,White,0,1,1
75708,Foreign body in anus and rectum,racial,Unknown,0,1,1
4056329,Vaginitis and vulvovaginitis NOS,racial,Other Race,1,0,1
437986,FTT - Failure to thrive,racial,Filipino,1,0,1
372894,central serous retinopathy,ethnic,Hispanic or Latino,0,1,1
435207,"Nodular lymphoma of lymph nodes of head, face and neck",ethnic,Not Hispanic or Latino,0,1,1
40481792,Acquired auditory processing disorder,ethnic,Hispanic or Latino,0,1,1
4314713,Abusive parenting,ethnic,Hispanic or Latino,1,0,1
438836,Poliomyelitis osteopathy of the lower leg,racial,Asian,1,0,1
440697,Nonaggressive unsocial conduct disorder,racial,Asian,0,1,1
75608,Shoulder dystocia with antenatal problem,ethnic,Hispanic or Latino,1,0,1
4144123,Other kidney and ureter disorders,ethnic,Hispanic or Latino,1,0,1
200588,Injury of abdomen,ethnic,Hispanic or Latino,0,1,1
75356,Congenital deformity of sternocleidomastoid muscle,racial,White,1,0,1
74114,Cellulitis and abscess of foot excluding toe,racial,Asian Indian,0,1,1
376416,Chronic dacryoadenitis,ethnic,Hispanic or Latino,0,1,1
4082086,No home medical services,ethnic,Not Hispanic or Latino,1,0,1
138389,Benign neoplasm of scalp and skin of neck,racial,Other Race,0,1,1
4143966,Essential hypertension NOS,racial,Other Race,0,1,1
443585,Abrasion AND/OR friction burn of multiple sites,racial,Filipino,0,1,1
4160185,Anterior acute poliomyelitis,ethnic,Hispanic or Latino,1,0,1
136538,Closed fracture larynx and/or trachea,ethnic,Not Hispanic or Latino,0,1,1
436953,Continuous chronic alcoholism,racial,Unknown,0,1,1
137900,Acute sphenoidal sinusitis,racial,Unknown,0,1,1
437833,Hypokalaemia,racial,Filipino,1,0,1
443345,Antineoplastic adverse reaction,ethnic,Hispanic or Latino,0,1,1
4062686,Diabetes mellitus in the pueperium - baby delivered during previous episode of care,racial,White,0,1,1
24909,Hereditary spherocytosis,ethnic,Not Hispanic or Latino,1,0,1
31967,Nausea,racial,American Indian,1,0,1
4122175,Carbuncle/boil,racial,Black or African American ,1,0,1
193253,Nephritis,racial,American Indian or Alaska Native ,0,1,1
432660,Dentofacial anomaly,ethnic,Not Hispanic or Latino,0,1,1
4105628,Facial nerve disorder NOS,racial,White,0,1,1
373463,Benign cough headache,ethnic,Not Hispanic or Latino,1,0,1
443747,Acute laryngotracheitis without obstruction,racial,Unknown,1,0,1
434820,Cold injury,racial,White,0,1,1
78835,Palindromic rheumatism of the lower leg,racial,Filipino,1,0,1
433811,Hydronephrosis,racial,American Indian,1,0,1
436358,Primary malignant neoplasm of exocervix,racial,Asian,1,0,1
254062,Acute chest syndrome,racial,Black or African American ,0,1,1
373648,Superficial injury of eyelid AND/OR periocular area,racial,Asian,0,1,1
4177966,Kaposi's sarcoma,racial,Unknown,0,1,1
437202,Giardiasis,ethnic,Hispanic or Latino,1,0,1
441553,Myoclonus,ethnic,Not Hispanic or Latino,0,1,1
200527,Splenomegaly,racial,Asian,1,0,1
372547,Viral encephalitis,ethnic,Hispanic or Latino,1,0,1
254796,Open wound of nose with complication,racial,White,0,1,1
434903,Ego-dystonic sexual orientation,racial,White,1,0,1
442793,Diabetic complication,racial,Asian Indian,0,1,1
432868,Hemoglobinopathy,racial,Asian,1,0,1
4109691,Persistent alcohol abuse,racial,Unknown,0,1,1
22666,Vomiting after gastrointestinal tract surgery,ethnic,Hispanic or Latino,1,0,1
320136,Disease of respiratory system,racial,Black or African American ,1,0,1
254676,Lung involvement associated with another disorder,racial,White,1,0,1
433678,Infection of central venous catheter,ethnic,Not Hispanic or Latino,1,0,1
200766,Ureteric fistula,ethnic,Hispanic or Latino,0,1,1
4326681,Family history of malignant neoplasm of ovary,racial,Unknown,1,0,1
436298,Adverse reaction to food,racial,American Indian or Alaska Native ,1,0,1
77517,Benign neoplasm of scapula and long bones of upper limb,ethnic,Hispanic or Latino,1,0,1
141941,Cervical spondylosis without myelopathy,racial,Black or African American ,1,0,1
436957,Functional disorders of polymorphonuclear neutrophils,racial,White,1,0,1
437255,Passive aggressive personality disorder,racial,Black or African American ,1,0,1
313590,Perinatal respiratory failure,ethnic,Not Hispanic or Latino,0,1,1
313504,Osler hemorrhagic telangiectasia syndrome,ethnic,Not Hispanic or Latino,1,0,1
433899,Subdural hemorrhage following injury without open intracranial wound AND with loss of consciousness,ethnic,Hispanic or Latino,0,1,1
437943,Pulp abscess of finger,racial,Black or African American ,0,1,1
438947,Burning due to contact with hot water,racial,Unknown,1,0,1
75908,Kissing spine,ethnic,Not Hispanic or Latino,0,1,1
4208970,History of physical abuse,racial,Asian,0,1,1
4155526,Acute otitis media with effusion,racial,Black or African American ,1,0,1
442289,Death in less then 24 hours from onset of symptoms,racial,White,0,1,1
377830,Alcohol withdrawal delirium,racial,Unknown,0,1,1
139850,Acute frontal sinusitis,racial,Native Hawaiian or Other Pacific Islander ,1,0,1
440543,Fracture of tibia,ethnic,Hispanic or Latino,0,1,1
433687,Botulism,ethnic,Hispanic or Latino,0,1,1
194519,Open wound of vagina without complication,racial,White,1,0,1
140842,Changes in skin texture,racial,Native Hawaiian or Other Pacific Islander ,0,1,1
4151244,Fracture NOS,racial,Unknown,0,1,1
441925,Obstetric nipple infection,ethnic,Hispanic or Latino,1,0,1
136198,Cervical spondylosis with myelopathy,racial,Other Race,1,0,1
435661,Closed orbital blow-out fracture,racial,White,0,1,1
198464,Incisional hernia,racial,Asian,0,1,1
442632,Abrasion AND/OR friction burn of wrist with infection,racial,White,1,0,1
201238,Primary malignant neoplasm of female genital organ,racial,White,0,1,1
439968,Late effect of tendon injury,racial,White,0,1,1
81250,Carcinoma in situ of breast,racial,Filipino,1,0,1
78504,"Arthropathy associated with mycoses, of the hand",ethnic,Not Hispanic or Latino,1,0,1
373035,Closed fracture of malar AND/OR maxillary bones,racial,Unknown,0,1,1
4092845,Candidiasis NOS,ethnic,Not Hispanic or Latino,0,1,1
435151,Physical child abuse,racial,Asian,0,1,1
77067,Bucket handle tear of lateral meniscus,racial,White,1,0,1
441170,Superficial injury with infection,ethnic,Hispanic or Latino,0,1,1
4106274,Neonatal cardiac arrest,ethnic,Hispanic or Latino,0,1,1
316866,Hyperpiesis,ethnic,Hispanic or Latino,1,0,1
139766,Carcinoma in situ of scalp and skin of neck,racial,White,1,0,1
436040,Infection by Strongyloides,racial,White,0,1,1
4273622,Operation on bone injury of carpals and metacarpals,racial,White,1,0,1
437854,Cataplexy and narcolepsy,ethnic,Hispanic or Latino,0,1,1
138641,Foreign body in tracheobronchial tree,racial,Unknown,0,1,1
74216,Injury of nerves at shoulder and upper arm level,ethnic,Not Hispanic or Latino,1,0,1
438090,"Overlapping malignant neoplasm of rectum, anus and anal canal",racial,White,0,1,1
4093311,Latent early syphilis NOS,ethnic,Not Hispanic or Latino,1,0,1
4108055,Other forms of retinal detachment,racial,Unknown,1,0,1
138225,Disease of sebaceous glands,racial,Black or African American ,0,1,1
4296205,Second degree burn,racial,Native Hawaiian or Other Pacific Islander ,1,0,1
198470,Unilateral inguinal hernia with obstruction but no gangrene,ethnic,Not Hispanic or Latino,0,1,1
4108517,Eustachian tube obstruction NOS,racial,White,0,1,1
435914,Metatarsus varus,racial,Other Race,1,0,1
4036945,Consciousness disturbance NOS,racial,Black or African American ,1,0,1
376412,Acute follicular conjunctivitis,ethnic,Hispanic or Latino,1,0,1
81382,Tendon sheath giant cell tumor,ethnic,Hispanic or Latino,1,0,1
434207,"Insect bite, nonvenomous, of hand, without mention of infection",racial,Asian,0,1,1
135618,Prurigo,racial,Filipino,0,1,1
374142,Congenital malformation of the nervous system,ethnic,Hispanic or Latino,1,0,1
442130,Open wound of tongue with complication,racial,White,0,1,1
434228,Passenger in vehicular AND/OR traffic accident,racial,White,0,1,1
321726,Injury of blood vessels of lower extremity,racial,White,1,0,1
439815,Choroidal degeneration,racial,White,0,1,1
4147164,Hematologic malignancy,racial,Unknown,0,1,1
72693,Poor fetal growth affecting management,racial,White,1,0,1
200579,Superficial injury of hip without infection,racial,White,1,0,1
442749,Inhibited female orgasm,racial,White,1,0,1
381559,Sensory disorder of eyelid,ethnic,Hispanic or Latino,1,0,1
432632,Noninfectious secondary iridocyclitis,racial,White,1,0,1
4060433,Multiple pregnancy NOS,racial,White,1,0,1
4086927,Contraception status,ethnic,Not Hispanic or Latino,1,0,1
443460,Pathological fracture of femur,racial,Unknown,1,0,1
317305,Stricture of artery,racial,Other Race,1,0,1
4177025,Fracture of patella,racial,Unknown,0,1,1
198995,Type 1 diabetes mellitus - poor control,racial,Alaska Native,1,0,1
81496,Tuberculosis of vertebral column,ethnic,Not Hispanic or Latino,0,1,1
436897,Transport fever,ethnic,Not Hispanic or Latino,0,1,1
375557,Cerebral embolism,racial,Asian,1,0,1
319038,Postmyocardial infarction syndrome,racial,White,0,1,1
25582,Tracheesophageal fistula,ethnic,Not Hispanic or Latino,0,1,1
435418,Accidental poisoning by caustic alkalis,racial,White,0,1,1
435835,Non-infectious disorder of lymphatics,racial,White,0,1,1
373755,Thunderclap headache,racial,Unknown,1,0,1
433657,Fall from furniture,racial,Other Race,1,0,1
440855,Closed fracture of base of metacarpal bone other than first metacarpal,racial,Unknown,0,1,1
136497,Scar conditions and fibrosis of skin,racial,Asian,1,0,1
434172,Insomnia with sleep apnoea,racial,Filipino,0,1,1
201905,Constipation by outlet obstruction,racial,Unknown,1,0,1
257905,Mucopurulent chronic bronchitis,racial,American Indian or Alaska Native ,1,0,1
439347,"Motor vehicle traffic accident involving pedestrian dragged by motor vehicle, passenger on motor cycle injured",ethnic,Hispanic or Latino,0,1,1
4064382,Skin disease screening,racial,Asian,1,0,1
321873,Dissection of carotid artery,racial,White,1,0,1
442170,Blister of neck with infection,racial,Unknown,1,0,1
81380,Cervical syndrome,racial,Asian,1,0,1
201332,Alveolitis of jaw,ethnic,Not Hispanic or Latino,1,0,1
192819,Typhoid fever,racial,White,1,0,1
442276,Closed medial dislocation of proximal end of tibia,ethnic,Not Hispanic or Latino,1,0,1
378734,Intraspinal abscess,ethnic,Hispanic or Latino,0,1,1
374139,Buphthalmos,racial,Unknown,1,0,1
4164770,Acute inflammatory demyelinating polyradiculoneuropathy,racial,White,0,1,1
433749,Heparin-induced thrombocytopenia,ethnic,Hispanic or Latino,0,1,1
372318,Chronic follicular conjunctivitis,racial,White,0,1,1
261738,Multiple burns of head and neck,ethnic,Hispanic or Latino,0,1,1
437590,Pulp necrosis,racial,White,0,1,1
137144,Open wound of palate with complication,ethnic,Hispanic or Latino,0,1,1
4237458,Fracture of clavicle,ethnic,Hispanic or Latino,1,0,1
137213,Fungal dermatosis,racial,Black or African American ,0,1,1
444384,Nonvenomous insect bite of leg with infection,ethnic,Not Hispanic or Latino,0,1,1
442454,"Motor vehicle traffic accident involving collision between motor vehicle and pedal cycle, passenger of motor vehicle injured",ethnic,Hispanic or Latino,0,1,1
4331070,Family history of polyp of colon,racial,Black or African American ,1,0,1
138502,Vitiligo,racial,Black or African American ,0,1,1
432478,Intracranial hemorrhage following injury without open intracranial wound AND with concussion,racial,Unknown,0,1,1
444259,Psychogenic amnesia,racial,White,1,0,1
433187,Cyclitis,racial,White,0,1,1
436940,Insulin resistance syndrome,racial,Black or African American ,0,1,1
433987,Benign tumour of orbit,ethnic,Hispanic or Latino,1,0,1
76777,Arthropathy associated with infection,racial,Other Race,1,0,1
375823,Optic nerve hypoplasia,racial,Unknown,0,1,1
443698,Abnormal anal Papanicolaou smear,ethnic,Not Hispanic or Latino,1,0,1
437693,Open fracture shaft of tibia,ethnic,Not Hispanic or Latino,0,1,1
442124,Orbital edema,racial,Unknown,1,0,1
317376,Tachypnoeic,racial,Unknown,0,1,1
437623,Polyhydramnios,ethnic,Hispanic or Latino,1,0,1
77178,Contusion of multiple sites of upper limb,ethnic,Not Hispanic or Latino,1,0,1
197377,Abnormal bowel sounds,racial,White,1,0,1
4286333,Carcinoma in situ,ethnic,Not Hispanic or Latino,1,0,1
4057346,"Contusion, hip and thigh",racial,Unknown,0,1,1
192785,Second degree burn of abdominal wall,ethnic,Not Hispanic or Latino,1,0,1
4147971,Personality disorder NOS,ethnic,Hispanic or Latino,1,0,1
197596,Toxic gastroenteritis,ethnic,Not Hispanic or Latino,0,1,1
256142,Dental arch relationship anomaly,racial,White,1,0,1
435925,Very premature - less than 1000g or less than 28 weeks,ethnic,Not Hispanic or Latino,0,1,1
436642,Adamantiades-Behcet disease,racial,White,1,0,1
444219,Osteitis deformans without bone tumor,ethnic,Not Hispanic or Latino,0,1,1
443262,Lack or loss of sexual desire,ethnic,Not Hispanic or Latino,1,0,1
135923,CP - Cleft palate,racial,Asian,1,0,1
78230,Rheumatoid arthritis with organ / system involvement,ethnic,Not Hispanic or Latino,1,0,1
436630,Visceral herpes simplex,ethnic,Hispanic or Latino,0,1,1
81380,Cervical syndrome,ethnic,Not Hispanic or Latino,1,0,1
440776,Abortion with complication,ethnic,Hispanic or Latino,1,0,1
40484028,Dental caries extending into dentine,racial,Asian,0,1,1
443415,Gestation greater than 24 weeks,racial,Other Race,0,1,1
380100,Glossopharyngeal neuralgia,racial,Unknown,1,0,1
381301,Chronic serous otitis media,racial,Other Race,1,0,1
4077080,Biopsy of chest wall,racial,White,0,1,1
441193,Accident caused by nonpowered hand tools and implements,ethnic,Hispanic or Latino,1,0,1
440088,Academic underachievement disorder,racial,Filipino,0,1,1
433095,Fall on or from steps,racial,Other Race,1,0,1
4096657,Toxic multinodular goitre NOS,racial,Unknown,1,0,1
78473,Solitary cyst of breast,racial,Other Race,1,0,1
444253,Blister of scalp without infection,ethnic,Not Hispanic or Latino,0,1,1
135893,Decubitus ulcer of heel,racial,Native Hawaiian or Other Pacific Islander ,0,1,1
437222,Respiratory syncytial virus infection,racial,Asian,0,1,1
194680,Acute gastric ulcer with perforation but without obstruction,ethnic,Hispanic or Latino,1,0,1
438903,Injury of external jugular vein,ethnic,Hispanic or Latino,1,0,1
433811,Hydronephrosis,racial,Filipino,1,0,1
4147972,Specific academic or work inhibition,racial,Unknown,0,1,1
441979,Open fracture of upper end of tibia,ethnic,Hispanic or Latino,0,1,1
138644,Burn erythema of lower limb,racial,White,1,0,1
372634,Nonphysiologic vision loss,racial,Filipino,0,1,1
199839,External haemorrhoids without complication,racial,American Indian or Alaska Native ,1,0,1
4058364,Superficial injury of foot and toe(s),racial,White,0,1,1
197050,Abnormality of organs AND/OR soft tissues of pelvis affecting pregnancy,racial,Unknown,1,0,1
432517,Posttraumatic wound infection,racial,Other Race,0,1,1
193693,Viral hepatitis without hepatic coma,racial,American Indian or Alaska Native ,0,1,1
260336,Primary malignant neoplasm of glottis,ethnic,Hispanic or Latino,0,1,1
196569,Contusion of abdominal wall,racial,Black or African American ,1,0,1
40480082,Hemicrania continua,racial,White,1,0,1
4129342,Nephrectomy of remaining or solitary kidney,ethnic,Not Hispanic or Latino,1,0,1
258458,Bacterial pleurisy with effusion,ethnic,Not Hispanic or Latino,1,0,1
141305,Unilateral sensorineural hearing loss with unrestricted hearing on the contralateral side,racial,Black or African American ,0,1,1
4062641,Malaria screening,racial,Black or African American ,1,0,1
315830,Variant angina,ethnic,Not Hispanic or Latino,1,0,1
77592,Articular crepitus of temporomandibular joint,racial,Other Race,1,0,1
75721,Prosthetic joint mechanical failure,ethnic,Hispanic or Latino,1,0,1
437922,Hematoma of vulva,ethnic,Not Hispanic or Latino,1,0,1
376106,Disorder of the central nervous system,racial,Unknown,1,0,1
4004785,Fetal alcohol syndrome,racial,Unknown,0,1,1
433675,Toxic effect of chemical,racial,Unknown,0,1,1
195864,Diverticulum of bladder,racial,White,0,1,1
377546,Chronic post-traumatic headache,ethnic,Hispanic or Latino,1,0,1
4298824,Free skin graft,ethnic,Hispanic or Latino,0,1,1
440840,Neonatal candidiasis,racial,Asian,1,0,1
77068,Secondary localised osteoarthrosis of lower leg,racial,Unknown,0,1,1
4096038,Diabetes mellitus NOS with ophthalmic manifestation,racial,Unknown,1,0,1
443323,Papyraceous fetus - not delivered,racial,White,1,0,1
434272,Varicella infection,racial,Black or African American ,0,1,1
434321,Schizoaffective schizophrenia in remission,racial,White,1,0,1
436624,Late congenital syphilis - latent,ethnic,Not Hispanic or Latino,0,1,1
193079,Injury of nerve of trunk,ethnic,Hispanic or Latino,1,0,1
72332,Serous labyrinthitis,racial,White,1,0,1
372886,Refractory migraine with aura,ethnic,Not Hispanic or Latino,1,0,1
4299653,Unilateral orchidectomy,racial,White,0,1,1
432719,Panniculitis,racial,Other Race,1,0,1
372423,Reduction deformities of brain,racial,Asian,1,0,1
438531,Chondromalacia,ethnic,Not Hispanic or Latino,1,0,1
441139,Instantaneous death,racial,Other Race,1,0,1
40482247,Organic sleep apnea,racial,Black or African American ,1,0,1
138918,Partial thickness burn of lip,racial,Unknown,0,1,1
441063,Acute gastrojejunal ulcer with hemorrhage AND obstruction,ethnic,Hispanic or Latino,1,0,1
379805,Myopia,racial,Filipino,0,1,1
378165,Nystagmus,racial,Black or African American ,1,0,1
260125,Acute bronchiolitis,racial,American Indian,1,0,1
4211231,Panic disorder without agoraphobia,racial,American Indian,1,0,1
379816,Simple chronic conjunctivitis,racial,White,1,0,1
314479,Primary apnea in the newborn,ethnic,Not Hispanic or Latino,0,1,1
136496,Cellulitis and abscess of face,racial,Filipino,0,1,1
197415,"Spleen capsular tear without major disruption of parenchyma, with open wound into cavity",ethnic,Hispanic or Latino,1,0,1
4117578,Other and unspecified joint disorders,ethnic,Hispanic or Latino,1,0,1
23798,Acute laryngopharyngitis,racial,American Indian or Alaska Native ,1,0,1
4204967,Laryngismus,racial,Other Race,1,0,1
257012,Chronic rhinosinusitis,racial,Asian Indian,0,1,1
4280828,"Carrier, infectious agent",racial,Other Race,1,0,1
437746,"Infection after injection, infusion, transfusion and vaccination",ethnic,Hispanic or Latino,0,1,1
75099,Coccyx sprain,ethnic,Not Hispanic or Latino,1,0,1
438783,Erosion of teeth,racial,White,0,1,1
437241,Qualitative platelet defect,racial,Unknown,0,1,1
444424,Open wound of Eustachian tube with complication,ethnic,Hispanic or Latino,0,1,1
318173,Vascular graft calcification,ethnic,Hispanic or Latino,1,0,1
4223536,Classical cesarean section,ethnic,Hispanic or Latino,1,0,1
435802,Blepharospasm,racial,Other Race,1,0,1
258453,Acute upper respiratory infection of multiple sites,racial,Filipino,1,0,1
377573,Pars tensa central perforation,racial,Other Race,0,1,1
436333,Orf virus disease,ethnic,Not Hispanic or Latino,1,0,1
433458,"Combined drug dependence, excluding opioid, in remission",racial,White,0,1,1
438583,Open fracture of femur,ethnic,Hispanic or Latino,1,0,1
4247802,Muscular dystrophy,racial,Other Race,0,1,1
441969,Radiology result abnormal,racial,Black or African American ,1,0,1
432789,Opioid analgesic adverse reaction,ethnic,Not Hispanic or Latino,0,1,1
437449,Victim of child abuse,racial,Black or African American ,0,1,1
77984,Congenital cleft hand,ethnic,Hispanic or Latino,0,1,1
434212,Contusion of axillary region,ethnic,Hispanic or Latino,1,0,1
4285734,Instability of joint,ethnic,Hispanic or Latino,0,1,1
376103,Retinopathy,racial,Asian,1,0,1
436230,Blood chemistry abnormal,racial,Asian Indian,1,0,1
432804,Fall from scaffold,racial,Unknown,1,0,1
138821,Seborrhea,racial,American Indian or Alaska Native ,1,0,1
438730,Alkalosis,racial,White,0,1,1
76744,Azoospermia,ethnic,Not Hispanic or Latino,0,1,1
378165,Nystagmus,racial,Asian Indian,0,1,1
437589,Pulpitis,racial,Other Race,1,0,1
4161977,Patient with cardiac pacemaker,racial,Filipino,1,0,1
196341,Dermatophytosis of the perianal area,racial,American Indian or Alaska Native ,1,0,1
441534,"Severe major depression, single episode, without psychotic features",racial,Other Race,1,0,1
